edon,disn,munn,seccion,id_elec,pan,apm,pbt,panal,asdc,efec,nr,nul,tot
1,1,1002,338,3,376,83,114,40,10,623,5,22,650
1,1,1002,339,3,321,122,66,30,19,558,9,13,580
1,1,1002,340,3,436,106,74,19,9,644,3,24,671
1,1,1002,341,3,512,87,131,38,12,780,10,18,808
1,1,1002,342,3,250,122,183,17,15,587,1,13,601
1,1,1002,343,3,650,315,252,66,11,1294,2,50,1346
1,1,1002,344,3,331,347,205,44,9,936,6,22,964
1,1,1002,345,3,267,292,204,30,12,805,7,29,841
1,1,1002,346,3,272,208,144,20,17,661,4,28,693
1,1,1002,347,3,626,184,208,39,5,1062,2,30,1094
1,1,1002,348,3,143,137,251,25,11,567,5,23,595
1,1,1002,349,3,273,259,261,33,12,838,2,26,866
1,1,1002,350,3,367,214,267,30,15,893,3,30,926
1,1,1002,351,3,221,130,213,24,4,592,2,23,617
1,1,1002,352,3,565,183,164,18,11,941,18,34,993
1,1,1002,353,3,259,145,161,22,6,593,3,6,602
1,1,1002,354,3,298,165,180,34,8,685,1,15,701
1,1,1003,355,3,268,95,121,28,21,533,0,2,535
1,1,1003,356,3,432,241,170,41,25,909,1,20,930
1,1,1003,357,3,408,142,115,28,16,709,1,16,726
1,1,1003,358,3,492,261,246,40,19,1058,2,28,1088
1,1,1003,359,3,256,115,92,18,9,490,3,14,507
1,1,1003,360,3,225,64,70,10,8,377,2,9,388
1,1,1003,361,3,393,172,229,26,11,831,0,7,838
1,1,1003,362,3,546,155,160,32,25,918,4,18,940
1,1,1003,363,3,277,130,208,29,15,659,0,22,681
1,1,1003,364,3,142,63,41,19,8,273,3,8,284
1,1,1003,365,3,139,11,8,4,2,164,0,5,169
1,1,1003,366,3,76,96,52,3,3,230,0,8,238
1,1,1003,367,3,273,269,119,52,13,726,2,19,747
1,1,1003,368,3,11,12,4,2,0,29,0,0,29
1,1,1003,369,3,144,24,15,2,0,185,0,6,191
1,1,1003,370,3,369,47,68,14,18,516,2,11,529
1,1,1003,371,3,298,35,27,12,6,378,0,8,386
1,1,1003,372,3,295,32,43,10,8,388,0,4,392
1,1,1003,373,3,101,88,24,7,4,224,2,7,233
1,1,1003,374,3,225,99,78,16,10,428,10,7,445
1,1,1003,375,3,320,67,148,35,19,589,2,18,609
1,1,1003,376,3,464,111,150,26,32,783,6,21,810
1,1,1003,377,3,300,83,113,33,17,546,1,14,561
1,1,1003,378,3,104,22,16,4,2,148,1,1,150
1,1,1003,379,3,482,28,70,19,4,603,2,13,618
1,1,1003,380,3,461,75,64,29,16,645,3,12,660
1,1,1003,381,3,245,54,47,11,8,365,0,11,376
1,1,1003,382,3,524,104,101,19,13,761,0,15,776
1,1,1003,383,3,461,121,189,31,24,826,1,19,846
1,1,1003,384,3,287,65,66,11,8,437,2,12,451
1,1,1003,385,3,324,88,68,16,18,514,0,11,525
1,1,1003,386,3,388,81,72,16,17,574,4,10,588
1,1,1004,387,3,497,453,181,99,13,1243,5,32,1280
1,1,1004,388,3,392,250,217,66,14,939,2,17,958
1,1,1004,389,3,330,303,59,48,5,745,3,9,757
1,1,1004,390,3,403,197,177,52,10,839,4,29,872
1,1,1004,391,3,559,314,91,20,5,989,6,22,1017
1,1,1005,392,3,761,531,209,69,35,1605,12,43,1660
1,1,1005,393,3,525,175,132,38,22,892,12,19,923
1,1,1005,394,3,735,541,194,77,24,1571,4,44,1619
1,1,1005,395,3,423,329,119,17,6,894,3,13,910
1,1,1005,396,3,1038,463,206,76,27,1810,6,18,1834
1,1,1005,397,3,1548,928,517,181,76,3250,10,60,3320
1,1,1005,398,3,297,274,46,52,8,677,1,9,687
1,1,1005,399,3,188,227,64,10,10,499,0,6,505
1,1,1005,400,3,305,209,88,22,16,640,7,14,661
1,1,1005,401,3,591,321,174,62,35,1183,5,22,1210
1,1,1005,402,3,311,155,78,16,10,570,7,22,599
1,1,1005,403,3,739,326,186,74,37,1362,0,47,1409
1,1,1010,404,3,214,125,23,17,6,385,2,5,392
1,1,1005,405,3,1190,517,338,103,92,2240,8,32,2280
1,1,1005,406,3,400,199,113,17,12,741,7,16,764
1,1,1005,407,3,155,225,18,11,8,417,3,13,433
1,1,1005,408,3,39,93,8,2,0,142,1,3,146
1,1,1005,409,3,216,171,34,9,9,439,1,6,446
1,1,1005,410,3,464,349,101,93,2,1009,4,41,1054
1,1,1005,411,3,568,508,187,60,28,1351,5,32,1388
1,1,1005,412,3,788,383,101,52,33,1357,5,44,1406
1,1,1005,413,3,582,199,109,42,37,969,4,21,994
1,1,1005,414,3,519,270,105,27,25,946,5,32,983
1,1,1006,415,3,490,435,328,235,26,1514,7,28,1549
1,1,1006,416,3,145,165,116,61,6,493,2,22,517
1,1,1006,417,3,224,186,183,116,24,733,2,25,760
1,1,1006,418,3,193,201,141,84,14,633,0,21,654
1,1,1006,419,3,276,299,233,134,22,964,5,20,989
1,1,1006,420,3,170,207,188,76,15,656,0,15,671
1,1,1006,421,3,553,553,545,173,44,1868,8,45,1921
1,1,1006,422,3,141,139,155,78,10,523,2,19,544
1,1,1006,423,3,206,172,196,53,15,642,5,33,680
1,1,1006,424,3,391,299,316,211,22,1239,3,25,1267
1,1,1006,425,3,118,147,115,63,3,446,1,3,450
1,1,1006,426,3,121,237,104,35,4,501,1,16,518
1,1,1006,427,3,145,114,56,5,7,327,2,7,336
1,1,1006,428,3,343,235,142,50,12,782,2,20,804
1,1,1006,429,3,219,497,192,40,15,963,7,38,1008
1,1,1006,430,3,229,185,74,15,6,509,5,10,524
1,1,1007,431,3,214,56,108,48,15,441,2,7,450
1,1,1007,432,3,261,177,126,47,14,625,5,12,642
1,1,1007,433,3,155,91,99,51,6,402,2,11,415
1,1,1007,434,3,224,114,103,68,17,526,1,11,538
1,1,1007,435,3,256,111,136,83,8,594,2,9,605
1,1,1007,436,3,380,182,155,86,22,825,7,27,859
1,1,1007,437,3,242,174,145,90,19,670,3,14,687
1,1,1007,438,3,164,166,98,72,9,509,2,11,522
1,1,1007,439,3,373,197,254,88,18,930,3,16,949
1,1,1007,440,3,914,542,563,215,53,2287,4,47,2338
1,1,1007,441,3,230,157,157,70,30,644,0,12,656
1,1,1007,442,3,276,157,42,14,3,492,4,14,510
1,1,1007,443,3,349,317,65,33,14,778,6,17,801
1,1,1007,444,3,164,117,32,3,2,318,2,12,332
1,1,1007,445,3,370,146,78,17,7,618,5,17,640
1,1,1007,446,3,266,122,105,17,9,519,0,18,537
1,1,1007,447,3,357,235,110,23,10,735,1,13,749
1,1,1007,448,3,175,108,72,20,7,382,4,6,392
1,1,1007,449,3,408,232,104,34,18,796,0,27,823
1,1,1007,450,3,221,176,61,23,8,489,4,12,505
1,1,1007,451,3,179,68,20,18,5,290,2,6,298
1,1,1008,452,3,189,87,207,59,25,567,2,26,595
1,1,1008,453,3,184,103,170,44,26,527,1,20,548
1,1,1008,454,3,180,138,237,66,22,643,7,15,665
1,1,1008,455,3,84,39,28,8,3,162,1,9,172
1,1,1008,456,3,82,54,32,3,2,173,0,6,179
1,1,1008,457,3,127,93,76,7,4,307,1,10,318
1,1,1008,458,3,203,86,111,12,17,429,1,19,449
1,1,1008,459,3,30,34,4,4,0,72,0,3,75
1,1,1009,460,3,326,130,71,22,5,554,0,17,571
1,1,1009,461,3,344,245,69,26,8,692,3,13,708
1,1,1009,462,3,279,213,125,86,7,710,2,14,726
1,1,1009,463,3,254,137,124,12,5,532,2,8,542
1,1,1009,464,3,487,149,80,20,6,742,4,14,760
1,1,1009,465,3,96,66,26,11,3,202,0,8,210
1,1,1009,466,3,103,92,62,3,2,262,0,8,270
1,1,1009,467,3,321,277,121,42,7,768,2,10,780
1,1,1009,468,3,63,97,95,16,1,272,0,5,277
1,1,1009,469,3,568,198,204,83,10,1063,5,16,1084
1,1,1010,470,3,378,203,179,48,17,825,1,17,843
1,1,1010,471,3,402,198,157,55,15,827,2,29,858
1,1,1010,472,3,328,210,145,45,21,749,2,12,763
1,1,1010,473,3,865,494,473,133,41,2006,9,51,2066
1,1,1010,474,3,277,231,47,12,5,572,1,0,573
1,1,1010,475,3,204,158,137,20,3,522,1,9,532
1,1,1010,476,3,204,288,106,20,11,629,1,17,647
1,1,1010,477,3,409,283,207,33,14,946,6,31,983
1,1,1010,478,3,641,555,270,81,42,1589,9,32,1630
1,1,1011,479,3,220,278,240,96,6,840,2,29,871
1,1,1011,480,3,243,269,164,81,12,769,1,23,793
1,1,1011,481,3,206,177,166,16,5,570,1,6,577
1,1,1011,482,3,374,450,220,54,11,1109,1,22,1132
1,1,1011,483,3,199,164,41,11,2,417,0,10,427
1,1,1011,484,3,153,177,34,19,8,391,6,11,408
1,1,1011,485,3,314,376,202,60,14,966,2,37,1005
1,1,1011,486,3,257,378,112,31,5,783,8,27,818
1,1,1003,487,3,35,5,3,1,0,44,0,0,44
1,1,1006,488,3,66,7,14,5,1,93,0,1,94
1,2,1001,42,3,290,163,71,27,19,570,4,24,598
1,2,1001,43,3,548,221,160,55,24,1008,6,13,1027
1,2,1001,57,3,257,176,110,36,16,595,2,14,611
1,2,1001,58,3,198,146,93,23,11,471,2,18,491
1,2,1001,63,3,178,111,98,41,6,434,0,4,438
1,2,1001,64,3,300,144,98,36,28,606,4,9,619
1,2,1001,65,3,222,119,62,25,11,439,1,10,450
1,2,1001,66,3,284,180,100,29,13,606,2,23,631
1,2,1001,67,3,261,90,52,15,13,431,2,9,442
1,2,1001,68,3,209,105,108,22,19,463,0,9,472
1,2,1001,69,3,329,164,105,40,22,660,1,11,672
1,2,1001,70,3,208,114,103,27,14,466,0,8,474
1,2,1001,71,3,516,176,100,33,23,848,1,15,864
1,2,1001,72,3,176,105,65,19,6,371,3,13,387
1,2,1001,73,3,347,160,67,27,16,617,0,13,630
1,2,1001,74,3,260,107,72,16,18,473,4,6,483
1,2,1001,75,3,243,91,115,14,16,479,0,5,484
1,2,1001,76,3,214,98,78,12,12,414,2,3,419
1,2,1001,77,3,212,100,90,18,15,435,1,1,437
1,2,1001,78,3,248,153,98,38,14,551,2,7,560
1,2,1001,79,3,305,147,82,28,17,579,0,14,593
1,2,1001,80,3,1066,577,465,136,100,2344,11,55,2410
1,2,1001,81,3,1522,836,748,230,140,3476,17,61,3554
1,2,1001,82,3,1536,609,495,121,130,2891,12,35,2938
1,2,1001,83,3,500,577,387,77,34,1575,13,49,1637
1,2,1001,84,3,257,500,225,52,24,1058,8,38,1104
1,2,1001,85,3,487,463,355,72,33,1410,15,27,1452
1,2,1001,86,3,1398,1090,836,225,145,3694,24,74,3792
1,2,1001,87,3,419,232,204,64,31,950,1,22,973
1,2,1001,88,3,291,180,105,32,21,629,5,25,659
1,2,1001,89,3,241,214,117,27,19,618,6,15,639
1,2,1001,90,3,705,306,246,58,64,1379,11,16,1406
1,2,1001,91,3,296,128,81,30,24,559,1,12,572
1,2,1001,92,3,260,109,121,22,16,528,2,12,542
1,2,1001,93,3,233,165,111,25,24,558,1,8,567
1,2,1001,94,3,201,122,59,21,8,411,2,13,426
1,2,1001,95,3,223,178,136,27,26,590,1,12,603
1,2,1001,96,3,506,245,202,54,56,1063,3,29,1095
1,2,1001,97,3,121,221,86,22,9,459,3,20,482
1,2,1001,99,3,247,363,198,45,27,880,4,21,905
1,2,1001,100,3,208,228,127,35,19,617,0,24,641
1,2,1001,101,3,328,191,133,47,34,733,0,19,752
1,2,1001,102,3,198,149,147,24,13,531,0,10,541
1,2,1001,103,3,224,146,95,26,18,509,4,20,533
1,2,1001,104,3,173,129,96,19,20,437,2,14,453
1,2,1001,105,3,161,131,86,19,10,407,0,11,418
1,2,1001,106,3,386,191,141,46,24,788,0,6,794
1,2,1001,107,3,368,171,117,41,21,718,2,13,733
1,2,1001,108,3,319,184,108,33,33,677,3,19,699
1,2,1001,109,3,430,199,148,46,26,849,5,27,881
1,2,1001,110,3,139,90,51,11,5,296,2,4,302
1,2,1001,111,3,269,218,173,26,18,704,5,22,731
1,2,1001,112,3,326,175,179,38,27,745,0,17,762
1,2,1001,113,3,324,152,159,75,24,734,5,9,748
1,2,1001,114,3,295,130,126,33,13,597,0,8,605
1,2,1001,115,3,258,221,165,39,27,710,0,18,728
1,2,1001,116,3,1642,1149,798,300,186,4075,15,65,4155
1,2,1001,117,3,304,292,166,49,31,842,5,11,858
1,2,1001,118,3,1136,818,607,168,123,2852,4,52,2908
1,2,1001,119,3,901,323,347,107,68,1746,6,23,1775
1,2,1001,120,3,228,142,83,37,15,505,0,13,518
1,2,1001,121,3,177,95,113,24,15,424,0,13,437
1,2,1001,122,3,267,204,151,28,22,672,5,11,688
1,2,1001,123,3,181,117,133,23,17,471,8,0,479
1,2,1001,124,3,149,95,93,22,19,378,1,8,387
1,2,1001,125,3,300,185,179,36,27,727,2,16,745
1,2,1001,126,3,377,315,169,47,24,932,5,15,952
1,2,1001,127,3,276,272,286,41,30,905,5,17,927
1,2,1001,128,3,149,167,240,36,27,619,1,13,633
1,2,1001,129,3,197,169,254,37,32,689,2,8,699
1,2,1001,130,3,293,225,276,44,31,869,1,7,877
1,2,1001,131,3,246,182,195,41,23,687,2,11,700
1,2,1001,132,3,205,188,173,43,31,640,1,16,657
1,2,1001,133,3,244,223,165,35,19,686,4,11,701
1,2,1001,134,3,225,141,178,46,21,611,1,5,617
1,2,1001,135,3,271,196,190,49,23,729,11,3,743
1,2,1001,136,3,366,312,220,45,34,977,4,23,1004
1,2,1001,137,3,73,74,82,23,14,266,0,3,269
1,2,1001,138,3,382,239,208,52,37,918,7,18,943
1,2,1001,139,3,201,174,147,29,14,565,4,10,579
1,2,1001,140,3,308,182,161,42,22,715,3,11,729
1,2,1001,141,3,275,182,149,34,40,680,1,18,699
1,2,1001,142,3,214,167,162,46,25,614,1,8,623
1,2,1001,143,3,219,166,141,33,20,579,2,14,595
1,2,1001,144,3,202,199,162,41,25,629,1,15,645
1,2,1001,145,3,233,147,133,24,17,554,0,10,564
1,2,1001,146,3,252,235,183,44,14,728,1,19,748
1,2,1001,147,3,182,237,164,36,28,647,3,9,659
1,2,1001,148,3,309,246,212,58,17,842,8,16,866
1,2,1001,149,3,800,544,497,172,75,2088,3,28,2119
1,2,1001,150,3,159,132,188,32,44,555,4,10,569
1,2,1001,151,3,146,93,64,21,19,343,1,7,351
1,2,1001,152,3,416,470,321,82,46,1335,12,36,1383
1,2,1001,153,3,154,142,207,64,30,597,3,9,609
1,2,1001,154,3,213,309,140,17,14,693,3,27,723
1,2,1001,155,3,1286,1126,871,155,102,3540,24,64,3628
1,2,1001,156,3,2414,1422,1165,279,206,5486,32,89,5607
1,2,1001,157,3,187,168,142,34,12,543,1,19,563
1,2,1001,158,3,104,62,67,17,21,271,1,3,275
1,2,1001,159,3,168,162,134,23,14,501,1,9,511
1,2,1001,160,3,267,208,160,59,28,722,0,19,741
1,2,1001,164,3,1739,637,734,190,149,3449,8,39,3496
1,2,1001,165,3,355,126,171,44,14,710,0,11,721
1,2,1001,167,3,177,59,109,18,9,372,1,7,380
1,2,1001,168,3,649,343,334,95,61,1482,3,22,1507
1,2,1001,169,3,377,311,246,66,51,1051,5,9,1065
1,2,1001,170,3,470,291,300,58,35,1154,7,25,1186
1,2,1001,185,3,104,72,61,8,10,255,0,8,263
1,2,1001,186,3,93,80,44,14,8,239,3,3,245
1,2,1001,315,3,495,551,295,29,25,1395,12,47,1454
1,2,1001,316,3,250,509,220,94,21,1094,2,26,1122
1,2,1001,317,3,524,341,191,45,23,1124,4,20,1148
1,2,1001,318,3,487,404,194,50,18,1153,6,33,1192
1,2,1001,323,3,160,141,30,4,3,338,2,11,351
1,2,1001,324,3,369,225,66,17,6,683,3,25,711
1,2,1001,325,3,620,374,176,48,35,1253,7,35,1295
1,2,1001,332,3,348,431,105,59,15,958,5,28,991
1,2,1001,489,3,126,100,94,11,12,343,8,11,362
1,2,1001,490,3,115,96,93,10,10,324,2,11,337
1,2,1001,491,3,93,136,82,8,6,325,7,6,338
1,2,1001,492,3,99,121,72,13,9,314,1,11,326
1,2,1001,493,3,88,122,60,9,4,283,2,11,296
1,2,1001,494,3,59,37,42,12,9,159,2,5,166
1,2,1001,495,3,115,79,70,20,8,292,1,7,300
1,2,1001,496,3,135,74,56,27,8,300,1,3,304
1,2,1001,497,3,120,54,45,11,5,235,1,5,241
1,2,1001,498,3,136,129,76,21,13,375,0,9,384
1,2,1001,499,3,133,125,83,20,15,376,8,15,399
1,2,1001,500,3,110,148,78,18,18,372,4,8,384
1,2,1001,501,3,163,140,105,23,14,445,2,10,457
1,2,1001,502,3,98,123,83,19,20,343,3,9,355
1,2,1001,503,3,117,59,47,18,10,251,1,3,255
1,2,1001,504,3,164,149,71,35,22,441,1,15,457
1,2,1001,505,3,126,95,77,19,16,333,1,11,345
1,2,1001,506,3,129,127,68,24,14,362,5,4,371
1,2,1001,507,3,121,105,41,26,20,313,1,0,314
1,2,1001,508,3,87,91,53,16,11,258,2,6,266
1,2,1001,509,3,100,128,90,11,15,344,9,10,363
1,2,1001,510,3,80,124,53,17,9,283,2,0,285
1,2,1001,511,3,109,104,87,14,17,331,2,5,338
1,2,1001,512,3,92,76,34,5,3,210,0,2,212
1,2,1001,513,3,78,73,52,19,6,228,0,4,232
1,2,1001,514,3,119,67,73,20,14,293,0,4,297
1,2,1001,515,3,169,74,96,16,11,366,0,6,372
1,2,1001,516,3,142,79,55,18,9,303,0,5,308
1,2,1001,517,3,169,76,104,22,14,385,2,3,390
1,2,1001,518,3,135,62,89,20,15,321,1,1,323
1,2,1001,519,3,156,53,60,26,23,318,0,8,326
1,2,1001,520,3,140,82,109,27,16,374,0,9,383
1,2,1001,521,3,176,72,100,17,9,374,1,4,379
1,2,1001,522,3,124,70,146,21,13,374,3,5,382
1,2,1001,523,3,115,122,74,13,6,330,4,12,346
1,2,1001,524,3,120,132,89,17,17,375,3,6,384
1,2,1001,525,3,222,157,179,39,26,623,5,14,642
1,2,1001,526,3,80,30,79,13,3,205,2,0,207
1,2,1001,527,3,130,105,94,26,14,369,0,6,375
1,2,1001,528,3,99,54,82,12,9,256,4,5,265
1,2,1001,529,3,137,124,82,10,10,363,4,10,377
1,2,1001,530,3,163,70,88,15,17,353,0,9,362
1,2,1001,531,3,139,89,72,31,12,343,0,7,350
1,2,1001,532,3,130,68,103,31,10,342,2,3,347
1,2,1001,533,3,112,91,69,17,13,302,1,3,306
1,2,1001,534,3,113,81,89,22,9,314,2,12,328
1,2,1001,535,3,115,71,79,15,11,291,4,5,300
1,2,1001,536,3,126,69,113,16,13,337,3,12,352
1,2,1001,537,3,90,63,99,16,7,275,2,4,281
1,2,1001,538,3,64,59,74,15,15,227,0,3,230
1,2,1001,539,3,87,66,60,7,11,231,2,4,237
1,2,1001,540,3,114,97,74,25,6,316,5,3,324
1,2,1001,541,3,110,71,58,17,13,269,1,2,272
1,2,1001,542,3,157,83,100,17,21,378,0,4,382
1,2,1001,543,3,119,87,87,18,7,318,0,3,321
1,2,1001,544,3,107,86,71,7,11,282,0,9,291
1,2,1001,545,3,121,79,75,13,11,299,1,10,310
1,2,1001,546,3,144,99,87,12,15,357,3,6,366
1,2,1001,547,3,142,108,97,16,15,378,3,6,387
1,2,1001,548,3,85,97,89,12,5,288,0,10,298
1,2,1001,549,3,50,48,36,5,3,142,2,2,146
1,2,1001,550,3,110,56,64,21,9,260,3,3,266
1,2,1001,551,3,128,75,80,14,5,302,1,0,303
1,2,1001,552,3,112,48,46,18,6,230,0,3,233
1,2,1001,553,3,142,54,58,19,16,289,0,5,294
1,2,1001,554,3,136,73,63,19,20,311,0,10,321
1,2,1001,555,3,80,44,47,7,13,191,1,1,193
1,2,1001,556,3,156,82,56,20,16,330,0,1,331
1,2,1001,557,3,165,70,59,21,23,338,1,3,342
1,2,1001,558,3,146,64,99,25,19,353,3,1,357
1,2,1001,559,3,152,56,53,15,12,288,1,3,292
1,2,1001,560,3,105,59,57,24,10,255,3,5,263
1,2,1001,561,3,62,48,26,8,5,149,1,3,153
1,2,1001,562,3,132,160,81,15,13,401,1,0,402
1,2,1001,563,3,141,128,86,15,5,375,1,13,389
1,2,1001,564,3,102,133,111,27,5,378,0,13,391
1,2,1001,565,3,118,100,82,18,6,324,4,7,335
1,2,1001,566,3,115,106,60,11,11,303,4,11,318
1,2,1001,567,3,149,120,83,25,15,392,2,10,404
1,2,1001,568,3,104,85,70,8,7,274,3,0,277
1,2,1001,569,3,111,107,72,19,14,323,2,13,338
1,2,1001,570,3,80,61,59,16,7,223,0,8,231
1,2,1001,571,3,63,120,69,9,7,268,6,6,280
1,2,1001,572,3,102,44,41,14,2,203,1,7,211
1,2,1001,573,3,148,97,44,10,7,306,6,12,324
1,2,1001,574,3,106,185,33,6,3,333,1,15,349
1,2,1001,575,3,105,145,41,3,3,297,4,14,315
1,2,1001,576,3,60,86,54,7,7,214,2,23,239
1,2,1001,577,3,92,61,74,7,9,243,0,12,255
1,2,1001,578,3,92,61,74,7,9,243,0,12,255
1,2,1001,579,3,86,48,53,8,3,198,3,28,229
1,2,1001,580,3,97,79,62,8,12,258,5,9,272
1,2,1001,581,3,119,65,61,8,8,261,4,1,266
1,2,1001,582,3,133,61,56,14,6,270,1,0,271
1,2,1001,583,3,108,78,96,12,7,301,0,7,308
1,2,1001,584,3,99,86,64,11,10,270,1,2,273
1,2,1001,585,3,134,67,54,17,5,277,1,0,278
1,2,1001,586,3,123,62,70,16,10,281,11,2,294
1,2,1001,587,3,115,67,48,7,13,250,3,11,264
1,2,1001,588,3,89,56,65,11,8,229,8,5,242
1,2,1001,589,3,93,64,43,13,9,222,4,2,228
1,2,1001,590,3,77,66,50,8,12,213,0,5,218
1,2,1001,591,3,98,29,41,8,12,188,0,0,188
1,2,1001,592,3,91,67,41,8,15,222,3,1,226
1,2,1001,593,3,44,55,43,5,5,152,3,6,161
1,3,1001,1,3,801,303,71,30,27,1232,2,22,1256
1,3,1001,2,3,326,207,36,20,6,595,4,10,609
1,3,1001,3,3,570,197,146,53,25,991,1,19,1011
1,3,1001,4,3,381,180,145,99,39,844,0,13,857
1,3,1001,5,3,306,142,76,34,15,573,4,9,586
1,3,1001,6,3,310,131,88,44,14,587,3,3,593
1,3,1001,7,3,391,135,85,35,16,662,2,8,672
1,3,1001,8,3,425,287,83,46,18,859,1,14,874
1,3,1001,9,3,413,278,172,67,19,949,0,14,963
1,3,1001,10,3,488,228,97,50,14,877,1,3,881
1,3,1001,11,3,496,152,126,45,26,845,2,17,864
1,3,1001,12,3,380,165,80,56,19,700,1,9,710
1,3,1001,13,3,348,137,94,32,21,632,3,10,645
1,3,1001,14,3,392,152,108,47,17,716,1,13,730
1,3,1001,15,3,308,160,97,38,9,612,3,13,628
1,3,1001,16,3,263,115,66,40,7,491,0,17,508
1,3,1001,17,3,341,146,91,51,20,649,0,15,664
1,3,1001,18,3,361,170,95,49,14,689,3,15,707
1,3,1001,19,3,373,146,95,50,21,685,4,5,694
1,3,1001,20,3,423,153,108,53,25,762,3,12,777
1,3,1001,21,3,398,198,121,39,18,774,0,18,792
1,3,1001,22,3,215,179,72,25,7,498,1,8,507
1,3,1001,23,3,340,174,63,35,16,628,6,16,650
1,3,1001,24,3,204,124,34,17,10,389,0,14,403
1,3,1001,25,3,383,126,70,36,11,626,2,17,645
1,3,1001,26,3,405,176,98,47,15,741,2,29,772
1,3,1001,27,3,197,118,54,22,0,391,0,8,399
1,3,1001,28,3,110,96,44,18,5,273,2,8,283
1,3,1001,29,3,233,186,100,17,16,552,1,17,570
1,3,1001,30,3,183,117,51,24,17,392,0,7,399
1,3,1001,31,3,286,134,74,39,6,539,1,25,565
1,3,1001,32,3,320,254,88,41,8,711,5,18,734
1,3,1001,33,3,242,167,97,33,15,554,2,19,575
1,3,1001,34,3,302,97,41,26,13,479,0,11,490
1,3,1001,35,3,561,234,125,45,30,995,0,22,1017
1,3,1001,36,3,354,171,95,29,25,674,0,10,684
1,3,1001,37,3,536,245,119,43,20,963,0,10,973
1,3,1001,38,3,445,248,156,53,27,929,1,31,961
1,3,1001,39,3,286,161,74,27,11,559,2,24,585
1,3,1001,40,3,479,208,126,44,20,877,4,26,907
1,3,1001,41,3,699,267,132,48,47,1193,7,21,1221
1,3,1001,44,3,1724,462,270,92,73,2621,4,36,2661
1,3,1001,45,3,786,261,111,48,34,1240,1,15,1256
1,3,1001,46,3,849,242,116,48,16,1271,6,21,1298
1,3,1001,47,3,1568,367,205,74,52,2266,1,15,2282
1,3,1001,48,3,646,163,87,37,21,954,0,18,972
1,3,1001,49,3,453,228,99,43,17,840,1,16,857
1,3,1001,50,3,550,179,153,57,31,970,2,23,995
1,3,1001,51,3,429,188,134,44,21,816,2,10,828
1,3,1001,52,3,436,184,120,35,18,793,5,15,813
1,3,1001,53,3,705,209,146,50,36,1146,5,15,1166
1,3,1001,54,3,385,153,98,37,13,686,5,8,699
1,3,1001,55,3,390,193,123,34,21,761,4,13,778
1,3,1001,56,3,399,129,97,28,15,668,2,10,680
1,3,1001,59,3,286,121,58,26,11,502,0,9,511
1,3,1001,60,3,353,173,95,40,15,676,2,23,701
1,3,1001,61,3,251,163,74,25,14,527,4,14,545
1,3,1001,62,3,178,124,73,30,14,419,0,14,433
1,3,1001,161,3,1482,631,465,157,96,2831,6,36,2873
1,3,1001,162,3,262,133,102,33,14,544,4,15,563
1,3,1001,163,3,232,127,81,23,15,478,3,14,495
1,3,1001,171,3,237,102,62,21,10,432,5,4,441
1,3,1001,172,3,268,177,53,26,14,538,3,4,545
1,3,1001,173,3,219,97,36,13,11,376,2,9,387
1,3,1001,174,3,497,162,83,38,15,795,1,12,808
1,3,1001,175,3,431,122,62,36,17,668,3,13,684
1,3,1001,176,3,214,80,38,13,4,349,0,10,359
1,3,1001,177,3,417,146,85,29,14,691,1,14,706
1,3,1001,178,3,215,155,69,20,16,475,4,11,490
1,3,1001,179,3,339,157,107,29,15,647,4,11,662
1,3,1001,180,3,161,110,90,19,12,392,1,8,401
1,3,1001,181,3,190,125,87,20,15,437,2,4,443
1,3,1001,182,3,246,112,82,19,15,474,2,0,476
1,3,1001,183,3,138,89,67,9,7,310,3,5,318
1,3,1001,184,3,289,167,104,30,4,594,1,15,610
1,3,1001,187,3,195,138,78,31,20,462,1,12,475
1,3,1001,188,3,318,321,117,42,17,815,2,25,842
1,3,1001,189,3,374,207,130,35,25,771,3,18,792
1,3,1001,190,3,529,254,136,52,36,1007,3,4,1014
1,3,1001,191,3,168,157,86,29,14,454,2,8,464
1,3,1001,192,3,301,241,116,37,14,709,2,19,730
1,3,1001,193,3,262,170,81,20,11,544,4,20,568
1,3,1001,194,3,589,317,142,61,32,1141,7,30,1178
1,3,1001,195,3,368,174,107,34,25,708,2,20,730
1,3,1001,196,3,295,110,93,33,11,542,2,11,555
1,3,1001,197,3,384,125,75,33,18,635,0,12,647
1,3,1001,198,3,190,101,56,27,10,384,0,11,395
1,3,1001,199,3,180,154,72,20,15,441,3,15,459
1,3,1001,200,3,374,166,93,31,21,685,3,12,700
1,3,1001,201,3,341,192,97,26,15,671,3,14,688
1,3,1001,202,3,205,136,88,22,5,456,2,12,470
1,3,1001,203,3,212,193,66,25,14,510,3,11,524
1,3,1001,204,3,360,275,126,44,29,834,1,16,851
1,3,1001,205,3,314,312,96,36,23,781,1,12,794
1,3,1001,206,3,177,101,53,20,8,359,5,6,370
1,3,1001,207,3,378,228,129,36,19,790,8,3,801
1,3,1001,208,3,590,242,108,46,26,1012,4,14,1030
1,3,1001,209,3,513,216,76,19,8,832,1,12,845
1,3,1001,210,3,567,211,89,18,21,906,0,0,906
1,3,1001,211,3,170,124,50,12,8,364,2,10,376
1,3,1001,212,3,251,107,69,38,11,476,3,14,493
1,3,1001,213,3,260,107,72,39,19,497,0,16,513
1,3,1001,214,3,461,240,77,27,13,818,0,18,836
1,3,1001,215,3,566,191,73,41,21,892,0,12,904
1,3,1001,216,3,419,110,79,23,18,649,1,15,665
1,3,1001,217,3,405,153,88,49,29,724,1,9,734
1,3,1001,218,3,506,217,125,44,24,916,0,24,940
1,3,1001,219,3,307,129,55,31,15,537,1,8,546
1,3,1001,220,3,452,175,89,34,29,779,2,10,791
1,3,1001,221,3,425,186,78,45,22,756,2,7,765
1,3,1001,222,3,491,221,107,49,30,898,1,16,915
1,3,1001,223,3,206,101,60,29,15,411,2,6,419
1,3,1001,224,3,393,154,137,59,12,755,0,6,761
1,3,1001,225,3,323,242,133,30,18,746,1,19,766
1,3,1001,226,3,376,141,73,39,19,648,2,8,658
1,3,1001,227,3,195,187,44,22,13,461,2,4,467
1,3,1001,228,3,216,142,75,27,10,470,1,14,485
1,3,1001,229,3,255,159,90,26,17,547,0,15,562
1,3,1001,230,3,439,250,122,61,23,895,2,7,904
1,3,1001,231,3,439,166,110,58,24,797,2,13,812
1,3,1001,232,3,145,135,85,17,10,392,0,17,409
1,3,1001,233,3,163,151,95,36,15,460,4,16,480
1,3,1001,234,3,181,128,90,37,9,445,2,18,465
1,3,1001,235,3,128,131,66,24,6,355,2,7,364
1,3,1001,236,3,214,199,164,27,15,619,3,9,631
1,3,1001,237,3,122,161,107,25,14,429,2,8,439
1,3,1001,238,3,171,166,105,31,14,487,6,17,510
1,3,1001,239,3,127,165,119,22,8,441,4,13,458
1,3,1001,240,3,155,160,73,16,4,408,3,15,426
1,3,1001,241,3,135,183,52,17,7,394,2,12,408
1,3,1001,242,3,135,162,45,19,0,361,11,8,380
1,3,1001,243,3,381,261,108,58,27,835,5,22,862
1,3,1001,244,3,283,239,93,50,10,675,2,11,688
1,3,1001,245,3,214,201,71,27,11,524,1,7,532
1,3,1001,246,3,193,181,103,31,16,524,1,8,533
1,3,1001,247,3,167,180,108,22,4,481,2,17,500
1,3,1001,248,3,136,185,71,22,6,420,2,13,435
1,3,1001,249,3,184,211,125,18,15,553,3,13,569
1,3,1001,250,3,137,189,106,25,11,468,4,16,488
1,3,1001,251,3,157,186,148,21,14,526,6,18,550
1,3,1001,252,3,169,162,104,20,11,466,5,14,485
1,3,1001,253,3,205,95,119,27,22,468,4,12,484
1,3,1001,254,3,173,145,78,19,8,423,6,14,443
1,3,1001,255,3,129,185,39,31,7,391,0,12,403
1,3,1001,256,3,178,161,98,28,10,475,1,9,485
1,3,1001,257,3,536,488,194,79,32,1329,9,27,1365
1,3,1001,258,3,311,282,109,38,20,760,1,13,774
1,3,1001,259,3,166,122,48,20,6,362,0,7,369
1,3,1001,260,3,526,223,162,37,35,983,1,13,997
1,3,1001,261,3,264,230,83,27,14,618,3,6,627
1,3,1001,262,3,101,126,58,18,7,310,1,2,313
1,3,1001,263,3,194,149,66,32,17,458,1,10,469
1,3,1001,264,3,266,177,72,34,18,567,1,10,578
1,3,1001,265,3,214,177,71,28,6,496,1,7,504
1,3,1001,266,3,163,152,60,20,8,403,1,3,407
1,3,1001,267,3,304,231,97,39,19,690,5,17,712
1,3,1001,268,3,156,136,48,25,15,380,0,9,389
1,3,1001,269,3,247,167,57,22,12,505,1,20,526
1,3,1001,270,3,1394,796,402,197,93,2882,8,55,2945
1,3,1001,271,3,252,179,73,22,11,537,2,13,552
1,3,1001,272,3,260,146,100,40,10,556,1,13,570
1,3,1001,273,3,251,165,71,19,11,517,2,13,532
1,3,1001,274,3,290,161,69,21,6,547,1,7,555
1,3,1001,275,3,313,214,77,34,11,649,2,12,663
1,3,1001,276,3,415,160,101,24,14,714,2,14,730
1,3,1001,277,3,380,155,72,20,12,639,1,9,649
1,3,1001,278,3,383,138,46,26,11,604,3,9,616
1,3,1001,279,3,352,126,69,25,14,586,2,1,589
1,3,1001,280,3,276,96,58,15,18,463,2,10,475
1,3,1001,281,3,283,117,73,30,22,525,0,8,533
1,3,1001,282,3,233,104,52,21,9,419,5,8,432
1,3,1001,283,3,322,109,55,21,14,521,0,5,526
1,3,1001,284,3,373,236,81,39,23,752,0,5,757
1,3,1001,285,3,236,116,76,25,16,469,0,9,478
1,3,1001,286,3,180,126,64,26,17,413,2,11,426
1,3,1001,287,3,227,108,72,23,14,444,1,10,455
1,3,1001,288,3,317,119,79,36,12,563,0,16,579
1,3,1001,289,3,226,134,80,35,16,491,2,8,501
1,3,1001,290,3,198,127,75,19,13,432,3,9,444
1,3,1001,291,3,404,154,96,36,21,711,0,22,733
1,3,1001,292,3,288,161,81,44,20,594,1,16,611
1,3,1001,293,3,288,194,101,29,15,627,2,7,636
1,3,1001,294,3,331,152,102,40,15,640,3,11,654
1,3,1001,295,3,420,211,141,40,31,843,3,19,865
1,3,1001,296,3,375,152,95,53,29,704,0,13,717
1,3,1001,297,3,279,151,90,30,19,569,2,14,585
1,3,1001,298,3,428,201,114,48,22,813,7,23,843
1,3,1001,299,3,383,189,102,37,9,720,3,21,744
1,3,1001,300,3,261,203,99,46,13,622,1,6,629
1,3,1001,301,3,782,313,225,78,59,1457,1,14,1472
1,3,1001,302,3,284,189,120,41,21,655,2,11,668
1,3,1001,303,3,259,150,78,27,19,533,3,19,555
1,3,1001,304,3,307,250,84,34,14,689,2,16,707
1,3,1001,305,3,289,204,82,40,17,632,7,14,653
1,3,1001,306,3,253,230,101,44,22,650,5,18,673
1,3,1001,307,3,344,240,116,71,33,804,7,7,818
1,3,1001,308,3,278,205,111,43,24,661,1,10,672
1,3,1001,309,3,366,257,100,37,21,781,6,8,795
1,3,1001,310,3,270,219,105,99,30,723,4,15,742
1,3,1001,311,3,299,237,104,55,19,714,3,13,730
1,3,1001,312,3,303,245,119,68,23,758,5,14,777
1,3,1001,313,3,338,256,124,40,11,769,3,23,795
1,3,1001,314,3,255,253,76,37,16,637,8,16,661
1,3,1001,320,3,543,485,121,73,14,1236,11,35,1282
1,3,1001,321,3,284,172,46,19,8,529,1,25,555
1,3,1001,322,3,967,502,236,108,35,1848,7,34,1889
1,3,1001,326,3,259,84,43,22,8,416,1,16,433
1,3,1001,327,3,470,385,86,39,19,999,0,21,1020
1,3,1001,328,3,308,215,73,24,13,633,1,21,655
1,3,1001,329,3,186,213,17,11,11,438,2,20,460
1,3,1001,330,3,306,307,95,71,8,787,1,30,818
1,3,1001,331,3,289,292,60,22,5,668,6,20,694
1,3,1001,333,3,312,440,93,55,16,916,7,19,942
1,3,1001,334,3,295,332,40,23,11,701,6,10,717
1,3,1001,335,3,70,141,20,15,2,248,1,13,262
1,3,1001,336,3,155,279,56,22,4,516,5,28,549
1,3,1001,337,3,183,262,15,21,7,488,3,13,504
2,1,2002,319,3,226,212,104,32,27,601,8,14,623
2,1,2002,320,3,128,123,65,29,8,353,2,10,365
2,1,2002,321,3,296,143,108,32,14,593,2,15,610
2,1,2002,338,3,287,157,100,51,51,646,2,20,668
2,1,2002,339,3,187,136,99,47,14,483,7,19,509
2,1,2002,340,3,220,146,110,34,20,530,1,8,539
2,1,2002,341,3,213,195,104,53,9,574,3,9,586
2,1,2002,342,3,290,124,133,53,17,617,2,17,636
2,1,2002,358,3,309,180,119,38,26,672,8,19,699
2,1,2002,359,3,160,124,87,43,10,424,1,12,437
2,1,2002,360,3,227,154,92,46,13,532,1,33,566
2,1,2002,361,3,301,265,170,59,14,809,4,9,822
2,1,2002,362,3,363,175,143,45,22,748,3,9,760
2,1,2002,363,3,198,125,93,43,14,473,252,15,740
2,1,2002,364,3,282,134,135,43,15,609,2,8,619
2,1,2002,365,3,245,123,131,44,19,562,4,7,573
2,1,2002,366,3,523,241,219,61,31,1075,12,18,1105
2,1,2002,367,3,197,126,148,25,11,507,2,19,528
2,1,2002,368,3,293,165,104,55,7,624,5,9,638
2,1,2002,451,3,243,129,72,35,13,492,0,7,499
2,1,2002,459,3,382,181,126,90,18,797,1,13,811
2,1,2002,463,3,315,149,122,51,11,648,3,8,659
2,1,2002,464,3,150,91,75,31,11,358,5,5,368
2,1,2002,465,3,296,183,131,39,19,668,10,23,701
2,1,2002,466,3,189,181,97,29,11,507,3,5,515
2,1,2002,467,3,323,199,137,56,30,745,3,9,757
2,1,2002,468,3,346,190,145,107,20,808,1,13,822
2,1,2002,471,3,316,166,98,57,21,658,5,8,671
2,1,2002,472,3,331,241,154,113,19,858,6,18,882
2,1,2002,473,3,154,124,84,38,8,408,4,11,423
2,1,2002,474,3,251,229,159,49,21,709,7,10,726
2,1,2002,475,3,143,113,62,22,1,341,1,10,352
2,1,2002,476,3,400,189,104,67,34,794,6,28,828
2,1,2002,477,3,373,158,128,60,14,733,1,25,759
2,1,2002,478,3,408,174,109,68,18,777,4,11,792
2,1,2002,479,3,246,122,98,62,15,543,2,6,551
2,1,2002,480,3,457,189,148,88,36,918,3,7,928
2,1,2002,481,3,354,194,125,67,31,771,3,13,787
2,1,2002,482,3,371,233,177,83,12,876,6,13,895
2,1,2002,483,3,178,107,53,38,6,382,0,14,396
2,1,2002,484,3,266,111,89,37,15,518,0,17,535
2,1,2002,485,3,237,100,56,40,7,440,0,6,446
2,1,2002,486,3,370,111,80,43,17,621,0,21,642
2,1,2002,487,3,254,98,70,44,14,480,1,8,489
2,1,2002,488,3,1268,606,374,202,77,2527,13,47,2587
2,1,2002,489,3,282,108,79,46,14,529,0,11,540
2,1,2002,490,3,199,57,88,28,35,407,1,7,415
2,1,2002,491,3,286,108,96,49,12,551,4,14,569
2,1,2002,492,3,387,175,115,72,26,775,2,10,787
2,1,2002,493,3,376,157,151,73,11,768,2,17,787
2,1,2002,494,3,298,139,84,49,12,582,4,0,586
2,1,2002,495,3,315,162,136,54,27,694,5,15,714
2,1,2002,496,3,623,256,228,73,54,1234,4,28,1266
2,1,2002,497,3,192,195,89,46,9,531,2,14,547
2,1,2002,498,3,286,135,96,38,18,573,3,7,583
2,1,2002,499,3,285,131,103,43,19,581,4,13,598
2,1,2002,500,3,266,108,58,36,5,473,3,5,481
2,1,2002,501,3,1486,583,450,221,74,2814,9,36,2859
2,1,2002,502,3,1279,545,432,204,85,2545,7,25,2577
2,1,2002,503,3,138,97,68,53,12,368,0,3,371
2,1,2002,504,3,259,114,79,51,7,510,0,9,519
2,1,2002,505,3,253,137,62,36,9,497,1,12,510
2,1,2002,506,3,1232,529,468,196,61,2486,16,41,2543
2,1,2002,507,3,174,135,57,30,15,411,3,18,432
2,1,2002,508,3,156,148,83,40,10,437,6,17,460
2,1,2002,509,3,180,105,76,38,11,410,3,17,430
2,1,2002,510,3,152,126,66,41,10,395,2,16,413
2,1,2002,511,3,172,108,54,43,9,386,0,18,404
2,1,2002,512,3,139,88,68,55,10,360,6,11,377
2,1,2002,513,3,144,96,84,42,6,372,4,18,394
2,1,2002,514,3,150,104,97,47,5,403,8,9,420
2,1,2002,515,3,115,124,66,62,8,375,2,13,390
2,1,2002,516,3,305,171,182,113,24,795,8,21,824
2,1,2002,569,3,184,62,45,25,5,321,1,4,326
2,1,2002,570,3,298,189,132,39,12,670,2,10,682
2,1,2002,571,3,440,245,264,76,24,1049,5,29,1083
2,1,2002,580,3,143,38,67,8,1,257,0,6,263
2,1,2002,581,3,217,111,89,31,5,453,0,18,471
2,1,2002,582,3,113,138,194,28,5,478,1,24,503
2,1,2002,587,3,65,41,28,5,1,140,0,3,143
2,1,2002,588,3,142,142,70,43,16,413,1,4,418
2,1,2002,589,3,229,173,66,73,8,549,1,10,560
2,1,2002,590,3,211,303,131,50,13,708,2,32,742
2,1,2002,591,3,148,98,61,15,0,322,1,0,323
2,1,2002,592,3,175,307,133,31,13,659,3,18,680
2,1,2002,593,3,199,121,86,23,7,436,1,15,452
2,1,2002,594,3,215,87,92,30,12,436,2,21,459
2,1,2002,595,3,263,161,150,42,20,636,2,22,660
2,1,2002,596,3,236,156,157,39,11,599,1,15,615
2,1,2002,597,3,308,167,159,49,11,694,13,18,725
2,1,2002,598,3,135,96,125,14,6,376,0,11,387
2,1,2002,599,3,306,260,122,42,9,739,1,19,759
2,1,2002,600,3,94,192,33,28,4,351,2,13,366
2,1,2002,601,3,159,197,76,67,1,500,0,15,515
2,1,2002,602,3,183,169,61,41,7,461,2,13,476
2,1,2002,603,3,352,264,94,44,9,763,1,27,791
2,1,2002,604,3,160,136,60,24,7,387,1,10,398
2,1,2002,605,3,232,89,99,35,7,462,2,19,483
2,1,2002,606,3,215,100,111,49,4,479,0,19,498
2,1,2002,607,3,247,107,98,49,12,513,0,20,533
2,1,2002,608,3,247,114,107,47,5,520,3,14,537
2,1,2002,609,3,126,88,36,12,5,267,3,8,278
2,1,2002,610,3,204,108,48,25,8,393,6,10,409
2,1,2002,611,3,210,124,76,56,6,472,3,10,485
2,1,2002,612,3,75,38,21,11,1,146,0,4,150
2,1,2002,613,3,277,216,104,128,13,738,4,29,771
2,1,2002,614,3,82,171,68,37,8,366,5,9,380
2,1,2002,615,3,186,234,271,151,9,851,0,24,875
2,1,2002,616,3,180,98,42,26,8,354,7,8,369
2,1,2002,617,3,99,216,78,34,11,438,2,10,450
2,1,2002,618,3,153,101,27,41,7,329,0,10,339
2,1,2002,619,3,104,34,32,21,3,194,4,9,207
2,1,2002,620,3,271,345,134,42,13,805,3,20,828
2,1,2002,621,3,218,226,106,144,11,705,2,26,733
2,1,2002,622,3,202,309,148,102,9,770,3,24,797
2,1,2002,623,3,118,227,130,60,6,541,0,21,562
2,1,2002,624,3,140,141,132,106,5,524,2,9,535
2,1,2002,625,3,176,202,169,52,9,608,2,15,625
2,1,2002,626,3,234,160,109,27,5,535,0,23,558
2,1,2002,627,3,206,180,166,50,10,612,1,10,623
2,1,2002,628,3,106,140,102,50,5,403,0,7,410
2,1,2002,629,3,112,133,125,42,4,416,3,20,439
2,1,2002,630,3,133,141,105,55,4,438,5,10,453
2,1,2002,631,3,114,191,127,81,3,516,6,17,539
2,1,2002,632,3,80,134,72,47,6,339,1,11,351
2,1,2002,633,3,178,116,64,18,5,381,1,14,396
2,1,2002,634,3,243,182,147,57,10,639,0,16,655
2,1,2002,635,3,142,121,107,18,4,392,2,20,414
2,1,2002,636,3,80,70,48,16,1,215,4,0,219
2,1,2002,637,3,74,59,56,13,7,209,2,6,217
2,1,2002,638,3,149,103,71,53,6,382,0,6,388
2,1,2002,639,3,176,82,93,68,4,423,2,18,443
2,1,2002,640,3,113,148,109,41,12,423,2,19,444
2,1,2002,641,3,206,207,98,54,11,576,0,11,587
2,1,2002,642,3,239,203,161,70,14,687,2,4,693
2,1,2002,643,3,174,145,91,47,8,465,1,17,483
2,1,2002,644,3,166,116,89,35,8,414,4,6,424
2,1,2002,645,3,381,343,316,87,27,1154,12,45,1211
2,1,2002,646,3,102,93,82,33,2,312,1,9,322
2,1,2002,647,3,101,153,102,19,5,380,7,13,400
2,1,2002,648,3,132,258,156,43,12,601,3,7,611
2,1,2002,649,3,140,96,82,27,7,352,2,14,368
2,1,2002,650,3,84,153,65,16,3,321,1,11,333
2,1,2002,651,3,202,198,85,42,5,532,5,31,568
2,1,2002,652,3,115,108,47,33,8,311,4,11,326
2,1,2002,653,3,171,210,92,35,9,517,11,8,536
2,1,2002,654,3,131,167,85,49,7,439,3,14,456
2,1,2002,655,3,126,119,79,29,7,360,9,18,387
2,1,2002,656,3,136,129,91,37,2,395,4,13,412
2,1,2002,657,3,121,115,94,22,10,362,4,11,377
2,1,2002,658,3,146,106,59,12,2,325,1,19,345
2,1,2002,659,3,118,148,52,26,2,346,0,9,355
2,1,2002,660,3,73,55,86,31,3,248,0,3,251
2,1,2002,661,3,22,17,4,2,0,45,0,2,47
2,1,2002,662,3,27,39,15,1,2,84,0,0,84
2,1,2002,663,3,174,254,213,59,7,707,1,18,726
2,1,2002,664,3,253,158,126,34,12,583,2,18,603
2,1,2002,665,3,157,102,84,25,3,371,1,11,383
2,1,2002,666,3,127,74,73,0,0,274,0,5,279
2,1,2002,667,3,161,156,79,21,9,426,0,14,440
2,1,2002,668,3,147,125,78,22,3,375,5,21,401
2,1,2002,669,3,49,58,32,1,1,141,2,6,149
2,1,2002,670,3,72,32,67,8,0,179,3,10,192
2,1,2002,671,3,71,40,50,5,0,166,1,4,171
2,1,2002,673,3,427,349,198,65,18,1057,3,24,1084
2,1,2002,674,3,105,148,41,13,9,316,0,5,321
2,1,2002,675,3,177,152,67,26,2,424,0,7,431
2,1,2002,676,3,171,190,85,29,11,486,0,6,492
2,1,2002,677,3,120,128,73,14,11,346,1,9,356
2,1,2002,678,3,356,342,108,25,20,851,4,21,876
2,1,2002,679,3,212,206,59,28,11,516,0,14,530
2,1,2002,680,3,148,220,97,34,12,511,11,26,548
2,1,2002,688,3,191,54,66,25,4,340,3,20,363
2,1,2002,689,3,177,80,48,34,11,350,0,8,358
2,1,2002,690,3,789,485,379,130,43,1826,12,45,1883
2,1,2002,691,3,1255,938,621,238,79,3131,17,76,3224
2,1,2002,693,3,135,162,142,65,5,509,0,5,514
2,2,2002,213,3,148,101,81,18,10,358,4,9,371
2,2,2002,214,3,141,104,44,19,13,321,2,8,331
2,2,2002,215,3,118,84,50,24,4,280,0,8,288
2,2,2002,216,3,98,72,37,6,4,217,0,10,227
2,2,2002,217,3,114,76,54,6,6,256,0,4,260
2,2,2002,218,3,122,80,55,18,6,281,3,5,289
2,2,2002,219,3,128,86,55,15,8,292,0,4,296
2,2,2002,220,3,109,105,25,13,4,256,0,4,260
2,2,2002,221,3,223,168,85,25,16,517,4,9,530
2,2,2002,222,3,259,154,62,16,6,497,1,4,502
2,2,2002,223,3,248,202,62,16,13,541,0,8,549
2,2,2002,224,3,247,185,37,6,18,493,0,10,503
2,2,2002,225,3,289,220,57,17,12,595,0,8,603
2,2,2002,226,3,228,170,62,23,13,496,1,12,509
2,2,2002,227,3,129,114,45,14,5,307,1,6,314
2,2,2002,228,3,92,65,50,1,7,215,0,0,215
2,2,2002,229,3,116,94,43,21,6,280,1,2,283
2,2,2002,230,3,196,94,68,26,16,400,1,9,410
2,2,2002,231,3,197,137,64,18,12,428,1,12,441
2,2,2002,232,3,155,112,46,25,10,348,2,16,366
2,2,2002,237,3,196,105,76,28,15,420,1,17,438
2,2,2002,238,3,129,71,56,19,4,279,2,10,291
2,2,2002,239,3,96,55,31,8,5,195,0,5,200
2,2,2002,240,3,200,158,91,38,20,507,0,8,515
2,2,2002,241,3,276,152,69,32,13,542,0,5,547
2,2,2002,242,3,229,173,67,20,6,495,3,7,505
2,2,2002,243,3,262,158,38,17,7,482,0,6,488
2,2,2002,244,3,285,161,89,15,21,571,0,7,578
2,2,2002,245,3,206,166,66,23,8,469,1,4,474
2,2,2002,246,3,253,184,72,22,6,537,4,10,551
2,2,2002,247,3,185,124,85,30,11,435,1,20,456
2,2,2002,248,3,178,109,58,19,12,376,0,17,393
2,2,2002,249,3,116,65,35,11,4,231,1,5,237
2,2,2002,250,3,107,81,50,12,6,256,4,10,270
2,2,2002,251,3,107,77,28,15,11,238,0,8,246
2,2,2002,258,3,180,113,78,30,10,411,2,13,426
2,2,2002,259,3,129,71,51,9,12,272,0,6,278
2,2,2002,260,3,89,118,61,40,13,321,2,6,329
2,2,2002,261,3,126,91,67,24,9,317,3,9,329
2,2,2002,262,3,128,96,52,16,12,304,3,7,314
2,2,2002,263,3,117,104,76,16,10,323,0,7,330
2,2,2002,264,3,208,94,47,21,12,382,0,2,384
2,2,2002,265,3,139,98,46,19,7,309,0,3,312
2,2,2002,266,3,196,117,80,25,11,429,1,13,443
2,2,2002,267,3,138,110,55,20,11,334,1,6,341
2,2,2002,268,3,229,159,79,34,18,519,1,8,528
2,2,2002,269,3,180,146,84,27,10,447,0,11,458
2,2,2002,270,3,238,164,93,25,14,534,2,12,548
2,2,2002,271,3,328,269,140,37,18,792,1,8,801
2,2,2002,272,3,185,154,51,20,18,428,10,7,445
2,2,2002,273,3,245,121,67,31,10,474,1,11,486
2,2,2002,274,3,244,94,78,32,15,463,0,16,479
2,2,2002,275,3,208,108,55,25,16,412,5,11,428
2,2,2002,276,3,212,151,64,22,14,463,1,7,471
2,2,2002,277,3,160,97,55,21,13,346,0,10,356
2,2,2002,278,3,133,73,64,8,5,283,2,7,292
2,2,2002,279,3,184,130,72,20,15,421,3,15,439
2,2,2002,285,3,206,152,59,25,13,455,0,14,469
2,2,2002,286,3,215,120,78,34,22,469,4,9,482
2,2,2002,287,3,214,122,86,35,14,471,0,4,475
2,2,2002,288,3,216,89,52,38,17,412,3,9,424
2,2,2002,289,3,169,77,58,22,9,335,4,7,346
2,2,2002,290,3,250,212,103,64,10,639,1,8,648
2,2,2002,291,3,323,198,108,41,18,688,5,5,698
2,2,2002,292,3,450,353,76,54,24,957,3,10,970
2,2,2002,293,3,253,197,100,43,26,619,1,19,639
2,2,2002,294,3,237,139,89,47,17,529,3,12,544
2,2,2002,295,3,183,138,51,22,10,404,1,8,413
2,2,2002,296,3,209,130,70,25,14,448,0,10,458
2,2,2002,297,3,262,138,91,38,12,541,1,4,546
2,2,2002,298,3,166,129,54,21,5,375,0,19,394
2,2,2002,299,3,228,113,103,26,19,489,1,10,500
2,2,2002,300,3,184,126,72,33,11,426,2,6,434
2,2,2002,301,3,289,136,77,34,20,556,6,18,580
2,2,2002,302,3,243,111,65,25,7,451,1,6,458
2,2,2002,303,3,289,157,90,30,12,578,1,8,587
2,2,2002,304,3,86,163,133,19,13,414,2,12,428
2,2,2002,309,3,329,193,84,33,18,657,1,9,667
2,2,2002,310,3,313,172,83,26,11,605,1,11,617
2,2,2002,311,3,206,107,54,26,9,402,0,10,412
2,2,2002,312,3,209,130,50,21,5,415,0,5,420
2,2,2002,313,3,338,175,87,31,15,646,2,15,663
2,2,2002,314,3,408,188,86,50,18,750,0,9,759
2,2,2002,315,3,275,189,121,66,15,666,0,7,673
2,2,2002,316,3,228,153,72,49,18,520,0,8,528
2,2,2002,317,3,264,138,83,29,11,525,1,12,538
2,2,2002,318,3,363,197,51,26,14,651,0,2,653
2,2,2002,324,3,376,180,114,29,20,719,0,5,724
2,2,2002,325,3,235,100,59,28,8,430,0,5,435
2,2,2002,326,3,483,249,95,45,20,892,0,8,900
2,2,2002,369,3,171,148,71,46,13,449,0,8,457
2,2,2002,370,3,221,145,84,28,17,495,3,8,506
2,2,2002,371,3,252,151,44,22,16,485,2,7,494
2,2,2002,372,3,304,146,81,34,12,577,2,9,588
2,2,2002,373,3,271,140,94,32,17,554,1,7,562
2,2,2002,374,3,275,121,76,38,15,525,0,11,536
2,2,2002,375,3,317,150,94,38,25,624,1,13,638
2,2,2002,376,3,398,192,117,55,24,786,3,11,800
2,2,2002,377,3,431,174,120,33,21,779,4,31,814
2,2,2002,378,3,313,144,64,32,20,573,0,16,589
2,2,2002,379,3,249,127,77,25,23,501,4,15,520
2,2,2002,380,3,135,86,50,20,0,291,4,9,304
2,2,2002,381,3,204,166,61,27,17,475,0,3,478
2,2,2002,382,3,254,187,98,32,16,587,0,9,596
2,2,2002,383,3,285,139,83,49,13,569,5,11,585
2,2,2002,384,3,319,137,95,38,11,600,2,8,610
2,2,2002,385,3,408,197,110,43,21,779,3,13,795
2,2,2002,386,3,365,143,88,34,20,650,0,8,658
2,2,2002,387,3,208,115,82,27,16,448,2,36,486
2,2,2002,388,3,352,222,109,39,12,734,2,2,738
2,2,2002,389,3,250,178,77,9,23,537,0,10,547
2,2,2002,390,3,229,144,62,27,8,470,1,12,483
2,2,2002,391,3,206,133,80,27,9,455,1,8,464
2,2,2002,392,3,345,146,99,40,20,650,3,14,667
2,2,2002,393,3,337,155,84,39,21,636,2,17,655
2,2,2002,394,3,265,171,83,34,15,568,1,10,579
2,2,2002,395,3,309,165,78,38,16,606,0,18,624
2,2,2002,396,3,337,161,111,33,21,663,2,16,681
2,2,2002,397,3,221,125,63,31,11,451,2,9,462
2,2,2002,398,3,1366,536,233,121,49,2305,2,22,2329
2,2,2002,399,3,493,267,98,45,18,921,0,11,932
2,2,2002,400,3,357,225,120,49,25,776,3,12,791
2,2,2002,401,3,318,163,99,35,13,628,1,12,641
2,2,2002,402,3,335,198,73,28,14,648,3,12,663
2,2,2002,403,3,381,289,67,22,22,781,0,9,790
2,2,2002,404,3,252,194,56,25,8,535,3,4,542
2,2,2002,405,3,239,133,59,31,14,476,2,7,485
2,2,2002,406,3,312,191,119,24,24,670,1,25,696
2,2,2002,407,3,310,144,49,24,10,537,0,6,543
2,2,2002,408,3,221,85,69,25,18,418,1,10,429
2,2,2002,409,3,341,204,103,46,18,712,3,10,725
2,2,2002,410,3,298,131,54,22,11,516,0,1,517
2,2,2002,411,3,373,343,50,13,10,789,0,3,792
2,2,2002,412,3,255,161,85,19,6,526,0,11,537
2,2,2002,413,3,261,237,110,61,12,681,2,9,692
2,2,2002,414,3,323,188,78,40,10,639,0,10,649
2,2,2002,415,3,251,119,74,25,13,482,2,15,499
2,2,2002,416,3,231,131,72,25,12,471,1,13,485
2,2,2002,417,3,300,137,72,44,15,568,2,19,589
2,2,2002,418,3,382,199,98,51,25,755,3,11,769
2,2,2002,419,3,238,106,63,21,20,448,0,8,456
2,2,2002,420,3,201,115,55,17,9,397,2,11,410
2,2,2002,421,3,263,113,59,39,21,495,1,9,505
2,2,2002,422,3,255,163,85,21,12,536,2,8,546
2,2,2002,423,3,352,322,68,20,9,771,0,11,782
2,2,2002,424,3,389,231,84,30,14,748,2,9,759
2,2,2002,425,3,332,176,79,42,13,642,0,16,658
2,2,2002,426,3,244,159,106,17,14,540,1,14,555
2,2,2002,427,3,231,116,84,21,16,468,3,11,482
2,2,2002,428,3,262,137,74,26,12,511,5,6,522
2,2,2002,429,3,231,134,84,35,17,501,5,3,509
2,2,2002,430,3,244,140,94,41,21,540,3,8,551
2,2,2002,431,3,319,155,62,20,14,570,1,5,576
2,2,2002,432,3,346,224,128,55,21,774,1,6,781
2,2,2002,433,3,261,157,101,30,13,562,5,11,578
2,2,2002,434,3,329,159,79,27,16,610,4,9,623
2,2,2002,435,3,328,204,107,38,21,698,1,18,717
2,2,2002,436,3,351,182,110,55,15,713,0,17,730
2,2,2002,437,3,177,106,49,23,12,367,2,4,373
2,2,2002,438,3,338,262,133,59,25,817,0,6,823
2,2,2002,439,3,645,337,228,63,34,1307,2,15,1324
2,2,2002,440,3,301,186,99,49,15,650,2,11,663
2,2,2002,441,3,388,161,110,43,19,721,2,21,744
2,2,2002,442,3,380,223,101,44,22,770,0,20,790
2,2,2002,443,3,366,185,122,33,18,724,3,27,754
2,2,2002,444,3,1515,728,474,208,127,3052,6,30,3088
2,2,2002,445,3,318,192,96,42,34,682,7,14,703
2,2,2002,446,3,368,193,106,40,22,729,3,7,739
2,2,2002,447,3,262,104,74,26,15,481,5,7,493
2,2,2002,448,3,484,177,112,48,27,848,11,22,881
2,2,2002,449,3,517,282,106,50,18,973,1,11,985
2,2,2002,450,3,469,294,112,39,21,935,1,13,949
2,2,2002,452,3,224,101,70,28,13,436,1,9,446
2,2,2002,453,3,216,112,63,38,8,437,1,9,447
2,2,2002,454,3,406,204,82,36,29,757,3,18,778
2,2,2002,455,3,418,307,183,114,38,1060,3,11,1074
2,2,2002,456,3,461,195,139,66,41,902,5,7,914
2,2,2002,457,3,326,208,110,32,16,692,5,16,713
2,2,2002,458,3,228,90,59,29,11,417,0,7,424
2,2,2002,460,3,196,100,54,26,12,388,5,7,400
2,2,2002,461,3,253,162,84,26,15,540,1,4,545
2,2,2002,462,3,169,84,97,23,3,376,0,5,381
2,2,2002,469,3,1056,474,345,158,64,2097,0,42,2139
2,2,2002,470,3,1330,582,386,150,97,2545,3,39,2587
2,2,2002,548,3,69,28,27,8,1,133,0,6,139
2,2,2002,549,3,119,142,61,14,7,343,0,7,350
2,2,2002,550,3,217,151,115,25,5,513,3,12,528
2,2,2002,551,3,160,164,83,11,10,428,0,9,437
2,2,2002,552,3,203,152,82,23,6,466,0,14,480
2,2,2002,553,3,295,212,66,32,9,614,2,10,626
2,2,2002,554,3,290,249,94,29,23,685,6,23,714
2,2,2002,555,3,272,221,92,30,17,632,1,19,652
2,2,2002,556,3,374,217,82,136,8,817,0,24,841
2,2,2002,557,3,54,60,48,8,2,172,0,10,182
2,2,2002,558,3,250,216,114,55,16,651,0,24,675
2,2,2002,559,3,247,146,92,47,19,551,5,19,575
2,2,2002,560,3,230,184,89,56,15,574,0,18,592
2,2,2002,561,3,208,193,89,47,8,545,1,8,554
2,2,2002,562,3,234,101,162,32,90,619,11,8,638
2,2,2002,563,3,184,149,97,28,7,465,3,18,486
2,2,2002,564,3,228,139,70,39,13,489,4,16,509
2,2,2002,572,3,195,277,133,38,27,670,2,24,696
2,2,2002,573,3,181,223,71,26,15,516,0,16,532
2,2,2002,574,3,223,167,84,34,14,522,3,24,549
2,2,2002,575,3,327,191,191,32,12,753,4,13,770
2,2,2002,576,3,94,61,23,5,4,187,0,10,197
2,2,2002,577,3,285,190,113,36,10,634,2,24,660
2,2,2002,578,3,260,193,144,52,10,659,1,20,680
2,2,2002,579,3,207,213,89,47,8,564,0,18,582
2,2,2002,583,3,174,120,77,34,7,412,0,11,423
2,2,2002,584,3,158,178,86,48,7,477,2,18,497
2,2,2002,585,3,169,209,89,23,9,499,0,10,509
2,2,2002,586,3,182,181,57,30,8,458,0,13,471
2,2,2002,681,3,154,115,74,21,10,374,0,6,380
2,2,2002,682,3,172,96,57,23,10,358,1,13,372
2,2,2002,683,3,182,76,57,25,9,349,1,8,358
2,2,2002,684,3,188,87,62,29,13,379,2,10,391
2,2,2002,685,3,189,82,60,17,11,359,1,8,368
2,2,2002,686,3,153,84,58,26,11,332,0,3,335
2,2,2002,687,3,169,75,32,17,10,303,5,11,319
2,3,2001,1,3,245,94,228,36,14,617,3,8,628
2,3,2001,2,3,331,94,247,54,13,739,0,6,745
2,3,2001,3,3,173,127,216,23,16,555,3,13,571
2,3,2001,4,3,217,147,251,32,7,654,3,14,671
2,3,2001,5,3,108,67,93,6,4,278,2,3,283
2,3,2001,6,3,194,100,157,21,6,478,0,17,495
2,3,2001,7,3,127,76,105,8,6,322,1,12,335
2,3,2001,8,3,202,91,193,21,14,521,2,11,534
2,3,2001,9,3,208,85,150,17,7,467,2,12,481
2,3,2001,10,3,206,125,181,20,7,539,2,13,554
2,3,2001,11,3,449,208,336,44,32,1069,3,20,1092
2,3,2001,15,3,309,178,311,42,20,860,5,11,876
2,3,2001,16,3,308,178,273,46,13,818,3,30,851
2,3,2001,17,3,343,235,324,36,21,959,4,35,998
2,3,2001,18,3,448,251,303,61,26,1089,3,15,1107
2,3,2001,19,3,361,134,241,36,8,780,1,9,790
2,3,2001,20,3,350,120,284,68,19,841,1,11,853
2,3,2001,21,3,207,61,142,25,7,442,0,5,447
2,3,2001,22,3,257,118,260,25,11,671,0,13,684
2,3,2001,23,3,445,168,263,34,14,924,0,8,932
2,3,2001,24,3,320,148,250,30,11,759,1,15,775
2,3,2001,25,3,298,144,172,30,12,656,2,19,677
2,3,2001,26,3,243,85,146,23,8,505,0,7,512
2,3,2001,27,3,305,154,255,43,15,772,2,6,780
2,3,2001,28,3,85,61,86,23,7,262,0,4,266
2,3,2001,29,3,227,81,146,47,14,515,0,4,519
2,3,2001,30,3,196,147,193,19,11,566,3,23,592
2,3,2001,31,3,121,76,107,7,7,318,0,10,328
2,3,2001,32,3,286,199,241,36,9,771,3,28,802
2,3,2001,33,3,274,153,232,34,14,707,1,33,741
2,3,2001,34,3,226,147,185,28,11,597,1,13,611
2,3,2001,35,3,181,126,212,27,14,560,3,12,575
2,3,2001,37,3,226,164,322,43,21,776,0,16,792
2,3,2001,38,3,243,157,267,24,13,704,5,18,727
2,3,2001,39,3,280,140,233,43,9,705,4,18,727
2,3,2001,40,3,232,153,299,32,12,728,4,29,761
2,3,2001,41,3,273,82,173,27,14,569,1,14,584
2,3,2001,42,3,236,91,200,16,12,555,3,9,567
2,3,2001,43,3,235,167,223,33,12,670,0,8,678
2,3,2001,44,3,179,59,120,24,5,387,1,12,400
2,3,2001,45,3,173,85,164,12,6,440,0,10,450
2,3,2001,46,3,261,90,161,21,9,542,0,7,549
2,3,2001,47,3,310,144,247,39,12,752,2,12,766
2,3,2001,48,3,335,228,296,30,8,897,1,10,908
2,3,2001,49,3,59,29,57,3,5,153,1,4,158
2,3,2001,50,3,79,46,92,10,6,233,1,6,240
2,3,2001,51,3,98,82,100,11,6,297,2,4,303
2,3,2001,52,3,194,88,127,13,7,429,0,14,443
2,3,2001,53,3,106,67,137,12,8,330,3,13,346
2,3,2001,54,3,292,104,145,20,5,566,1,8,575
2,3,2001,55,3,200,76,100,13,10,399,0,4,403
2,3,2001,56,3,164,115,202,25,11,517,1,10,528
2,3,2001,57,3,99,84,152,20,6,361,3,10,374
2,3,2001,58,3,320,132,189,46,11,698,0,26,724
2,3,2001,59,3,245,109,166,21,9,550,2,17,569
2,3,2001,63,3,240,80,132,17,17,486,2,8,496
2,3,2001,64,3,287,78,131,18,8,522,0,12,534
2,3,2001,65,3,362,115,194,48,9,728,1,13,742
2,3,2001,66,3,224,88,146,31,8,497,0,4,501
2,3,2001,67,3,215,104,135,22,10,486,0,7,493
2,3,2001,68,3,224,89,143,28,9,493,0,8,501
2,3,2001,69,3,185,87,167,28,10,477,2,16,495
2,3,2001,70,3,157,78,149,16,6,406,0,7,413
2,3,2001,71,3,189,108,173,21,7,498,2,6,506
2,3,2001,72,3,282,126,202,36,10,656,0,12,668
2,3,2001,73,3,184,103,143,22,7,459,0,9,468
2,3,2001,74,3,256,128,169,19,8,580,1,15,596
2,3,2001,75,3,237,133,178,28,16,592,0,12,604
2,3,2001,76,3,318,123,210,42,12,705,1,7,713
2,3,2001,77,3,331,133,209,28,16,717,0,12,729
2,3,2001,78,3,260,136,194,33,9,632,0,10,642
2,3,2001,85,3,280,123,186,22,12,623,0,13,636
2,3,2001,86,3,397,165,253,27,9,851,0,7,858
2,3,2001,87,3,368,229,288,28,15,928,0,14,942
2,3,2001,88,3,386,194,300,45,18,943,0,13,956
2,3,2001,89,3,301,123,180,30,10,644,4,8,656
2,3,2001,90,3,381,172,221,19,10,803,0,8,811
2,3,2001,91,3,253,99,155,23,5,535,0,7,542
2,3,2001,103,3,297,138,216,32,9,692,2,7,701
2,3,2001,104,3,351,159,255,34,17,816,2,20,838
2,3,2001,105,3,439,214,251,62,14,980,0,7,987
2,3,2001,106,3,394,192,314,44,20,964,2,10,976
2,3,2001,110,3,367,126,235,34,11,773,3,12,788
2,3,2001,111,3,216,77,125,20,8,446,0,6,452
2,3,2001,112,3,205,92,201,21,11,530,0,9,539
2,3,2001,113,3,373,114,232,36,12,767,0,7,774
2,3,2001,114,3,430,134,256,15,13,848,0,8,856
2,3,2001,115,3,493,172,290,36,22,1013,1,9,1023
2,3,2001,116,3,614,328,487,62,26,1517,0,24,1541
2,3,2001,117,3,258,162,175,38,17,650,2,16,668
2,3,2001,118,3,331,178,230,35,12,786,5,11,802
2,3,2001,119,3,268,136,224,38,16,682,1,7,690
2,3,2001,120,3,168,130,163,19,7,487,2,6,495
2,3,2001,121,3,235,97,148,23,13,516,1,6,523
2,3,2001,122,3,133,103,139,14,13,402,1,12,415
2,3,2001,123,3,1432,890,1413,223,111,4069,20,44,4133
2,3,2001,124,3,199,78,160,22,8,467,0,7,474
2,3,2001,125,3,184,99,153,25,9,470,0,9,479
2,3,2001,126,3,1228,609,1005,170,68,3080,8,52,3140
2,3,2001,127,3,200,91,128,17,4,440,1,6,447
2,3,2001,130,3,235,175,264,31,16,721,6,22,749
2,3,2001,131,3,205,161,302,27,10,705,4,20,729
2,3,2001,132,3,248,161,336,29,20,794,0,19,813
2,3,2001,133,3,344,176,401,45,7,973,1,17,991
2,3,2001,134,3,347,291,288,39,29,994,5,26,1025
2,3,2001,135,3,230,192,127,15,9,573,0,12,585
2,3,2001,136,3,181,134,105,17,7,444,6,15,465
2,3,2001,137,3,170,110,76,13,6,375,5,22,402
2,3,2001,138,3,160,104,95,6,6,371,0,12,383
2,3,2001,139,3,244,131,143,16,6,540,1,15,556
2,3,2001,140,3,208,171,127,19,7,532,3,16,551
2,3,2001,141,3,223,134,116,17,14,504,2,10,516
2,3,2001,142,3,331,269,208,31,19,858,8,27,893
2,3,2001,143,3,105,70,50,3,1,229,1,5,235
2,3,2001,144,3,121,57,46,5,5,234,0,0,234
2,3,2001,145,3,97,145,64,15,3,324,0,14,338
2,3,2001,146,3,129,193,109,11,3,445,0,23,468
2,3,2001,147,3,107,95,105,14,5,326,5,7,338
2,3,2001,148,3,131,174,110,53,5,473,0,7,480
2,3,2001,149,3,210,164,109,42,5,530,0,19,549
2,3,2001,150,3,142,141,90,16,0,389,0,5,394
2,3,2001,151,3,225,116,139,34,7,521,2,23,546
2,3,2001,152,3,402,161,120,32,14,729,0,24,753
2,3,2001,153,3,252,150,344,32,13,791,2,34,827
2,3,2001,154,3,252,144,155,40,10,601,0,11,612
2,3,2001,155,3,134,107,60,11,1,313,5,8,326
2,3,2001,156,3,163,143,113,39,12,470,1,21,492
2,3,2001,157,3,169,137,76,28,8,418,1,5,424
2,3,2001,158,3,284,183,271,32,12,782,4,30,816
2,3,2001,159,3,120,150,72,22,6,370,0,7,377
2,3,2001,160,3,223,234,163,37,10,667,7,33,707
2,3,2001,161,3,126,113,100,16,11,366,0,23,389
2,3,2001,162,3,190,124,89,22,3,428,1,12,441
2,3,2001,163,3,93,50,23,6,2,174,0,5,179
2,3,2001,164,3,117,80,26,10,1,234,1,7,242
2,3,2001,165,3,101,53,16,4,5,179,0,3,182
2,3,2001,166,3,300,200,206,98,17,821,2,25,848
2,3,2001,167,3,56,24,33,4,2,119,1,4,124
2,3,2001,168,3,234,227,160,23,13,657,1,17,675
2,3,2001,173,3,160,124,182,18,6,490,0,11,501
2,3,2001,174,3,51,20,45,9,0,125,0,2,127
2,3,2001,175,3,140,48,121,14,7,330,0,6,336
2,3,2001,176,3,360,512,320,39,15,1246,7,41,1294
2,3,2001,177,3,48,192,92,2,2,336,0,7,343
2,3,2001,178,3,472,276,383,26,20,1177,4,61,1242
2,3,2001,179,3,74,126,33,2,1,236,0,5,241
2,3,2001,180,3,108,104,90,5,4,311,0,28,339
2,3,2001,181,3,159,237,134,21,7,558,0,17,575
2,3,2001,182,3,59,143,59,4,2,267,0,12,279
2,3,2001,183,3,159,142,55,5,8,369,1,10,380
2,3,2001,184,3,43,57,21,4,7,132,0,3,135
2,3,2001,185,3,362,270,284,34,14,964,0,23,987
2,3,2001,186,3,240,151,207,37,4,639,0,35,674
2,3,2001,187,3,257,238,370,39,7,911,0,28,939
2,3,2001,188,3,201,168,150,22,16,557,4,21,582
2,3,2001,189,3,377,411,698,55,22,1563,1,68,1632
2,3,2001,190,3,279,196,180,31,17,703,5,20,728
2,3,2001,191,3,124,86,58,18,4,290,0,6,296
2,3,2001,192,3,535,481,422,78,22,1538,3,42,1583
2,3,2001,193,3,51,16,18,3,0,88,0,3,91
2,3,2001,194,3,420,345,248,38,18,1069,6,32,1107
2,3,2001,195,3,271,229,367,49,21,937,3,43,983
2,3,2001,196,3,102,105,76,3,10,296,4,10,310
2,3,2001,197,3,149,138,111,32,6,436,1,14,451
2,3,2001,198,3,95,52,46,8,1,202,0,9,211
2,3,2001,199,3,347,137,207,24,5,720,0,21,741
2,3,2001,200,3,58,51,15,2,0,126,0,3,129
2,3,2001,201,3,142,16,18,5,0,181,0,0,181
2,3,2001,202,3,82,91,34,11,2,220,0,3,223
2,3,2001,203,3,99,52,54,10,1,216,0,0,216
2,3,2001,204,3,55,11,4,2,1,73,0,0,73
2,3,2001,206,3,177,91,174,21,11,474,0,9,483
2,3,2001,207,3,193,63,129,11,4,400,0,4,404
2,3,2001,208,3,342,157,285,36,14,834,0,9,843
2,3,2001,209,3,757,455,714,110,57,2093,7,22,2122
2,3,2001,210,3,169,122,62,12,1,366,0,14,380
2,4,2004,1049,3,918,499,455,109,52,2033,6,43,2082
2,4,2004,1050,3,799,458,361,85,57,1760,9,44,1813
2,4,2004,1120,3,160,62,73,28,12,335,0,0,335
2,4,2004,1121,3,439,175,114,82,27,837,3,5,845
2,4,2004,1124,3,308,133,144,44,29,658,1,8,667
2,4,2004,1125,3,784,312,308,142,50,1596,2,19,1617
2,4,2004,1126,3,290,107,130,37,22,586,1,5,592
2,4,2004,1127,3,236,120,84,36,10,486,1,5,492
2,4,2004,1141,3,418,159,116,68,30,791,3,14,808
2,4,2004,1142,3,424,134,127,54,23,762,1,16,779
2,4,2004,1143,3,661,254,163,110,27,1215,4,25,1244
2,4,2004,1144,3,433,148,132,65,22,800,0,14,814
2,4,2004,1145,3,564,209,137,74,26,1010,2,8,1020
2,4,2004,1146,3,465,181,113,88,29,876,2,9,887
2,4,2004,1147,3,550,195,137,80,32,994,1,11,1006
2,4,2004,1148,3,202,64,32,13,7,318,3,14,335
2,4,2004,1149,3,682,281,147,72,25,1207,0,20,1227
2,4,2004,1151,3,553,255,197,99,51,1155,1,22,1178
2,4,2004,1152,3,1538,898,718,339,105,3598,5,37,3640
2,4,2004,1153,3,870,621,417,190,49,2147,4,42,2193
2,4,2004,1154,3,386,217,154,66,20,843,2,8,853
2,4,2004,1155,3,553,285,202,94,36,1170,2,11,1183
2,4,2004,1156,3,395,163,179,45,18,800,5,5,810
2,4,2004,1158,3,427,306,236,79,25,1073,3,20,1096
2,4,2004,1159,3,287,145,169,48,17,666,1,12,679
2,4,2004,1160,3,370,152,139,68,28,757,2,8,767
2,4,2004,1161,3,165,76,69,44,10,364,0,3,367
2,4,2004,1162,3,421,142,108,58,20,749,2,12,763
2,4,2004,1163,3,299,160,127,33,15,634,1,9,644
2,4,2004,1164,3,501,259,184,92,39,1075,3,31,1109
2,4,2004,1171,3,498,159,122,79,41,899,0,11,910
2,4,2004,1172,3,171,86,64,17,12,350,0,9,359
2,4,2004,1173,3,287,153,101,38,17,596,3,11,610
2,4,2004,1174,3,282,203,163,51,17,716,0,11,727
2,4,2004,1175,3,366,342,202,70,25,1005,2,22,1029
2,4,2004,1176,3,193,79,54,29,12,367,0,4,371
2,4,2004,1177,3,337,233,220,51,24,865,3,13,881
2,4,2004,1178,3,149,99,92,30,18,388,2,9,399
2,4,2004,1179,3,240,105,86,23,12,466,1,11,478
2,4,2004,1180,3,341,163,118,28,21,671,1,15,687
2,4,2004,1181,3,213,140,87,32,13,485,2,8,495
2,4,2004,1182,3,223,132,82,35,19,491,1,10,502
2,4,2004,1183,3,346,190,120,31,13,700,4,9,713
2,4,2004,1184,3,313,194,157,39,18,721,7,17,745
2,4,2004,1185,3,347,135,129,38,13,662,1,16,679
2,4,2004,1186,3,330,178,122,32,9,671,7,9,687
2,4,2004,1187,3,421,271,155,47,23,917,1,28,946
2,4,2004,1188,3,300,149,152,46,14,661,1,15,677
2,4,2004,1215,3,271,114,101,37,12,535,0,13,548
2,4,2004,1216,3,266,102,104,41,12,525,1,14,540
2,4,2004,1217,3,342,174,134,56,25,731,1,14,746
2,4,2004,1218,3,298,181,137,41,17,674,0,5,679
2,4,2004,1219,3,243,180,102,31,14,570,7,11,588
2,4,2004,1220,3,292,137,108,35,22,594,1,12,607
2,4,2004,1229,3,221,206,142,32,13,614,5,13,632
2,4,2004,1230,3,518,318,291,87,23,1237,2,33,1272
2,4,2004,1278,3,1299,1065,770,280,108,3522,12,80,3614
2,4,2004,1279,3,2424,818,873,486,160,4761,4,63,4828
2,4,2004,1281,3,2565,1149,1057,527,207,5505,14,64,5583
2,4,2004,1282,3,1250,646,556,220,72,2744,13,29,2786
2,4,2004,1332,3,306,119,69,37,15,546,0,11,557
2,4,2004,1333,3,169,98,89,34,12,402,0,5,407
2,4,2004,1334,3,273,123,68,49,15,528,1,12,541
2,4,2004,1335,3,407,165,104,82,26,784,1,15,800
2,4,2004,1337,3,540,127,134,58,27,886,1,10,897
2,4,2004,1338,3,194,76,52,22,17,361,2,5,368
2,4,2004,1339,3,145,79,72,18,6,320,0,9,329
2,4,2004,1371,3,92,72,44,12,5,225,0,4,229
2,4,2004,1372,3,97,52,53,12,2,216,0,17,233
2,4,2004,1373,3,125,96,72,26,11,330,2,1,333
2,4,2004,1374,3,152,76,68,16,4,316,2,4,322
2,4,2004,1375,3,100,68,67,15,3,253,0,1,254
2,4,2004,1376,3,107,82,76,17,4,286,1,1,288
2,4,2004,1377,3,109,93,76,20,9,307,1,5,313
2,4,2004,1378,3,118,91,52,15,8,284,1,11,296
2,4,2004,1379,3,138,62,82,20,6,308,0,4,312
2,4,2004,1380,3,87,95,55,13,10,260,1,9,270
2,4,2004,1381,3,91,22,69,7,7,196,0,0,196
2,4,2004,1382,3,116,109,86,15,8,334,7,6,347
2,4,2004,1383,3,97,83,107,24,4,315,1,13,329
2,4,2004,1384,3,125,48,46,20,14,253,1,1,255
2,4,2004,1385,3,78,44,40,31,10,203,1,1,205
2,4,2004,1386,3,55,41,38,19,6,159,0,3,162
2,4,2004,1387,3,91,54,41,18,4,208,0,1,209
2,4,2004,1388,3,90,31,34,12,6,173,0,2,175
2,4,2004,1389,3,60,30,32,8,3,133,1,1,135
2,4,2004,1390,3,54,29,38,11,1,133,0,3,136
2,4,2004,1391,3,34,12,27,5,1,79,0,1,80
2,4,2004,1392,3,126,78,64,22,5,295,1,7,303
2,4,2004,1393,3,109,68,43,13,4,237,0,4,241
2,4,2004,1394,3,137,46,32,19,6,240,0,5,245
2,4,2004,1395,3,137,37,34,23,7,238,0,0,238
2,4,2004,1396,3,133,35,33,29,15,245,1,2,248
2,4,2004,1397,3,112,58,37,36,12,255,0,1,256
2,4,2004,1398,3,151,61,53,48,9,322,1,0,323
2,4,2004,1399,3,138,57,50,24,9,278,0,7,285
2,4,2004,1400,3,135,60,43,21,11,270,0,5,275
2,4,2004,1401,3,136,81,46,31,11,305,0,0,305
2,4,2004,1402,3,119,33,42,29,6,229,0,1,230
2,4,2004,1403,3,100,56,50,29,11,246,1,0,247
2,4,2004,1404,3,113,39,42,18,9,221,0,4,225
2,4,2004,1405,3,157,36,53,34,10,290,0,3,293
2,4,2004,1406,3,170,64,67,43,9,353,1,2,356
2,4,2004,1407,3,79,31,45,27,7,189,2,3,194
2,4,2004,1408,3,99,50,32,25,13,219,2,0,221
2,4,2004,1409,3,75,34,22,20,3,154,2,0,156
2,4,2004,1410,3,89,52,49,17,9,216,2,0,218
2,4,2004,1411,3,73,43,23,25,4,168,1,2,171
2,4,2004,1412,3,118,62,69,18,13,280,0,3,283
2,4,2004,1413,3,126,75,105,18,9,333,0,2,335
2,4,2004,1414,3,151,99,109,21,13,393,1,5,399
2,4,2004,1415,3,137,112,211,30,10,500,1,18,519
2,4,2004,1416,3,127,86,141,26,1,381,4,8,393
2,4,2004,1417,3,72,79,73,12,6,242,0,3,245
2,4,2004,1418,3,99,77,143,10,7,336,3,3,342
2,4,2004,1419,3,123,77,71,18,13,302,1,3,306
2,4,2004,1420,3,69,41,55,13,5,183,0,4,187
2,4,2004,1421,3,17,7,3,3,1,31,0,3,34
2,4,2004,1422,3,91,73,47,12,3,226,1,5,232
2,4,2004,1423,3,56,34,26,8,8,132,0,3,135
2,4,2004,1424,3,74,80,34,15,5,208,0,7,215
2,4,2004,1425,3,73,86,46,9,4,218,7,0,225
2,4,2004,1426,3,79,28,46,10,7,170,0,3,173
2,4,2004,1427,3,81,47,43,23,10,204,0,3,207
2,4,2004,1428,3,73,47,43,10,4,177,1,11,189
2,4,2004,1429,3,84,80,31,11,3,209,2,0,211
2,4,2004,1430,3,35,42,32,9,0,118,2,2,122
2,4,2004,1431,3,118,69,65,20,7,279,0,3,282
2,4,2004,1432,3,104,84,60,23,10,281,1,9,291
2,4,2004,1433,3,80,51,38,24,4,197,6,6,209
2,4,2004,1434,3,104,72,49,19,5,249,1,6,256
2,4,2004,1435,3,64,53,31,8,5,161,0,5,166
2,4,2004,1436,3,73,53,46,16,2,190,0,8,198
2,4,2004,1437,3,66,78,66,7,6,223,0,6,229
2,4,2004,1438,3,58,34,26,8,0,126,0,21,147
2,4,2004,1439,3,49,70,36,10,2,167,0,1,168
2,4,2004,1440,3,80,67,49,8,5,209,1,6,216
2,4,2004,1441,3,52,56,32,9,2,151,0,4,155
2,4,2004,1442,3,99,69,68,14,14,264,0,7,271
2,4,2004,1443,3,66,44,37,8,3,158,1,3,162
2,4,2004,1444,3,64,36,33,14,4,151,0,0,151
2,4,2004,1445,3,87,61,52,10,2,212,3,4,219
2,4,2004,1446,3,74,53,44,9,5,185,0,4,189
2,4,2004,1447,3,122,60,65,15,5,267,0,11,278
2,4,2004,1448,3,35,45,68,11,6,165,0,8,173
2,4,2004,1449,3,34,33,59,8,3,137,0,5,142
2,4,2004,1450,3,41,60,72,14,3,190,1,12,203
2,4,2004,1451,3,63,67,75,14,6,225,0,9,234
2,4,2004,1452,3,34,58,92,7,3,194,1,5,200
2,4,2004,1453,3,74,36,30,12,3,155,2,0,157
2,4,2004,1454,3,47,34,40,14,5,140,0,7,147
2,4,2004,1455,3,84,68,42,18,1,213,1,2,216
2,4,2004,1456,3,77,65,64,22,9,237,1,3,241
2,4,2004,1457,3,49,34,34,4,5,126,2,2,130
2,4,2004,1458,3,93,77,73,26,2,271,0,3,274
2,4,2004,1459,3,84,76,41,21,8,230,1,11,242
2,4,2004,1460,3,94,62,63,16,8,243,0,0,243
2,4,2004,1461,3,108,60,55,22,6,251,2,13,266
2,4,2004,1462,3,117,77,56,16,10,276,0,7,283
2,4,2004,1463,3,169,102,79,36,10,396,0,11,407
2,4,2004,1464,3,114,69,60,23,9,275,0,12,287
2,4,2004,1465,3,151,80,64,31,13,339,0,7,346
2,4,2004,1466,3,110,66,89,22,6,293,2,10,305
2,4,2004,1467,3,158,65,73,19,8,323,2,21,346
2,4,2004,1468,3,111,39,63,21,6,240,1,7,248
2,4,2004,1469,3,110,61,77,18,18,284,0,7,291
2,4,2004,1470,3,150,107,89,36,3,385,2,2,389
2,4,2004,1471,3,101,90,55,15,7,268,3,7,278
2,4,2004,1472,3,137,64,72,24,3,300,0,12,312
2,4,2004,1473,3,86,37,45,20,6,194,1,5,200
2,4,2004,1474,3,67,57,43,10,3,180,0,0,180
2,4,2004,1475,3,70,52,31,0,0,153,0,3,156
2,4,2004,1476,3,82,47,28,24,9,190,1,13,204
2,4,2004,1477,3,79,64,59,23,0,225,1,2,228
2,4,2004,1478,3,54,40,28,8,1,131,0,2,133
2,4,2004,1479,3,167,101,79,43,12,402,0,0,402
2,4,2004,1480,3,66,41,38,18,10,173,0,0,173
2,4,2004,1481,3,139,81,89,32,8,349,0,6,355
2,4,2004,1482,3,147,70,65,24,13,319,1,8,328
2,4,2004,1483,3,99,65,25,28,6,223,0,4,227
2,5,2004,868,3,140,100,98,16,10,364,1,10,375
2,5,2004,869,3,119,81,53,19,11,283,1,3,287
2,5,2004,870,3,205,80,65,21,2,373,0,2,375
2,5,2004,871,3,313,106,69,23,16,527,0,5,532
2,5,2004,872,3,282,112,60,27,22,503,1,3,507
2,5,2004,873,3,128,95,72,15,7,317,1,6,324
2,5,2004,874,3,206,95,111,23,15,450,2,11,463
2,5,2004,875,3,143,98,63,13,17,334,2,1,337
2,5,2004,876,3,224,90,74,19,12,419,0,6,425
2,5,2004,877,3,123,54,39,10,11,237,0,0,237
2,5,2004,878,3,169,78,65,17,10,339,2,6,347
2,5,2004,879,3,104,53,49,9,10,225,0,1,226
2,5,2004,880,3,220,136,76,23,11,466,0,7,473
2,5,2004,881,3,244,112,68,17,8,449,0,3,452
2,5,2004,882,3,359,126,71,44,20,620,0,1,621
2,5,2004,883,3,232,139,65,24,10,470,0,2,472
2,5,2004,884,3,595,221,91,29,22,958,0,2,960
2,5,2004,885,3,260,76,38,8,8,390,0,2,392
2,5,2004,886,3,303,136,66,16,8,529,1,1,531
2,5,2004,887,3,276,139,56,14,13,498,4,2,504
2,5,2004,900,3,239,148,62,22,9,480,3,2,485
2,5,2004,901,3,402,189,97,23,23,734,2,12,748
2,5,2004,927,3,376,153,116,60,22,727,3,11,741
2,5,2004,928,3,762,215,88,42,28,1135,0,5,1140
2,5,2004,929,3,251,81,53,2,15,402,0,4,406
2,5,2004,930,3,618,232,90,38,14,992,0,2,994
2,5,2004,931,3,453,231,74,39,15,812,0,4,816
2,5,2004,932,3,201,71,44,23,6,345,0,0,345
2,5,2004,933,3,209,136,70,33,12,460,3,12,475
2,5,2004,934,3,311,162,73,35,9,590,0,8,598
2,5,2004,935,3,457,203,142,86,34,922,2,10,934
2,5,2004,936,3,284,102,77,44,12,519,0,6,525
2,5,2004,937,3,228,172,106,39,19,564,0,1,565
2,5,2004,938,3,183,86,50,23,11,353,2,6,361
2,5,2004,939,3,372,124,63,32,12,603,0,2,605
2,5,2004,940,3,489,179,86,42,13,809,0,10,819
2,5,2004,941,3,287,88,47,16,10,448,0,5,453
2,5,2004,942,3,555,178,86,46,16,881,1,9,891
2,5,2004,943,3,229,100,121,36,17,503,2,11,516
2,5,2004,957,3,312,89,62,36,14,513,1,7,521
2,5,2004,958,3,473,159,73,38,20,763,1,9,773
2,5,2004,959,3,414,156,58,21,10,659,0,7,666
2,5,2004,960,3,522,171,77,31,24,825,1,6,832
2,5,2004,961,3,413,123,88,35,7,666,0,8,674
2,5,2004,962,3,487,155,91,34,13,780,0,10,790
2,5,2004,963,3,208,78,59,19,8,372,0,5,377
2,5,2004,964,3,316,92,84,17,14,523,0,8,531
2,5,2004,965,3,326,101,85,24,11,547,0,9,556
2,5,2004,970,3,323,124,71,29,9,556,0,9,565
2,5,2004,971,3,212,97,62,21,9,401,1,8,410
2,5,2004,972,3,591,135,96,54,22,898,1,16,915
2,5,2004,973,3,939,242,163,79,38,1461,0,8,1469
2,5,2004,974,3,464,146,87,18,13,728,0,4,732
2,5,2004,975,3,373,112,63,24,10,582,0,3,585
2,5,2004,976,3,298,182,102,40,15,637,0,4,641
2,5,2004,999,3,351,249,101,50,19,770,0,12,782
2,5,2004,1014,3,318,105,77,27,8,535,0,4,539
2,5,2004,1015,3,348,150,65,29,14,606,0,4,610
2,5,2004,1016,3,399,169,44,13,12,637,0,3,640
2,5,2004,1019,3,203,86,38,9,12,348,0,3,351
2,5,2004,1020,3,250,81,61,28,16,436,0,6,442
2,5,2004,1021,3,221,83,51,17,7,379,0,5,384
2,5,2004,1022,3,236,116,62,14,9,437,3,6,446
2,5,2004,1025,3,194,67,36,13,8,318,0,4,322
2,5,2004,1030,3,357,170,131,58,17,733,2,8,743
2,5,2004,1038,3,208,122,71,24,12,437,0,4,441
2,5,2004,1039,3,323,170,96,34,16,639,0,21,660
2,5,2004,1040,3,293,157,54,22,10,536,1,13,550
2,5,2004,1041,3,221,140,68,24,8,461,3,9,473
2,5,2004,1042,3,337,135,86,25,7,590,3,11,604
2,5,2004,1043,3,307,135,106,22,15,585,2,13,600
2,5,2004,1044,3,1116,423,285,112,56,1992,0,22,2014
2,5,2004,1045,3,399,186,174,53,23,835,1,14,850
2,5,2004,1046,3,213,66,82,27,9,397,0,9,406
2,5,2004,1047,3,447,166,109,54,18,794,1,17,812
2,5,2004,1048,3,431,197,185,50,21,884,3,14,901
2,5,2004,1051,3,252,90,87,31,16,476,1,12,489
2,5,2004,1052,3,468,166,141,63,27,865,1,13,879
2,5,2004,1053,3,188,179,98,57,15,537,0,11,548
2,5,2004,1054,3,178,205,100,38,16,537,0,4,541
2,5,2004,1055,3,165,119,77,30,16,407,3,4,414
2,5,2004,1056,3,373,105,61,25,15,579,0,7,586
2,5,2004,1057,3,288,106,71,29,12,506,1,1,508
2,5,2004,1058,3,273,132,82,34,12,533,1,13,547
2,5,2004,1059,3,269,120,77,34,18,518,2,9,529
2,5,2004,1060,3,263,140,80,26,17,526,0,7,533
2,5,2004,1061,3,180,74,45,13,6,318,2,4,324
2,5,2004,1062,3,243,109,97,28,7,484,1,8,493
2,5,2004,1063,3,231,140,81,14,14,480,1,6,487
2,5,2004,1064,3,205,103,70,24,9,411,1,11,423
2,5,2004,1065,3,197,92,77,22,10,398,1,7,406
2,5,2004,1066,3,243,102,60,12,13,430,0,12,442
2,5,2004,1067,3,175,114,43,13,6,351,1,3,355
2,5,2004,1068,3,135,125,52,17,9,338,0,10,348
2,5,2004,1069,3,232,165,67,31,13,508,0,9,517
2,5,2004,1070,3,330,294,149,46,21,840,3,10,853
2,5,2004,1071,3,245,272,115,43,13,688,3,12,703
2,5,2004,1072,3,424,133,108,39,17,721,0,4,725
2,5,2004,1073,3,197,107,100,30,6,440,2,10,452
2,5,2004,1074,3,240,93,96,20,12,461,1,4,466
2,5,2004,1075,3,301,122,101,32,18,574,2,10,586
2,5,2004,1076,3,579,278,168,74,34,1133,4,14,1151
2,5,2004,1077,3,565,193,163,48,22,991,0,11,1002
2,5,2004,1078,3,490,183,157,46,24,900,1,11,912
2,5,2004,1079,3,277,104,85,30,10,506,2,12,520
2,5,2004,1080,3,224,85,81,20,16,426,2,12,440
2,5,2004,1081,3,212,165,82,31,15,505,1,17,523
2,5,2004,1082,3,180,128,72,25,11,416,1,4,421
2,5,2004,1083,3,227,175,86,33,6,527,1,15,543
2,5,2004,1084,3,219,107,71,26,8,431,0,1,432
2,5,2004,1085,3,261,144,82,21,31,539,0,5,544
2,5,2004,1086,3,388,160,70,36,17,671,0,9,680
2,5,2004,1087,3,236,103,72,22,17,450,0,8,458
2,5,2004,1088,3,260,126,92,37,27,542,2,13,557
2,5,2004,1089,3,287,165,64,32,13,561,1,15,577
2,5,2004,1090,3,271,137,74,30,9,521,3,5,529
2,5,2004,1091,3,197,100,54,22,8,381,0,9,390
2,5,2004,1092,3,288,102,89,17,6,502,1,8,511
2,5,2004,1093,3,555,208,140,55,34,992,4,9,1005
2,5,2004,1094,3,489,183,113,48,16,849,2,12,863
2,5,2004,1095,3,450,199,111,41,19,820,0,9,829
2,5,2004,1096,3,434,165,131,93,32,855,0,4,859
2,5,2004,1097,3,1032,275,258,109,47,1721,0,11,1732
2,5,2004,1098,3,359,199,169,41,16,784,3,20,807
2,5,2004,1099,3,472,130,113,50,16,781,6,4,791
2,5,2004,1100,3,356,143,103,41,25,668,1,10,679
2,5,2004,1101,3,659,302,270,58,25,1314,5,25,1344
2,5,2004,1102,3,267,79,81,28,14,469,1,4,474
2,5,2004,1103,3,621,317,257,85,33,1313,3,20,1336
2,5,2004,1104,3,143,81,116,23,11,374,1,8,383
2,5,2004,1105,3,194,91,77,21,8,391,0,12,403
2,5,2004,1106,3,298,125,82,23,11,539,1,14,554
2,5,2004,1107,3,262,170,110,27,17,586,0,7,593
2,5,2004,1108,3,158,101,71,19,15,364,1,12,377
2,5,2004,1109,3,342,148,140,31,22,683,6,16,705
2,5,2004,1110,3,287,138,79,36,12,552,4,12,568
2,5,2004,1111,3,161,158,82,29,14,444,0,12,456
2,5,2004,1112,3,181,108,66,22,15,392,1,8,401
2,5,2004,1113,3,209,98,66,28,11,412,2,6,420
2,5,2004,1114,3,219,147,95,22,7,490,0,10,500
2,5,2004,1115,3,153,87,49,18,10,317,1,5,323
2,5,2004,1116,3,476,265,131,57,19,948,1,19,968
2,5,2004,1117,3,142,101,32,18,7,300,0,5,305
2,5,2004,1118,3,339,174,94,39,17,663,2,15,680
2,5,2004,1119,3,706,324,230,96,33,1389,1,11,1401
2,5,2004,1122,3,1102,501,340,150,61,2154,4,28,2186
2,5,2004,1123,3,378,185,134,51,22,770,2,4,776
2,5,2004,1128,3,647,372,371,94,33,1517,10,22,1549
2,5,2004,1129,3,273,130,104,36,13,556,0,8,564
2,5,2004,1130,3,174,64,63,22,8,331,0,0,331
2,5,2004,1131,3,379,114,107,60,17,677,1,6,684
2,5,2004,1132,3,430,143,102,60,23,758,0,6,764
2,5,2004,1133,3,233,92,48,24,13,410,2,12,424
2,5,2004,1134,3,188,80,56,17,8,349,0,8,357
2,5,2004,1135,3,414,174,116,44,26,774,3,10,787
2,5,2004,1136,3,229,84,68,25,11,417,0,4,421
2,5,2004,1137,3,378,160,100,43,21,702,0,15,717
2,5,2004,1138,3,415,224,128,42,29,838,1,12,851
2,5,2004,1139,3,312,162,91,50,7,622,1,17,640
2,5,2004,1140,3,899,300,226,122,48,1595,0,16,1611
2,5,2004,1150,3,1351,486,442,197,87,2563,6,24,2593
2,5,2004,1299,3,216,46,43,23,11,339,2,9,350
2,5,2004,1300,3,1008,301,234,108,57,1708,3,14,1725
2,5,2004,1301,3,171,118,64,35,12,400,0,11,411
2,5,2004,1302,3,529,200,245,82,38,1094,2,20,1116
2,5,2004,1303,3,273,80,128,7,18,506,7,4,517
2,5,2004,1304,3,228,159,73,37,8,505,0,11,516
2,5,2004,1305,3,191,167,55,27,15,455,3,14,472
2,5,2004,1306,3,103,49,37,16,10,215,1,6,222
2,5,2004,1307,3,200,90,51,21,3,365,2,2,369
2,5,2004,1308,3,185,162,93,17,9,466,1,11,478
2,5,2004,1309,3,185,211,102,30,15,543,0,17,560
2,5,2004,1310,3,268,119,95,25,7,514,1,7,522
2,5,2004,1311,3,257,113,123,28,6,527,1,8,536
2,5,2004,1312,3,290,81,85,22,14,492,3,10,505
2,5,2004,1313,3,251,59,69,28,16,423,1,6,430
2,5,2004,1314,3,331,168,134,67,17,717,0,9,726
2,5,2004,1315,3,201,101,71,22,13,408,6,2,416
2,5,2004,1316,3,164,117,71,17,8,377,0,8,385
2,5,2004,1317,3,213,177,87,29,26,532,0,23,555
2,5,2004,1318,3,371,166,98,43,20,698,0,6,704
2,5,2004,1319,3,358,188,154,47,15,762,1,5,768
2,5,2004,1320,3,335,139,108,40,16,638,0,18,656
2,5,2004,1321,3,570,319,285,74,30,1278,2,17,1297
2,5,2004,1322,3,149,91,105,28,10,383,4,9,396
2,5,2004,1323,3,113,64,53,17,3,250,0,7,257
2,5,2004,1324,3,190,105,94,32,8,429,0,4,433
2,5,2004,1325,3,218,113,56,24,9,420,0,5,425
2,5,2004,1326,3,437,174,130,40,25,806,0,11,817
2,5,2004,1327,3,623,194,194,72,25,1108,0,19,1127
2,5,2004,1328,3,907,485,406,105,55,1958,10,21,1989
2,5,2004,1329,3,280,125,90,45,18,558,0,4,562
2,5,2004,1330,3,307,133,106,39,16,601,2,7,610
2,5,2004,1331,3,348,121,107,51,12,639,1,7,647
2,6,2004,735,3,277,225,162,54,21,739,1,12,752
2,6,2004,736,3,187,161,101,49,30,528,1,3,532
2,6,2004,737,3,339,135,96,43,6,619,1,8,628
2,6,2004,738,3,329,116,90,41,12,588,1,6,595
2,6,2004,739,3,401,101,80,36,16,634,3,12,649
2,6,2004,740,3,402,114,92,35,16,659,2,16,677
2,6,2004,741,3,373,135,111,49,22,690,1,10,701
2,6,2004,742,3,348,172,95,32,23,670,0,13,683
2,6,2004,743,3,145,117,48,12,6,328,0,1,329
2,6,2004,744,3,209,108,52,28,9,406,1,4,411
2,6,2004,745,3,147,98,47,37,3,332,1,4,337
2,6,2004,746,3,240,141,86,29,19,515,1,6,522
2,6,2004,747,3,185,124,78,33,10,430,1,6,437
2,6,2004,748,3,176,117,64,23,2,382,3,7,392
2,6,2004,749,3,138,132,103,22,6,401,3,6,410
2,6,2004,750,3,92,161,91,20,13,377,1,4,382
2,6,2004,751,3,103,179,92,21,9,404,2,9,415
2,6,2004,752,3,68,94,63,9,1,235,0,1,236
2,6,2004,753,3,108,117,91,21,5,342,0,6,348
2,6,2004,754,3,125,116,79,23,14,357,4,12,373
2,6,2004,755,3,115,87,59,16,7,284,3,3,290
2,6,2004,756,3,168,132,98,43,16,457,1,5,463
2,6,2004,757,3,190,128,89,44,10,461,0,9,470
2,6,2004,758,3,199,113,70,20,7,409,1,9,419
2,6,2004,759,3,157,79,57,19,4,316,0,3,319
2,6,2004,760,3,173,76,60,33,6,348,0,10,358
2,6,2004,761,3,201,184,133,30,17,565,1,20,586
2,6,2004,762,3,186,164,101,36,14,501,2,18,521
2,6,2004,763,3,213,184,98,48,10,553,2,9,564
2,6,2004,764,3,283,206,187,45,23,744,3,15,762
2,6,2004,765,3,397,209,93,60,17,776,1,6,783
2,6,2004,766,3,525,292,212,118,40,1187,2,8,1197
2,6,2004,767,3,280,162,111,40,15,608,0,12,620
2,6,2004,768,3,224,118,82,25,12,461,0,2,463
2,6,2004,769,3,183,180,91,34,11,499,0,7,506
2,6,2004,770,3,85,120,45,20,4,274,0,8,282
2,6,2004,771,3,280,105,119,40,16,560,1,12,573
2,6,2004,772,3,212,114,81,45,10,462,0,15,477
2,6,2004,773,3,148,98,56,28,3,333,0,13,346
2,6,2004,774,3,147,87,60,22,9,325,1,8,334
2,6,2004,775,3,179,67,73,21,12,352,0,1,353
2,6,2004,776,3,229,112,66,27,9,443,0,3,446
2,6,2004,777,3,266,94,68,33,11,472,1,8,481
2,6,2004,778,3,183,133,73,17,11,417,0,4,421
2,6,2004,779,3,118,86,76,21,9,310,0,4,314
2,6,2004,780,3,136,63,87,27,4,317,2,2,321
2,6,2004,781,3,116,73,58,17,1,265,0,2,267
2,6,2004,782,3,171,95,67,19,6,358,0,11,369
2,6,2004,783,3,217,106,98,21,10,452,1,7,460
2,6,2004,784,3,155,88,65,24,12,344,0,4,348
2,6,2004,785,3,199,97,67,38,13,414,0,10,424
2,6,2004,786,3,196,105,77,32,7,417,0,36,453
2,6,2004,787,3,227,116,65,36,5,449,0,8,457
2,6,2004,788,3,184,99,52,32,6,373,0,3,376
2,6,2004,789,3,234,125,57,34,15,465,1,5,471
2,6,2004,790,3,293,145,107,46,17,608,0,8,616
2,6,2004,791,3,150,46,49,24,18,287,0,6,293
2,6,2004,792,3,257,102,57,29,13,458,4,7,469
2,6,2004,793,3,225,99,81,45,12,462,0,9,471
2,6,2004,794,3,351,178,98,44,18,689,0,8,697
2,6,2004,795,3,308,101,82,34,9,534,0,7,541
2,6,2004,796,3,374,122,81,60,13,650,2,15,667
2,6,2004,797,3,211,195,148,49,13,616,0,7,623
2,6,2004,798,3,366,210,126,46,16,764,1,21,786
2,6,2004,799,3,163,120,87,46,15,431,0,7,438
2,6,2004,800,3,363,160,133,48,17,721,0,11,732
2,6,2004,801,3,260,126,79,30,16,511,0,4,515
2,6,2004,802,3,297,167,95,35,18,612,3,3,618
2,6,2004,803,3,377,192,83,54,18,724,1,13,738
2,6,2004,804,3,315,176,102,41,22,656,1,10,667
2,6,2004,805,3,359,186,100,47,20,712,1,18,731
2,6,2004,806,3,164,113,74,15,5,371,0,5,376
2,6,2004,807,3,184,166,96,20,24,490,1,11,502
2,6,2004,808,3,284,146,91,46,18,585,1,5,591
2,6,2004,809,3,179,103,57,24,18,381,0,10,391
2,6,2004,810,3,179,94,63,16,12,364,0,4,368
2,6,2004,811,3,271,105,80,35,13,504,2,12,518
2,6,2004,812,3,192,105,75,25,12,409,1,0,410
2,6,2004,813,3,146,82,69,26,5,328,1,4,333
2,6,2004,814,3,227,98,81,26,18,450,3,4,457
2,6,2004,815,3,175,91,86,27,6,385,2,3,390
2,6,2004,816,3,194,133,57,22,8,414,0,8,422
2,6,2004,817,3,179,107,58,27,8,379,3,6,388
2,6,2004,818,3,185,112,61,25,10,393,0,10,403
2,6,2004,819,3,234,104,92,30,14,474,1,12,487
2,6,2004,820,3,283,152,74,40,6,555,0,17,572
2,6,2004,821,3,314,143,107,55,16,635,0,13,648
2,6,2004,822,3,268,196,100,36,17,617,1,17,635
2,6,2004,823,3,216,68,87,29,15,415,1,3,419
2,6,2004,824,3,177,135,92,34,3,441,0,11,452
2,6,2004,825,3,166,136,76,23,9,410,1,10,421
2,6,2004,826,3,153,174,105,31,18,481,0,2,483
2,6,2004,827,3,254,175,98,59,9,595,6,5,606
2,6,2004,828,3,218,158,83,26,12,497,10,14,521
2,6,2004,829,3,309,148,103,51,13,624,2,7,633
2,6,2004,830,3,372,249,186,73,20,900,4,14,918
2,6,2004,831,3,215,168,134,13,15,545,2,10,557
2,6,2004,832,3,177,181,80,45,7,490,1,11,502
2,6,2004,833,3,231,195,82,42,8,558,5,28,591
2,6,2004,834,3,215,191,110,44,9,569,0,14,583
2,6,2004,835,3,152,96,58,22,6,334,1,7,342
2,6,2004,836,3,191,119,71,32,8,421,3,9,433
2,6,2004,837,3,206,128,105,36,13,488,1,7,496
2,6,2004,838,3,277,133,100,29,12,551,2,10,563
2,6,2004,839,3,168,104,67,24,22,385,0,9,394
2,6,2004,840,3,262,109,82,38,12,503,3,15,521
2,6,2004,841,3,130,115,57,28,11,341,0,7,348
2,6,2004,842,3,205,144,93,37,16,495,1,14,510
2,6,2004,843,3,297,289,189,47,19,841,6,8,855
2,6,2004,844,3,226,202,99,50,14,591,2,13,606
2,6,2004,845,3,146,138,64,31,9,388,3,9,400
2,6,2004,846,3,192,194,85,44,11,526,1,12,539
2,6,2004,847,3,256,138,103,41,6,544,2,19,565
2,6,2004,848,3,223,144,98,31,7,503,2,11,516
2,6,2004,849,3,225,134,91,31,13,494,2,18,514
2,6,2004,850,3,352,221,130,42,22,767,3,10,780
2,6,2004,851,3,239,186,68,37,3,533,2,18,553
2,6,2004,852,3,178,169,121,55,15,538,5,4,547
2,6,2004,853,3,220,200,137,36,9,602,9,21,632
2,6,2004,854,3,392,443,285,88,31,1239,10,21,1270
2,6,2004,855,3,212,165,90,56,14,537,6,20,563
2,6,2004,856,3,338,282,170,57,18,865,10,20,895
2,6,2004,857,3,317,312,207,66,32,934,4,21,959
2,6,2004,858,3,415,484,290,108,51,1348,0,41,1389
2,6,2004,859,3,129,104,72,21,7,333,1,5,339
2,6,2004,860,3,140,109,88,24,13,374,1,5,380
2,6,2004,861,3,161,108,48,38,5,360,0,6,366
2,6,2004,862,3,81,122,38,19,10,270,1,4,275
2,6,2004,863,3,147,65,31,16,7,266,3,5,274
2,6,2004,864,3,82,81,64,16,9,252,2,3,257
2,6,2004,865,3,213,97,63,37,10,420,1,9,430
2,6,2004,866,3,149,83,48,24,12,316,0,10,326
2,6,2004,867,3,119,88,68,17,8,300,4,5,309
2,6,2004,888,3,236,132,50,21,2,441,0,5,446
2,6,2004,889,3,221,108,54,18,13,414,0,4,418
2,6,2004,890,3,173,70,42,19,9,313,1,6,320
2,6,2004,891,3,349,179,131,32,18,709,1,9,719
2,6,2004,892,3,189,147,94,26,6,462,0,8,470
2,6,2004,893,3,187,118,68,27,8,408,1,9,418
2,6,2004,894,3,273,145,95,36,15,564,3,12,579
2,6,2004,895,3,192,134,78,20,8,432,1,7,440
2,6,2004,896,3,193,146,82,24,7,452,1,9,462
2,6,2004,897,3,312,150,107,42,19,630,1,8,639
2,6,2004,898,3,361,161,92,37,14,665,0,0,665
2,6,2004,899,3,182,72,35,18,4,311,0,6,317
2,6,2004,902,3,374,106,66,33,12,591,0,3,594
2,6,2004,903,3,253,165,47,28,14,507,0,8,515
2,6,2004,904,3,188,112,66,23,11,400,0,6,406
2,6,2004,905,3,130,83,48,20,6,287,0,0,287
2,6,2004,906,3,128,118,58,25,7,336,0,7,343
2,6,2004,907,3,120,71,46,13,5,255,0,6,261
2,6,2004,908,3,180,127,60,30,5,402,1,12,415
2,6,2004,909,3,123,48,29,12,4,216,2,2,220
2,6,2004,910,3,205,110,48,29,6,398,0,8,406
2,6,2004,911,3,233,113,91,10,12,459,4,9,472
2,6,2004,912,3,181,106,72,23,13,395,0,7,402
2,6,2004,913,3,177,100,52,23,15,367,0,5,372
2,6,2004,914,3,156,107,56,22,7,348,0,1,349
2,6,2004,915,3,119,103,22,18,6,268,1,5,274
2,6,2004,916,3,256,214,54,23,13,560,0,3,563
2,6,2004,917,3,234,160,79,31,14,518,0,6,524
2,6,2004,918,3,116,96,32,12,7,263,0,5,268
2,6,2004,919,3,192,112,53,31,8,396,6,9,411
2,6,2004,920,3,149,105,37,28,12,331,3,10,344
2,6,2004,921,3,73,74,27,23,6,203,0,6,209
2,6,2004,922,3,240,151,63,31,9,494,1,9,504
2,6,2004,923,3,171,161,55,23,2,412,1,12,425
2,6,2004,924,3,239,104,80,24,3,450,0,14,464
2,6,2004,925,3,248,107,70,34,7,466,0,1,467
2,6,2004,926,3,506,190,132,57,20,905,1,5,911
2,6,2004,944,3,77,62,55,13,3,210,1,3,214
2,6,2004,945,3,171,90,59,31,8,359,0,8,367
2,6,2004,946,3,94,61,38,26,0,219,0,0,219
2,6,2004,947,3,262,80,79,37,12,470,2,2,474
2,6,2004,948,3,185,143,77,27,6,438,0,12,450
2,6,2004,949,3,122,56,41,30,12,261,0,10,271
2,6,2004,950,3,166,149,81,26,8,430,0,14,444
2,6,2004,951,3,142,143,107,19,7,418,2,8,428
2,6,2004,952,3,217,249,175,46,30,717,4,8,729
2,6,2004,953,3,259,126,70,57,11,523,1,9,533
2,6,2004,954,3,327,138,90,52,20,627,3,8,638
2,6,2004,955,3,169,124,60,32,9,394,1,9,404
2,6,2004,956,3,141,143,73,26,10,393,2,12,407
2,6,2004,977,3,208,185,129,43,12,577,4,16,597
2,6,2004,978,3,242,247,119,56,15,679,2,11,692
2,6,2004,979,3,332,224,149,79,18,802,4,19,825
2,6,2004,980,3,339,151,96,58,15,659,0,10,669
2,6,2004,981,3,336,110,91,35,23,595,2,11,608
2,6,2004,982,3,184,121,62,37,9,413,2,13,428
2,6,2004,983,3,240,196,83,38,10,567,2,17,586
2,6,2004,984,3,134,168,65,29,9,405,2,4,411
2,6,2004,985,3,211,127,111,36,11,496,4,11,511
2,6,2004,986,3,166,141,71,15,12,405,1,18,424
2,6,2004,987,3,215,205,89,42,14,565,5,11,581
2,6,2004,988,3,281,212,80,47,12,632,4,5,641
2,6,2004,989,3,258,106,72,33,16,485,3,9,497
2,6,2004,990,3,352,162,94,50,13,671,0,6,677
2,6,2004,991,3,219,68,59,26,10,382,0,1,383
2,6,2004,992,3,126,75,63,24,8,296,0,4,300
2,6,2004,993,3,449,205,114,74,27,869,0,11,880
2,6,2004,994,3,288,196,105,45,26,660,3,14,677
2,6,2004,995,3,229,138,72,31,11,481,0,3,484
2,6,2004,996,3,204,152,104,23,17,500,2,14,516
2,6,2004,997,3,71,140,55,12,7,285,1,6,292
2,6,2004,998,3,189,100,98,35,7,429,1,12,442
2,6,2004,1017,3,182,92,67,20,9,370,0,14,384
2,6,2004,1018,3,139,86,41,19,2,287,1,0,288
2,6,2004,1023,3,169,104,51,28,3,355,0,4,359
2,6,2004,1024,3,164,112,74,20,6,376,1,10,387
2,6,2004,1026,3,131,132,74,23,7,367,0,17,384
2,6,2004,1027,3,143,96,72,30,12,353,1,4,358
2,6,2004,1028,3,134,107,56,22,4,323,3,13,339
2,6,2004,1029,3,107,147,52,24,6,336,1,5,342
2,6,2004,1245,3,435,163,147,58,26,829,0,11,840
2,6,2004,1246,3,428,98,111,45,20,702,0,6,708
2,6,2004,1247,3,395,152,111,54,14,726,0,5,731
2,6,2004,1248,3,345,106,112,46,23,632,0,5,637
2,6,2004,1249,3,492,147,156,88,39,922,0,9,931
2,6,2004,1250,3,491,155,157,71,20,894,1,13,908
2,6,2004,1251,3,400,119,131,70,19,739,0,5,744
2,6,2004,1252,3,437,108,152,70,33,800,0,4,804
2,6,2004,1253,3,427,139,156,57,36,815,2,7,824
2,6,2004,1254,3,515,162,190,77,29,973,1,12,986
2,6,2004,1255,3,317,145,110,45,17,634,1,11,646
2,6,2004,1256,3,296,115,144,47,17,619,0,2,621
2,6,2004,1257,3,222,166,123,39,9,559,3,6,568
2,6,2004,1258,3,200,185,71,27,10,493,2,14,509
2,6,2004,1358,3,323,111,99,28,14,575,5,3,583
2,6,2004,1359,3,278,119,105,51,20,573,0,5,578
2,6,2004,1360,3,266,99,81,36,17,499,0,2,501
2,6,2004,1361,3,305,84,87,67,12,555,0,3,558
2,6,2004,1362,3,294,95,104,42,19,554,0,3,557
2,6,2004,1484,3,196,31,58,21,9,315,0,2,317
2,6,2004,1485,3,129,55,55,14,6,259,3,6,268
2,6,2004,1486,3,96,61,78,16,7,258,0,2,260
2,6,2004,1487,3,104,60,80,14,5,263,1,2,266
2,6,2004,1488,3,148,89,75,18,10,340,3,3,346
2,6,2004,1489,3,68,63,35,12,6,184,0,0,184
2,6,2004,1490,3,120,101,72,22,8,323,1,5,329
2,6,2004,1491,3,139,92,66,25,8,330,0,0,330
2,6,2004,1492,3,86,77,70,24,6,263,0,4,267
2,6,2004,1493,3,124,72,47,26,5,274,0,3,277
2,6,2004,1494,3,82,45,50,26,7,210,0,3,213
2,6,2004,1495,3,96,68,47,29,7,247,0,6,253
2,6,2004,1496,3,68,37,25,17,6,153,1,0,154
2,6,2004,1497,3,183,56,43,13,7,302,1,2,305
2,6,2004,1498,3,101,40,44,30,8,223,0,1,224
2,6,2004,1499,3,92,69,56,20,10,247,0,5,252
2,6,2004,1500,3,112,28,32,21,5,198,0,2,200
2,6,2004,1501,3,71,26,35,25,10,167,0,2,169
2,6,2004,1502,3,110,30,31,15,9,195,0,4,199
2,6,2004,1503,3,65,15,15,16,4,115,0,0,115
2,6,2004,1504,3,69,21,32,22,5,149,0,2,151
2,6,2004,1505,3,71,43,33,21,2,170,0,5,175
2,6,2004,1506,3,99,17,33,10,9,168,0,0,168
2,6,2004,1507,3,78,30,23,13,8,152,0,0,152
2,6,2004,1508,3,83,26,21,13,5,148,0,1,149
2,6,2004,1509,3,47,27,25,11,10,120,0,0,120
2,6,2004,1510,3,86,40,53,24,8,211,0,0,211
2,6,2004,1511,3,50,45,32,16,8,151,0,3,154
2,6,2004,1512,3,86,58,41,17,6,208,0,4,212
2,6,2004,1513,3,52,30,27,10,3,122,0,4,126
2,6,2004,1514,3,76,41,46,7,6,176,3,2,181
2,6,2004,1515,3,66,9,14,11,4,104,0,0,104
2,6,2004,1516,3,58,22,33,16,4,133,0,0,133
2,6,2004,1517,3,55,16,30,11,5,117,0,2,119
2,6,2004,1518,3,99,32,58,15,9,213,0,1,214
2,6,2004,1519,3,101,44,43,23,9,220,0,1,221
2,6,2004,1520,3,122,33,52,19,10,236,3,1,240
2,6,2004,1521,3,78,25,32,17,7,159,0,2,161
2,6,2004,1522,3,117,51,30,18,4,220,0,4,224
2,6,2004,1523,3,140,50,45,21,11,267,0,5,272
2,6,2004,1524,3,93,36,30,21,6,186,2,0,188
2,6,2004,1525,3,67,47,55,24,4,197,0,5,202
2,7,2001,12,3,351,145,170,37,13,716,4,25,745
2,7,2001,13,3,816,360,455,128,56,1815,15,28,1858
2,7,2001,14,3,1207,641,965,175,62,3050,9,78,3137
2,7,2001,36,3,169,131,183,39,21,543,5,12,560
2,7,2001,60,3,434,179,214,42,32,901,4,26,931
2,7,2001,61,3,299,167,214,53,15,748,2,30,780
2,7,2001,62,3,218,163,217,34,12,644,2,10,656
2,7,2001,79,3,381,144,135,39,13,712,1,8,721
2,7,2001,80,3,247,101,98,33,16,495,0,21,516
2,7,2001,81,3,223,75,70,29,10,407,4,11,422
2,7,2001,82,3,132,77,82,23,9,323,2,9,334
2,7,2001,83,3,322,136,110,30,16,614,3,12,629
2,7,2001,84,3,303,113,94,32,19,561,0,17,578
2,7,2001,92,3,325,134,102,34,10,605,0,5,610
2,7,2001,93,3,310,88,115,39,16,568,5,13,586
2,7,2001,94,3,323,139,123,42,22,649,2,17,668
2,7,2001,95,3,297,138,150,44,17,646,2,8,656
2,7,2001,96,3,211,100,142,31,11,495,4,25,524
2,7,2001,97,3,145,74,116,29,10,374,8,22,404
2,7,2001,98,3,411,209,189,55,7,871,0,22,893
2,7,2001,99,3,275,121,131,32,12,571,6,19,596
2,7,2001,100,3,419,208,178,45,22,872,2,21,895
2,7,2001,101,3,368,146,142,39,20,715,6,9,730
2,7,2001,102,3,403,213,193,33,21,863,0,19,882
2,7,2001,107,3,300,177,177,46,16,716,3,18,737
2,7,2001,108,3,640,270,291,101,45,1347,3,26,1376
2,7,2001,109,3,277,225,301,60,24,887,9,20,916
2,7,2001,128,3,208,115,144,19,17,503,1,20,524
2,7,2001,129,3,178,104,141,24,12,459,1,18,478
2,7,2001,169,3,128,117,102,28,6,381,1,19,401
2,7,2001,170,3,92,127,21,6,2,248,0,14,262
2,7,2001,171,3,329,168,89,15,5,606,4,31,641
2,7,2001,172,3,84,60,55,12,2,213,1,8,222
2,7,2002,211,3,135,105,48,19,8,315,0,9,324
2,7,2002,212,3,155,74,52,17,11,309,1,8,318
2,7,2002,233,3,119,85,70,17,15,306,1,9,316
2,7,2002,234,3,143,76,41,18,10,288,2,15,305
2,7,2002,235,3,146,115,54,22,11,348,0,11,359
2,7,2002,236,3,176,84,48,24,7,339,7,2,348
2,7,2002,252,3,206,157,73,38,14,488,3,18,509
2,7,2002,253,3,164,100,54,22,12,352,1,11,364
2,7,2002,254,3,214,150,66,25,10,465,4,17,486
2,7,2002,255,3,201,122,62,31,10,426,4,19,449
2,7,2002,256,3,149,97,50,20,9,325,4,10,339
2,7,2002,257,3,181,130,60,24,15,410,4,13,427
2,7,2002,280,3,180,95,63,27,7,372,0,12,384
2,7,2002,281,3,191,129,74,33,12,439,6,7,452
2,7,2002,282,3,194,105,75,30,18,422,1,11,434
2,7,2002,283,3,195,105,87,19,14,420,5,11,436
2,7,2002,284,3,198,95,52,48,13,406,0,5,411
2,7,2002,305,3,431,250,163,58,29,931,1,12,944
2,7,2002,306,3,268,179,121,35,23,626,1,19,646
2,7,2002,307,3,222,126,81,47,16,492,10,18,520
2,7,2002,308,3,200,122,95,39,12,468,3,16,487
2,7,2002,322,3,188,132,88,48,16,472,2,2,476
2,7,2002,323,3,284,154,82,33,15,568,2,8,578
2,7,2002,327,3,349,146,112,59,21,687,0,9,696
2,7,2002,328,3,342,136,113,76,13,680,2,18,700
2,7,2002,329,3,279,144,66,50,23,562,0,7,569
2,7,2002,330,3,307,176,79,64,18,644,4,15,663
2,7,2002,331,3,558,264,167,81,39,1109,9,23,1141
2,7,2002,332,3,257,156,94,33,16,556,0,8,564
2,7,2002,333,3,679,255,157,92,31,1214,11,23,1248
2,7,2002,334,3,385,161,88,51,16,701,2,6,709
2,7,2002,335,3,448,204,126,50,23,851,1,15,867
2,7,2002,336,3,224,94,52,26,11,407,0,6,413
2,7,2002,337,3,255,125,86,42,16,524,1,11,536
2,7,2002,343,3,344,109,78,41,10,582,0,18,600
2,7,2002,344,3,257,123,49,26,17,472,4,10,486
2,7,2002,345,3,308,136,82,52,10,588,1,12,601
2,7,2002,346,3,1484,604,404,239,94,2825,7,20,2852
2,7,2002,347,3,509,218,159,58,28,972,3,11,986
2,7,2002,348,3,404,184,96,46,16,746,0,11,757
2,7,2002,349,3,200,126,79,24,6,435,4,16,455
2,7,2002,350,3,332,157,102,60,21,672,0,16,688
2,7,2002,351,3,391,198,121,86,24,820,3,11,834
2,7,2002,352,3,233,151,88,52,21,545,2,10,557
2,7,2002,353,3,132,132,76,28,7,375,2,8,385
2,7,2002,354,3,206,111,71,35,16,439,4,13,456
2,7,2002,355,3,247,170,100,39,15,571,1,10,582
2,7,2002,356,3,739,374,256,129,67,1565,5,28,1598
2,7,2002,357,3,762,319,224,127,68,1500,8,24,1532
2,7,2002,517,3,178,104,111,31,13,437,2,217,656
2,7,2002,518,3,374,364,268,82,28,1116,12,27,1155
2,7,2002,519,3,238,210,172,40,18,678,4,6,688
2,7,2002,520,3,360,282,192,56,15,905,1,28,934
2,7,2002,521,3,196,186,132,42,17,573,3,13,589
2,7,2002,522,3,441,278,248,96,34,1097,7,21,1125
2,7,2002,523,3,412,272,235,107,26,1052,2,23,1077
2,7,2002,524,3,169,103,68,32,9,381,1,10,392
2,7,2002,525,3,163,114,87,26,11,401,2,6,409
2,7,2002,526,3,174,124,76,30,45,449,1,15,465
2,7,2002,527,3,165,105,71,37,13,391,6,14,411
2,7,2002,528,3,103,98,83,42,9,335,0,10,345
2,7,2002,529,3,201,136,104,30,15,486,3,14,503
2,7,2002,530,3,172,130,85,48,9,444,0,16,460
2,7,2002,531,3,179,125,106,44,10,464,3,13,480
2,7,2002,532,3,190,205,113,47,11,566,1,9,576
2,7,2002,533,3,223,133,141,54,18,569,6,10,585
2,7,2002,534,3,240,90,89,44,20,483,6,7,496
2,7,2002,535,3,118,63,45,21,13,260,3,7,270
2,7,2002,536,3,92,63,76,24,8,263,0,15,278
2,7,2002,537,3,143,103,71,21,8,346,2,10,358
2,7,2002,538,3,1065,495,426,201,101,2288,16,35,2339
2,7,2002,539,3,161,96,87,26,12,382,2,7,391
2,7,2002,540,3,245,157,99,36,14,551,3,18,572
2,7,2002,541,3,310,263,175,73,26,847,2,22,871
2,7,2002,542,3,292,187,160,50,11,700,6,369,1075
2,7,2002,543,3,208,227,113,38,18,604,4,19,627
2,7,2002,544,3,747,457,360,185,45,1794,6,49,1849
2,7,2002,545,3,224,229,111,28,15,607,8,20,635
2,7,2002,546,3,69,90,65,20,5,249,2,7,258
2,7,2002,547,3,265,165,145,66,16,657,7,34,698
2,7,2002,565,3,671,463,321,117,40,1612,11,29,1652
2,7,2002,566,3,231,166,150,49,24,620,2,23,645
2,7,2002,567,3,165,136,88,31,16,436,3,13,452
2,7,2002,568,3,644,417,379,165,61,1666,10,38,1714
2,7,2002,672,3,51,68,32,10,2,163,2,6,171
2,7,2002,692,3,2488,984,935,523,208,5138,31,52,5221
2,7,2003,694,3,345,180,162,52,25,764,2,14,780
2,7,2003,695,3,281,177,135,68,22,683,1,11,695
2,7,2003,696,3,490,233,163,65,24,975,0,29,1004
2,7,2003,697,3,253,230,93,49,14,639,0,8,647
2,7,2003,698,3,192,96,69,25,11,393,0,10,403
2,7,2003,699,3,220,127,68,30,19,464,0,3,467
2,7,2003,700,3,531,324,221,74,28,1178,4,23,1205
2,7,2003,701,3,307,149,103,38,15,612,0,5,617
2,7,2003,702,3,596,322,316,118,35,1387,6,36,1429
2,7,2003,703,3,351,230,178,97,19,875,5,12,892
2,7,2003,704,3,176,143,93,37,14,463,0,9,472
2,7,2003,705,3,306,223,132,33,20,714,0,22,736
2,7,2003,706,3,326,151,103,48,19,647,3,6,656
2,7,2003,707,3,297,161,66,34,10,568,0,13,581
2,7,2003,708,3,284,185,111,53,25,658,4,9,671
2,7,2003,709,3,316,162,130,48,14,670,0,18,688
2,7,2003,710,3,335,135,120,31,18,639,1,12,652
2,7,2003,711,3,319,235,256,80,32,922,2,17,941
2,7,2003,712,3,327,168,128,46,19,688,1,14,703
2,7,2003,713,3,237,172,122,39,14,584,1,12,597
2,7,2003,714,3,450,329,236,89,22,1126,6,28,1160
2,7,2003,715,3,295,241,337,57,29,959,3,34,996
2,7,2003,716,3,330,258,186,71,19,864,1,11,876
2,7,2003,717,3,236,140,131,42,13,562,2,12,576
2,7,2003,718,3,243,218,177,45,17,700,0,15,715
2,7,2003,719,3,231,147,92,18,12,500,2,17,519
2,7,2003,720,3,230,150,108,37,10,535,1,12,548
2,7,2003,721,3,481,287,277,74,38,1157,2,27,1186
2,7,2003,722,3,1389,663,785,273,105,3215,13,61,3289
2,7,2003,723,3,436,319,291,64,25,1135,15,22,1172
2,7,2003,724,3,305,331,297,38,21,992,3,20,1015
2,7,2003,725,3,162,100,71,21,7,361,2,18,381
2,7,2003,726,3,166,138,106,33,6,449,1,11,461
2,7,2003,727,3,100,66,49,4,4,223,0,8,231
2,7,2003,728,3,80,78,53,11,2,224,1,0,225
2,7,2003,729,3,137,124,90,22,6,379,2,23,404
2,7,2003,730,3,174,130,121,18,7,450,3,9,462
2,7,2003,731,3,120,90,47,11,5,273,0,11,284
2,7,2003,732,3,49,45,30,5,0,129,1,7,137
2,7,2003,733,3,113,120,45,14,0,292,0,14,306
2,7,2003,734,3,251,166,102,31,7,557,1,7,565
2,8,2004,966,3,367,158,139,44,13,721,0,5,726
2,8,2004,967,3,179,75,57,15,4,330,0,2,332
2,8,2004,968,3,237,97,38,17,7,396,0,3,399
2,8,2004,969,3,243,86,60,19,8,416,0,5,421
2,8,2004,1000,3,175,65,71,12,6,329,0,5,334
2,8,2004,1001,3,311,91,97,33,11,543,1,11,555
2,8,2004,1002,3,399,151,86,42,14,692,1,16,709
2,8,2004,1003,3,390,107,93,29,21,640,0,7,647
2,8,2004,1004,3,314,106,79,31,13,543,0,8,551
2,8,2004,1005,3,166,84,68,30,7,355,0,8,363
2,8,2004,1006,3,167,85,72,19,14,357,0,8,365
2,8,2004,1007,3,317,118,95,19,13,562,3,5,570
2,8,2004,1008,3,198,70,71,32,1,372,2,2,376
2,8,2004,1009,3,258,111,95,19,12,495,0,8,503
2,8,2004,1010,3,155,47,48,18,16,284,2,4,290
2,8,2004,1011,3,284,197,164,39,18,702,0,12,714
2,8,2004,1012,3,228,100,69,44,16,457,1,6,464
2,8,2004,1013,3,383,109,96,47,27,662,2,3,667
2,8,2004,1031,3,385,139,140,49,24,737,1,21,759
2,8,2004,1032,3,203,105,63,23,8,402,0,4,406
2,8,2004,1033,3,321,123,91,41,19,595,0,7,602
2,8,2004,1034,3,278,199,126,44,13,660,2,11,673
2,8,2004,1035,3,251,87,58,32,5,433,0,5,438
2,8,2004,1036,3,250,125,70,44,16,505,2,8,515
2,8,2004,1037,3,282,114,72,41,14,523,4,8,535
2,8,2004,1165,3,167,136,101,18,8,430,1,6,437
2,8,2004,1166,3,285,190,132,41,14,662,3,32,697
2,8,2004,1167,3,253,175,177,40,29,674,2,16,692
2,8,2004,1168,3,386,318,231,62,24,1021,1,34,1056
2,8,2004,1169,3,600,243,261,60,41,1205,5,20,1230
2,8,2004,1170,3,331,96,89,28,26,570,0,10,580
2,8,2004,1189,3,1446,1096,1064,224,72,3902,14,72,3988
2,8,2004,1190,3,295,232,219,54,13,813,2,19,834
2,8,2004,1191,3,413,268,153,64,27,925,0,16,941
2,8,2004,1192,3,552,306,200,83,34,1175,3,16,1194
2,8,2004,1193,3,336,171,113,62,26,708,1,7,716
2,8,2005,1194,3,460,220,287,63,30,1060,1,27,1088
2,8,2004,1195,3,307,278,177,57,30,849,0,13,862
2,8,2004,1196,3,773,324,249,96,51,1493,3,40,1536
2,8,2004,1197,3,281,167,111,37,12,608,4,13,625
2,8,2004,1198,3,360,313,172,50,29,924,3,32,959
2,8,2004,1199,3,326,144,95,46,11,622,1,12,635
2,8,2004,1200,3,290,235,118,62,28,733,2,16,751
2,8,2004,1201,3,400,224,246,58,16,944,5,37,986
2,8,2004,1202,3,402,184,199,60,27,872,3,23,898
2,8,2004,1203,3,366,192,207,40,20,825,6,19,850
2,8,2004,1204,3,317,198,158,44,17,734,2,25,761
2,8,2004,1205,3,522,332,248,87,33,1222,2,30,1254
2,8,2004,1206,3,173,133,124,36,20,486,3,9,498
2,8,2004,1207,3,43,30,41,5,4,123,0,2,125
2,8,2004,1208,3,115,68,63,17,6,269,0,7,276
2,8,2004,1209,3,379,252,172,47,24,874,3,18,895
2,8,2004,1210,3,339,236,145,43,12,775,1,13,789
2,8,2004,1211,3,283,178,127,53,15,656,2,4,662
2,8,2004,1212,3,320,252,173,64,15,824,1,22,847
2,8,2004,1213,3,353,198,132,66,20,769,1,10,780
2,8,2004,1214,3,382,177,153,56,20,788,1,8,797
2,8,2004,1221,3,337,156,123,42,13,671,9,17,697
2,8,2004,1222,3,283,183,99,41,20,626,1,13,640
2,8,2004,1223,3,295,170,98,37,15,615,3,13,631
2,8,2004,1224,3,434,171,168,73,38,884,2,17,903
2,8,2004,1225,3,195,98,79,35,8,415,0,9,424
2,8,2004,1226,3,1599,632,754,277,112,3374,2,37,3413
2,8,2004,1227,3,179,143,79,34,20,455,0,16,471
2,8,2004,1228,3,236,151,129,30,13,559,8,11,578
2,8,2004,1231,3,969,281,330,127,65,1772,1,10,1783
2,8,2004,1232,3,219,173,130,33,14,569,4,7,580
2,8,2004,1233,3,256,122,61,19,3,461,2,4,467
2,8,2004,1234,3,537,125,201,81,40,984,1,11,996
2,8,2004,1235,3,268,83,77,34,17,479,2,4,485
2,8,2004,1236,3,1313,686,613,230,101,2943,7,48,2998
2,8,2004,1237,3,462,277,264,55,21,1079,5,22,1106
2,8,2004,1238,3,448,396,279,81,29,1233,5,20,1258
2,8,2004,1239,3,460,446,304,71,31,1312,2,34,1348
2,8,2004,1240,3,310,242,168,61,20,801,2,19,822
2,8,2004,1241,3,250,189,123,40,16,618,2,6,626
2,8,2004,1242,3,612,530,290,111,39,1582,3,36,1621
2,8,2004,1243,3,183,121,77,38,10,429,1,6,436
2,8,2004,1244,3,390,274,197,76,14,951,1,24,976
2,8,2005,1259,3,478,287,277,85,32,1159,4,21,1184
2,8,2005,1260,3,370,262,222,65,25,944,0,19,963
2,8,2005,1261,3,568,295,340,81,24,1308,1,28,1337
2,8,2005,1262,3,591,354,521,117,40,1623,2,24,1649
2,8,2005,1263,3,825,505,718,172,58,2278,5,52,2335
2,8,2005,1264,3,487,220,305,92,32,1136,0,19,1155
2,8,2005,1265,3,437,224,215,74,25,975,0,23,998
2,8,2005,1266,3,386,225,195,79,20,905,2,18,925
2,8,2005,1267,3,125,89,64,23,8,309,1,0,310
2,8,2005,1268,3,155,128,90,32,9,414,0,6,420
2,8,2005,1269,3,233,191,130,38,13,605,2,21,628
2,8,2005,1270,3,279,143,110,33,9,574,4,8,586
2,8,2005,1271,3,646,344,328,86,25,1429,2,17,1448
2,8,2005,1272,3,254,94,115,32,16,511,0,5,516
2,8,2005,1273,3,268,109,112,43,19,551,0,6,557
2,8,2004,1274,3,234,156,46,35,7,478,0,11,489
2,8,2004,1275,3,176,118,41,20,14,369,0,6,375
2,8,2004,1276,3,267,241,140,26,11,685,0,9,694
2,8,2004,1277,3,302,148,117,39,12,618,0,10,628
2,8,2004,1283,3,223,115,60,35,16,449,0,12,461
2,8,2004,1284,3,487,404,236,88,28,1243,2,11,1256
2,8,2004,1285,3,405,288,219,67,21,1000,2,22,1024
2,8,2004,1286,3,477,341,245,86,32,1181,9,34,1224
2,8,2004,1287,3,253,207,179,48,14,701,4,14,719
2,8,2004,1288,3,359,160,136,58,24,737,1,19,757
2,8,2004,1289,3,555,305,302,84,35,1281,13,23,1317
2,8,2005,1290,3,197,97,98,28,10,430,0,17,447
2,8,2005,1291,3,417,190,202,40,19,868,1,27,896
2,8,2004,1293,3,89,29,23,10,8,159,0,1,160
2,8,2004,1294,3,1278,459,573,244,73,2627,1,25,2653
2,8,2005,1295,3,987,358,538,162,52,2097,3,38,2138
2,8,2005,1297,3,257,161,175,41,20,654,2,19,675
2,8,2005,1298,3,196,80,70,16,4,366,0,18,384
2,8,2004,1336,3,1157,617,483,186,94,2537,5,35,2577
2,8,2004,1340,3,341,126,107,35,20,629,1,11,641
2,8,2004,1341,3,206,114,117,19,17,473,2,9,484
2,8,2004,1342,3,191,96,85,33,3,408,1,13,422
2,8,2004,1343,3,255,147,91,41,13,547,1,7,555
2,8,2004,1344,3,497,251,153,55,35,991,1,15,1007
2,8,2004,1345,3,193,170,83,38,14,498,3,9,510
2,8,2004,1346,3,261,133,79,31,8,512,1,8,521
2,8,2004,1347,3,333,179,169,52,19,752,3,10,765
2,8,2004,1348,3,325,260,142,42,28,797,6,23,826
2,8,2004,1349,3,464,361,336,77,36,1274,3,21,1298
2,8,2004,1350,3,322,278,257,50,23,930,2,12,944
2,8,2004,1351,3,290,221,135,50,17,713,2,5,720
2,8,2004,1352,3,192,120,103,26,13,454,1,15,470
2,8,2004,1353,3,350,127,123,40,20,660,0,1,661
2,8,2004,1355,3,98,99,74,15,4,290,0,10,300
2,8,2004,1356,3,282,237,171,37,10,737,0,21,758
2,8,2004,1357,3,190,149,105,36,8,488,4,5,497
2,8,2005,1363,3,91,60,40,23,7,221,0,2,223
2,8,2005,1364,3,151,107,65,21,14,358,0,10,368
2,8,2005,1365,3,412,180,226,58,22,898,0,19,917
2,8,2005,1366,3,225,94,93,25,16,453,0,6,459
2,8,2005,1367,3,210,106,145,40,15,516,0,11,527
2,8,2004,1368,3,53,28,19,9,1,110,0,1,111
2,8,2005,1370,3,340,151,201,57,16,765,8,19,792
3,1,3001,1,3,120,71,143,13,8,355,3,5,363
3,1,3001,2,3,62,22,103,4,5,196,0,10,206
3,1,3001,3,3,170,77,278,23,17,565,2,13,580
3,1,3001,4,3,183,99,271,21,15,589,3,13,605
3,1,3001,5,3,147,106,238,27,6,524,3,9,536
3,1,3001,6,3,111,137,142,15,9,414,0,5,419
3,1,3001,7,3,143,74,247,18,6,488,0,6,494
3,1,3001,8,3,96,38,125,17,7,283,0,11,294
3,1,3001,9,3,106,46,125,7,3,287,2,4,293
3,1,3001,10,3,156,71,202,19,9,457,0,10,467
3,1,3001,11,3,89,46,127,11,8,281,0,6,287
3,1,3001,12,3,83,36,103,8,3,233,0,2,235
3,1,3001,13,3,119,67,174,17,6,383,0,6,389
3,1,3001,14,3,108,58,153,7,7,333,1,6,340
3,1,3001,15,3,111,66,163,6,4,350,0,20,370
3,1,3001,16,3,163,72,230,19,13,497,3,1,501
3,1,3001,17,3,83,41,121,11,4,260,1,5,266
3,1,3001,18,3,202,84,201,19,7,513,0,12,525
3,1,3001,19,3,171,89,78,10,9,357,0,10,367
3,1,3001,20,3,132,80,276,17,12,517,4,6,527
3,1,3001,21,3,159,79,213,14,14,479,3,8,490
3,1,3001,22,3,185,70,216,10,7,488,0,17,505
3,1,3001,23,3,190,62,214,12,5,483,0,18,501
3,1,3001,24,3,91,45,154,10,1,301,0,6,307
3,1,3001,25,3,121,64,232,12,13,442,0,8,450
3,1,3001,26,3,137,81,190,15,13,436,2,13,451
3,1,3001,27,3,81,41,184,5,5,316,0,11,327
3,1,3001,28,3,239,147,384,24,14,808,11,29,848
3,1,3001,29,3,171,76,239,23,17,526,2,11,539
3,1,3001,30,3,195,98,253,12,10,568,1,17,586
3,1,3001,31,3,117,82,239,19,9,466,5,13,484
3,1,3001,32,3,135,90,226,19,10,480,0,14,494
3,1,3001,33,3,45,50,96,5,1,197,1,6,204
3,1,3001,34,3,67,61,150,4,4,286,0,16,302
3,1,3001,35,3,10,21,56,1,0,88,0,0,88
3,1,3001,36,3,24,21,93,2,0,140,0,9,149
3,1,3001,37,3,30,29,73,5,4,141,1,5,147
3,1,3001,38,3,53,16,57,3,3,132,0,8,140
3,1,3001,39,3,24,8,67,0,0,99,0,6,105
3,1,3001,40,3,116,62,135,7,7,327,0,14,341
3,1,3001,41,3,212,74,131,7,4,428,0,14,442
3,1,3001,42,3,179,83,106,7,5,380,0,12,392
3,1,3001,43,3,131,57,99,6,2,295,0,0,295
3,1,3001,44,3,139,73,163,5,4,384,0,8,392
3,1,3001,45,3,127,39,135,4,4,309,0,4,313
3,1,3001,46,3,125,84,99,11,7,326,0,0,326
3,1,3001,47,3,103,50,114,7,6,280,0,3,283
3,1,3001,48,3,217,116,205,23,6,567,0,13,580
3,1,3001,49,3,28,16,27,1,0,72,1,2,75
3,1,3001,50,3,29,33,49,5,4,120,0,1,121
3,1,3001,51,3,13,19,87,2,1,122,0,8,130
3,1,3001,52,3,52,74,75,4,1,206,0,4,210
3,1,3001,53,3,27,79,72,7,2,187,0,3,190
3,1,3001,54,3,146,37,195,6,7,391,3,9,403
3,1,3001,55,3,48,33,66,13,1,161,3,1,165
3,1,3001,56,3,45,73,74,5,0,197,0,3,200
3,1,3001,57,3,117,102,156,4,3,382,0,10,392
3,1,3001,58,3,90,68,158,9,6,331,0,7,338
3,1,3001,59,3,87,93,183,26,5,394,0,11,405
3,1,3001,60,3,92,120,145,26,12,395,3,8,406
3,1,3001,61,3,155,185,286,22,12,660,3,14,677
3,1,3001,62,3,23,11,47,2,1,84,0,0,84
3,1,3001,63,3,23,18,57,2,2,102,0,2,104
3,1,3001,64,3,18,0,8,0,0,26,0,1,27
3,1,3001,66,3,20,17,11,0,2,50,1,1,52
3,1,3001,67,3,103,77,145,5,2,332,1,7,340
3,1,3001,68,3,187,40,37,2,0,266,1,1,268
3,1,3001,69,3,31,16,128,1,3,179,0,4,183
3,1,3001,70,3,82,11,85,4,0,182,0,4,186
3,1,3001,71,3,16,15,27,1,3,62,0,2,64
3,1,3001,72,3,50,50,146,1,0,247,0,0,247
3,1,3001,73,3,72,72,134,1,0,279,0,7,286
3,1,3001,74,3,11,10,47,2,0,70,0,5,75
3,1,3002,75,3,67,112,158,8,4,349,0,3,352
3,1,3002,76,3,166,188,276,24,6,660,0,13,673
3,1,3002,77,3,134,176,213,18,9,550,1,11,562
3,1,3002,78,3,82,113,225,10,6,436,0,16,452
3,1,3002,79,3,85,98,134,7,6,330,1,6,337
3,1,3002,80,3,126,120,208,19,10,483,0,7,490
3,1,3002,81,3,67,91,102,9,6,275,0,8,283
3,1,3002,82,3,84,191,253,14,5,547,0,11,558
3,1,3002,83,3,204,276,445,24,18,967,1,21,989
3,1,3002,84,3,69,35,73,8,1,186,0,2,188
3,1,3002,85,3,120,139,260,17,13,549,0,20,569
3,1,3002,86,3,6,17,40,1,0,64,0,2,66
3,1,3002,87,3,42,10,56,3,0,111,0,4,115
3,1,3002,88,3,114,60,226,11,5,416,2,16,434
3,1,3002,89,3,145,57,185,9,4,400,0,12,412
3,1,3002,90,3,131,71,122,8,6,338,8,8,354
3,1,3002,91,3,47,38,72,6,1,164,0,2,166
3,1,3002,92,3,89,53,119,8,4,273,0,6,279
3,1,3002,93,3,136,52,134,15,9,346,0,7,353
3,1,3002,94,3,371,208,439,51,28,1097,4,34,1135
3,1,3002,95,3,162,118,148,29,10,467,0,25,492
3,1,3002,96,3,219,139,202,30,20,610,0,13,623
3,1,3002,97,3,160,93,173,25,16,467,0,9,476
3,1,3002,98,3,235,160,348,56,24,823,0,4,827
3,1,3002,99,3,41,75,62,4,1,183,0,6,189
3,1,3002,101,3,19,35,45,4,1,104,1,4,109
3,1,3002,102,3,34,47,77,3,2,163,0,9,172
3,1,3002,103,3,98,124,138,12,12,384,0,9,393
3,1,3002,104,3,329,413,476,31,30,1279,11,39,1329
3,1,3002,105,3,18,12,64,9,1,104,0,2,106
3,1,3002,107,3,31,44,107,6,9,197,0,3,200
3,1,3002,108,3,105,65,233,6,8,417,0,5,422
3,1,3002,109,3,73,65,180,11,5,334,1,5,340
3,1,3002,110,3,9,31,69,0,1,110,0,3,113
3,1,3002,111,3,46,47,56,8,1,158,0,0,158
3,1,3002,112,3,52,67,140,3,3,265,0,11,276
3,1,3002,113,3,54,33,77,3,2,169,0,6,175
3,1,3002,114,3,65,65,277,7,5,419,0,5,424
3,1,3002,115,3,12,30,66,2,2,112,0,0,112
3,1,3002,116,3,144,117,324,16,8,609,0,10,619
3,1,3002,117,3,22,52,116,2,3,195,1,7,203
3,1,3002,118,3,15,8,87,0,0,110,0,1,111
3,1,3002,119,3,16,43,86,2,2,149,0,1,150
3,1,3002,120,3,42,55,252,15,10,374,0,3,377
3,1,3003,184,3,42,73,126,9,7,257,2,6,265
3,1,3003,185,3,117,99,229,21,14,480,0,6,486
3,1,3003,186,3,190,156,207,29,21,603,0,15,618
3,1,3003,187,3,186,154,231,35,20,626,1,8,635
3,1,3003,190,3,232,161,270,35,31,729,5,10,744
3,1,3003,191,3,217,176,278,40,26,737,0,13,750
3,1,3003,207,3,80,130,138,17,9,374,0,0,374
3,1,3003,208,3,144,83,204,20,17,468,0,9,477
3,1,3003,209,3,255,145,206,25,30,661,3,4,668
3,1,3003,210,3,484,324,593,101,49,1551,3,21,1575
3,1,3003,211,3,179,118,282,33,31,643,2,1,646
3,1,3003,212,3,173,111,167,30,16,497,2,5,504
3,1,3003,213,3,204,154,398,36,23,815,3,21,839
3,1,3003,214,3,177,153,190,37,28,585,0,8,593
3,1,3003,215,3,108,143,248,43,25,567,3,7,577
3,1,3003,216,3,57,68,129,22,15,291,0,5,296
3,1,3003,217,3,407,343,680,99,86,1615,3,27,1645
3,1,3003,218,3,315,157,236,33,39,780,0,6,786
3,1,3003,219,3,186,155,271,36,21,669,2,6,677
3,1,3003,220,3,160,163,305,52,31,711,0,10,721
3,1,3003,221,3,145,88,178,23,31,465,3,8,476
3,1,3003,222,3,181,114,188,23,33,539,2,9,550
3,1,3003,223,3,188,170,330,33,21,742,3,11,756
3,1,3003,224,3,110,107,137,17,17,388,0,3,391
3,1,3003,225,3,132,97,177,22,18,446,2,2,450
3,1,3003,226,3,134,128,217,34,10,523,0,5,528
3,1,3003,227,3,180,120,292,37,30,659,7,16,682
3,1,3003,228,3,150,117,283,27,28,605,2,9,616
3,1,3003,229,3,102,109,208,34,17,470,1,7,478
3,1,3003,230,3,119,98,227,28,11,483,3,7,493
3,1,3003,231,3,61,71,151,17,12,312,0,7,319
3,1,3003,232,3,127,104,245,24,21,521,0,3,524
3,1,3003,233,3,94,81,194,15,13,397,0,6,403
3,1,3003,234,3,146,162,284,28,34,654,2,15,671
3,1,3003,235,3,112,98,213,22,20,465,1,9,475
3,1,3003,236,3,48,51,114,18,9,240,0,7,247
3,1,3003,237,3,165,99,228,38,22,552,1,2,555
3,1,3003,238,3,123,116,224,44,24,531,2,5,538
3,1,3003,239,3,148,87,232,31,23,521,6,7,534
3,1,3003,240,3,64,52,116,15,10,257,2,5,264
3,1,3003,241,3,66,66,95,11,13,251,3,4,258
3,1,3003,242,3,144,141,223,29,19,556,2,10,568
3,1,3003,243,3,115,114,187,35,20,471,1,8,480
3,1,3003,244,3,143,149,233,28,20,573,1,12,586
3,1,3003,245,3,117,130,167,21,14,449,0,9,458
3,1,3003,246,3,124,143,228,25,19,539,3,17,559
3,1,3003,247,3,126,74,222,21,17,460,1,23,484
3,1,3003,252,3,911,608,1554,197,160,3430,10,55,3495
3,1,3003,253,3,781,557,1216,178,110,2842,22,60,2924
3,1,3003,255,3,108,96,430,21,5,660,3,9,672
3,1,3003,256,3,227,196,314,36,20,793,9,7,809
3,1,3003,257,3,104,118,220,24,13,479,3,15,497
3,1,3003,258,3,28,50,64,3,2,147,0,7,154
3,1,3003,259,3,9,19,65,2,0,95,1,2,98
3,1,3003,260,3,6,15,39,0,0,60,1,2,63
3,1,3003,261,3,130,49,162,12,6,359,1,17,377
3,1,3003,262,3,18,12,78,2,0,110,0,1,111
3,1,3003,263,3,14,9,69,0,1,93,0,6,99
3,1,3003,264,3,12,14,39,1,1,67,0,5,72
3,1,3003,265,3,43,22,160,3,0,228,0,11,239
3,1,3003,266,3,50,20,80,5,3,158,0,8,166
3,1,3003,267,3,89,41,209,10,3,352,0,6,358
3,1,3003,274,3,86,72,160,11,2,331,2,11,344
3,1,3003,288,3,50,70,137,11,9,277,3,8,288
3,1,3003,289,3,123,95,228,10,22,478,5,12,495
3,1,3005,337,3,26,3,34,1,0,64,0,1,65
3,1,3005,338,3,197,97,140,28,9,471,0,14,485
3,1,3005,339,3,447,195,373,47,35,1097,5,26,1128
3,1,3005,340,3,313,77,161,19,6,576,1,18,595
3,1,3005,341,3,186,98,181,24,8,497,0,11,508
3,1,3005,342,3,240,121,256,22,12,651,0,56,707
3,1,3005,343,3,95,33,70,15,3,216,0,6,222
3,1,3005,344,3,191,51,232,9,2,485,3,7,495
3,1,3005,345,3,126,13,47,0,1,187,0,5,192
3,1,3005,346,3,56,17,103,8,5,189,0,9,198
3,1,3005,347,3,49,25,43,4,0,121,0,3,124
3,1,3003,348,3,50,48,106,13,17,234,0,3,237
3,1,3003,349,3,83,56,132,20,15,306,0,2,308
3,1,3003,350,3,61,50,84,9,10,214,2,0,216
3,2,3003,121,3,148,127,162,29,20,486,0,3,489
3,2,3003,122,3,75,146,120,16,7,364,3,9,376
3,2,3003,123,3,127,180,229,35,8,579,1,16,596
3,2,3003,124,3,226,211,258,28,12,735,1,5,741
3,2,3003,125,3,173,129,148,17,9,476,0,7,483
3,2,3003,126,3,76,132,222,16,19,465,1,15,481
3,2,3003,127,3,91,163,198,16,4,472,6,6,484
3,2,3003,128,3,59,102,161,7,8,337,1,8,346
3,2,3003,129,3,63,138,208,19,10,438,0,25,463
3,2,3003,130,3,52,51,92,15,10,220,0,8,228
3,2,3003,131,3,70,85,129,12,15,311,1,7,319
3,2,3003,132,3,60,76,117,15,4,272,0,3,275
3,2,3003,133,3,50,64,90,5,4,213,0,2,215
3,2,3003,134,3,38,64,106,9,9,226,0,5,231
3,2,3003,135,3,71,171,262,33,15,552,5,14,571
3,2,3003,136,3,120,114,224,16,12,486,1,10,497
3,2,3003,137,3,171,143,237,16,7,574,0,8,582
3,2,3003,138,3,97,114,182,14,6,413,0,13,426
3,2,3003,139,3,77,57,160,7,12,313,0,9,322
3,2,3003,140,3,54,56,132,10,7,259,3,9,271
3,2,3003,141,3,69,115,177,17,8,386,2,11,399
3,2,3003,142,3,110,104,220,21,3,458,0,26,484
3,2,3003,143,3,123,150,269,21,14,577,2,13,592
3,2,3003,144,3,119,135,199,24,8,485,2,1,488
3,2,3003,145,3,56,83,177,6,3,325,0,9,334
3,2,3003,146,3,58,72,139,13,6,288,5,12,305
3,2,3003,147,3,80,68,191,9,10,358,5,2,365
3,2,3003,148,3,63,74,178,13,6,334,3,1,338
3,2,3003,149,3,81,107,176,13,9,386,0,8,394
3,2,3003,150,3,58,82,159,14,6,319,4,3,326
3,2,3003,151,3,50,66,141,11,7,275,2,6,283
3,2,3003,152,3,96,69,170,13,13,361,2,10,373
3,2,3003,153,3,73,106,188,8,6,381,2,21,404
3,2,3003,154,3,128,144,238,20,7,537,0,15,552
3,2,3003,155,3,128,149,304,36,9,626,0,24,650
3,2,3003,156,3,112,169,421,35,17,754,5,15,774
3,2,3003,157,3,65,112,168,14,5,364,4,15,383
3,2,3003,158,3,106,93,177,17,8,401,0,11,412
3,2,3003,159,3,126,86,105,8,13,338,0,0,338
3,2,3003,160,3,115,92,135,18,7,367,0,8,375
3,2,3003,161,3,146,145,181,12,15,499,0,11,510
3,2,3003,162,3,176,155,232,24,10,597,5,8,610
3,2,3003,163,3,144,138,187,12,10,491,1,13,505
3,2,3003,164,3,168,153,231,21,14,587,1,13,601
3,2,3003,165,3,151,214,280,22,15,682,0,17,699
3,2,3003,166,3,277,130,131,18,8,564,0,0,564
3,2,3003,167,3,172,180,338,35,15,740,2,13,755
3,2,3003,168,3,153,160,312,29,8,662,1,18,681
3,2,3003,169,3,130,235,289,15,11,680,0,16,696
3,2,3003,170,3,72,79,181,12,3,347,1,6,354
3,2,3003,171,3,82,82,189,8,13,374,2,13,389
3,2,3003,172,3,91,119,225,11,8,454,1,10,465
3,2,3003,173,3,153,161,276,22,8,620,2,16,638
3,2,3003,174,3,145,151,266,14,8,584,6,7,597
3,2,3003,175,3,105,209,370,19,10,713,1,13,727
3,2,3003,176,3,88,85,171,16,6,366,2,10,378
3,2,3003,177,3,79,86,197,14,6,382,2,6,390
3,2,3003,178,3,67,65,134,15,4,285,0,7,292
3,2,3003,179,3,103,131,241,16,7,498,1,12,511
3,2,3003,180,3,95,122,207,21,3,448,0,6,454
3,2,3003,181,3,144,169,321,11,11,656,5,13,674
3,2,3003,182,3,76,129,140,9,5,359,0,17,376
3,2,3003,183,3,62,97,178,11,2,350,1,9,360
3,2,3003,188,3,221,167,189,19,16,612,0,22,634
3,2,3003,189,3,256,181,250,31,18,736,1,9,746
3,2,3003,192,3,164,143,140,23,11,481,0,5,486
3,2,3003,193,3,236,193,204,26,11,670,3,12,685
3,2,3003,194,3,86,111,138,13,9,357,2,0,359
3,2,3003,195,3,123,93,212,16,19,463,3,13,479
3,2,3003,196,3,135,130,248,23,12,548,3,16,567
3,2,3003,197,3,244,187,294,30,16,771,1,11,783
3,2,3003,198,3,90,95,195,20,10,410,1,3,414
3,2,3003,199,3,82,112,197,13,7,411,1,6,418
3,2,3003,200,3,110,117,147,11,10,395,2,12,409
3,2,3003,201,3,67,55,113,11,4,250,3,10,263
3,2,3003,202,3,295,189,222,38,29,773,1,12,786
3,2,3003,203,3,105,130,181,22,9,447,1,10,458
3,2,3003,204,3,143,101,190,14,8,456,2,13,471
3,2,3003,205,3,90,93,158,15,9,365,5,11,381
3,2,3003,206,3,151,142,395,36,13,737,1,14,752
3,2,3003,248,3,75,109,189,43,11,427,2,4,433
3,2,3003,249,3,176,101,217,26,12,532,1,9,542
3,2,3003,250,3,155,157,287,28,14,641,3,16,660
3,2,3003,251,3,56,77,131,5,8,277,3,7,287
3,2,3003,254,3,22,20,123,1,0,166,0,7,173
3,2,3003,268,3,33,12,147,4,2,198,0,3,201
3,2,3003,269,3,53,132,242,17,12,456,3,4,463
3,2,3003,270,3,132,175,581,23,7,918,0,9,927
3,2,3003,271,3,49,104,175,5,4,337,0,12,349
3,2,3003,272,3,42,17,102,3,0,164,0,9,173
3,2,3003,273,3,20,17,58,1,2,98,0,13,111
3,2,3003,275,3,6,2,22,0,0,30,0,1,31
3,2,3003,276,3,21,38,151,0,2,212,0,2,214
3,2,3003,277,3,43,62,116,1,8,230,0,7,237
3,2,3003,278,3,150,60,183,12,5,410,0,0,410
3,2,3003,279,3,8,16,18,3,0,45,0,3,48
3,2,3003,280,3,153,245,316,18,13,745,1,21,767
3,2,3003,281,3,88,186,172,16,6,468,0,15,483
3,2,3003,282,3,84,164,274,13,7,542,2,15,559
3,2,3003,283,3,65,172,229,18,2,486,0,14,500
3,2,3003,284,3,9,14,23,2,0,48,0,1,49
3,2,3003,285,3,2,9,39,0,0,50,0,0,50
3,2,3003,286,3,10,11,15,3,3,42,0,4,46
3,2,3003,287,3,32,7,33,1,1,74,0,1,75
3,2,3004,290,3,325,50,138,19,21,553,1,3,557
3,2,3004,291,3,268,201,453,41,17,980,2,19,1001
3,2,3004,292,3,141,98,201,9,11,460,0,13,473
3,2,3004,293,3,165,108,282,9,13,577,0,9,586
3,2,3004,294,3,296,78,274,23,22,693,0,12,705
3,2,3004,295,3,363,151,441,21,31,1007,2,23,1032
3,2,3004,296,3,237,98,434,23,23,815,1,14,830
3,2,3004,297,3,154,66,323,20,13,576,2,13,591
3,2,3004,298,3,724,289,892,45,50,2000,8,77,2085
3,2,3004,299,3,99,49,249,9,12,418,0,14,432
3,2,3004,300,3,353,193,663,43,38,1290,0,12,1302
3,2,3004,301,3,1048,548,1753,106,96,3551,6,69,3626
3,2,3004,302,3,63,24,129,7,6,229,0,4,233
3,2,3004,303,3,80,37,159,12,3,291,0,4,295
3,2,3004,304,3,161,94,384,15,9,663,2,9,674
3,2,3004,305,3,87,38,244,5,2,376,0,10,386
3,2,3004,306,3,90,138,442,8,5,683,0,10,693
3,2,3004,307,3,38,27,100,5,1,171,1,5,177
3,2,3004,308,3,178,199,504,12,5,898,1,16,915
3,2,3004,309,3,35,54,209,3,1,302,0,9,311
3,2,3004,310,3,46,52,293,9,7,407,0,6,413
3,2,3004,311,3,42,63,201,7,4,317,0,12,329
3,2,3004,312,3,547,266,996,63,47,1919,4,36,1959
3,2,3004,313,3,105,113,299,13,12,542,1,13,556
3,2,3004,314,3,326,168,581,38,16,1129,1,32,1162
3,2,3004,315,3,12,93,118,3,3,229,0,4,233
3,2,3004,316,3,570,93,211,30,17,921,1,7,929
3,2,3004,317,3,385,102,289,28,27,831,1,2,834
3,2,3004,318,3,292,99,181,30,21,623,0,11,634
3,2,3004,319,3,157,44,94,11,7,313,0,3,316
3,2,3004,320,3,264,84,302,26,15,691,0,11,702
3,2,3004,321,3,194,56,215,17,12,494,1,23,518
3,2,3004,322,3,225,78,235,24,14,576,1,11,588
3,2,3004,323,3,343,90,204,39,21,697,6,12,715
3,2,3004,324,3,304,113,384,31,16,848,2,14,864
3,2,3004,325,3,220,127,380,24,8,759,3,21,783
3,2,3004,326,3,207,60,173,13,10,463,0,5,468
3,2,3004,327,3,301,85,266,33,15,700,0,14,714
3,2,3004,328,3,245,107,304,31,11,698,0,11,709
3,2,3004,329,3,118,72,183,27,11,411,1,8,420
3,2,3004,330,3,2811,1063,3541,333,182,7930,278,155,8363
3,2,3004,331,3,389,88,290,45,27,839,0,5,844
3,2,3004,332,3,838,186,692,83,52,1851,3,14,1868
3,2,3004,333,3,300,112,412,38,30,892,0,20,912
3,2,3004,334,3,18,19,57,0,3,97,0,0,97
3,2,3004,335,3,79,28,81,9,5,202,0,2,204
3,2,3004,336,3,64,21,71,8,2,166,0,1,167
3,2,3004,351,3,94,28,105,11,6,244,0,3,247
3,2,3004,352,3,240,47,140,25,13,465,0,4,469
4,1,4001,1,3,151,142,75,40,6,414,1,1,416
4,1,4001,2,3,175,128,115,27,9,454,0,9,463
4,1,4001,3,3,180,163,95,32,8,478,1,19,498
4,1,4001,4,3,1375,1100,600,141,39,3255,3,114,3372
4,1,4001,5,3,248,209,164,49,5,675,0,19,694
4,1,4001,6,3,217,178,127,31,12,565,0,9,574
4,1,4001,7,3,268,192,126,44,8,638,2,12,652
4,1,4001,8,3,175,122,122,30,7,456,1,9,466
4,1,4001,9,3,698,496,372,142,29,1737,3,30,1770
4,1,4001,10,3,233,186,131,47,8,605,1,20,626
4,1,4001,11,3,234,201,145,20,5,605,1,16,622
4,1,4001,12,3,384,358,270,60,32,1104,1,44,1149
4,1,4001,13,3,305,214,137,33,10,699,2,31,732
4,1,4001,14,3,200,179,113,26,9,527,2,21,550
4,1,4001,15,3,211,190,125,35,7,568,1,22,591
4,1,4001,16,3,158,144,92,56,7,457,0,27,484
4,1,4001,17,3,340,283,224,101,13,961,3,31,995
4,1,4001,18,3,127,164,75,38,2,406,0,16,422
4,1,4001,19,3,205,129,59,16,4,413,1,16,430
4,1,4001,20,3,204,214,113,38,7,576,1,13,590
4,1,4001,21,3,229,268,133,40,8,678,0,35,713
4,1,4001,22,3,158,195,156,44,6,559,1,30,590
4,1,4001,23,3,164,195,102,37,1,499,0,20,519
4,1,4001,24,3,255,241,212,49,10,767,0,30,797
4,1,4001,25,3,175,155,108,30,3,471,0,15,486
4,1,4001,26,3,354,234,213,40,15,856,7,10,873
4,1,4001,27,3,407,237,183,65,4,896,2,17,915
4,1,4001,28,3,188,171,76,26,6,467,0,18,485
4,1,4001,29,3,248,214,216,34,13,725,1,18,744
4,1,4001,30,3,229,172,142,49,8,600,0,16,616
4,1,4001,31,3,191,179,134,41,5,550,1,17,568
4,1,4001,32,3,222,169,141,42,7,581,0,23,604
4,1,4001,33,3,183,183,106,13,2,487,0,23,510
4,1,4001,34,3,264,207,138,35,7,651,0,33,684
4,1,4001,35,3,213,145,102,28,5,493,2,12,507
4,1,4001,36,3,250,194,117,25,1,587,4,27,618
4,1,4001,37,3,210,153,74,14,2,453,0,5,458
4,1,4001,38,3,155,133,101,35,5,429,0,12,441
4,1,4001,39,3,387,351,239,46,13,1036,11,31,1078
4,1,4001,40,3,163,161,117,32,7,480,0,24,504
4,1,4001,41,3,165,168,118,35,5,491,0,21,512
4,1,4001,42,3,281,209,184,46,12,732,0,20,752
4,1,4001,43,3,268,222,150,43,19,702,0,15,717
4,1,4001,44,3,203,136,192,43,4,578,0,21,599
4,1,4001,45,3,188,174,129,53,10,554,0,18,572
4,1,4001,46,3,244,226,165,41,6,682,0,11,693
4,1,4001,47,3,239,224,212,50,9,734,1,11,746
4,1,4001,48,3,263,232,175,50,19,739,1,13,753
4,1,4001,49,3,320,238,188,52,7,805,0,21,826
4,1,4001,50,3,176,210,157,45,10,598,0,18,616
4,1,4001,51,3,290,278,192,55,12,827,0,22,849
4,1,4001,52,3,250,205,125,35,4,619,2,15,636
4,1,4001,53,3,340,288,211,60,15,914,0,28,942
4,1,4001,54,3,237,212,162,35,9,655,0,25,680
4,1,4001,55,3,360,285,223,64,20,952,0,24,976
4,1,4001,56,3,222,205,145,30,6,608,2,11,621
4,1,4001,57,3,256,259,160,59,11,745,1,18,764
4,1,4001,58,3,295,245,172,58,14,784,1,26,811
4,1,4001,59,3,283,213,155,61,19,731,0,14,745
4,1,4001,60,3,209,182,189,60,2,642,1,15,658
4,1,4001,61,3,206,212,175,36,12,641,0,30,671
4,1,4001,62,3,200,187,149,29,8,573,0,38,611
4,1,4001,63,3,305,271,148,35,13,772,1,23,796
4,1,4001,64,3,201,222,213,72,14,722,1,17,740
4,1,4001,65,3,330,289,194,53,11,877,3,40,920
4,1,4001,66,3,184,236,170,49,12,651,1,15,667
4,1,4001,67,3,225,189,169,59,12,654,2,24,680
4,1,4001,68,3,213,182,147,42,5,589,1,29,619
4,1,4001,69,3,227,233,155,33,5,653,1,13,667
4,1,4001,70,3,283,228,198,70,10,789,2,19,810
4,1,4001,71,3,246,279,156,49,8,738,0,16,754
4,1,4001,72,3,356,323,189,40,18,926,0,24,950
4,1,4001,73,3,319,358,129,34,11,851,1,16,868
4,1,4001,74,3,309,289,258,74,14,944,1,48,993
4,1,4001,75,3,365,297,241,62,13,978,1,36,1015
4,1,4001,76,3,233,233,190,44,12,712,0,27,739
4,1,4001,77,3,249,246,159,80,13,747,0,27,774
4,1,4001,78,3,207,197,143,45,4,596,1,25,622
4,1,4001,79,3,454,459,315,74,12,1314,6,321,1641
4,1,4001,80,3,199,195,165,56,6,621,2,15,638
4,1,4001,81,3,1412,1144,1029,260,69,3914,4,72,3990
4,1,4001,82,3,173,199,183,69,8,632,0,53,685
4,1,4001,83,3,795,563,500,122,33,2013,7,51,2071
4,1,4001,84,3,164,173,105,21,3,466,0,18,484
4,1,4001,85,3,220,194,178,27,12,631,0,17,648
4,1,4001,86,3,263,232,209,129,10,843,0,15,858
4,1,4001,87,3,270,236,162,56,9,733,0,19,752
4,1,4001,88,3,212,163,74,21,5,475,0,14,489
4,1,4001,89,3,334,261,121,40,9,765,0,14,779
4,1,4001,90,3,381,337,243,65,22,1048,0,20,1068
4,1,4001,91,3,274,254,190,44,5,767,2,30,799
4,1,4001,92,3,359,219,116,47,8,749,0,13,762
4,1,4001,93,3,286,232,172,51,4,745,0,10,755
4,1,4001,94,3,292,199,183,55,8,737,1,16,754
4,1,4001,95,3,199,164,137,35,8,543,4,18,565
4,1,4001,96,3,265,185,117,29,6,602,6,19,627
4,1,4001,97,3,293,206,123,17,5,644,0,30,674
4,1,4001,98,3,239,202,157,48,11,657,1,28,686
4,1,4001,99,3,249,212,204,45,4,714,4,20,738
4,1,4001,100,3,409,501,187,30,6,1133,0,52,1185
4,1,4001,101,3,432,466,245,72,16,1231,1,41,1273
4,1,4001,102,3,254,291,161,41,13,760,3,26,789
4,1,4001,103,3,240,218,171,31,5,665,2,32,699
4,1,4001,104,3,202,191,177,34,10,614,1,12,627
4,1,4001,105,3,816,719,520,110,25,2190,4,77,2271
4,1,4001,106,3,273,223,171,67,12,746,0,22,768
4,1,4001,107,3,241,238,159,42,17,697,0,28,725
4,1,4001,108,3,477,392,270,36,13,1188,0,31,1219
4,1,4001,109,3,293,375,146,22,5,841,0,40,881
4,1,4001,110,3,252,217,127,47,6,649,0,0,649
4,1,4001,111,3,310,319,146,39,11,825,0,32,857
4,1,4001,112,3,408,343,296,55,15,1117,3,64,1184
4,1,4001,113,3,262,173,140,32,12,619,1,29,649
4,1,4001,114,3,322,197,159,43,7,728,3,27,758
4,1,4001,115,3,192,176,112,36,8,524,0,19,543
4,1,4001,116,3,196,335,107,39,5,682,3,9,694
4,1,4001,117,3,200,242,137,39,5,623,3,20,646
4,1,4001,118,3,183,210,84,19,5,501,2,25,528
4,1,4001,119,3,73,85,32,12,2,204,1,9,214
4,1,4001,120,3,73,179,103,22,1,378,0,28,406
4,1,4001,121,3,171,121,100,14,2,408,3,13,424
4,1,4001,122,3,119,203,89,16,12,439,0,13,452
4,1,4001,123,3,197,123,52,13,0,385,2,14,401
4,1,4001,124,3,237,244,44,15,2,542,0,16,558
4,1,4001,125,3,287,238,99,39,6,669,4,27,700
4,1,4001,126,3,413,268,171,57,7,916,1,22,939
4,1,4001,127,3,165,171,108,46,5,495,2,18,515
4,1,4001,128,3,27,71,16,3,1,118,1,4,123
4,1,4001,129,3,349,326,126,13,4,818,1,18,837
4,1,4001,130,3,80,99,52,5,1,237,0,6,243
4,1,4001,131,3,69,56,2,11,0,138,0,4,142
4,1,4001,132,3,52,25,11,19,0,107,0,3,110
4,1,4001,133,3,116,154,27,15,1,313,0,5,318
4,1,4001,134,3,90,82,25,9,1,207,0,6,213
4,1,4001,135,3,229,138,39,17,1,424,0,6,430
4,1,4001,136,3,49,45,10,10,1,115,0,4,119
4,1,4001,137,3,44,38,11,3,0,96,0,4,100
4,1,4001,138,3,37,253,55,0,0,345,3,5,353
4,1,4001,139,3,318,295,248,34,6,901,6,85,992
4,1,4001,140,3,162,147,116,32,4,461,1,15,477
4,1,4001,141,3,114,165,105,38,2,424,0,12,436
4,1,4001,142,3,388,463,232,51,4,1138,3,91,1232
4,1,4001,143,3,82,53,38,4,0,177,0,4,181
4,1,4001,144,3,35,57,16,1,0,109,1,5,115
4,1,4001,145,3,118,146,62,4,4,334,0,7,341
4,1,4001,146,3,75,115,59,10,1,260,0,2,262
4,1,4002,147,3,177,226,181,195,3,782,0,29,811
4,1,4002,148,3,170,191,134,138,3,636,2,29,667
4,1,4002,149,3,216,212,140,111,7,686,0,26,712
4,1,4002,150,3,100,206,75,141,7,529,0,18,547
4,1,4002,151,3,176,202,159,100,4,641,0,14,655
4,1,4002,152,3,156,200,181,126,10,673,1,15,689
4,1,4002,153,3,150,241,117,148,9,665,2,33,700
4,1,4002,154,3,208,265,124,199,10,806,1,33,840
4,1,4002,155,3,145,293,183,133,15,769,1,14,784
4,1,4002,156,3,119,121,100,85,2,427,0,0,427
4,1,4002,157,3,135,216,86,13,2,452,0,4,456
4,1,4002,158,3,105,222,184,26,1,538,1,0,539
4,1,4002,159,3,145,236,36,53,1,471,0,11,482
4,1,4002,160,3,204,230,52,50,3,539,0,0,539
4,1,4002,161,3,212,190,44,58,4,508,1,19,528
4,1,4002,162,3,195,243,51,47,1,537,0,23,560
4,1,4002,163,3,232,207,37,45,0,521,0,12,533
4,1,4002,164,3,144,262,53,64,2,525,1,16,542
4,1,4002,165,3,29,106,44,0,0,179,0,0,179
4,1,4002,166,3,367,627,224,117,4,1339,0,14,1353
4,1,4002,167,3,225,427,126,44,1,823,0,13,836
4,1,4002,168,3,266,401,119,27,1,814,0,10,824
4,1,4002,169,3,287,394,93,99,6,879,0,25,904
4,1,4002,170,3,167,212,159,27,4,569,0,18,587
4,1,4002,171,3,73,180,71,49,4,377,2,13,392
4,1,4002,172,3,189,320,148,20,2,679,0,17,696
4,1,4002,173,3,336,294,124,104,8,866,4,25,895
4,1,4002,174,3,182,276,86,84,6,634,0,6,640
4,1,4002,175,3,364,253,119,151,4,891,0,0,891
4,1,4002,176,3,438,300,107,104,5,954,1,49,1004
4,1,4002,177,3,375,309,112,109,9,914,6,28,948
4,1,4002,178,3,42,54,88,12,2,198,0,7,205
4,1,4002,179,3,226,296,139,21,3,685,1,77,763
4,1,4002,180,3,575,479,54,34,5,1147,0,25,1172
4,1,4002,181,3,129,112,13,16,0,270,0,4,274
4,1,4002,182,3,38,59,17,2,0,116,1,2,119
4,1,4005,363,3,150,476,133,395,4,1158,0,71,1229
4,1,4005,364,3,146,464,124,473,10,1217,0,53,1270
4,1,4005,365,3,92,273,71,192,2,630,0,14,644
4,1,4005,366,3,74,267,89,301,3,734,0,23,757
4,1,4005,367,3,73,266,76,285,5,705,4,22,731
4,1,4005,368,3,82,263,57,247,2,651,1,15,667
4,1,4005,369,3,34,258,17,208,1,518,0,16,534
4,1,4005,370,3,85,361,27,355,2,830,2,36,868
4,1,4005,371,3,101,166,59,224,0,550,0,27,577
4,1,4005,372,3,88,287,87,390,7,859,0,53,912
4,1,4005,373,3,46,162,52,174,0,434,2,33,469
4,1,4005,374,3,19,97,34,49,2,201,1,19,221
4,1,4005,375,3,149,360,63,295,6,873,0,52,925
4,1,4005,376,3,183,360,63,206,5,817,0,38,855
4,1,4005,377,3,142,338,79,193,4,756,1,34,791
4,1,4005,378,3,129,401,57,154,5,746,0,40,786
4,1,4005,379,3,148,213,33,288,4,686,0,29,715
4,1,4005,380,3,129,66,31,159,0,385,0,6,391
4,1,4006,381,3,332,375,64,82,13,866,0,26,892
4,1,4006,382,3,355,435,76,99,3,968,0,24,992
4,1,4006,383,3,233,322,109,87,8,759,1,28,788
4,1,4006,384,3,171,270,65,54,5,565,0,31,596
4,1,4006,385,3,74,103,27,10,3,217,0,2,219
4,1,4006,386,3,17,73,24,29,0,143,0,7,150
4,1,4006,387,3,41,86,11,9,0,147,0,5,152
4,1,4006,388,3,611,456,101,77,1,1246,0,49,1295
4,1,4006,389,3,266,198,27,43,1,535,1,23,559
4,1,4006,390,3,45,103,14,3,1,166,0,4,170
4,1,4006,391,3,79,83,13,8,0,183,0,22,205
4,1,4006,392,3,14,53,13,21,0,101,0,3,104
4,1,4006,393,3,55,28,2,2,0,87,0,3,90
4,1,4006,394,3,167,168,60,60,2,457,4,18,479
4,1,4006,395,3,202,171,42,60,4,479,0,0,479
4,1,4006,396,3,100,92,49,60,1,302,0,26,328
4,1,4006,397,3,170,130,38,18,2,358,0,30,388
4,1,4006,398,3,144,113,48,60,4,369,0,23,392
4,1,4006,399,3,61,121,31,29,3,245,0,37,282
4,1,4006,400,3,245,370,26,35,1,677,0,8,685
4,1,4006,401,3,209,298,86,25,0,618,0,20,638
4,1,4006,402,3,17,73,16,8,0,114,0,6,120
4,1,4006,403,3,107,252,166,36,0,561,0,34,595
4,1,4006,404,3,97,228,120,58,3,506,1,19,526
4,1,4006,405,3,39,39,12,6,0,96,0,2,98
4,1,4006,406,3,77,76,36,24,2,215,0,19,234
4,1,4006,407,3,136,185,80,25,0,426,0,17,443
4,1,4006,408,3,33,129,16,19,0,197,0,11,208
4,1,4006,409,3,54,168,59,78,6,365,0,43,408
4,1,4006,410,3,287,312,97,45,7,748,0,12,760
4,1,4006,411,3,49,115,17,22,1,204,0,20,224
4,1,4006,412,3,65,54,53,14,2,188,0,11,199
4,1,4006,413,3,55,93,54,10,1,213,0,23,236
4,1,4006,414,3,4,65,53,0,1,123,0,6,129
4,1,4006,415,3,44,335,394,16,8,797,0,31,828
4,1,4006,416,3,7,6,69,1,0,83,0,7,90
4,1,4006,417,3,149,663,519,41,26,1398,0,65,1463
4,1,4006,418,3,2,24,32,2,0,60,0,2,62
4,1,4006,419,3,16,52,96,11,0,175,0,6,181
4,1,4006,420,3,7,42,44,0,2,95,0,0,95
4,1,4006,421,3,46,203,456,9,6,720,0,35,755
4,1,4006,422,3,10,96,186,7,1,300,3,13,316
4,1,4006,423,3,12,31,80,0,0,123,0,14,137
4,1,4006,424,3,26,62,76,5,2,171,0,10,181
4,1,4006,425,3,35,147,244,3,3,432,0,12,444
4,1,4006,426,3,69,209,369,1,7,655,0,40,695
4,1,4006,427,3,41,205,239,2,5,492,0,19,511
4,1,4008,440,3,332,314,78,33,5,762,0,43,805
4,1,4008,441,3,343,453,54,32,6,888,2,42,932
4,1,4008,442,3,329,429,46,79,7,890,0,49,939
4,1,4008,443,3,225,530,63,46,9,873,0,76,949
4,1,4008,444,3,53,29,12,2,2,98,2,9,109
4,1,4008,445,3,219,302,59,70,3,653,1,31,685
4,1,4008,446,3,17,23,10,2,3,55,0,0,55
4,1,4008,447,3,87,146,13,3,1,250,0,0,250
4,2,4003,183,3,279,191,186,12,11,679,1,10,690
4,2,4003,184,3,624,520,288,28,14,1474,1,23,1498
4,2,4003,185,3,257,442,212,24,8,943,1,30,974
4,2,4003,186,3,270,200,147,11,4,632,0,21,653
4,2,4003,187,3,299,280,200,15,3,797,0,22,819
4,2,4003,188,3,405,390,122,15,6,938,2,13,953
4,2,4003,189,3,338,281,202,25,10,856,0,25,881
4,2,4003,190,3,273,231,149,11,7,671,0,8,679
4,2,4003,191,3,337,268,168,20,2,795,1,40,836
4,2,4003,192,3,244,280,148,10,5,687,0,3,690
4,2,4003,193,3,113,191,79,10,0,393,0,13,406
4,2,4003,194,3,245,216,142,3,4,610,0,11,621
4,2,4003,195,3,213,260,135,14,8,630,3,17,650
4,2,4003,196,3,217,314,183,12,1,727,2,25,754
4,2,4003,197,3,281,240,100,13,6,640,4,6,650
4,2,4003,198,3,15,81,40,5,6,147,0,2,149
4,2,4003,199,3,380,354,216,21,8,979,0,22,1001
4,2,4003,200,3,266,247,117,16,5,651,0,23,674
4,2,4003,201,3,213,160,101,10,2,486,0,13,499
4,2,4003,202,3,420,333,129,22,7,911,1,15,927
4,2,4003,203,3,283,284,144,14,6,731,2,13,746
4,2,4003,204,3,202,129,75,21,2,429,0,9,438
4,2,4003,205,3,597,691,482,40,10,1820,1,67,1888
4,2,4003,206,3,534,475,208,39,11,1267,0,16,1283
4,2,4003,207,3,218,242,129,9,1,599,0,14,613
4,2,4003,208,3,388,309,150,15,5,867,0,17,884
4,2,4003,209,3,400,321,132,25,8,886,0,22,908
4,2,4003,210,3,424,305,173,15,8,925,2,27,954
4,2,4003,211,3,414,308,174,8,8,912,0,21,933
4,2,4003,212,3,229,155,88,12,3,487,0,13,500
4,2,4003,213,3,288,165,112,16,10,591,1,10,602
4,2,4003,214,3,373,233,154,12,1,773,0,15,788
4,2,4003,215,3,110,84,50,7,1,252,1,5,258
4,2,4003,216,3,560,349,312,34,10,1265,0,20,1285
4,2,4003,217,3,340,237,153,15,2,747,1,14,762
4,2,4003,218,3,356,215,165,17,4,757,2,12,771
4,2,4003,219,3,170,101,48,13,2,334,0,6,340
4,2,4003,220,3,207,150,80,25,1,463,0,6,469
4,2,4003,221,3,248,128,81,10,2,469,0,16,485
4,2,4003,222,3,172,115,66,8,4,365,0,10,375
4,2,4003,223,3,245,177,110,6,5,543,0,8,551
4,2,4003,224,3,294,258,124,17,2,695,0,25,720
4,2,4003,225,3,248,274,130,17,5,674,2,3,679
4,2,4003,226,3,271,176,159,11,8,625,0,9,634
4,2,4003,227,3,324,261,142,18,3,748,0,17,765
4,2,4003,228,3,229,189,114,13,5,550,0,10,560
4,2,4003,229,3,1466,1498,836,68,26,3894,6,59,3959
4,2,4003,230,3,847,1017,722,44,16,2646,0,52,2698
4,2,4003,231,3,228,261,212,17,2,720,1,18,739
4,2,4003,232,3,365,325,225,10,7,932,0,8,940
4,2,4003,233,3,386,379,233,19,2,1019,1,21,1041
4,2,4003,234,3,328,321,214,13,7,883,3,23,909
4,2,4003,235,3,253,249,139,20,4,665,0,14,679
4,2,4003,236,3,278,244,143,8,0,673,1,15,689
4,2,4003,237,3,258,240,94,21,0,613,0,9,622
4,2,4003,238,3,11,22,14,1,0,48,0,2,50
4,2,4003,239,3,244,140,115,16,5,520,2,18,540
4,2,4003,240,3,325,358,282,18,7,990,0,20,1010
4,2,4003,241,3,210,254,178,12,4,658,1,12,671
4,2,4003,242,3,258,207,163,10,2,640,0,18,658
4,2,4003,243,3,291,315,211,16,5,838,0,22,860
4,2,4003,244,3,740,787,812,50,12,2401,5,46,2452
4,2,4003,245,3,239,227,174,13,3,656,0,16,672
4,2,4003,246,3,227,212,149,13,0,601,0,18,619
4,2,4003,247,3,120,219,222,10,2,573,0,14,587
4,2,4003,248,3,161,199,243,12,7,622,0,20,642
4,2,4003,249,3,332,245,232,9,4,822,1,25,848
4,2,4003,250,3,477,246,109,8,2,842,0,55,897
4,2,4003,251,3,306,234,39,6,2,587,0,22,609
4,2,4003,252,3,272,277,43,21,3,616,0,8,624
4,2,4003,253,3,390,259,116,4,2,771,2,21,794
4,2,4003,254,3,47,81,123,3,1,255,0,18,273
4,2,4003,255,3,83,139,42,8,2,274,0,5,279
4,2,4003,256,3,302,305,140,7,2,756,1,41,798
4,2,4003,257,3,418,292,153,5,3,871,0,30,901
4,2,4003,258,3,226,304,167,12,1,710,1,20,731
4,2,4003,259,3,242,229,152,12,3,638,1,15,654
4,2,4003,260,3,101,70,71,6,1,249,0,8,257
4,2,4003,261,3,194,254,73,3,3,527,0,22,549
4,2,4003,262,3,309,240,118,2,3,672,0,11,683
4,2,4003,263,3,125,335,79,4,0,543,0,13,556
4,2,4003,264,3,113,134,59,1,0,307,0,11,318
4,2,4003,265,3,248,488,274,11,0,1021,0,44,1065
4,2,4003,266,3,197,427,225,9,1,859,0,12,871
4,2,4003,267,3,406,458,568,17,8,1457,0,67,1524
4,2,4003,268,3,273,317,347,19,1,957,1,28,986
4,2,4003,269,3,81,101,52,3,0,237,0,15,252
4,2,4003,270,3,30,29,37,1,0,97,0,3,100
4,2,4003,271,3,48,110,134,8,3,303,0,18,321
4,2,4003,272,3,14,24,15,0,0,53,0,4,57
4,2,4010,273,3,334,226,228,16,2,806,2,49,857
4,2,4010,274,3,276,187,54,1,2,520,1,12,533
4,2,4010,275,3,100,109,18,0,1,228,0,24,252
4,2,4010,276,3,64,66,21,5,0,156,0,8,164
4,2,4010,277,3,300,275,114,6,5,700,0,31,731
4,2,4010,278,3,339,377,137,5,3,861,1,74,936
4,2,4010,279,3,381,266,108,10,3,768,0,27,795
4,2,4010,280,3,279,203,42,22,1,547,0,27,574
4,2,4010,281,3,250,297,64,12,1,624,1,30,655
4,2,4010,282,3,223,167,50,7,0,447,0,17,464
4,2,4010,283,3,275,272,65,8,2,622,10,20,652
4,2,4003,284,3,29,40,38,1,0,108,0,1,109
4,2,4010,285,3,157,97,58,4,3,319,0,13,332
4,2,4010,286,3,36,61,3,0,0,100,0,3,103
4,2,4010,287,3,41,87,18,2,0,148,1,8,157
4,2,4010,288,3,101,49,41,4,2,197,3,14,214
4,2,4010,289,3,204,163,72,3,4,446,0,23,469
4,2,4010,290,3,11,16,6,2,0,35,0,1,36
4,2,4010,291,3,259,161,86,7,3,516,1,36,553
4,2,4010,292,3,99,59,113,11,0,282,0,14,296
4,2,4010,293,3,163,153,123,7,3,449,0,24,473
4,2,4010,294,3,16,48,7,1,0,72,0,1,73
4,2,4010,295,3,123,124,58,0,1,306,0,20,326
4,2,4010,296,3,133,127,40,5,0,305,0,10,315
4,2,4010,297,3,112,111,37,0,0,260,0,15,275
4,2,4010,298,3,141,143,115,8,2,409,1,17,427
4,2,4010,299,3,133,161,94,28,1,417,3,21,441
4,2,4010,300,3,36,79,82,1,1,199,1,10,210
4,2,4010,301,3,177,125,75,0,1,378,0,13,391
4,2,4010,302,3,65,37,31,1,0,134,0,8,142
4,2,4004,303,3,122,217,133,39,2,513,0,44,557
4,2,4004,304,3,178,188,70,65,5,506,0,29,535
4,2,4004,305,3,213,177,114,47,4,555,2,37,594
4,2,4004,306,3,215,273,105,59,6,658,0,25,683
4,2,4004,307,3,212,177,82,57,6,534,0,23,557
4,2,4004,308,3,134,186,78,37,6,441,0,8,449
4,2,4004,309,3,148,244,73,43,6,514,0,10,524
4,2,4004,310,3,153,256,64,51,6,530,0,23,553
4,2,4004,311,3,147,184,51,51,5,438,0,24,462
4,2,4004,312,3,294,167,79,45,4,589,2,50,641
4,2,4004,313,3,230,174,98,78,14,594,0,22,616
4,2,4004,314,3,231,210,74,92,7,614,0,13,627
4,2,4004,315,3,175,296,89,86,4,650,1,44,695
4,2,4004,316,3,199,251,116,56,6,628,6,34,668
4,2,4004,317,3,192,184,97,85,4,562,0,53,615
4,2,4004,318,3,243,266,91,64,7,671,0,43,714
4,2,4004,319,3,436,376,252,153,15,1232,2,61,1295
4,2,4004,320,3,366,254,139,52,9,820,0,42,862
4,2,4004,321,3,142,224,105,49,6,526,0,16,542
4,2,4004,322,3,187,265,104,40,4,600,1,28,629
4,2,4004,323,3,156,311,117,69,14,667,0,12,679
4,2,4004,324,3,276,280,96,59,8,719,2,44,765
4,2,4004,325,3,294,313,87,38,9,741,1,29,771
4,2,4004,326,3,164,162,56,24,6,412,0,18,430
4,2,4004,327,3,200,588,92,19,3,902,2,29,933
4,2,4004,328,3,215,342,115,23,7,702,4,34,740
4,2,4004,329,3,150,206,130,12,1,499,1,30,530
4,2,4004,330,3,211,298,104,18,1,632,7,24,663
4,2,4004,331,3,678,533,246,41,12,1510,0,92,1602
4,2,4004,332,3,80,147,61,12,0,300,0,15,315
4,2,4004,333,3,234,260,122,24,3,643,5,35,683
4,2,4004,334,3,198,145,117,14,3,477,4,14,495
4,2,4004,335,3,223,23,67,26,7,346,4,11,361
4,2,4004,336,3,171,125,54,20,2,372,0,17,389
4,2,4004,337,3,127,81,95,34,3,340,0,27,367
4,2,4004,338,3,46,50,24,13,0,133,0,5,138
4,2,4004,339,3,282,81,84,22,5,474,2,17,493
4,2,4004,340,3,495,317,108,42,7,969,0,93,1062
4,2,4004,341,3,254,163,101,25,2,545,2,21,568
4,2,4004,342,3,396,268,75,7,2,748,0,33,781
4,2,4004,343,3,224,201,66,2,2,495,1,31,527
4,2,4004,344,3,118,118,75,20,4,335,0,27,362
4,2,4004,345,3,142,72,139,21,0,374,1,19,394
4,2,4004,346,3,128,138,177,13,1,457,1,27,485
4,2,4004,347,3,270,256,46,15,4,591,0,20,611
4,2,4004,348,3,143,137,36,6,3,325,0,11,336
4,2,4004,349,3,115,233,110,29,2,489,3,19,511
4,2,4004,350,3,242,321,72,6,2,643,6,18,667
4,2,4004,351,3,68,133,41,17,1,260,0,3,263
4,2,4004,352,3,133,91,34,1,0,259,0,11,270
4,2,4004,353,3,47,127,9,8,1,192,4,7,203
4,2,4004,354,3,190,59,117,17,1,384,0,20,404
4,2,4004,355,3,50,38,58,11,0,157,2,7,166
4,2,4009,356,3,173,177,325,57,0,732,0,43,775
4,2,4009,357,3,64,114,40,45,3,266,1,0,267
4,2,4009,358,3,59,58,33,11,0,161,0,11,172
4,2,4004,359,3,114,214,141,2,16,487,1,15,503
4,2,4004,360,3,154,248,234,5,13,654,0,22,676
4,2,4009,361,3,113,174,232,66,3,588,0,46,634
4,2,4004,362,3,70,113,137,0,5,325,0,21,346
4,2,4007,428,3,84,394,242,54,6,780,0,36,816
4,2,4007,429,3,133,502,358,39,15,1047,2,61,1110
4,2,4007,430,3,44,69,142,6,1,262,0,13,275
4,2,4007,431,3,66,166,163,34,2,431,0,30,461
4,2,4007,432,3,21,120,86,7,3,237,0,0,237
4,2,4007,433,3,36,120,127,4,4,291,0,32,323
4,2,4007,434,3,16,38,48,1,1,104,0,2,106
4,2,4007,435,3,33,111,109,4,1,258,0,20,278
4,2,4007,436,3,14,30,16,1,0,61,0,7,68
4,2,4007,437,3,7,8,26,0,0,41,0,3,44
4,2,4007,439,3,39,114,155,7,1,316,0,15,331
4,2,4009,448,3,176,241,254,113,2,786,1,31,818
4,2,4009,449,3,114,170,214,93,7,598,2,34,634
4,2,4009,450,3,106,185,179,56,4,530,0,24,554
4,2,4009,451,3,149,233,283,89,7,761,1,32,794
4,2,4009,452,3,81,124,115,60,1,381,0,13,394
4,2,4009,453,3,105,164,164,90,6,529,2,21,552
4,2,4009,454,3,138,270,258,119,9,794,1,23,818
4,2,4009,455,3,129,228,220,113,6,696,1,18,715
4,2,4009,456,3,68,132,139,34,3,376,2,18,396
4,2,4009,457,3,59,183,129,27,3,401,0,18,419
4,2,4009,458,3,109,173,168,72,5,527,1,19,547
4,2,4009,459,3,104,139,187,45,5,480,1,12,493
4,2,4009,460,3,124,144,148,59,3,478,2,14,494
4,2,4009,461,3,92,162,178,47,3,482,0,22,504
4,2,4009,462,3,88,145,158,81,4,476,2,21,499
4,2,4009,463,3,164,142,186,53,0,545,1,26,572
4,2,4009,464,3,159,162,303,102,2,728,3,34,765
4,2,4009,465,3,38,47,61,29,0,175,0,10,185
4,2,4009,466,3,32,55,69,23,0,179,0,13,192
4,2,4009,467,3,51,119,97,25,0,292,0,0,292
4,2,4009,468,3,130,220,233,56,6,645,2,27,674
4,2,4009,469,3,69,80,80,16,2,247,3,22,272
4,2,4009,470,3,300,214,237,74,0,825,0,54,879
4,2,4009,471,3,93,87,269,68,4,521,0,31,552
4,2,4003,472,3,214,137,81,6,3,441,0,15,456
4,2,4003,473,3,123,190,127,6,1,447,0,6,453
4,2,4003,474,3,54,34,19,0,0,107,0,7,114
4,2,4009,475,3,48,98,158,49,6,359,1,21,381
4,2,4009,476,3,85,82,139,34,3,343,1,16,360
4,2,4009,477,3,75,96,234,44,2,451,1,10,462
4,2,4003,478,3,156,213,198,8,2,577,0,22,599
4,2,4003,479,3,134,75,64,2,2,277,0,11,288
4,2,4009,480,3,84,144,130,32,0,390,2,0,392
4,2,4009,481,3,78,138,217,19,2,454,0,17,471
4,2,4009,482,3,84,67,82,24,3,260,0,15,275
4,2,4003,483,3,37,31,63,2,0,133,0,6,139
4,2,4003,484,3,194,234,69,2,1,500,0,22,522
4,2,4009,485,3,90,60,131,31,0,312,2,0,314
4,2,4003,486,3,215,277,148,2,2,644,1,24,669
4,2,4003,487,3,169,93,111,6,4,383,0,0,383
4,2,4003,488,3,66,87,44,2,0,199,2,0,201
4,2,4009,489,3,136,179,248,74,5,642,3,21,666
4,2,4010,490,3,46,63,34,4,1,148,0,6,154
5,1,5002,3,3,346,414,192,158,21,1131,1,12,1144
5,1,5002,4,3,841,820,582,169,37,2449,16,54,2519
5,1,5002,5,3,204,155,143,75,15,592,2,11,605
5,1,5002,6,3,202,165,77,50,3,497,1,8,506
5,1,5002,7,3,260,222,75,70,8,635,1,10,646
5,1,5002,8,3,210,187,117,49,7,570,0,12,582
5,1,5002,9,3,731,741,561,184,44,2261,9,75,2345
5,1,5002,10,3,905,1079,749,279,46,3058,13,83,3154
5,1,5002,11,3,409,319,214,150,23,1115,1,29,1145
5,1,5002,12,3,445,410,235,157,23,1270,1,33,1304
5,1,5002,13,3,124,78,44,36,1,283,0,10,293
5,1,5002,14,3,158,130,56,67,2,413,1,11,425
5,1,5002,15,3,163,178,45,63,8,457,6,11,474
5,1,5002,16,3,195,250,61,89,3,598,3,5,606
5,1,5002,17,3,234,213,77,90,7,621,0,11,632
5,1,5002,18,3,312,294,116,113,11,846,0,29,875
5,1,5002,19,3,1079,950,638,292,47,3006,14,47,3067
5,1,5002,20,3,212,192,57,80,1,542,1,25,568
5,1,5002,21,3,228,165,77,50,4,524,0,19,543
5,1,5002,22,3,155,139,81,68,0,443,1,14,458
5,1,5002,23,3,105,130,90,48,5,378,0,10,388
5,1,5002,24,3,126,135,46,41,7,355,0,12,367
5,1,5002,25,3,210,203,82,95,11,601,1,6,608
5,1,5002,26,3,145,108,70,82,5,410,1,5,416
5,1,5002,27,3,135,168,71,71,4,449,0,12,461
5,1,5002,28,3,196,252,102,61,8,619,2,13,634
5,1,5002,29,3,240,235,110,53,11,649,4,19,672
5,1,5002,30,3,245,257,70,195,4,771,0,11,782
5,1,5002,31,3,634,643,353,280,32,1942,7,46,1995
5,1,5002,32,3,125,137,54,61,9,386,0,28,414
5,1,5002,33,3,414,375,301,105,13,1208,9,19,1236
5,1,5002,34,3,493,567,283,140,30,1513,7,50,1570
5,1,5002,35,3,333,405,194,99,9,1040,8,39,1087
5,1,5002,36,3,201,193,75,58,6,533,1,21,555
5,1,5002,37,3,125,182,79,44,4,434,4,14,452
5,1,5002,40,3,0,9,4,0,0,13,0,0,13
5,1,5002,41,3,109,149,37,19,0,314,0,13,327
5,1,5003,42,3,282,225,62,64,8,641,0,9,650
5,1,5003,43,3,300,214,52,26,5,597,1,12,610
5,1,5003,44,3,229,152,32,20,3,436,0,8,444
5,1,5003,45,3,205,131,43,34,7,420,1,11,432
5,1,5003,46,3,235,145,67,33,8,488,2,8,498
5,1,5003,47,3,309,187,58,33,9,596,3,11,610
5,1,5003,48,3,159,111,23,10,3,306,0,11,317
5,1,5003,49,3,293,197,43,27,7,567,0,12,579
5,1,5003,50,3,319,179,62,53,5,618,0,11,629
5,1,5003,51,3,269,170,34,25,7,505,0,14,519
5,1,5003,52,3,171,109,34,11,5,330,0,6,336
5,1,5003,53,3,215,132,43,7,5,402,1,7,410
5,1,5003,54,3,365,201,49,20,8,643,0,13,656
5,1,5003,55,3,205,235,41,25,3,509,3,17,529
5,1,5003,56,3,28,25,5,4,0,62,0,0,62
5,1,5012,233,3,111,100,14,5,1,231,0,3,234
5,1,5012,234,3,62,85,11,2,1,161,0,4,165
5,1,5012,235,3,26,70,6,0,0,102,0,4,106
5,1,5012,236,3,56,76,2,2,1,137,0,4,141
5,1,5012,237,3,54,45,3,3,0,105,0,3,108
5,1,5013,238,3,32,116,15,1,0,164,0,1,165
5,1,5013,239,3,56,180,38,7,3,284,1,5,290
5,1,5014,240,3,20,124,23,9,2,178,0,7,185
5,1,5014,241,3,28,104,28,7,3,170,0,8,178
5,1,5014,242,3,78,241,69,30,6,424,3,24,451
5,1,5014,243,3,87,169,103,24,3,386,3,7,396
5,1,5014,244,3,45,128,34,3,2,212,0,7,219
5,1,5014,245,3,153,212,115,20,6,506,2,14,522
5,1,5014,246,3,110,191,103,30,8,442,1,27,470
5,1,5014,247,3,20,9,1,0,0,30,0,2,32
5,1,5014,248,3,9,62,14,2,0,87,0,0,87
5,1,5014,249,3,38,135,58,3,2,236,0,17,253
5,1,5019,444,3,211,163,41,24,3,442,1,2,445
5,1,5019,445,3,234,217,97,20,3,571,0,16,587
5,1,5019,446,3,278,233,95,29,5,640,1,6,647
5,1,5019,447,3,229,172,114,15,1,531,0,16,547
5,1,5019,448,3,181,119,68,10,1,379,1,8,388
5,1,5019,449,3,136,219,10,2,0,367,0,4,371
5,1,5022,508,3,294,225,107,12,14,652,5,11,668
5,1,5022,509,3,153,124,60,18,7,362,0,1,363
5,1,5022,510,3,252,251,96,9,10,618,0,6,624
5,1,5022,511,3,296,202,86,23,9,616,1,12,629
5,1,5022,512,3,251,238,90,13,12,604,10,13,627
5,1,5022,513,3,182,168,50,10,3,413,4,8,425
5,1,5022,514,3,165,147,38,14,4,368,0,5,373
5,1,5022,515,3,272,217,64,18,9,580,6,5,591
5,1,5022,516,3,269,192,71,10,9,551,2,9,562
5,1,5022,517,3,164,148,41,8,8,369,0,9,378
5,1,5022,518,3,177,252,67,27,10,533,1,3,537
5,1,5022,519,3,158,144,81,10,3,396,0,12,408
5,1,5022,520,3,70,59,23,8,1,161,0,6,167
5,1,5022,521,3,22,27,14,0,0,63,0,1,64
5,1,5022,522,3,17,16,5,0,0,38,0,1,39
5,1,5022,523,3,88,48,29,2,2,169,0,4,173
5,1,5022,525,3,14,9,2,0,1,26,0,0,26
5,1,5025,577,3,177,208,90,14,5,494,10,11,515
5,1,5025,578,3,237,175,101,13,6,532,3,10,545
5,1,5025,579,3,141,126,63,8,3,341,1,8,350
5,1,5025,580,3,375,440,218,30,16,1079,3,17,1099
5,1,5025,581,3,310,276,166,32,17,801,0,17,818
5,1,5025,582,3,81,95,37,5,1,219,0,3,222
5,1,5025,583,3,151,132,48,12,2,345,0,2,347
5,1,5025,584,3,99,93,50,4,4,250,2,0,252
5,1,5025,585,3,286,303,200,21,17,827,2,18,847
5,1,5025,586,3,685,678,353,50,33,1799,1,51,1851
5,1,5025,587,3,910,952,434,101,40,2437,8,25,2470
5,1,5025,588,3,419,342,161,32,10,964,1,20,985
5,1,5025,589,3,81,94,38,6,1,220,0,0,220
5,1,5025,590,3,112,79,26,4,2,223,0,6,229
5,1,5025,591,3,185,161,58,5,5,414,1,11,426
5,1,5025,592,3,103,124,55,3,3,288,0,4,292
5,1,5025,593,3,228,231,85,8,3,555,1,6,562
5,1,5025,594,3,398,435,65,25,6,929,3,2,934
5,1,5025,595,3,399,324,116,18,6,863,2,20,885
5,1,5025,596,3,148,142,60,13,6,369,0,5,374
5,1,5025,597,3,208,196,71,15,4,494,1,7,502
5,1,5025,598,3,212,173,50,13,4,452,0,7,459
5,1,5025,599,3,140,121,40,7,4,312,1,5,318
5,1,5025,600,3,179,160,41,14,4,398,3,4,405
5,1,5025,601,3,283,285,122,25,8,723,1,6,730
5,1,5025,602,3,199,235,88,16,8,546,0,5,551
5,1,5025,603,3,166,162,68,8,6,410,1,6,417
5,1,5025,604,3,89,81,35,5,2,212,0,1,213
5,1,5025,605,3,125,107,62,5,3,302,2,4,308
5,1,5025,606,3,311,267,67,21,2,668,4,6,678
5,1,5025,607,3,122,115,51,16,3,307,0,7,314
5,1,5025,608,3,157,173,58,18,5,411,0,2,413
5,1,5025,609,3,177,132,77,13,8,407,2,3,412
5,1,5025,610,3,236,188,84,17,7,532,1,6,539
5,1,5025,611,3,1763,1729,788,181,77,4538,7,64,4609
5,1,5025,612,3,451,545,157,51,12,1216,0,8,1224
5,1,5025,613,3,318,350,118,19,12,817,0,31,848
5,1,5025,614,3,241,208,83,17,15,564,1,9,574
5,1,5025,615,3,166,147,71,9,8,401,2,13,416
5,1,5025,616,3,105,120,62,12,6,305,0,3,308
5,1,5025,617,3,182,220,83,18,9,512,1,5,518
5,1,5025,618,3,331,330,155,19,7,842,0,18,860
5,1,5025,619,3,223,136,69,7,3,438,1,13,452
5,1,5025,620,3,231,237,78,14,11,571,1,15,587
5,1,5025,621,3,352,330,85,18,12,797,2,18,817
5,1,5025,622,3,334,381,177,33,22,947,3,16,966
5,1,5025,623,3,1030,780,425,93,36,2364,2,40,2406
5,1,5025,624,3,277,277,109,34,4,701,1,12,714
5,1,5025,625,3,191,172,59,12,7,441,1,9,451
5,1,5025,626,3,242,212,100,16,9,579,0,4,583
5,1,5025,627,3,343,336,131,44,11,865,7,13,885
5,1,5025,628,3,335,276,134,46,14,805,2,6,813
5,1,5025,629,3,127,112,38,7,12,296,3,9,308
5,1,5025,630,3,243,189,112,13,6,563,2,13,578
5,1,5025,631,3,265,259,137,23,4,688,4,22,714
5,1,5025,632,3,191,194,78,13,7,483,0,6,489
5,1,5025,633,3,811,754,384,96,32,2077,10,22,2109
5,1,5025,634,3,143,138,80,6,4,371,0,6,377
5,1,5025,635,3,329,312,152,30,9,832,0,25,857
5,1,5025,636,3,201,154,97,13,2,467,0,13,480
5,1,5025,637,3,191,159,71,12,7,440,1,11,452
5,1,5025,638,3,286,226,103,30,13,658,2,10,670
5,1,5025,639,3,338,294,103,29,12,776,3,14,793
5,1,5025,640,3,492,487,179,57,20,1235,1,24,1260
5,1,5025,641,3,305,235,92,28,8,668,1,19,688
5,1,5025,642,3,41,78,19,2,2,142,0,4,146
5,1,5025,643,3,40,116,31,1,2,190,1,9,200
5,1,5025,644,3,26,59,15,0,2,102,1,3,106
5,1,5037,1498,3,85,86,12,6,1,190,0,6,196
5,1,5037,1499,3,145,126,20,14,2,307,0,9,316
5,1,5037,1500,3,171,141,17,11,2,342,1,15,358
5,1,5037,1501,3,125,146,19,19,1,310,0,7,317
5,1,5037,1502,3,161,137,14,22,7,341,0,9,350
5,1,5037,1503,3,54,73,10,2,4,143,1,0,144
5,1,5037,1504,3,28,30,3,3,0,64,0,0,64
5,1,5037,1505,3,68,97,9,4,1,179,0,2,181
5,1,5038,1506,3,291,165,39,21,4,520,4,14,538
5,1,5038,1507,3,209,143,40,8,5,405,0,9,414
5,1,5038,1508,3,221,169,49,25,3,467,0,17,484
5,1,5038,1509,3,203,103,27,32,2,367,0,9,376
5,1,5038,1510,3,143,89,14,7,2,255,0,7,262
5,1,5038,1511,3,232,158,26,24,4,444,0,11,455
5,1,5038,1512,3,166,165,45,23,2,401,0,7,408
5,1,5038,1513,3,231,121,17,4,6,379,4,11,394
5,1,5038,1515,3,54,37,11,1,5,108,0,5,113
5,1,5038,1516,3,92,91,3,4,1,191,0,3,194
5,1,5038,1517,3,36,42,9,1,0,88,0,1,89
5,1,5038,1518,3,27,57,5,1,1,91,0,0,91
5,1,5038,1520,3,125,75,7,3,1,211,0,1,212
5,2,5007,110,3,72,135,67,10,4,288,0,10,298
5,2,5007,111,3,121,263,97,11,1,493,2,4,499
5,2,5007,112,3,119,194,57,2,3,375,0,9,384
5,2,5007,113,3,104,241,106,11,7,469,3,10,482
5,2,5007,114,3,96,201,88,4,1,390,0,12,402
5,2,5007,115,3,120,193,103,7,4,427,0,11,438
5,2,5007,116,3,132,246,139,3,1,521,1,20,542
5,2,5007,117,3,4,22,7,0,0,33,0,1,34
5,2,5007,118,3,1,29,11,1,0,42,0,1,43
5,2,5007,119,3,8,35,9,0,0,52,0,2,54
5,2,5007,121,3,3,42,14,0,0,59,0,1,60
5,2,5007,122,3,11,92,33,1,1,138,0,0,138
5,2,5007,123,3,36,71,72,1,2,182,0,6,188
5,2,5007,124,3,1,64,28,0,0,93,0,3,96
5,2,5007,125,3,4,33,19,0,0,56,0,0,56
5,2,5007,126,3,3,94,3,0,0,100,0,11,111
5,2,5009,131,3,128,266,354,35,6,789,4,20,813
5,2,5009,132,3,93,166,242,13,3,517,1,25,543
5,2,5009,133,3,61,103,196,10,4,374,0,7,381
5,2,5009,134,3,92,247,375,49,9,772,0,7,779
5,2,5009,135,3,182,307,377,47,6,919,0,21,940
5,2,5009,136,3,122,214,247,19,8,610,0,13,623
5,2,5009,137,3,74,162,152,18,3,409,1,5,415
5,2,5009,138,3,123,214,253,38,11,639,1,10,650
5,2,5009,139,3,96,178,269,35,4,582,2,2,586
5,2,5009,140,3,81,97,155,16,2,351,0,5,356
5,2,5009,141,3,71,181,248,25,3,528,0,8,536
5,2,5009,142,3,88,181,259,13,7,548,0,8,556
5,2,5009,143,3,109,229,376,57,5,776,0,11,787
5,2,5009,144,3,129,213,333,26,10,711,3,15,729
5,2,5009,145,3,118,167,349,28,7,669,2,22,693
5,2,5009,146,3,96,252,477,22,4,851,1,22,874
5,2,5009,147,3,107,206,366,28,6,713,0,11,724
5,2,5009,148,3,64,150,195,22,1,432,1,5,438
5,2,5009,149,3,9,66,20,5,0,100,0,2,102
5,2,5009,150,3,51,67,92,3,0,213,2,7,222
5,2,5009,151,3,6,25,48,1,0,80,0,0,80
5,2,5009,152,3,59,99,133,7,1,299,5,3,307
5,2,5009,153,3,30,108,86,11,4,239,1,8,248
5,2,5009,154,3,89,187,44,4,3,327,0,9,336
5,2,5009,155,3,18,149,46,5,0,218,0,2,220
5,2,5009,156,3,37,86,138,25,1,287,0,12,299
5,2,5009,157,3,35,178,277,31,1,522,0,15,537
5,2,5009,158,3,25,125,137,17,8,312,3,12,327
5,2,5009,159,3,81,211,141,25,6,464,2,5,471
5,2,5009,160,3,16,102,177,4,0,299,0,8,307
5,2,5009,161,3,56,127,154,29,1,367,3,5,375
5,2,5009,162,3,82,221,350,71,6,730,3,30,763
5,2,5009,163,3,30,52,143,61,3,289,0,10,299
5,2,5009,164,3,17,122,133,7,2,281,1,10,292
5,2,5009,165,3,66,119,93,18,0,296,0,5,301
5,2,5009,166,3,33,211,97,20,2,363,2,16,381
5,2,5009,167,3,3,56,88,1,1,149,0,3,152
5,2,5009,168,3,85,247,218,115,2,667,1,24,692
5,2,5009,169,3,137,305,235,46,9,732,4,24,760
5,2,5009,170,3,27,93,93,24,5,242,0,7,249
5,2,5009,171,3,61,163,224,17,3,468,2,14,484
5,2,5009,172,3,47,85,141,5,3,281,0,9,290
5,2,5010,173,3,307,229,232,21,14,803,4,7,814
5,2,5010,174,3,464,449,222,20,24,1179,6,5,1190
5,2,5010,175,3,274,242,155,28,9,708,4,7,719
5,2,5010,176,3,242,190,135,20,8,595,1,1,597
5,2,5010,177,3,277,229,165,22,11,704,1,11,716
5,2,5010,178,3,255,179,168,13,5,620,3,7,630
5,2,5010,179,3,275,151,162,21,9,618,1,3,622
5,2,5010,180,3,255,212,133,18,13,631,0,5,636
5,2,5010,181,3,140,132,99,16,10,397,0,4,401
5,2,5010,182,3,227,120,77,10,9,443,0,9,452
5,2,5010,183,3,242,176,64,6,3,491,1,2,494
5,2,5010,184,3,194,155,75,11,4,439,0,11,450
5,2,5010,185,3,411,164,93,20,9,697,1,12,710
5,2,5010,186,3,289,200,112,18,10,629,0,1,630
5,2,5010,187,3,296,168,140,21,10,635,1,5,641
5,2,5010,188,3,339,194,132,20,8,693,0,7,700
5,2,5010,189,3,110,86,73,4,3,276,0,4,280
5,2,5010,190,3,284,156,84,9,2,535,1,6,542
5,2,5010,191,3,124,107,67,7,4,309,0,3,312
5,2,5010,192,3,283,231,124,12,15,665,3,10,678
5,2,5010,193,3,343,189,112,18,4,666,0,14,680
5,2,5010,194,3,189,133,58,8,2,390,0,9,399
5,2,5010,195,3,340,172,83,22,8,625,1,5,631
5,2,5010,196,3,200,111,82,9,8,410,2,6,418
5,2,5010,197,3,334,194,128,12,6,674,0,9,683
5,2,5010,198,3,186,171,130,6,2,495,1,9,505
5,2,5010,199,3,297,173,146,25,9,650,2,10,662
5,2,5010,200,3,274,202,152,21,9,658,0,12,670
5,2,5010,201,3,165,114,98,14,7,398,0,6,404
5,2,5010,202,3,210,231,88,13,9,551,1,4,556
5,2,5010,203,3,237,155,108,12,2,514,0,4,518
5,2,5010,204,3,143,178,131,9,5,466,0,6,472
5,2,5010,205,3,93,155,65,3,3,319,1,9,329
5,2,5010,206,3,202,192,94,15,6,509,2,8,519
5,2,5010,207,3,232,238,96,10,14,590,2,4,596
5,2,5010,208,3,213,248,119,15,7,602,1,6,609
5,2,5010,209,3,255,202,83,9,9,558,0,9,567
5,2,5010,210,3,196,182,98,13,6,495,1,10,506
5,2,5010,211,3,201,170,118,19,8,516,2,10,528
5,2,5010,212,3,169,183,113,15,5,485,0,7,492
5,2,5010,213,3,28,43,16,2,0,89,1,2,92
5,2,5016,255,3,140,102,66,6,0,314,0,10,324
5,2,5016,256,3,163,185,85,3,2,438,0,8,446
5,2,5020,450,3,138,260,97,11,9,515,1,21,537
5,2,5020,451,3,151,247,109,15,10,532,0,20,552
5,2,5020,452,3,168,307,75,16,7,573,0,21,594
5,2,5020,453,3,157,275,99,18,4,553,1,27,581
5,2,5020,454,3,222,261,85,17,6,591,2,29,622
5,2,5020,455,3,112,203,77,29,4,425,0,9,434
5,2,5020,456,3,68,180,67,8,3,326,2,10,338
5,2,5020,457,3,164,246,91,9,4,514,3,17,534
5,2,5020,458,3,205,452,144,28,13,842,1,22,865
5,2,5020,459,3,139,263,76,7,8,493,6,17,516
5,2,5020,460,3,131,225,97,21,11,485,0,9,494
5,2,5020,461,3,156,323,114,26,5,624,3,11,638
5,2,5020,462,3,179,310,88,10,25,612,0,14,626
5,2,5020,463,3,112,233,57,18,3,423,0,15,438
5,2,5020,464,3,179,247,125,22,4,577,0,12,589
5,2,5020,465,3,70,129,51,13,2,265,4,5,274
5,2,5020,466,3,114,168,50,18,2,352,1,6,359
5,2,5020,467,3,124,247,98,11,13,493,1,19,513
5,2,5020,468,3,121,243,118,18,11,511,0,11,522
5,2,5020,469,3,133,335,108,27,6,609,0,22,631
5,2,5020,470,3,139,370,170,16,12,707,0,21,728
5,2,5020,473,3,27,59,23,3,2,114,0,2,116
5,2,5020,474,3,77,122,46,3,2,250,1,9,260
5,2,5020,475,3,141,296,103,17,15,572,0,4,576
5,2,5020,476,3,217,215,100,19,10,561,2,7,570
5,2,5020,477,3,294,392,179,25,28,918,10,7,935
5,2,5020,478,3,192,288,132,25,16,653,2,16,671
5,2,5020,479,3,203,266,119,19,14,621,0,14,635
5,2,5020,480,3,115,213,88,20,10,446,1,11,458
5,2,5020,481,3,90,202,100,10,15,417,5,12,434
5,2,5020,482,3,146,181,85,18,6,436,0,5,441
5,2,5020,483,3,144,234,101,10,6,495,2,15,512
5,2,5020,484,3,80,153,61,6,2,302,2,9,313
5,2,5020,485,3,118,148,86,10,6,368,5,11,384
5,2,5020,486,3,123,159,65,12,9,368,1,8,377
5,2,5020,487,3,46,126,41,4,2,219,0,7,226
5,2,5020,488,3,51,143,47,6,2,249,1,9,259
5,2,5020,489,3,138,194,60,20,9,421,0,11,432
5,2,5020,490,3,106,164,113,12,3,398,2,4,404
5,2,5020,491,3,40,83,8,0,1,132,0,4,136
5,2,5020,492,3,130,349,113,20,6,618,4,20,642
5,2,5020,493,3,148,194,135,10,2,489,1,33,523
5,2,5020,494,3,65,101,61,7,4,238,2,6,246
5,2,5020,495,3,132,204,123,15,5,479,2,6,487
5,2,5020,496,3,117,94,46,10,4,271,0,19,290
5,2,5020,497,3,104,128,80,15,9,336,0,8,344
5,2,5020,498,3,72,109,52,5,3,241,2,8,251
5,2,5020,499,3,91,202,109,8,5,415,0,18,433
5,2,5021,500,3,122,117,84,4,2,329,1,5,335
5,2,5021,501,3,127,206,89,9,5,436,0,20,456
5,2,5021,502,3,131,117,84,6,2,340,0,9,349
5,2,5021,503,3,89,99,63,5,2,258,0,32,290
5,2,5021,504,3,14,89,27,0,1,131,0,5,136
5,2,5021,505,3,81,163,23,1,1,269,0,13,282
5,2,5021,506,3,26,16,13,3,2,60,0,0,60
5,2,5021,507,3,20,22,8,1,0,51,2,1,54
5,2,5023,526,3,61,238,251,4,2,556,0,17,573
5,2,5023,527,3,48,185,169,4,2,408,0,3,411
5,2,5023,528,3,2,15,12,1,0,30,0,2,32
5,2,5023,529,3,3,29,16,0,0,48,0,0,48
5,2,5023,530,3,4,25,47,0,0,76,0,1,77
5,2,5023,531,3,1,25,5,0,0,31,0,0,31
5,2,5023,532,3,63,157,166,7,7,400,4,16,420
5,2,5023,534,3,7,25,56,0,0,88,0,1,89
5,2,5023,535,3,4,24,7,0,0,35,0,0,35
5,2,5023,536,3,6,57,49,0,1,113,0,4,117
5,2,5023,537,3,1,22,69,0,0,92,0,1,93
5,2,5023,538,3,4,24,4,0,0,32,1,0,33
5,2,5023,539,3,99,106,47,9,5,266,0,2,268
5,2,5023,540,3,82,187,83,12,6,370,1,11,382
5,2,5031,1040,3,117,163,62,4,3,349,2,10,361
5,2,5031,1041,3,167,175,116,17,7,482,0,5,487
5,2,5031,1042,3,154,142,102,22,11,431,3,6,440
5,2,5031,1043,3,210,197,110,11,3,531,1,3,535
5,2,5031,1044,3,243,190,107,21,5,566,0,11,577
5,2,5031,1045,3,181,119,59,14,6,379,0,6,385
5,2,5031,1046,3,186,189,115,14,3,507,0,5,512
5,2,5031,1047,3,259,273,108,48,9,697,0,12,709
5,2,5031,1048,3,294,220,155,18,4,691,4,16,711
5,2,5031,1049,3,119,148,91,7,4,369,1,7,377
5,2,5031,1050,3,155,152,59,14,8,388,0,2,390
5,2,5031,1051,3,131,156,92,12,9,400,1,6,407
5,2,5031,1052,3,108,115,75,8,4,310,0,3,313
5,2,5031,1054,3,19,50,44,0,0,113,0,4,117
5,2,5031,1055,3,48,93,37,2,0,180,0,9,189
5,2,5031,1056,3,71,52,27,2,1,153,3,9,165
5,2,5031,1057,3,31,75,45,3,2,156,0,5,161
5,2,5032,1058,3,96,187,67,17,3,370,0,6,376
5,2,5032,1059,3,51,140,48,20,5,264,0,0,264
5,2,5032,1060,3,79,157,33,7,0,276,4,12,292
5,2,5032,1061,3,271,257,74,25,4,631,0,12,643
5,2,5032,1062,3,117,145,100,14,4,380,2,11,393
5,2,5032,1063,3,148,250,96,42,7,543,0,7,550
5,2,5032,1064,3,201,224,138,36,9,608,0,17,625
5,2,5032,1065,3,103,140,73,9,5,330,0,7,337
5,2,5032,1066,3,122,167,101,32,6,428,0,4,432
5,2,5032,1067,3,235,294,108,29,9,675,4,15,694
5,2,5032,1068,3,184,204,126,17,6,537,1,6,544
5,2,5032,1069,3,53,113,36,6,5,213,2,7,222
5,2,5032,1070,3,80,72,35,1,7,195,0,7,202
5,2,5032,1071,3,151,307,104,19,14,595,7,19,621
5,2,5032,1072,3,181,186,91,27,13,498,0,5,503
5,2,5032,1073,3,212,234,150,33,13,642,1,14,657
5,2,5032,1074,3,112,161,53,9,2,337,2,4,343
5,2,5032,1075,3,118,164,51,16,3,352,0,9,361
5,2,5032,1076,3,212,237,101,31,6,587,0,12,599
5,2,5032,1077,3,143,152,54,15,3,367,1,4,372
5,2,5032,1078,3,287,406,133,35,24,885,0,10,895
5,2,5032,1079,3,193,240,107,43,9,592,0,7,599
5,2,5032,1080,3,182,159,76,38,10,465,1,8,474
5,2,5032,1081,3,134,173,44,22,9,382,1,6,389
5,2,5032,1082,3,153,285,80,10,5,533,0,5,538
5,2,5032,1083,3,203,263,117,33,10,626,0,5,631
5,2,5032,1084,3,146,210,87,23,2,468,1,11,480
5,2,5032,1085,3,160,243,64,33,4,504,1,2,507
5,2,5032,1086,3,168,217,108,24,8,525,1,7,533
5,2,5032,1087,3,91,210,49,10,8,368,1,12,381
5,2,5032,1088,3,206,265,111,38,10,630,0,7,637
5,2,5032,1089,3,53,149,29,5,1,237,2,5,244
5,2,5032,1090,3,61,118,33,6,5,223,0,6,229
5,2,5033,1091,3,73,414,432,27,4,950,4,21,975
5,2,5033,1092,3,6,104,125,4,0,239,0,4,243
5,2,5033,1093,3,38,292,376,14,5,725,0,7,732
5,2,5033,1094,3,28,232,418,6,5,689,1,9,699
5,2,5033,1095,3,30,241,253,12,5,541,0,15,556
5,2,5033,1096,3,85,249,445,8,5,792,1,23,816
5,2,5033,1097,3,22,287,331,10,3,653,0,14,667
5,2,5033,1098,3,74,410,549,10,6,1049,2,35,1086
5,2,5033,1099,3,54,246,270,8,3,581,2,9,592
5,2,5033,1100,3,32,288,521,10,5,856,2,17,875
5,2,5033,1101,3,45,194,169,15,2,425,0,6,431
5,2,5033,1102,3,56,178,147,8,2,391,0,7,398
5,2,5033,1103,3,71,279,350,12,5,717,1,22,740
5,2,5033,1104,3,44,299,389,23,2,757,0,6,763
5,2,5033,1105,3,22,204,265,6,1,498,0,14,512
5,2,5033,1106,3,22,141,243,4,0,410,0,19,429
5,2,5033,1107,3,45,126,112,3,1,287,0,6,293
5,2,5033,1108,3,96,350,222,20,6,694,0,11,705
5,2,5033,1109,3,98,370,370,12,7,857,3,5,865
5,2,5033,1110,3,34,201,242,12,8,497,2,13,512
5,2,5033,1111,3,62,384,367,20,2,835,0,28,863
5,2,5033,1112,3,27,245,256,8,2,538,1,11,550
5,2,5033,1113,3,26,268,268,1,2,565,0,21,586
5,2,5033,1114,3,17,75,106,3,2,203,0,10,213
5,2,5033,1115,3,53,264,307,9,3,636,5,15,656
5,2,5033,1116,3,44,382,368,17,4,815,1,21,837
5,2,5033,1117,3,27,287,340,15,0,669,0,20,689
5,2,5033,1118,3,26,254,328,7,2,617,0,11,628
5,2,5033,1119,3,10,77,30,2,0,119,1,6,126
5,2,5033,1120,3,3,75,30,0,0,108,0,5,113
5,2,5033,1121,3,11,38,83,2,0,134,2,4,140
5,2,5033,1122,3,31,86,195,7,1,320,0,6,326
5,2,5033,1123,3,3,30,18,0,0,51,0,0,51
5,2,5033,1124,3,1,39,20,0,0,60,0,3,63
5,2,5033,1125,3,161,96,251,12,7,527,1,34,562
5,2,5033,1126,3,5,29,92,6,0,132,0,2,134
5,2,5033,1127,3,12,93,173,4,2,284,0,4,288
5,2,5033,1128,3,15,123,279,2,2,421,1,16,438
5,2,5033,1129,3,18,93,311,13,0,435,1,10,446
5,2,5033,1130,3,17,167,276,5,1,466,0,6,472
5,2,5033,1131,3,21,150,331,0,5,507,0,11,518
5,2,5033,1132,3,25,380,396,7,1,809,1,14,824
5,2,5033,1133,3,13,118,136,1,0,268,0,11,279
5,2,5033,1134,3,3,24,83,2,0,112,1,1,114
5,2,5033,1135,3,16,83,298,6,4,407,1,11,419
5,2,5033,1136,3,44,204,355,40,1,644,1,18,663
5,2,5033,1137,3,24,187,395,38,2,646,3,17,666
5,2,5033,1138,3,48,136,302,11,1,498,2,8,508
5,2,5033,1139,3,37,80,299,10,1,427,0,16,443
5,2,5033,1140,3,44,166,570,18,8,806,6,22,834
5,2,5033,1141,3,39,189,498,8,5,739,3,17,759
5,2,5033,1142,3,44,204,483,19,5,755,0,22,777
5,2,5033,1143,3,7,49,165,3,5,229,0,8,237
5,2,5033,1144,3,2,118,128,1,2,251,0,5,256
5,2,5033,1145,3,2,29,39,2,0,72,0,2,74
5,2,5033,1146,3,50,220,342,13,2,627,4,5,636
5,2,5033,1147,3,47,133,263,8,4,455,0,23,478
5,2,5033,1148,3,22,114,391,3,1,531,2,9,542
5,2,5033,1149,3,28,481,511,9,0,1029,0,33,1062
5,2,5033,1150,3,13,69,142,6,1,231,0,8,239
5,2,5033,1151,3,15,94,179,4,2,294,0,17,311
5,2,5033,1152,3,6,86,131,0,0,223,0,0,223
5,2,5033,1153,3,3,116,192,1,1,313,1,7,321
5,2,5033,1154,3,16,81,269,6,0,372,0,20,392
5,2,5033,1155,3,10,124,226,1,2,363,0,16,379
5,2,5033,1156,3,32,228,370,8,4,642,1,17,660
5,2,5033,1157,3,37,247,386,3,0,673,3,27,703
5,2,5033,1158,3,21,104,233,8,9,375,1,20,396
5,2,5033,1159,3,44,134,325,8,0,511,0,28,539
5,2,5033,1160,3,9,135,270,1,1,416,0,16,432
5,2,5033,1161,3,13,235,309,94,0,651,0,10,661
5,2,5033,1162,3,24,160,460,5,0,649,3,19,671
5,2,5033,1163,3,43,269,472,8,1,793,1,19,813
5,2,5033,1164,3,5,78,142,4,0,229,3,0,232
5,2,5033,1165,3,2,75,82,0,1,160,0,2,162
5,2,5034,1166,3,30,56,25,0,1,112,0,4,116
5,2,5034,1167,3,230,218,78,15,13,554,2,6,562
5,2,5034,1168,3,5,72,2,0,0,79,0,2,81
5,2,5034,1169,3,2,19,1,0,0,22,0,0,22
5,2,5034,1170,3,116,80,44,2,6,248,3,4,255
5,2,5034,1171,3,19,38,8,0,1,66,0,3,69
5,3,5001,1,3,132,163,28,16,2,341,0,18,359
5,3,5001,2,3,92,66,15,8,0,181,1,4,186
5,3,5004,57,3,471,444,151,129,25,1220,2,41,1263
5,3,5004,58,3,150,105,24,15,2,296,0,5,301
5,3,5004,59,3,263,307,92,57,12,731,2,22,755
5,3,5004,61,3,15,46,7,6,2,76,0,2,78
5,3,5004,62,3,17,19,5,12,0,53,0,0,53
5,3,5004,63,3,109,113,72,50,6,350,5,13,368
5,3,5004,64,3,78,268,12,8,0,366,3,19,388
5,3,5004,65,3,7,9,1,1,0,18,0,1,19
5,3,5004,66,3,93,98,18,11,2,222,2,7,231
5,3,5004,67,3,25,49,6,11,0,91,0,3,94
5,3,5004,68,3,18,75,21,6,1,121,2,4,127
5,3,5004,69,3,82,300,34,10,3,429,2,16,447
5,3,5004,70,3,33,145,26,12,1,217,0,11,228
5,3,5004,71,3,15,42,8,1,0,66,0,3,69
5,3,5004,72,3,5,39,17,2,1,64,0,0,64
5,3,5004,73,3,4,74,4,18,3,103,0,14,117
5,3,5004,74,3,29,159,8,4,3,203,0,5,208
5,3,5004,75,3,152,580,74,37,6,849,0,17,866
5,3,5004,76,3,14,50,5,3,0,72,0,5,77
5,3,5004,77,3,12,59,4,2,2,79,0,0,79
5,3,5004,78,3,58,260,38,7,1,364,1,11,376
5,3,5004,79,3,80,444,50,31,4,609,3,29,641
5,3,5004,80,3,25,145,4,7,2,183,0,0,183
5,3,5005,81,3,82,115,13,5,0,215,0,9,224
5,3,5005,82,3,162,229,24,6,2,423,0,15,438
5,3,5005,83,3,13,110,4,2,0,129,0,1,130
5,3,5006,84,3,152,223,189,31,8,603,9,5,617
5,3,5006,85,3,97,156,84,16,7,360,0,10,370
5,3,5006,86,3,70,99,73,9,3,254,0,7,261
5,3,5006,87,3,255,253,170,22,8,708,3,8,719
5,3,5006,88,3,172,203,162,35,8,580,5,12,597
5,3,5006,89,3,198,212,177,29,5,621,3,10,634
5,3,5006,90,3,193,180,89,11,2,475,2,9,486
5,3,5006,91,3,128,204,125,15,7,479,0,13,492
5,3,5006,92,3,131,144,98,22,2,397,2,5,404
5,3,5006,93,3,82,181,96,37,6,402,1,12,415
5,3,5006,94,3,268,178,183,46,6,681,3,15,699
5,3,5006,95,3,219,206,148,68,13,654,0,24,678
5,3,5006,96,3,180,188,166,24,7,565,1,17,583
5,3,5006,97,3,34,95,34,0,1,164,3,1,168
5,3,5006,98,3,32,27,8,1,0,68,0,0,68
5,3,5006,99,3,1,48,7,0,0,56,0,1,57
5,3,5006,101,3,6,16,11,0,1,34,0,2,36
5,3,5006,102,3,5,62,13,1,0,81,0,1,82
5,3,5006,103,3,8,22,4,1,0,35,0,2,37
5,3,5006,104,3,12,109,11,0,1,133,0,7,140
5,3,5006,105,3,2,90,7,2,0,101,0,2,103
5,3,5006,106,3,10,78,34,2,0,124,0,7,131
5,3,5006,107,3,8,31,1,1,0,41,0,1,42
5,3,5006,108,3,3,114,3,0,0,120,0,0,120
5,3,5006,109,3,8,50,19,1,1,79,0,3,82
5,3,5008,127,3,24,58,16,1,0,99,0,3,102
5,3,5008,128,3,20,58,7,3,1,89,0,5,94
5,3,5008,129,3,36,65,8,2,1,112,0,3,115
5,3,5008,130,3,166,304,57,12,4,543,0,17,560
5,3,5011,214,3,102,216,47,28,3,396,1,20,417
5,3,5011,215,3,113,170,41,51,7,382,1,17,400
5,3,5011,216,3,216,205,37,82,1,541,3,21,565
5,3,5011,217,3,64,95,56,0,4,219,2,7,228
5,3,5011,218,3,23,82,48,4,3,160,1,8,169
5,3,5011,219,3,12,32,11,0,2,57,0,6,63
5,3,5011,220,3,26,76,29,5,0,136,1,5,142
5,3,5011,221,3,6,21,5,0,0,32,0,0,32
5,3,5011,222,3,38,126,29,6,0,199,3,0,202
5,3,5011,223,3,33,91,8,2,2,136,0,4,140
5,3,5011,224,3,5,16,0,0,0,21,0,3,24
5,3,5011,225,3,46,93,17,5,0,161,0,6,167
5,3,5011,226,3,46,79,5,0,2,132,0,4,136
5,3,5011,227,3,27,62,8,0,1,98,0,1,99
5,3,5011,228,3,31,62,7,1,2,103,0,7,110
5,3,5011,229,3,45,82,18,4,0,149,0,2,151
5,3,5011,230,3,35,61,3,0,0,99,2,7,108
5,3,5011,231,3,57,165,17,2,0,241,4,8,253
5,3,5015,250,3,48,98,5,35,0,186,0,6,192
5,3,5015,251,3,42,38,7,23,0,110,0,3,113
5,3,5015,252,3,40,42,9,21,0,112,0,5,117
5,3,5015,253,3,13,23,2,3,0,41,0,1,42
5,3,5015,254,3,18,37,4,13,0,72,0,3,75
5,3,5018,319,3,152,172,77,20,4,425,1,10,436
5,3,5018,320,3,173,129,90,28,5,425,1,4,430
5,3,5018,321,3,157,237,88,38,7,527,6,6,539
5,3,5018,322,3,218,168,65,34,7,492,0,2,494
5,3,5018,323,3,209,126,109,27,6,477,1,10,488
5,3,5018,324,3,104,152,53,29,3,341,1,2,344
5,3,5018,325,3,223,261,118,40,12,654,0,7,661
5,3,5018,326,3,518,430,208,128,30,1314,0,14,1328
5,3,5018,327,3,172,128,75,23,7,405,0,8,413
5,3,5018,328,3,109,149,65,25,5,353,0,6,359
5,3,5018,329,3,69,109,60,10,6,254,0,8,262
5,3,5018,330,3,131,173,63,12,5,384,2,0,386
5,3,5018,331,3,152,235,130,11,7,535,6,9,550
5,3,5018,332,3,517,405,97,57,16,1092,1,11,1104
5,3,5018,333,3,513,384,158,114,25,1194,1,16,1211
5,3,5018,334,3,546,309,153,80,15,1103,0,8,1111
5,3,5018,335,3,363,344,114,68,13,902,2,10,914
5,3,5018,336,3,258,152,92,37,7,546,4,5,555
5,3,5018,337,3,328,390,195,38,23,974,4,7,985
5,3,5018,338,3,147,176,96,18,5,442,1,5,448
5,3,5018,339,3,242,259,110,60,13,684,1,12,697
5,3,5018,340,3,355,200,93,50,6,704,0,13,717
5,3,5018,341,3,312,232,155,26,10,735,1,8,744
5,3,5018,342,3,383,244,106,46,4,783,2,10,795
5,3,5018,343,3,366,174,111,53,15,719,2,6,727
5,3,5018,344,3,306,221,97,60,17,701,0,6,707
5,3,5018,345,3,313,192,132,41,13,691,1,10,702
5,3,5018,346,3,184,186,85,23,5,483,4,6,493
5,3,5018,347,3,257,267,131,27,15,697,2,10,709
5,3,5018,348,3,116,265,78,14,4,477,1,5,483
5,3,5018,349,3,190,243,87,24,3,547,0,10,557
5,3,5018,350,3,185,234,111,28,8,566,6,17,589
5,3,5018,351,3,263,324,151,22,11,771,2,12,785
5,3,5018,352,3,234,182,79,34,9,538,0,2,540
5,3,5018,353,3,254,182,90,38,15,579,1,12,592
5,3,5018,354,3,168,101,41,24,3,337,0,5,342
5,3,5018,355,3,425,247,97,36,11,816,3,9,828
5,3,5018,356,3,321,256,132,31,7,747,1,15,763
5,3,5018,357,3,694,407,148,67,16,1332,0,4,1336
5,3,5018,358,3,171,152,89,34,8,454,0,4,458
5,3,5018,359,3,214,172,101,37,15,539,1,15,555
5,3,5018,360,3,184,202,105,22,13,526,1,9,536
5,3,5018,361,3,172,297,147,39,21,676,5,13,694
5,3,5018,362,3,131,269,90,14,6,510,1,17,528
5,3,5018,363,3,101,126,69,16,2,314,1,3,318
5,3,5018,364,3,245,216,123,20,6,610,0,9,619
5,3,5018,365,3,127,122,53,12,6,320,0,8,328
5,3,5018,366,3,113,76,39,24,9,261,0,1,262
5,3,5018,367,3,248,171,83,51,8,561,0,6,567
5,3,5018,368,3,351,246,107,46,7,757,0,7,764
5,3,5018,369,3,493,366,133,46,17,1055,1,2,1058
5,3,5018,370,3,308,308,146,38,19,819,2,14,835
5,3,5018,371,3,240,297,107,28,21,693,2,13,708
5,3,5018,372,3,448,244,113,95,16,916,0,9,925
5,3,5018,373,3,464,223,114,67,15,883,1,6,890
5,3,5018,374,3,204,118,60,36,8,426,3,4,433
5,3,5018,375,3,165,103,78,24,9,379,0,6,385
5,3,5018,376,3,149,228,128,17,12,534,0,14,548
5,3,5018,377,3,175,269,123,19,5,591,3,14,608
5,3,5018,378,3,124,201,137,15,10,487,1,7,495
5,3,5018,379,3,248,250,109,20,8,635,0,11,646
5,3,5018,380,3,175,133,52,15,8,383,0,5,388
5,3,5018,381,3,300,178,75,34,10,597,0,4,601
5,3,5018,382,3,313,229,108,54,18,722,1,15,738
5,3,5018,383,3,435,226,133,78,16,888,0,5,893
5,3,5018,384,3,213,296,90,25,11,635,2,11,648
5,3,5018,385,3,235,255,131,73,13,707,1,1,709
5,3,5018,386,3,211,269,99,58,10,647,0,8,655
5,3,5018,387,3,293,236,176,59,9,773,1,4,778
5,3,5018,388,3,187,145,85,26,5,448,2,1,451
5,3,5018,389,3,172,152,99,40,6,469,0,7,476
5,3,5018,390,3,374,158,123,22,6,683,4,11,698
5,3,5018,391,3,252,132,63,23,7,477,0,4,481
5,3,5018,392,3,268,210,118,34,11,641,0,7,648
5,3,5018,393,3,209,145,65,26,8,453,1,7,461
5,3,5018,394,3,119,100,38,0,7,264,0,5,269
5,3,5018,395,3,193,98,97,20,9,417,0,5,422
5,3,5018,396,3,244,138,96,47,11,536,1,16,553
5,3,5018,397,3,116,114,65,24,12,331,1,5,337
5,3,5018,398,3,230,159,106,31,9,535,0,9,544
5,3,5018,399,3,287,188,104,33,13,625,0,11,636
5,3,5018,400,3,249,102,67,17,8,443,0,2,445
5,3,5018,401,3,172,119,76,53,8,428,2,4,434
5,3,5018,402,3,284,176,90,44,6,600,0,6,606
5,3,5018,403,3,227,137,91,53,5,513,0,8,521
5,3,5018,404,3,292,192,140,48,6,678,0,11,689
5,3,5018,405,3,291,150,169,29,7,646,1,15,662
5,3,5018,406,3,187,200,102,20,3,512,1,9,522
5,3,5018,407,3,306,211,117,39,4,677,2,10,689
5,3,5018,408,3,276,179,134,24,6,619,3,1,623
5,3,5018,409,3,177,73,51,12,4,317,0,2,319
5,3,5018,410,3,217,179,78,31,6,511,0,14,525
5,3,5018,411,3,202,139,102,36,10,489,0,12,501
5,3,5018,412,3,384,190,191,40,18,823,4,4,831
5,3,5018,413,3,309,213,132,31,15,700,0,10,710
5,3,5018,414,3,98,172,71,10,5,356,0,8,364
5,3,5018,415,3,269,272,122,38,11,712,0,11,723
5,3,5018,416,3,308,225,128,45,3,709,3,18,730
5,3,5018,417,3,211,121,87,31,5,455,3,9,467
5,3,5018,418,3,123,64,88,13,2,290,0,5,295
5,3,5018,419,3,400,200,126,30,31,787,1,7,795
5,3,5018,420,3,250,198,88,23,6,565,3,12,580
5,3,5018,421,3,67,81,40,14,7,209,1,8,218
5,3,5018,422,3,208,255,151,19,7,640,3,16,659
5,3,5018,423,3,44,64,31,4,2,145,0,1,146
5,3,5018,424,3,110,145,149,9,6,419,0,6,425
5,3,5018,425,3,274,140,117,50,16,597,2,10,609
5,3,5018,426,3,150,141,108,15,9,423,0,7,430
5,3,5018,427,3,170,198,109,18,11,506,2,10,518
5,3,5018,428,3,248,219,168,34,7,676,0,5,681
5,3,5018,429,3,246,143,186,36,14,625,1,14,640
5,3,5018,430,3,159,160,102,23,12,456,1,9,466
5,3,5018,431,3,455,465,220,67,18,1225,5,14,1244
5,3,5018,432,3,169,142,92,24,7,434,2,11,447
5,3,5018,433,3,242,185,145,21,16,609,3,5,617
5,3,5018,434,3,439,232,147,51,11,880,1,10,891
5,3,5018,435,3,114,114,46,9,4,287,2,0,289
5,3,5018,436,3,601,451,299,87,26,1464,5,14,1483
5,3,5018,437,3,192,248,155,34,13,642,6,10,658
5,3,5018,438,3,261,273,173,36,13,756,2,13,771
5,3,5018,439,3,310,168,105,49,11,643,4,6,653
5,3,5018,440,3,141,119,38,8,4,310,2,4,316
5,3,5018,441,3,228,157,88,38,11,522,1,1,524
5,3,5018,442,3,41,67,14,2,2,126,1,4,131
5,3,5018,443,3,21,17,2,0,0,40,0,0,40
5,3,5026,645,3,29,73,5,15,0,122,0,0,122
5,3,5026,646,3,31,47,19,13,5,115,0,0,115
5,3,5026,647,3,26,160,17,5,4,212,0,3,215
5,3,5026,648,3,80,94,25,4,4,207,0,10,217
5,3,5026,649,3,58,168,47,6,0,279,0,9,288
5,3,5026,650,3,38,109,13,3,1,164,2,11,177
5,3,5026,651,3,7,14,6,0,0,27,0,0,27
5,3,5027,652,3,399,203,92,59,7,760,2,34,796
5,3,5027,653,3,770,402,185,108,29,1494,2,37,1533
5,3,5027,654,3,369,207,73,43,9,701,0,17,718
5,3,5027,655,3,359,173,74,54,14,674,0,18,692
5,3,5027,656,3,339,148,44,31,7,569,1,10,580
5,3,5027,657,3,385,164,67,24,10,650,1,22,673
5,3,5027,658,3,178,105,34,17,13,347,0,8,355
5,3,5027,659,3,377,187,67,55,12,698,1,15,714
5,3,5027,660,3,462,262,94,58,17,893,1,13,907
5,3,5027,661,3,481,312,105,66,21,985,1,20,1006
5,3,5027,662,3,268,140,42,37,13,500,0,10,510
5,3,5027,663,3,1577,547,199,141,51,2515,5,44,2564
5,3,5027,664,3,1512,755,328,208,62,2865,3,53,2921
5,3,5027,665,3,7,62,0,0,0,69,0,2,71
5,3,5027,666,3,28,44,10,2,0,84,0,0,84
5,3,5027,667,3,46,46,9,1,2,104,0,4,108
5,3,5027,668,3,15,24,8,0,1,48,1,1,50
5,3,5027,669,3,62,47,50,1,0,160,0,3,163
5,3,5027,670,3,46,35,17,1,1,100,1,2,103
5,3,5027,671,3,67,52,31,6,1,157,0,0,157
5,3,5027,672,3,24,16,1,0,0,41,0,2,43
5,3,5027,673,3,200,122,25,2,4,353,1,8,362
5,3,5027,674,3,29,51,6,2,1,89,0,5,94
5,3,5027,675,3,7,3,16,1,0,27,0,5,32
5,3,5027,676,3,62,122,7,0,0,191,0,5,196
5,3,5027,677,3,57,75,14,2,1,149,0,9,158
5,3,5027,678,3,15,12,4,1,0,32,0,1,33
5,3,5027,679,3,56,11,4,0,0,71,0,0,71
5,3,5027,680,3,28,21,6,1,0,56,0,1,57
5,3,5027,681,3,24,42,10,1,0,77,0,3,80
5,3,5027,682,3,25,34,6,0,0,65,0,1,66
5,3,5027,683,3,33,41,3,0,0,77,3,5,85
5,3,5027,684,3,43,36,9,0,0,88,0,6,94
5,3,5027,685,3,88,66,14,6,3,177,1,5,183
5,3,5027,686,3,66,52,31,2,1,152,0,7,159
5,3,5027,687,3,26,33,27,6,0,92,1,9,102
5,3,5027,688,3,34,54,7,3,1,99,2,7,108
5,3,5027,689,3,48,46,16,1,1,112,0,5,117
5,3,5027,690,3,24,56,5,3,0,88,1,1,90
5,3,5028,691,3,228,165,54,142,4,593,2,6,601
5,3,5028,692,3,544,472,176,392,27,1611,4,37,1652
5,3,5028,693,3,419,380,133,328,17,1277,2,25,1304
5,3,5028,694,3,278,233,46,168,3,728,2,20,750
5,3,5028,695,3,301,223,37,144,9,714,1,13,728
5,3,5028,696,3,331,240,45,128,11,755,0,13,768
5,3,5028,697,3,132,144,37,34,3,350,0,3,353
5,3,5028,698,3,211,191,39,146,8,595,0,10,605
5,3,5028,699,3,187,129,38,91,2,447,0,13,460
5,3,5028,700,3,197,164,33,101,2,497,0,10,507
5,3,5028,701,3,178,156,56,104,7,501,1,14,516
5,3,5028,702,3,174,232,98,137,3,644,1,23,668
5,3,5028,703,3,219,196,101,66,13,595,3,27,625
5,3,5028,704,3,77,63,31,41,5,217,0,2,219
5,3,5028,705,3,172,134,43,58,4,411,0,8,419
5,3,5028,706,3,204,222,95,76,12,609,1,29,639
5,3,5028,707,3,151,147,46,83,4,431,8,0,439
5,3,5028,708,3,161,189,89,79,6,524,0,19,543
5,3,5028,709,3,178,243,87,87,6,601,4,26,631
5,3,5028,710,3,138,160,58,64,4,424,5,21,450
5,3,5028,711,3,214,180,76,101,8,579,0,23,602
5,3,5028,712,3,71,67,18,40,0,196,3,4,203
5,3,5028,713,3,50,52,35,35,4,176,0,8,184
5,3,5028,714,3,175,171,79,142,11,578,0,10,588
5,3,5028,715,3,253,243,80,169,10,755,1,16,772
5,3,5028,716,3,11,49,1,4,0,65,0,0,65
5,3,5028,717,3,136,98,59,53,4,350,0,14,364
5,3,5028,718,3,148,77,63,54,8,350,0,10,360
5,3,5028,719,3,106,104,49,62,8,329,2,9,340
5,3,5028,720,3,95,98,48,39,1,281,0,8,289
5,3,5028,721,3,163,120,53,47,2,385,0,14,399
5,3,5028,722,3,152,141,101,42,5,441,0,12,453
5,3,5028,723,3,199,297,136,38,9,679,1,18,698
5,3,5028,724,3,177,214,89,91,13,584,0,14,598
5,3,5028,725,3,137,167,98,59,4,465,0,19,484
5,3,5028,726,3,106,120,42,31,6,305,0,11,316
5,3,5028,727,3,15,38,4,8,0,65,0,2,67
5,3,5029,728,3,78,223,151,30,6,488,1,6,495
5,3,5029,729,3,44,161,205,26,2,438,0,7,445
5,4,5030,754,3,224,318,59,30,12,643,6,8,657
5,4,5030,755,3,563,748,225,90,46,1672,6,38,1716
5,4,5030,756,3,247,298,70,41,12,668,2,10,680
5,4,5030,757,3,653,538,143,74,22,1430,7,14,1451
5,4,5030,776,3,469,345,91,50,21,976,0,8,984
5,4,5030,777,3,400,593,112,43,12,1160,4,28,1192
5,4,5030,800,3,544,403,97,67,21,1132,1,17,1150
5,4,5030,801,3,349,329,67,85,17,847,0,5,852
5,4,5030,830,3,1466,1746,502,203,102,4019,17,68,4104
5,4,5030,831,3,340,388,90,40,10,868,6,3,877
5,4,5030,832,3,408,450,112,51,14,1035,3,17,1055
5,4,5030,833,3,394,337,94,50,29,904,3,5,912
5,4,5030,834,3,151,311,91,25,11,589,1,16,606
5,4,5030,835,3,195,373,61,26,6,661,4,16,681
5,4,5030,836,3,303,441,94,30,10,878,4,31,913
5,4,5030,837,3,214,230,57,24,11,536,5,13,554
5,4,5030,838,3,282,246,68,27,14,637,3,4,644
5,4,5030,840,3,200,221,60,20,17,518,0,14,532
5,4,5030,862,3,259,221,75,28,13,596,6,16,618
5,4,5030,863,3,291,335,92,44,14,776,4,18,798
5,4,5030,864,3,390,232,103,20,27,772,6,14,792
5,4,5030,865,3,379,334,96,66,16,891,3,4,898
5,4,5030,866,3,453,304,92,57,20,926,1,9,936
5,4,5030,867,3,378,373,88,30,13,882,2,14,898
5,4,5030,868,3,601,784,203,94,37,1719,9,22,1750
5,4,5030,869,3,830,1324,337,144,66,2701,13,40,2754
5,4,5030,870,3,208,202,45,36,16,507,0,15,522
5,4,5030,871,3,397,271,71,37,16,792,0,12,804
5,4,5030,872,3,532,267,125,51,15,990,1,17,1008
5,4,5030,873,3,261,287,93,33,14,688,2,10,700
5,4,5030,874,3,178,170,39,24,1,412,1,7,420
5,4,5030,876,3,229,257,86,23,11,606,5,15,626
5,4,5030,877,3,279,230,53,30,9,601,2,3,606
5,4,5030,879,3,178,180,71,31,10,470,0,10,480
5,4,5030,894,3,165,172,44,14,4,399,2,9,410
5,4,5030,895,3,172,298,79,27,7,583,6,12,601
5,4,5030,896,3,227,247,64,33,13,584,1,7,592
5,4,5030,897,3,344,304,77,39,11,775,2,12,789
5,4,5030,898,3,331,228,70,44,16,689,3,11,703
5,4,5030,899,3,284,241,83,36,14,658,0,6,664
5,4,5030,900,3,149,165,29,10,6,359,0,14,373
5,4,5030,901,3,176,141,46,22,10,395,0,4,399
5,4,5030,902,3,349,383,84,36,18,870,0,14,884
5,4,5030,903,3,183,348,55,24,23,633,3,18,654
5,4,5030,904,3,202,327,74,21,12,636,4,19,659
5,4,5030,905,3,638,820,221,71,35,1785,11,34,1830
5,4,5030,906,3,245,369,102,33,18,767,2,15,784
5,4,5030,907,3,516,2090,676,94,38,3414,18,91,3523
5,4,5030,908,3,112,426,62,16,8,624,0,24,648
5,4,5030,909,3,209,485,81,32,13,820,2,25,847
5,4,5030,910,3,180,253,55,26,15,529,2,13,544
5,4,5030,911,3,270,326,105,42,21,764,4,16,784
5,4,5030,912,3,356,284,86,42,15,783,2,3,788
5,4,5030,913,3,321,279,91,44,14,749,0,13,762
5,4,5030,914,3,274,280,61,40,14,669,0,13,682
5,4,5030,915,3,227,267,75,28,6,603,5,11,619
5,4,5030,916,3,165,228,53,23,10,479,1,5,485
5,4,5030,917,3,153,229,66,23,9,480,1,12,493
5,4,5030,918,3,164,226,52,23,9,474,2,16,492
5,4,5030,931,3,224,260,78,19,17,598,0,17,615
5,4,5030,932,3,250,402,93,38,13,796,2,21,819
5,4,5030,933,3,189,297,110,27,7,630,3,9,642
5,4,5030,934,3,261,333,64,23,10,691,5,12,708
5,4,5030,935,3,159,301,78,23,16,577,4,23,604
5,4,5030,936,3,273,397,103,45,19,837,1,7,845
5,4,5030,937,3,288,334,78,41,10,751,4,15,770
5,4,5030,938,3,190,516,61,29,14,810,4,12,826
5,4,5030,939,3,206,267,51,28,8,560,3,17,580
5,4,5030,940,3,185,261,56,29,7,538,1,11,550
5,4,5030,941,3,251,337,76,33,13,710,0,18,728
5,4,5030,942,3,216,352,86,19,11,684,3,12,699
5,4,5030,943,3,864,1328,245,124,59,2620,12,38,2670
5,4,5030,944,3,64,250,37,9,3,363,3,11,377
5,4,5030,945,3,88,275,173,2,1,539,0,5,544
5,4,5030,946,3,149,455,121,22,9,756,15,32,803
5,4,5030,947,3,187,259,48,19,9,522,2,12,536
5,4,5030,948,3,156,247,66,31,6,506,4,8,518
5,4,5030,949,3,538,792,200,101,38,1669,2,45,1716
5,4,5030,950,3,249,588,96,34,20,987,5,43,1035
5,4,5030,951,3,110,211,64,22,13,420,0,12,432
5,4,5030,952,3,447,739,85,55,18,1344,9,16,1369
5,4,5030,953,3,273,389,93,29,13,797,2,19,818
5,4,5030,954,3,300,310,91,43,12,756,1,10,767
5,4,5030,955,3,217,293,73,28,10,621,1,13,635
5,4,5030,956,3,275,332,99,35,23,764,4,15,783
5,4,5030,957,3,278,389,93,65,19,844,2,8,854
5,4,5030,958,3,333,341,106,70,19,869,3,18,890
5,4,5030,959,3,222,366,67,18,18,691,0,22,713
5,4,5030,960,3,198,262,42,26,10,538,3,6,547
5,4,5030,961,3,237,458,130,36,15,876,2,16,894
5,4,5030,962,3,192,243,66,24,10,535,2,16,553
5,4,5030,963,3,232,379,97,34,12,754,3,7,764
5,4,5030,964,3,192,306,96,36,14,644,1,23,668
5,4,5030,972,3,367,434,72,48,21,942,1,26,969
5,4,5030,973,3,280,474,133,35,25,947,0,19,966
5,4,5030,974,3,305,476,114,49,25,969,5,18,992
5,4,5030,975,3,226,361,74,33,14,708,2,9,719
5,4,5030,976,3,642,255,145,19,26,1087,2,6,1095
5,4,5030,977,3,529,547,155,66,42,1339,0,17,1356
5,4,5030,978,3,383,406,97,49,23,958,6,18,982
5,4,5030,979,3,263,608,101,40,32,1044,8,47,1099
5,4,5030,980,3,200,469,83,46,20,818,3,16,837
5,4,5030,981,3,273,636,137,50,19,1115,0,14,1129
5,4,5030,982,3,252,343,79,36,23,733,3,8,744
5,4,5030,983,3,238,375,88,52,20,773,0,9,782
5,4,5030,984,3,272,349,125,43,6,795,4,19,818
5,4,5030,985,3,289,515,134,48,33,1019,4,32,1055
5,4,5030,986,3,241,418,121,34,19,833,2,12,847
5,4,5030,988,3,477,234,79,25,10,825,0,5,830
5,4,5030,989,3,196,345,67,23,20,651,0,18,669
5,4,5030,990,3,396,433,109,53,18,1009,1,17,1027
5,4,5030,991,3,217,276,61,46,14,614,0,6,620
5,4,5030,992,3,1172,2046,431,165,60,3874,13,53,3940
5,4,5030,993,3,913,1599,340,141,57,3050,18,72,3140
5,4,5030,994,3,299,881,157,49,21,1407,12,30,1449
5,4,5030,995,3,244,258,80,36,14,632,0,11,643
5,4,5030,996,3,225,271,76,42,16,630,0,7,637
5,4,5030,997,3,174,202,58,21,6,461,2,3,466
5,4,5030,998,3,171,257,69,22,6,525,0,9,534
5,4,5030,999,3,125,177,56,22,7,387,1,4,392
5,4,5030,1005,3,71,93,21,7,2,194,3,4,201
5,4,5030,1006,3,192,333,83,25,6,639,0,12,651
5,4,5030,1012,3,11,53,6,2,3,75,0,3,78
5,4,5030,1013,3,29,47,23,4,1,104,0,2,106
5,4,5030,1014,3,108,253,59,6,1,427,3,14,444
5,4,5030,1015,3,18,95,15,1,1,130,1,10,141
5,4,5030,1016,3,16,90,4,2,1,113,0,6,119
5,4,5030,1021,3,10,55,4,4,0,73,1,6,80
5,4,5030,1022,3,30,54,4,2,0,90,0,0,90
5,4,5030,1026,3,30,67,8,3,1,109,0,2,111
5,4,5030,1027,3,34,32,4,17,0,87,0,2,89
5,4,5030,1028,3,4,50,2,8,0,64,0,8,72
5,4,5030,1029,3,39,53,29,0,1,122,0,8,130
5,4,5030,1033,3,32,58,9,3,0,102,0,11,113
5,4,5030,1034,3,15,45,6,0,0,66,0,2,68
5,4,5030,1036,3,30,62,11,2,0,105,0,2,107
5,4,5030,1037,3,9,24,0,1,0,34,0,1,35
5,4,5030,1038,3,27,90,13,7,1,138,0,4,142
5,4,5030,1039,3,72,103,29,9,0,213,0,8,221
5,5,5017,257,3,199,194,148,7,3,551,5,12,568
5,5,5017,258,3,237,308,181,38,7,771,11,20,802
5,5,5017,259,3,221,261,165,20,9,676,2,13,691
5,5,5017,260,3,355,340,209,20,15,939,9,37,985
5,5,5017,261,3,283,354,170,12,11,830,1,17,848
5,5,5017,262,3,300,403,189,21,11,924,0,22,946
5,5,5017,263,3,234,416,169,21,15,855,0,20,875
5,5,5017,264,3,233,253,161,14,10,671,0,23,694
5,5,5017,265,3,350,538,187,26,7,1108,3,25,1136
5,5,5017,266,3,214,437,151,13,7,822,0,7,829
5,5,5017,267,3,225,332,100,14,6,677,1,14,692
5,5,5017,268,3,179,234,107,11,8,539,4,24,567
5,5,5017,269,3,392,483,328,22,10,1235,8,34,1277
5,5,5017,270,3,194,214,110,5,3,526,0,16,542
5,5,5017,271,3,339,430,204,20,9,1002,3,23,1028
5,5,5017,272,3,308,397,183,8,19,915,8,39,962
5,5,5017,273,3,193,305,157,7,15,677,1,13,691
5,5,5017,274,3,235,308,190,14,15,762,2,25,789
5,5,5017,275,3,143,205,95,13,10,466,6,4,476
5,5,5017,276,3,176,323,91,7,9,606,4,9,619
5,5,5017,277,3,145,148,70,8,6,377,0,17,394
5,5,5017,278,3,31,139,174,4,7,355,4,12,371
5,5,5017,279,3,49,242,149,21,3,464,2,15,481
5,5,5017,280,3,194,268,333,16,5,816,3,13,832
5,5,5017,281,3,49,96,73,15,1,234,2,9,245
5,5,5017,282,3,59,165,221,11,6,462,3,11,476
5,5,5017,283,3,61,260,273,9,4,607,3,13,623
5,5,5017,284,3,138,251,313,10,7,719,7,25,751
5,5,5017,285,3,125,238,279,14,5,661,2,20,683
5,5,5017,286,3,127,310,200,10,6,653,2,17,672
5,5,5017,287,3,163,450,206,14,8,841,0,26,867
5,5,5017,288,3,189,500,233,10,10,942,1,19,962
5,5,5017,289,3,72,166,236,9,1,484,0,0,484
5,5,5017,290,3,107,275,435,25,7,849,0,26,875
5,5,5017,291,3,74,319,371,22,2,788,1,18,807
5,5,5017,292,3,101,132,69,11,4,317,0,13,330
5,5,5017,293,3,121,213,258,7,3,602,0,14,616
5,5,5017,294,3,113,183,165,9,3,473,2,15,490
5,5,5017,295,3,82,115,79,5,2,283,0,7,290
5,5,5017,296,3,95,206,160,3,6,470,0,9,479
5,5,5017,297,3,159,197,359,21,6,742,3,18,763
5,5,5017,298,3,101,154,194,6,4,459,3,7,469
5,5,5017,299,3,39,150,50,0,1,240,2,10,252
5,5,5017,300,3,72,97,69,5,6,249,0,2,251
5,5,5017,301,3,77,88,90,8,3,266,0,9,275
5,5,5017,302,3,90,122,111,8,4,335,3,10,348
5,5,5017,303,3,176,145,87,3,2,413,0,14,427
5,5,5017,304,3,184,165,136,3,7,495,4,20,519
5,5,5017,305,3,293,325,347,19,19,1003,6,26,1035
5,5,5017,306,3,186,269,161,10,11,637,2,18,657
5,5,5017,307,3,117,233,109,11,4,474,5,15,494
5,5,5017,308,3,105,173,76,4,4,362,2,16,380
5,5,5017,309,3,40,145,48,2,1,236,0,4,240
5,5,5017,310,3,214,188,84,10,7,503,2,11,516
5,5,5017,311,3,75,154,31,2,2,264,1,3,268
5,5,5017,312,3,229,310,140,12,8,699,3,14,716
5,5,5017,313,3,82,134,20,4,4,244,2,3,249
5,5,5017,314,3,89,178,22,6,6,301,5,14,320
5,5,5017,315,3,42,107,3,5,3,160,0,0,160
5,5,5017,316,3,7,82,13,3,1,106,0,4,110
5,5,5017,317,3,46,69,14,2,2,133,1,2,136
5,5,5017,318,3,146,146,82,13,6,393,3,12,408
5,5,5024,542,3,250,364,186,36,21,857,0,12,869
5,5,5024,543,3,405,367,160,50,12,994,2,22,1018
5,5,5024,544,3,159,183,123,39,20,524,1,10,535
5,5,5024,545,3,195,199,202,37,15,648,6,6,660
5,5,5024,546,3,126,122,137,15,8,408,1,10,419
5,5,5024,547,3,171,256,100,27,14,568,3,16,587
5,5,5024,548,3,107,152,107,29,12,407,2,15,424
5,5,5024,549,3,210,292,122,31,13,668,9,9,686
5,5,5024,550,3,224,303,153,45,25,750,2,21,773
5,5,5024,551,3,230,239,86,32,11,598,1,6,605
5,5,5024,552,3,85,115,75,5,5,285,0,7,292
5,5,5024,553,3,143,129,89,17,13,391,1,7,399
5,5,5024,554,3,210,223,103,35,16,587,1,15,603
5,5,5024,555,3,136,190,56,17,8,407,1,6,414
5,5,5024,556,3,171,140,64,29,6,410,0,9,419
5,5,5024,557,3,279,374,170,41,12,876,5,25,906
5,5,5024,558,3,177,240,131,32,8,588,1,22,611
5,5,5024,559,3,123,202,67,17,3,412,0,15,427
5,5,5024,560,3,25,45,43,1,1,115,0,2,117
5,5,5024,561,3,3,34,9,0,0,46,0,5,51
5,5,5024,562,3,23,46,46,0,0,115,0,4,119
5,5,5024,563,3,21,32,33,0,0,86,4,0,90
5,5,5024,564,3,34,55,30,0,0,119,3,3,125
5,5,5024,565,3,57,153,30,5,1,246,2,8,256
5,5,5024,566,3,46,126,25,0,1,198,0,12,210
5,5,5024,567,3,116,174,71,9,4,374,4,13,391
5,5,5024,568,3,27,91,14,5,1,138,2,8,148
5,5,5024,569,3,99,148,31,5,5,288,0,14,302
5,5,5024,570,3,17,73,3,1,0,94,0,0,94
5,5,5024,571,3,79,194,17,2,2,294,1,6,301
5,5,5024,573,3,34,98,7,0,1,140,1,5,146
5,5,5024,574,3,26,67,18,2,2,115,0,4,119
5,5,5024,575,3,55,83,20,0,1,159,0,11,170
5,5,5024,576,3,7,38,5,0,0,50,0,1,51
5,5,5035,1215,3,724,189,91,22,22,1048,0,6,1054
5,5,5035,1218,3,843,158,105,26,21,1153,1,10,1164
5,5,5035,1219,3,664,80,52,4,10,810,0,7,817
5,5,5035,1225,3,303,170,61,17,8,559,1,11,571
5,5,5035,1226,3,233,101,59,13,17,423,0,4,427
5,5,5035,1227,3,760,124,77,17,19,997,0,7,1004
5,5,5035,1228,3,688,111,84,18,17,918,1,3,922
5,5,5035,1229,3,239,170,75,11,10,505,1,7,513
5,5,5035,1230,3,243,137,114,14,11,519,3,5,527
5,5,5035,1231,3,221,107,69,6,7,410,3,9,422
5,5,5035,1232,3,577,123,78,18,10,806,0,4,810
5,5,5035,1233,3,578,131,115,32,13,869,1,9,879
5,5,5035,1234,3,342,131,79,14,13,579,1,4,584
5,5,5035,1235,3,279,103,94,13,7,496,0,4,500
5,5,5035,1236,3,285,85,71,11,12,464,0,3,467
5,5,5035,1240,3,300,149,125,18,16,608,0,8,616
5,5,5035,1241,3,362,110,84,10,12,578,0,6,584
5,5,5035,1242,3,385,111,96,18,14,624,11,12,647
5,5,5035,1243,3,274,92,67,9,13,455,2,6,463
5,5,5035,1244,3,240,91,52,15,17,415,0,8,423
5,5,5035,1245,3,296,108,98,14,28,544,5,9,558
5,5,5035,1246,3,237,112,92,20,8,469,1,3,473
5,5,5035,1247,3,408,210,102,20,10,750,2,8,760
5,5,5035,1248,3,368,208,152,21,15,764,2,16,782
5,5,5035,1249,3,319,123,78,8,7,535,0,6,541
5,5,5035,1250,3,272,124,81,8,7,492,1,7,500
5,5,5035,1251,3,160,94,95,6,4,359,1,5,365
5,5,5035,1252,3,245,176,90,16,7,534,4,4,542
5,5,5035,1253,3,304,167,134,15,12,632,3,10,645
5,5,5035,1254,3,403,182,133,26,15,759,0,9,768
5,5,5035,1255,3,274,103,88,11,6,482,0,5,487
5,5,5035,1256,3,231,125,71,16,23,466,2,6,474
5,5,5035,1257,3,362,238,159,25,17,801,2,10,813
5,5,5035,1258,3,313,247,161,30,9,760,1,10,771
5,5,5035,1259,3,428,196,172,30,7,833,2,16,851
5,5,5035,1260,3,36,24,15,1,2,78,0,2,80
5,5,5035,1261,3,415,317,139,24,16,911,4,11,926
5,5,5035,1262,3,180,163,89,11,3,446,0,7,453
5,5,5035,1263,3,216,157,100,6,2,481,1,15,497
5,5,5035,1264,3,304,306,142,28,11,791,6,14,811
5,5,5035,1265,3,207,156,83,18,5,469,2,5,476
5,5,5035,1266,3,408,292,208,24,6,938,1,18,957
5,5,5035,1267,3,308,243,176,14,12,753,0,6,759
5,5,5035,1268,3,184,81,77,14,12,368,0,4,372
5,5,5035,1269,3,230,146,118,15,9,518,6,3,527
5,5,5035,1270,3,151,208,83,16,5,463,5,7,475
5,5,5035,1271,3,301,256,129,22,10,718,4,17,739
5,5,5035,1272,3,205,259,161,4,5,634,2,10,646
5,5,5035,1273,3,296,140,109,18,13,576,6,2,584
5,5,5035,1274,3,269,185,98,12,17,581,0,15,596
5,5,5035,1275,3,303,188,144,24,10,669,3,15,687
5,5,5035,1276,3,251,229,165,19,10,674,5,9,688
5,5,5035,1277,3,284,261,164,15,9,733,3,14,750
5,5,5035,1278,3,186,209,100,5,8,508,2,15,525
5,5,5035,1279,3,164,145,85,13,5,412,1,5,418
5,5,5035,1280,3,134,134,70,5,7,350,0,7,357
5,5,5035,1281,3,122,106,70,4,4,306,0,6,312
5,5,5035,1282,3,186,131,85,10,7,419,2,11,432
5,5,5035,1283,3,331,197,143,19,11,701,10,15,726
5,5,5035,1284,3,128,157,59,11,5,360,2,9,371
5,5,5035,1285,3,270,191,109,17,8,595,1,14,610
5,5,5035,1286,3,184,125,62,4,4,379,3,3,385
5,5,5035,1287,3,213,178,132,13,11,547,2,10,559
5,5,5035,1288,3,49,107,47,7,1,211,1,4,216
5,5,5035,1289,3,108,155,62,5,5,335,6,2,343
5,5,5035,1290,3,142,113,59,10,5,329,0,7,336
5,5,5035,1291,3,220,214,134,12,9,589,2,13,604
5,5,5035,1292,3,135,153,125,8,9,430,2,7,439
5,5,5035,1293,3,123,154,54,5,4,340,5,10,355
5,5,5035,1294,3,105,309,94,5,3,516,0,15,531
5,5,5035,1295,3,144,215,57,14,6,436,0,12,448
5,5,5035,1296,3,182,220,66,7,4,479,1,6,486
5,5,5035,1297,3,126,166,66,9,6,373,0,0,373
5,5,5035,1298,3,201,179,93,9,4,486,7,11,504
5,5,5035,1299,3,136,146,113,10,3,408,1,14,423
5,5,5035,1300,3,169,196,123,22,8,518,0,4,522
5,5,5035,1301,3,205,161,113,7,3,489,0,4,493
5,5,5035,1302,3,170,158,112,18,3,461,0,8,469
5,5,5035,1303,3,134,188,41,7,7,377,0,6,383
5,5,5035,1304,3,117,148,40,3,3,311,0,10,321
5,5,5035,1305,3,56,109,40,6,4,215,2,4,221
5,5,5035,1306,3,178,160,97,13,11,459,5,7,471
5,5,5035,1307,3,148,195,115,23,2,483,3,9,495
5,5,5035,1308,3,171,158,92,23,4,448,0,14,462
5,5,5035,1309,3,189,327,147,17,3,683,7,8,698
5,5,5035,1410,3,316,276,181,27,14,814,6,14,834
5,5,5035,1411,3,1821,1845,1095,128,68,4957,35,70,5062
5,5,5035,1412,3,270,208,152,27,9,666,4,14,684
5,5,5035,1413,3,474,181,87,27,20,789,0,6,795
5,5,5035,1414,3,525,212,134,28,18,917,5,7,929
5,5,5035,1415,3,418,194,105,26,8,751,3,13,767
5,5,5035,1416,3,417,189,110,19,12,747,1,7,755
5,5,5035,1417,3,476,159,88,17,14,754,1,7,762
5,5,5035,1418,3,527,171,123,25,11,857,1,9,867
5,5,5035,1419,3,378,142,106,16,18,660,2,3,665
5,5,5035,1420,3,557,126,105,24,8,820,0,13,833
5,5,5035,1421,3,344,160,102,22,15,643,0,7,650
5,5,5035,1422,3,442,159,92,20,9,722,1,5,728
5,5,5035,1423,3,542,188,104,17,16,867,0,6,873
5,5,5035,1424,3,373,143,127,11,14,668,5,6,679
5,5,5035,1425,3,340,209,146,15,15,725,2,14,741
5,5,5035,1426,3,212,218,154,15,13,612,1,21,634
5,5,5035,1427,3,290,233,221,11,11,766,1,16,783
5,5,5035,1428,3,326,152,147,22,9,656,3,16,675
5,5,5035,1429,3,279,208,142,17,13,659,5,6,670
5,5,5035,1430,3,373,233,187,32,18,843,6,17,866
5,5,5035,1431,3,424,415,229,21,19,1108,10,31,1149
5,5,5035,1432,3,258,237,136,19,10,660,0,313,973
5,5,5035,1433,3,330,230,148,19,15,742,0,16,758
5,5,5035,1434,3,358,153,109,21,15,656,0,18,674
5,5,5035,1435,3,241,155,87,19,7,509,1,13,523
5,5,5035,1436,3,48,34,14,1,1,98,0,0,98
5,5,5035,1437,3,186,147,89,15,7,444,1,17,462
5,5,5035,1438,3,299,185,109,15,7,615,5,11,631
5,5,5035,1439,3,215,234,126,25,10,610,5,6,621
5,5,5035,1440,3,193,156,100,17,10,476,0,7,483
5,5,5035,1441,3,194,106,124,7,8,439,1,0,440
5,5,5035,1442,3,354,257,129,15,11,766,5,16,787
5,5,5035,1443,3,179,168,75,7,5,434,2,12,448
5,5,5035,1444,3,147,200,160,10,12,529,2,22,553
5,5,5035,1445,3,404,343,248,36,19,1050,7,40,1097
5,5,5035,1446,3,259,305,153,22,13,752,9,19,780
5,5,5035,1447,3,212,173,96,14,10,505,0,14,519
5,5,5035,1448,3,267,140,96,28,7,538,5,4,547
5,5,5035,1449,3,269,287,179,17,17,769,1,17,787
5,5,5035,1450,3,260,181,92,19,9,561,1,7,569
5,5,5035,1451,3,433,223,155,10,22,843,8,10,861
5,5,5035,1452,3,323,207,100,24,11,665,6,15,686
5,5,5035,1453,3,287,234,113,23,16,673,1,8,682
5,5,5035,1454,3,297,159,137,22,10,625,4,3,632
5,5,5035,1455,3,293,185,123,15,12,628,3,9,640
5,5,5035,1456,3,526,397,288,40,22,1273,9,8,1290
5,5,5035,1457,3,133,118,50,6,2,309,3,8,320
5,5,5035,1458,3,95,105,68,13,5,286,0,13,299
5,5,5035,1459,3,304,253,253,20,8,838,4,31,873
5,5,5035,1468,3,186,229,61,12,4,492,1,20,513
5,5,5035,1469,3,387,377,229,22,19,1034,10,33,1077
5,5,5035,1470,3,187,240,130,4,2,563,2,23,588
5,5,5035,1471,3,41,104,66,2,4,217,0,6,223
5,5,5035,1472,3,49,79,80,0,1,209,2,1,212
5,5,5035,1473,3,44,146,68,3,0,261,0,10,271
5,5,5035,1474,3,27,63,14,0,0,104,0,4,108
5,5,5036,1475,3,198,366,59,4,4,631,5,11,647
5,5,5036,1476,3,277,390,46,8,2,723,4,6,733
5,5,5036,1477,3,19,112,59,0,1,191,0,4,195
5,5,5036,1478,3,82,186,42,5,3,318,0,9,327
5,5,5036,1479,3,72,274,45,3,5,399,6,10,415
5,5,5036,1480,3,18,140,19,0,3,180,0,2,182
5,5,5036,1481,3,56,137,25,2,1,221,2,2,225
5,5,5036,1482,3,10,136,43,0,0,189,0,8,197
5,5,5036,1483,3,19,86,78,4,0,187,1,3,191
5,5,5036,1484,3,29,245,208,2,0,484,0,4,488
5,5,5036,1485,3,44,192,133,5,2,376,4,9,389
5,5,5036,1486,3,24,106,43,0,0,173,0,0,173
5,5,5036,1488,3,28,39,11,0,0,78,0,1,79
5,5,5036,1489,3,38,200,54,1,2,295,0,17,312
5,5,5036,1490,3,178,305,106,5,7,601,0,25,626
5,5,5036,1491,3,93,312,230,7,9,651,3,15,669
5,5,5036,1492,3,88,180,270,6,5,549,1,10,560
5,5,5036,1493,3,19,200,127,6,2,354,2,3,359
5,5,5036,1494,3,2,78,2,0,0,82,0,0,82
5,5,5036,1495,3,1,48,6,1,0,56,2,2,60
5,5,5036,1496,3,27,52,18,0,0,97,0,1,98
5,5,5036,1497,3,30,139,20,0,0,189,2,11,202
5,6,5035,1172,3,191,146,86,11,4,438,2,11,451
5,6,5035,1173,3,227,272,137,13,8,657,4,17,678
5,6,5035,1174,3,111,134,72,2,1,320,1,14,335
5,6,5035,1175,3,168,146,110,10,2,436,4,15,455
5,6,5035,1176,3,329,251,138,22,8,748,3,15,766
5,6,5035,1177,3,380,256,124,23,13,796,2,22,820
5,6,5035,1178,3,203,220,86,9,3,521,1,7,529
5,6,5035,1179,3,180,378,186,10,4,758,6,6,770
5,6,5035,1180,3,657,420,329,32,19,1457,8,27,1492
5,6,5035,1181,3,315,171,108,22,10,626,0,5,631
5,6,5035,1182,3,287,159,106,56,14,622,1,5,628
5,6,5035,1183,3,601,165,59,15,9,849,0,3,852
5,6,5035,1184,3,701,427,304,68,26,1526,4,15,1545
5,6,5035,1185,3,367,187,164,23,9,750,1,18,769
5,6,5035,1186,3,157,123,141,13,8,442,4,12,458
5,6,5035,1187,3,582,174,86,16,17,875,0,3,878
5,6,5035,1188,3,486,176,75,21,16,774,1,4,779
5,6,5035,1189,3,392,291,125,24,18,850,0,3,853
5,6,5035,1190,3,348,315,144,30,7,844,1,14,859
5,6,5035,1191,3,345,182,96,17,11,651,0,4,655
5,6,5035,1192,3,451,213,110,19,16,809,3,5,817
5,6,5035,1193,3,718,212,165,57,16,1168,1,10,1179
5,6,5035,1194,3,532,219,134,43,9,937,0,9,946
5,6,5035,1195,3,515,221,152,20,19,927,0,12,939
5,6,5035,1196,3,480,244,153,14,10,901,0,14,915
5,6,5035,1197,3,541,256,155,29,20,1001,5,18,1024
5,6,5035,1198,3,340,279,208,21,23,871,1,11,883
5,6,5035,1199,3,428,248,88,20,11,795,1,5,801
5,6,5035,1200,3,808,192,65,14,8,1087,0,2,1089
5,6,5035,1201,3,502,196,117,14,12,841,2,10,853
5,6,5035,1202,3,299,209,187,13,12,720,0,11,731
5,6,5035,1203,3,417,172,152,17,12,770,0,7,777
5,6,5035,1204,3,708,142,85,20,15,970,0,8,978
5,6,5035,1205,3,618,174,95,12,9,908,0,3,911
5,6,5035,1206,3,656,179,76,18,18,947,0,10,957
5,6,5035,1207,3,828,231,37,12,11,1119,0,5,1124
5,6,5035,1208,3,396,212,140,21,11,780,2,3,785
5,6,5035,1209,3,579,262,173,50,17,1081,1,14,1096
5,6,5035,1210,3,604,294,129,39,22,1088,1,12,1101
5,6,5035,1211,3,258,164,104,15,12,553,0,4,557
5,6,5035,1212,3,285,127,89,17,6,524,1,9,534
5,6,5035,1213,3,562,243,180,29,11,1025,0,8,1033
5,6,5035,1214,3,700,324,137,27,19,1207,1,8,1216
5,6,5035,1216,3,333,163,81,20,9,606,4,9,619
5,6,5035,1217,3,393,82,53,8,10,546,3,0,549
5,6,5035,1220,3,449,216,118,24,10,817,0,9,826
5,6,5035,1221,3,383,221,111,15,11,741,0,11,752
5,6,5035,1222,3,403,178,116,28,12,737,2,12,751
5,6,5035,1223,3,312,194,97,18,8,629,4,3,636
5,6,5035,1224,3,402,236,104,9,15,766,2,17,785
5,6,5035,1237,3,288,96,79,16,13,492,2,7,501
5,6,5035,1238,3,233,103,87,11,5,439,2,5,446
5,6,5035,1239,3,329,119,71,16,13,548,0,10,558
5,6,5035,1310,3,838,457,291,61,31,1678,2,10,1690
5,6,5035,1311,3,300,268,156,21,13,758,1,9,768
5,6,5035,1312,3,364,192,148,25,10,739,3,15,757
5,6,5035,1313,3,146,216,165,16,7,550,4,29,583
5,6,5035,1314,3,430,381,235,23,28,1097,1,22,1120
5,6,5035,1315,3,371,200,145,18,11,745,4,19,768
5,6,5035,1316,3,304,183,116,19,6,628,0,10,638
5,6,5035,1317,3,408,228,150,26,7,819,2,13,834
5,6,5035,1318,3,324,217,164,10,15,730,0,12,742
5,6,5035,1319,3,273,202,177,17,8,677,1,8,686
5,6,5035,1320,3,511,356,425,40,20,1352,2,17,1371
5,6,5035,1321,3,157,191,64,7,10,429,0,7,436
5,6,5035,1322,3,383,281,229,30,11,934,3,24,961
5,6,5035,1323,3,316,292,188,23,11,830,2,17,849
5,6,5035,1324,3,259,246,134,20,7,666,3,8,677
5,6,5035,1325,3,269,226,131,14,15,655,0,8,663
5,6,5035,1326,3,336,253,123,17,10,739,2,11,752
5,6,5035,1327,3,235,247,203,28,10,723,2,14,739
5,6,5035,1328,3,333,189,146,26,11,705,0,6,711
5,6,5035,1329,3,293,332,196,18,10,849,9,27,885
5,6,5035,1330,3,320,206,168,26,9,729,2,10,741
5,6,5035,1331,3,357,151,132,13,8,661,1,9,671
5,6,5035,1332,3,360,230,122,26,23,761,1,7,769
5,6,5035,1333,3,393,199,117,10,14,733,0,6,739
5,6,5035,1334,3,346,144,105,22,9,626,0,9,635
5,6,5035,1335,3,186,114,74,11,5,390,1,3,394
5,6,5035,1336,3,363,253,141,10,16,783,2,9,794
5,6,5035,1337,3,266,169,127,22,11,595,0,11,606
5,6,5035,1338,3,357,169,174,17,21,738,4,18,760
5,6,5035,1339,3,404,174,172,19,12,781,0,17,798
5,6,5035,1340,3,326,246,123,15,8,718,2,10,730
5,6,5035,1341,3,247,226,163,19,13,668,0,20,688
5,6,5035,1342,3,256,217,154,20,10,657,4,14,675
5,6,5035,1343,3,283,367,182,20,7,859,1,7,867
5,6,5035,1344,3,147,262,112,3,6,530,0,6,536
5,6,5035,1345,3,266,270,142,9,8,695,0,19,714
5,6,5035,1346,3,273,276,154,19,4,726,5,4,735
5,6,5035,1347,3,201,267,108,8,8,592,1,16,609
5,6,5035,1348,3,312,228,141,18,9,708,0,10,718
5,6,5035,1349,3,323,196,187,18,14,738,3,9,750
5,6,5035,1350,3,2878,1254,863,219,96,5310,5,48,5363
5,6,5035,1351,3,2188,1121,701,166,71,4247,11,33,4291
5,6,5035,1352,3,132,217,73,12,14,448,1,18,467
5,6,5035,1353,3,272,277,138,18,9,714,2,13,729
5,6,5035,1354,3,1321,970,504,108,48,2951,4,34,2989
5,6,5035,1355,3,419,215,125,27,25,811,1,9,821
5,6,5035,1356,3,373,201,72,20,6,672,7,12,691
5,6,5035,1357,3,287,189,67,14,16,573,0,3,576
5,6,5035,1358,3,327,237,108,20,13,705,2,13,720
5,6,5035,1359,3,408,255,160,19,8,850,2,8,860
5,6,5035,1360,3,2825,1052,706,145,84,4812,7,53,4872
5,6,5035,1361,3,463,275,212,46,15,1011,5,21,1037
5,6,5035,1362,3,512,232,136,33,18,931,4,12,947
5,6,5035,1363,3,345,246,137,21,9,758,2,20,780
5,6,5035,1364,3,369,180,102,28,18,697,8,4,709
5,6,5035,1365,3,1590,1052,621,132,56,3451,5,59,3515
5,6,5035,1366,3,442,177,107,18,3,747,1,10,758
5,6,5035,1367,3,564,254,127,19,11,975,2,12,989
5,6,5035,1368,3,460,198,172,24,14,868,3,8,879
5,6,5035,1369,3,358,211,93,21,13,696,2,12,710
5,6,5035,1370,3,247,79,57,8,6,397,1,6,404
5,6,5035,1371,3,279,149,86,20,10,544,2,4,550
5,6,5035,1372,3,284,145,75,12,9,525,0,5,530
5,6,5035,1373,3,355,149,100,17,5,626,0,19,645
5,6,5035,1374,3,464,168,132,41,14,819,4,15,838
5,6,5035,1375,3,334,163,128,28,10,663,6,5,674
5,6,5035,1376,3,478,130,88,30,14,740,1,5,746
5,6,5035,1377,3,531,224,134,28,9,926,1,8,935
5,6,5035,1378,3,341,162,134,19,15,671,0,14,685
5,6,5035,1379,3,293,109,93,25,6,526,0,3,529
5,6,5035,1380,3,646,175,124,21,20,986,3,4,993
5,6,5035,1381,3,449,159,78,12,6,704,2,7,713
5,6,5035,1382,3,1193,474,337,76,30,2110,5,32,2147
5,6,5035,1383,3,322,251,195,21,11,800,1,17,818
5,6,5035,1384,3,655,363,184,40,18,1260,3,11,1274
5,6,5035,1385,3,245,113,108,23,8,497,3,9,509
5,6,5035,1386,3,320,225,114,27,10,696,2,10,708
5,6,5035,1387,3,213,180,129,11,10,543,1,15,559
5,6,5035,1388,3,1248,388,225,66,28,1955,0,18,1973
5,6,5035,1389,3,270,174,107,22,10,583,0,4,587
5,6,5035,1390,3,395,260,148,61,9,873,0,8,881
5,6,5035,1391,3,728,249,71,13,15,1076,1,4,1081
5,6,5035,1392,3,601,199,61,16,17,894,1,2,897
5,6,5035,1393,3,725,226,64,14,22,1051,1,3,1055
5,6,5035,1394,3,262,99,69,20,9,459,0,2,461
5,6,5035,1395,3,648,207,74,13,20,962,0,12,974
5,6,5035,1396,3,186,95,61,22,4,368,0,4,372
5,6,5035,1397,3,358,222,113,24,6,723,1,11,735
5,6,5035,1398,3,683,203,148,28,16,1078,1,15,1094
5,6,5035,1399,3,571,192,113,37,11,924,0,13,937
5,6,5035,1400,3,508,154,57,7,9,735,0,5,740
5,6,5035,1401,3,579,147,73,13,8,820,1,11,832
5,6,5035,1402,3,732,218,88,14,15,1067,1,3,1071
5,6,5035,1403,3,775,249,39,10,15,1088,3,8,1099
5,6,5035,1404,3,522,152,84,21,12,791,0,12,803
5,6,5035,1405,3,558,131,85,30,11,815,0,6,821
5,6,5035,1406,3,752,213,85,24,14,1088,0,3,1091
5,6,5035,1407,3,998,311,185,50,24,1568,1,8,1577
5,6,5035,1408,3,546,173,118,34,13,884,0,2,886
5,6,5035,1460,3,335,282,168,38,3,826,4,13,843
5,6,5035,1461,3,330,240,166,47,10,793,6,16,815
5,6,5035,1462,3,432,336,243,13,15,1039,9,22,1070
5,6,5035,1463,3,309,250,312,16,7,894,3,27,924
5,6,5035,1464,3,254,222,271,14,11,772,13,15,800
5,6,5035,1465,3,317,297,134,11,7,766,1,12,779
5,6,5035,1466,3,223,195,99,16,3,536,3,19,558
5,6,5035,1467,3,324,345,191,13,8,881,0,27,908
5,6,5035,1521,3,286,83,40,6,7,422,1,0,423
5,6,5035,1522,3,89,114,63,7,6,279,1,7,287
5,6,5035,1523,3,281,90,45,11,4,431,0,1,432
5,6,5035,1524,3,210,40,34,14,3,301,0,0,301
5,6,5035,1525,3,147,74,42,7,12,282,0,3,285
5,6,5035,1526,3,269,115,55,11,3,453,1,3,457
5,6,5035,1527,3,133,128,58,15,2,336,0,3,339
5,6,5035,1528,3,224,85,61,11,5,386,0,5,391
5,6,5035,1529,3,173,94,72,14,4,357,0,15,372
5,6,5035,1530,3,206,151,82,8,12,459,0,5,464
5,6,5035,1531,3,185,104,39,15,6,349,2,2,353
5,6,5035,1532,3,223,88,54,18,2,385,1,2,388
5,6,5035,1533,3,212,122,58,6,9,407,0,4,411
5,6,5035,1534,3,158,101,69,16,1,345,0,5,350
5,6,5035,1535,3,215,104,60,8,7,394,1,7,402
5,6,5035,1536,3,124,94,34,9,2,263,1,4,268
5,6,5035,1537,3,193,98,75,9,8,383,1,5,389
5,6,5035,1538,3,172,98,75,9,5,359,0,2,361
5,6,5035,1539,3,40,47,21,9,1,118,0,0,118
5,6,5035,1540,3,230,107,85,11,4,437,2,4,443
5,6,5035,1541,3,123,77,58,7,3,268,2,2,272
5,6,5035,1542,3,158,82,64,5,4,313,0,2,315
5,6,5035,1543,3,162,70,70,9,5,316,5,0,321
5,6,5035,1544,3,87,46,24,7,4,168,0,1,169
5,6,5035,1545,3,128,59,35,4,1,227,0,5,232
5,6,5035,1546,3,52,36,34,7,1,130,0,2,132
5,6,5035,1547,3,201,98,80,7,7,393,1,5,399
5,7,5030,730,3,678,243,76,32,11,1040,1,11,1052
5,7,5030,731,3,987,521,137,46,14,1705,6,21,1732
5,7,5030,732,3,591,179,82,48,15,915,1,12,928
5,7,5030,733,3,822,345,112,44,28,1351,2,9,1362
5,7,5030,734,3,1228,445,134,46,16,1869,3,22,1894
5,7,5030,735,3,316,217,61,13,7,614,1,4,619
5,7,5030,736,3,405,259,120,33,16,833,2,23,858
5,7,5030,737,3,380,423,120,38,17,978,3,24,1005
5,7,5030,738,3,436,722,129,38,19,1344,8,32,1384
5,7,5030,739,3,333,256,73,47,19,728,1,23,752
5,7,5030,740,3,875,315,114,36,21,1361,1,17,1379
5,7,5030,741,3,426,156,62,26,9,679,0,2,681
5,7,5030,742,3,549,342,96,51,19,1057,1,17,1075
5,7,5030,743,3,569,283,111,41,20,1024,1,15,1040
5,7,5030,744,3,418,311,145,49,27,950,0,26,976
5,7,5030,745,3,454,245,118,42,16,875,0,9,884
5,7,5030,746,3,408,333,99,41,18,899,4,17,920
5,7,5030,747,3,267,270,83,33,14,667,2,13,682
5,7,5030,748,3,372,352,85,42,13,864,0,21,885
5,7,5030,749,3,415,142,72,34,13,676,2,2,680
5,7,5030,750,3,657,274,79,31,11,1052,0,11,1063
5,7,5030,751,3,1293,498,200,77,40,2108,2,16,2126
5,7,5030,752,3,2005,843,227,160,63,3298,7,41,3346
5,7,5030,753,3,597,220,100,59,10,986,1,11,998
5,7,5030,758,3,466,259,92,39,11,867,1,13,881
5,7,5030,759,3,773,337,115,73,24,1322,4,8,1334
5,7,5030,760,3,299,156,43,30,5,533,1,6,540
5,7,5030,761,3,398,225,78,46,10,757,0,10,767
5,7,5030,762,3,447,207,76,25,14,769,1,5,775
5,7,5030,763,3,589,299,118,49,12,1067,8,20,1095
5,7,5030,764,3,712,289,101,47,13,1162,2,15,1179
5,7,5030,765,3,367,229,65,36,13,710,2,8,720
5,7,5030,766,3,788,709,182,89,44,1812,4,26,1842
5,7,5030,767,3,329,180,64,40,4,617,0,5,622
5,7,5030,768,3,646,535,148,55,33,1417,16,15,1448
5,7,5030,769,3,315,253,63,27,12,670,3,14,687
5,7,5030,770,3,235,192,33,20,5,485,7,6,498
5,7,5030,771,3,265,319,178,40,14,816,3,26,845
5,7,5030,772,3,350,203,44,24,7,628,1,8,637
5,7,5030,773,3,457,170,38,14,6,685,0,6,691
5,7,5030,774,3,461,236,80,37,12,826,3,12,841
5,7,5030,775,3,402,214,94,26,16,752,1,6,759
5,7,5030,778,3,503,243,92,47,14,899,0,16,915
5,7,5030,779,3,562,256,85,48,22,973,0,7,980
5,7,5030,780,3,381,238,68,34,20,741,3,5,749
5,7,5030,781,3,499,217,72,26,12,826,0,10,836
5,7,5030,782,3,424,180,68,31,10,713,0,14,727
5,7,5030,783,3,427,287,139,49,13,915,1,9,925
5,7,5030,784,3,433,169,63,37,12,714,0,3,717
5,7,5030,785,3,344,159,58,22,6,589,0,7,596
5,7,5030,786,3,449,166,95,37,14,761,0,14,775
5,7,5030,787,3,278,319,84,27,11,719,0,27,746
5,7,5030,788,3,208,312,117,17,10,664,6,20,690
5,7,5030,789,3,275,284,56,26,10,651,1,10,662
5,7,5030,790,3,294,389,83,21,11,798,9,26,833
5,7,5030,791,3,366,195,79,29,12,681,3,10,694
5,7,5030,792,3,437,357,87,54,16,951,3,21,975
5,7,5030,793,3,321,239,47,26,10,643,6,6,655
5,7,5030,794,3,232,296,152,23,11,714,7,24,745
5,7,5030,795,3,426,404,103,50,17,1000,4,10,1014
5,7,5030,796,3,717,364,159,51,16,1307,1,14,1322
5,7,5030,797,3,363,160,49,15,13,600,0,4,604
5,7,5030,798,3,458,203,68,28,7,764,1,3,768
5,7,5030,799,3,354,161,49,36,7,607,3,4,614
5,7,5030,802,3,243,133,43,18,6,443,0,5,448
5,7,5030,803,3,259,247,68,24,19,617,2,7,626
5,7,5030,804,3,328,259,66,29,5,687,0,21,708
5,7,5030,805,3,296,245,68,27,12,648,1,15,664
5,7,5030,806,3,198,139,42,19,6,404,0,7,411
5,7,5030,807,3,347,218,65,40,19,689,4,15,708
5,7,5030,808,3,366,181,91,34,10,682,0,16,698
5,7,5030,809,3,211,164,61,32,16,484,0,15,499
5,7,5030,810,3,412,141,59,19,9,640,0,3,643
5,7,5030,811,3,291,163,41,13,8,516,1,10,527
5,7,5030,812,3,327,271,82,26,10,716,2,20,738
5,7,5030,813,3,262,239,71,23,12,607,2,11,620
5,7,5030,814,3,296,390,104,21,15,826,2,11,839
5,7,5030,815,3,241,253,71,19,5,589,2,20,611
5,7,5030,816,3,745,677,171,76,36,1705,3,21,1729
5,7,5030,817,3,230,371,130,26,13,770,8,20,798
5,7,5030,818,3,200,370,92,27,11,700,6,24,730
5,7,5030,819,3,283,320,92,44,12,751,3,21,775
5,7,5030,820,3,247,278,71,22,19,637,10,4,651
5,7,5030,821,3,237,247,70,45,11,610,1,4,615
5,7,5030,822,3,212,230,62,20,6,530,5,12,547
5,7,5030,823,3,232,206,58,28,12,536,2,10,548
5,7,5030,824,3,166,166,56,23,7,418,1,10,429
5,7,5030,825,3,160,203,77,18,6,464,2,9,475
5,7,5030,826,3,257,167,54,32,4,514,0,8,522
5,7,5030,827,3,304,145,64,32,9,554,1,11,566
5,7,5030,828,3,315,227,80,44,14,680,4,10,694
5,7,5030,829,3,528,379,107,56,15,1085,1,16,1102
5,7,5030,839,3,305,149,83,30,13,580,1,6,587
5,7,5030,841,3,268,144,71,14,8,505,1,5,511
5,7,5030,842,3,214,131,49,17,10,421,0,7,428
5,7,5030,843,3,250,138,67,27,9,491,1,6,498
5,7,5030,844,3,228,115,55,22,8,428,1,5,434
5,7,5030,845,3,210,126,56,24,3,419,2,7,428
5,7,5030,846,3,237,161,56,35,8,497,1,5,503
5,7,5030,847,3,405,258,106,76,12,857,0,19,876
5,7,5030,848,3,352,132,65,27,10,586,0,14,600
5,7,5030,849,3,88,162,43,21,9,323,3,7,333
5,7,5030,850,3,411,360,74,27,18,890,0,22,912
5,7,5030,851,3,342,258,99,45,11,755,4,11,770
5,7,5030,852,3,201,403,96,21,6,727,5,12,744
5,7,5030,853,3,289,332,81,29,18,749,7,15,771
5,7,5030,854,3,404,273,80,49,21,827,4,15,846
5,7,5030,855,3,440,218,91,45,11,805,5,7,817
5,7,5030,856,3,390,242,80,53,20,785,6,15,806
5,7,5030,857,3,342,199,60,27,16,644,0,0,644
5,7,5030,858,3,257,132,52,29,12,482,2,7,491
5,7,5030,859,3,294,161,63,31,8,557,1,7,565
5,7,5030,860,3,256,200,80,28,10,574,3,9,586
5,7,5030,861,3,258,127,85,27,7,504,1,6,511
5,7,5030,875,3,291,150,57,29,9,536,0,11,547
5,7,5030,878,3,198,119,38,27,8,390,0,7,397
5,7,5030,880,3,278,225,75,56,12,646,1,25,672
5,7,5030,881,3,195,144,63,36,10,448,2,9,459
5,7,5030,882,3,231,219,73,20,16,559,3,10,572
5,7,5030,883,3,325,419,113,39,17,913,0,27,940
5,7,5030,884,3,300,232,89,25,12,658,4,17,679
5,7,5030,885,3,202,278,60,38,11,589,7,19,615
5,7,5030,886,3,292,334,103,28,13,770,3,15,788
5,7,5030,887,3,266,295,79,26,34,700,5,21,726
5,7,5030,888,3,313,352,109,41,13,828,1,20,849
5,7,5030,889,3,211,300,84,21,12,628,1,18,647
5,7,5030,890,3,220,250,63,23,5,561,5,20,586
5,7,5030,891,3,290,191,71,27,1,580,4,16,600
5,7,5030,892,3,233,151,66,27,4,481,3,10,494
5,7,5030,893,3,353,206,77,46,18,700,0,15,715
5,7,5030,919,3,436,226,99,46,7,814,2,15,831
5,7,5030,920,3,254,212,66,25,9,566,3,10,579
5,7,5030,921,3,247,290,79,43,13,672,9,19,700
5,7,5030,922,3,306,293,86,29,11,725,2,24,751
5,7,5030,923,3,204,406,79,24,9,722,2,32,756
5,7,5030,924,3,180,244,53,19,12,508,5,5,518
5,7,5030,925,3,214,306,55,25,12,612,5,9,626
5,7,5030,926,3,163,323,70,10,6,572,9,14,595
5,7,5030,927,3,196,335,57,26,9,623,8,20,651
5,7,5030,928,3,186,309,56,21,8,580,11,13,604
5,7,5030,929,3,296,268,76,27,14,681,1,18,700
5,7,5030,930,3,311,368,103,37,15,834,2,29,865
5,7,5030,965,3,290,308,69,33,7,707,6,14,727
5,7,5030,966,3,406,238,67,31,14,756,10,28,794
5,7,5030,967,3,246,443,80,27,11,807,10,22,839
5,7,5030,968,3,197,251,55,12,2,517,4,9,530
5,7,5030,969,3,266,464,75,30,18,853,1,34,888
5,7,5030,970,3,863,950,242,91,38,2184,6,66,2256
5,7,5030,971,3,405,311,98,37,22,873,2,17,892
5,7,5030,987,3,442,744,158,34,33,1411,8,51,1470
5,7,5030,1000,3,1,99,9,1,0,110,0,4,114
5,7,5030,1001,3,11,87,38,0,0,136,1,5,142
5,7,5030,1002,3,43,81,24,3,3,154,0,5,159
5,7,5030,1003,3,29,31,3,0,0,63,0,2,65
5,7,5030,1004,3,22,95,20,2,1,140,0,6,146
5,7,5030,1007,3,21,91,32,3,0,147,0,5,152
5,7,5030,1008,3,59,77,16,1,0,153,0,0,153
5,7,5030,1009,3,47,144,91,14,2,298,0,18,316
5,7,5030,1010,3,30,77,29,0,2,138,0,7,145
5,7,5030,1011,3,169,224,112,14,6,525,2,26,553
5,7,5030,1017,3,1,52,5,0,0,58,0,2,60
5,7,5030,1018,3,13,23,5,0,1,42,0,0,42
5,7,5030,1019,3,8,73,27,2,0,110,0,4,114
5,7,5030,1020,3,22,19,5,2,0,48,0,0,48
5,7,5030,1023,3,32,69,37,2,4,144,0,6,150
5,7,5030,1024,3,8,47,7,1,1,64,0,1,65
5,7,5030,1025,3,12,67,27,0,0,106,0,8,114
5,7,5030,1030,3,17,58,16,1,0,92,1,2,95
5,7,5030,1031,3,18,150,43,1,1,213,0,4,217
5,7,5030,1032,3,10,45,13,0,0,68,0,5,73
5,7,5030,1035,3,2,57,12,1,0,72,0,2,74
6,1,6001,1,3,967,655,296,51,19,1988,0,22,2010
6,1,6001,2,3,237,182,58,10,3,490,0,5,495
6,1,6001,3,3,526,384,182,22,6,1120,2,14,1136
6,1,6001,4,3,302,211,80,16,7,616,1,3,620
6,1,6001,5,3,229,166,60,8,4,467,0,3,470
6,1,6001,6,3,535,312,127,22,10,1006,0,3,1009
6,1,6001,7,3,268,268,81,17,7,641,1,12,654
6,1,6001,8,3,337,400,143,24,5,909,0,11,920
6,1,6001,9,3,345,276,96,25,6,748,0,16,764
6,1,6001,10,3,301,357,109,19,10,796,0,9,805
6,1,6001,11,3,271,191,80,16,4,562,0,4,566
6,1,6001,12,3,224,151,60,15,7,457,0,5,462
6,1,6001,13,3,476,285,127,11,9,908,0,6,914
6,1,6001,14,3,262,237,98,24,5,626,0,12,638
6,1,6001,15,3,168,163,65,9,2,407,2,5,414
6,1,6001,16,3,206,194,74,15,6,495,0,7,502
6,1,6001,17,3,226,257,90,13,4,590,0,9,599
6,1,6001,18,3,325,271,118,21,7,742,1,13,756
6,1,6001,19,3,340,357,122,28,2,849,0,8,857
6,1,6001,20,3,384,301,116,22,7,830,1,10,841
6,1,6001,21,3,404,351,147,16,9,927,0,10,937
6,1,6001,22,3,211,217,93,15,9,545,0,8,553
6,1,6001,23,3,319,248,107,7,5,686,1,23,710
6,1,6001,24,3,562,494,277,24,13,1370,2,41,1413
6,1,6001,25,3,353,240,89,16,7,705,0,9,714
6,1,6001,26,3,293,282,89,14,1,679,1,1,681
6,1,6001,27,3,278,199,108,17,10,612,0,8,620
6,1,6001,28,3,176,175,76,17,5,449,0,4,453
6,1,6001,29,3,264,241,113,10,4,632,1,9,642
6,1,6001,30,3,192,151,50,14,5,412,0,3,415
6,1,6001,31,3,357,315,79,21,5,777,0,22,799
6,1,6001,32,3,355,396,116,18,3,888,0,23,911
6,1,6001,33,3,451,450,168,29,10,1108,0,5,1113
6,1,6001,34,3,341,426,137,46,8,958,0,7,965
6,1,6001,35,3,315,361,136,13,7,832,1,17,850
6,1,6001,36,3,270,278,129,13,4,694,1,16,711
6,1,6001,37,3,319,342,224,17,11,913,3,19,935
6,1,6001,38,3,280,220,89,16,2,607,0,13,620
6,1,6001,39,3,140,184,60,15,2,401,0,11,412
6,1,6001,40,3,172,196,67,10,3,448,1,4,453
6,1,6001,41,3,179,128,57,12,3,379,0,1,380
6,1,6001,42,3,200,217,67,7,1,492,0,6,498
6,1,6001,43,3,305,341,96,23,7,772,0,13,785
6,1,6001,44,3,186,203,105,10,6,510,1,4,515
6,1,6001,45,3,565,445,167,25,10,1212,0,15,1227
6,1,6001,46,3,302,292,110,13,5,722,0,4,726
6,1,6001,47,3,419,331,141,26,11,928,1,10,939
6,1,6001,48,3,356,280,125,34,9,804,0,8,812
6,1,6001,49,3,95,132,51,11,2,291,0,3,294
6,1,6001,50,3,303,257,120,16,4,700,1,14,715
6,1,6001,51,3,296,216,95,9,6,622,0,13,635
6,1,6001,52,3,545,588,149,28,7,1317,0,15,1332
6,1,6001,53,3,476,390,134,21,12,1033,0,15,1048
6,1,6001,54,3,455,366,133,19,11,984,0,10,994
6,1,6001,55,3,232,374,114,19,4,743,1,9,753
6,1,6001,56,3,148,153,62,7,2,372,0,1,373
6,1,6001,57,3,236,212,73,8,3,532,2,8,542
6,1,6001,58,3,305,254,106,8,7,680,0,10,690
6,1,6001,59,3,310,276,134,31,4,755,1,22,778
6,1,6001,60,3,835,767,343,50,15,2010,1,38,2049
6,1,6001,61,3,315,290,125,15,8,753,2,21,776
6,1,6001,62,3,775,925,269,41,11,2021,3,37,2061
6,1,6001,63,3,287,272,129,14,3,705,1,11,717
6,1,6001,64,3,428,265,141,22,6,862,2,17,881
6,1,6001,65,3,324,251,110,23,12,720,0,10,730
6,1,6001,66,3,319,319,138,32,9,817,1,17,835
6,1,6001,67,3,288,292,193,34,17,824,5,9,838
6,1,6001,68,3,436,388,135,21,6,986,0,18,1004
6,1,6001,69,3,341,216,103,17,11,688,2,11,701
6,1,6001,70,3,446,350,109,15,11,931,2,16,949
6,1,6001,71,3,237,237,88,14,2,578,2,17,597
6,1,6001,72,3,189,193,81,8,4,475,1,10,486
6,1,6001,73,3,368,321,128,28,9,854,0,13,867
6,1,6001,74,3,366,319,134,14,5,838,0,19,857
6,1,6001,75,3,219,235,111,11,6,582,1,9,592
6,1,6001,76,3,174,216,51,8,4,453,0,14,467
6,1,6001,77,3,152,160,42,1,1,356,1,4,361
6,1,6001,78,3,47,20,16,0,0,83,0,0,83
6,1,6001,79,3,307,306,115,14,3,745,2,17,764
6,1,6001,80,3,184,147,80,8,3,422,0,5,427
6,1,6001,81,3,498,417,122,21,5,1063,1,5,1069
6,1,6001,82,3,371,493,166,16,4,1050,3,31,1084
6,1,6001,83,3,112,123,44,4,4,287,0,4,291
6,1,6001,84,3,133,482,104,3,3,725,0,30,755
6,1,6001,85,3,247,253,52,6,2,560,0,24,584
6,1,6001,86,3,124,105,30,4,0,263,0,4,267
6,1,6001,87,3,158,187,64,14,2,425,0,18,443
6,1,6001,88,3,169,251,43,2,1,466,0,8,474
6,1,6001,89,3,107,248,26,4,0,385,0,14,399
6,1,6001,90,3,48,171,14,0,1,234,0,19,253
6,1,6001,91,3,85,169,38,1,0,293,0,5,298
6,1,6002,92,3,572,412,98,14,8,1104,1,14,1119
6,1,6002,93,3,438,394,86,8,8,934,1,9,944
6,1,6002,94,3,466,399,80,16,5,966,1,19,986
6,1,6002,95,3,520,321,60,7,6,914,1,25,940
6,1,6002,96,3,406,385,89,10,4,894,0,13,907
6,1,6002,97,3,104,53,16,0,0,173,2,5,180
6,1,6002,98,3,37,16,15,1,0,69,0,3,72
6,1,6002,99,3,152,185,32,5,0,374,0,9,383
6,1,6002,100,3,399,311,72,8,5,795,0,25,820
6,1,6002,101,3,269,532,28,2,4,835,1,25,861
6,1,6002,102,3,170,101,47,1,1,320,0,12,332
6,1,6002,103,3,271,609,59,11,2,952,2,13,967
6,1,6002,104,3,328,456,61,6,4,855,0,17,872
6,1,6003,105,3,297,473,46,23,7,846,1,20,867
6,1,6003,106,3,445,475,86,18,4,1028,2,32,1062
6,1,6003,107,3,431,399,88,23,5,946,3,2,951
6,1,6003,108,3,366,310,35,10,0,721,2,11,734
6,1,6003,109,3,274,297,70,9,3,653,1,10,664
6,1,6003,110,3,246,266,49,13,1,575,0,17,592
6,1,6003,111,3,443,511,62,16,4,1036,1,18,1055
6,1,6003,112,3,61,116,31,1,0,209,0,2,211
6,1,6003,113,3,47,146,15,1,1,210,1,2,213
6,1,6003,114,3,56,38,17,3,1,115,0,1,116
6,1,6003,115,3,58,87,10,3,1,159,0,6,165
6,1,6003,116,3,308,325,45,6,0,684,2,27,713
6,1,6003,117,3,188,242,26,10,1,467,1,13,481
6,1,6003,118,3,71,191,39,5,2,308,0,15,323
6,1,6003,119,3,54,181,33,5,0,273,0,18,291
6,1,6004,120,3,331,349,345,12,6,1043,0,37,1080
6,1,6004,121,3,204,167,218,17,11,617,0,33,650
6,1,6004,122,3,203,191,188,11,6,599,1,24,624
6,1,6004,123,3,281,255,261,2,6,805,0,32,837
6,1,6004,124,3,214,319,250,15,6,804,0,31,835
6,1,6004,125,3,179,265,136,7,3,590,2,25,617
6,1,6004,126,3,254,358,209,15,5,841,3,23,867
6,1,6004,127,3,191,248,188,12,7,646,0,13,659
6,1,6004,128,3,158,225,139,15,4,541,0,23,564
6,1,6004,129,3,167,271,177,9,1,625,2,26,653
6,1,6004,130,3,196,309,179,18,8,710,1,21,732
6,1,6004,131,3,250,269,152,7,3,681,0,24,705
6,1,6004,132,3,236,524,137,11,2,910,0,22,932
6,1,6004,133,3,86,217,134,3,0,440,1,20,461
6,1,6004,134,3,272,411,175,14,3,875,0,17,892
6,1,6004,135,3,243,347,166,14,1,771,0,21,792
6,1,6004,136,3,141,86,44,7,0,278,1,22,301
6,1,6004,137,3,102,148,234,2,2,488,0,20,508
6,1,6005,138,3,702,887,261,34,10,1894,3,48,1945
6,1,6005,139,3,1352,1117,538,73,30,3110,0,30,3140
6,1,6005,140,3,687,574,221,31,23,1536,8,22,1566
6,1,6005,141,3,316,229,78,15,6,644,0,2,646
6,1,6005,142,3,273,240,80,16,8,617,0,8,625
6,1,6005,143,3,295,319,88,23,6,731,1,15,747
6,1,6005,144,3,472,434,190,31,9,1136,0,10,1146
6,1,6005,145,3,1166,1207,451,119,29,2972,0,36,3008
6,1,6005,146,3,260,178,110,11,6,565,0,8,573
6,1,6005,147,3,669,454,189,26,10,1348,0,28,1376
6,1,6005,148,3,585,483,192,32,10,1302,0,25,1327
6,1,6005,149,3,451,301,155,42,5,954,2,23,979
6,1,6005,150,3,344,221,92,18,8,683,1,24,708
6,1,6005,151,3,316,245,84,13,2,660,0,9,669
6,1,6005,152,3,500,422,174,18,12,1126,0,19,1145
6,1,6005,153,3,300,280,108,21,9,718,1,18,737
6,1,6005,154,3,300,201,104,13,3,621,2,13,636
6,1,6005,155,3,390,392,111,13,5,911,0,9,920
6,1,6005,156,3,251,227,103,10,7,598,0,4,602
6,1,6005,157,3,302,266,80,11,13,672,0,16,688
6,1,6005,158,3,260,143,62,17,5,487,0,7,494
6,1,6005,159,3,553,460,160,36,15,1224,0,18,1242
6,1,6005,160,3,446,476,165,31,9,1127,0,24,1151
6,1,6005,161,3,688,705,295,62,17,1767,1,20,1788
6,1,6005,162,3,379,264,107,19,8,777,0,3,780
6,1,6005,163,3,3090,2839,1022,226,66,7243,7,66,7316
6,1,6005,164,3,526,491,149,25,12,1203,2,17,1222
6,1,6005,165,3,397,300,107,21,6,831,1,6,838
6,1,6005,166,3,48,106,16,2,0,172,0,7,179
6,1,6005,167,3,95,202,31,5,0,333,0,15,348
6,1,6005,168,3,72,122,28,1,1,224,0,8,232
6,1,6005,169,3,68,54,12,5,3,142,0,7,149
6,1,6007,191,3,194,344,206,5,8,757,1,61,819
6,1,6007,192,3,126,331,189,10,3,659,0,30,689
6,1,6007,193,3,27,145,49,3,1,225,0,9,234
6,1,6007,194,3,15,147,33,4,1,200,0,13,213
6,1,6007,195,3,70,103,97,1,1,272,0,22,294
6,1,6007,196,3,65,55,53,2,0,175,0,25,200
6,1,6007,197,3,64,41,15,1,1,122,0,12,134
6,1,6007,198,3,8,36,9,1,0,54,0,2,56
6,1,6007,199,3,36,226,56,4,0,322,0,16,338
6,2,6006,170,3,239,263,173,18,1,694,0,11,705
6,2,6006,171,3,335,238,177,24,3,777,0,20,797
6,2,6006,172,3,174,185,94,19,0,472,0,2,474
6,2,6006,173,3,272,297,130,23,2,724,2,20,746
6,2,6006,174,3,254,214,107,8,0,583,1,6,590
6,2,6006,175,3,170,176,61,16,3,426,0,2,428
6,2,6006,176,3,194,248,122,12,2,578,0,10,588
6,2,6006,177,3,217,275,137,18,1,648,1,21,670
6,2,6006,178,3,225,180,147,24,3,579,0,14,593
6,2,6006,179,3,152,173,128,15,1,469,0,15,484
6,2,6006,180,3,164,183,77,18,4,446,1,18,465
6,2,6006,181,3,114,209,112,3,1,439,0,15,454
6,2,6006,182,3,96,209,116,3,1,425,0,9,434
6,2,6006,183,3,151,150,87,7,0,395,1,10,406
6,2,6006,184,3,73,107,54,6,2,242,0,13,255
6,2,6006,185,3,83,147,115,16,0,361,0,15,376
6,2,6006,186,3,139,250,147,18,3,557,0,22,579
6,2,6006,187,3,130,224,166,6,2,528,3,1,532
6,2,6006,188,3,146,240,179,10,2,577,1,24,602
6,2,6006,189,3,76,84,29,7,1,197,1,6,204
6,2,6006,190,3,73,160,40,5,1,279,1,5,285
6,2,6008,200,3,373,133,32,5,2,545,0,3,548
6,2,6008,201,3,78,51,10,5,1,145,0,1,146
6,2,6008,202,3,808,315,108,48,7,1286,3,16,1305
6,2,6008,203,3,474,201,56,17,4,752,0,16,768
6,2,6008,204,3,503,200,73,13,5,794,1,24,819
6,2,6008,205,3,293,167,59,15,3,537,1,10,548
6,2,6008,206,3,532,279,65,16,5,897,0,18,915
6,2,6008,207,3,294,142,24,10,1,471,0,6,477
6,2,6008,208,3,382,221,33,12,4,652,1,7,660
6,2,6008,209,3,500,317,33,12,2,864,2,13,879
6,2,6008,210,3,408,262,58,12,6,746,3,11,760
6,2,6008,211,3,518,296,81,19,6,920,1,31,952
6,2,6008,212,3,327,150,21,15,1,514,1,12,527
6,2,6008,213,3,469,266,58,11,7,811,1,18,830
6,2,6008,214,3,500,262,70,15,6,853,0,23,876
6,2,6008,215,3,443,260,94,19,5,821,2,28,851
6,2,6008,216,3,459,224,106,8,9,806,1,22,829
6,2,6008,217,3,448,189,37,19,6,699,0,21,720
6,2,6008,218,3,309,129,50,12,3,503,0,9,512
6,2,6008,219,3,433,279,45,22,2,781,0,15,796
6,2,6008,220,3,332,134,19,16,3,504,0,6,510
6,2,6008,221,3,380,283,40,14,4,721,1,20,742
6,2,6008,222,3,150,120,21,2,1,294,0,7,301
6,2,6008,223,3,185,181,26,3,3,398,0,11,409
6,2,6008,224,3,146,67,14,3,1,231,0,9,240
6,2,6008,225,3,322,179,18,3,2,524,0,21,545
6,2,6008,226,3,349,188,31,6,4,578,2,18,598
6,2,6008,227,3,231,133,22,2,1,389,2,14,405
6,2,6008,228,3,563,284,40,8,4,899,0,15,914
6,2,6008,229,3,68,25,18,4,0,115,1,2,118
6,2,6008,230,3,637,392,78,16,4,1127,2,22,1151
6,2,6008,231,3,111,96,7,1,0,215,0,2,217
6,2,6008,232,3,268,199,41,10,2,520,0,12,532
6,2,6008,233,3,456,256,73,20,4,809,0,17,826
6,2,6008,234,3,572,280,43,11,8,914,1,23,938
6,2,6008,235,3,295,165,58,12,5,535,1,20,556
6,2,6008,236,3,1093,624,195,36,13,1961,3,62,2026
6,2,6008,237,3,644,227,181,19,5,1076,0,8,1084
6,2,6008,238,3,1746,759,258,87,26,2876,10,39,2925
6,2,6008,239,3,321,181,31,15,10,558,0,7,565
6,2,6008,240,3,490,298,45,17,12,862,0,9,871
6,2,6008,241,3,390,217,63,19,5,694,0,20,714
6,2,6008,242,3,173,88,13,7,1,282,1,0,283
6,2,6008,243,3,476,305,73,15,4,873,1,34,908
6,2,6008,244,3,614,286,70,25,4,999,1,18,1018
6,2,6008,245,3,639,294,86,23,6,1048,1,26,1075
6,2,6008,246,3,709,297,76,20,6,1108,0,16,1124
6,2,6008,247,3,62,21,8,3,1,95,0,0,95
6,2,6008,248,3,1289,375,171,73,15,1923,2,8,1933
6,2,6008,249,3,256,157,27,14,2,456,0,6,462
6,2,6008,250,3,2604,1275,365,186,49,4479,5,61,4545
6,2,6008,251,3,1118,709,171,67,37,2102,0,30,2132
6,2,6008,252,3,498,228,54,40,4,824,0,11,835
6,2,6008,253,3,499,232,60,13,11,815,5,16,836
6,2,6008,254,3,246,117,23,8,6,400,0,6,406
6,2,6008,255,3,138,64,21,3,5,231,1,4,236
6,2,6008,256,3,422,305,161,20,23,931,3,9,943
6,2,6008,257,3,364,192,41,17,8,622,0,8,630
6,2,6008,258,3,948,525,99,31,10,1613,0,36,1649
6,2,6008,259,3,379,226,87,4,7,703,0,20,723
6,2,6008,260,3,721,387,108,26,7,1249,2,37,1288
6,2,6008,261,3,471,273,96,15,7,862,0,20,882
6,2,6008,262,3,389,269,39,9,2,708,1,18,727
6,2,6008,263,3,250,157,37,9,4,457,0,10,467
6,2,6008,264,3,284,211,48,11,1,555,3,10,568
6,2,6008,265,3,176,85,13,2,1,277,0,5,282
6,2,6008,266,3,210,132,19,5,1,367,0,7,374
6,2,6008,267,3,423,334,88,13,4,862,4,18,884
6,2,6008,268,3,371,120,38,2,5,536,0,4,540
6,2,6008,269,3,514,345,64,24,7,954,0,17,971
6,2,6009,270,3,374,220,104,28,2,728,0,35,763
6,2,6009,271,3,265,280,103,23,2,673,0,22,695
6,2,6009,272,3,249,229,88,22,2,590,3,29,622
6,2,6009,273,3,60,276,37,8,3,384,0,20,404
6,2,6009,274,3,59,132,26,2,2,221,0,9,230
6,2,6009,275,3,200,170,61,32,3,466,4,8,478
6,2,6009,276,3,252,176,14,7,2,451,0,17,468
6,2,6010,277,3,514,551,174,26,8,1273,1,38,1312
6,2,6010,278,3,256,272,83,15,5,631,0,21,652
6,2,6010,279,3,135,139,53,13,2,342,2,10,354
6,2,6010,280,3,834,857,241,44,10,1986,6,46,2038
6,2,6010,281,3,336,248,64,19,3,670,0,14,684
6,2,6010,282,3,552,444,111,25,6,1138,3,30,1171
6,2,6010,283,3,519,443,95,18,0,1075,0,18,1093
6,2,6010,284,3,227,181,46,4,1,459,0,8,467
6,2,6010,285,3,183,207,38,15,1,444,1,9,454
6,2,6010,286,3,244,244,38,16,3,545,0,4,549
6,2,6010,287,3,181,189,29,6,2,407,0,6,413
6,2,6010,288,3,167,198,22,4,1,392,1,10,403
6,2,6010,289,3,293,262,58,17,3,633,0,16,649
6,2,6010,290,3,568,572,77,84,7,1308,0,17,1325
6,2,6010,291,3,511,482,136,17,2,1148,5,35,1188
6,2,6010,292,3,282,285,60,7,2,636,0,17,653
6,2,6010,293,3,243,233,56,14,4,550,2,14,566
6,2,6010,294,3,200,180,19,5,1,405,0,5,410
6,2,6010,295,3,219,302,46,12,0,579,0,7,586
6,2,6010,296,3,214,246,43,15,2,520,0,18,538
6,2,6010,297,3,345,418,82,38,19,902,0,24,926
6,2,6010,298,3,286,292,47,10,7,642,0,14,656
6,2,6010,299,3,279,271,54,17,1,622,1,13,636
6,2,6010,300,3,226,288,42,9,4,569,0,7,576
6,2,6010,301,3,229,355,48,13,3,648,0,5,653
6,2,6010,302,3,200,443,42,14,4,703,0,14,717
6,2,6010,303,3,244,229,44,13,2,532,0,13,545
6,2,6010,304,3,251,258,55,10,5,579,0,13,592
6,2,6010,305,3,314,424,71,8,3,820,0,21,841
6,2,6010,306,3,216,250,38,9,1,514,0,20,534
6,2,6010,307,3,222,267,43,15,2,549,1,11,561
6,2,6010,308,3,297,280,65,8,2,652,3,23,678
6,2,6010,309,3,212,261,32,18,2,525,2,5,532
6,2,6010,310,3,227,258,35,12,0,532,1,15,548
6,2,6010,311,3,408,462,75,27,3,975,1,27,1003
6,2,6010,312,3,633,681,165,30,11,1520,1,51,1572
6,2,6010,313,3,293,248,46,16,3,606,0,16,622
6,2,6010,314,3,286,248,43,35,0,612,0,16,628
6,2,6010,315,3,364,397,61,15,3,840,2,19,861
6,2,6010,316,3,434,488,161,25,4,1112,2,39,1153
6,2,6010,317,3,128,271,69,4,1,473,0,12,485
6,2,6010,318,3,100,212,124,4,0,440,0,25,465
6,2,6010,319,3,132,242,111,8,0,493,2,17,512
6,2,6010,320,3,207,206,22,10,0,445,0,13,458
6,2,6010,321,3,335,323,133,17,2,810,1,19,830
6,2,6010,322,3,111,97,28,4,5,245,0,3,248
6,2,6010,323,3,100,127,33,8,1,269,0,13,282
6,2,6010,324,3,225,312,59,14,6,616,2,20,638
6,2,6010,325,3,164,133,26,4,0,327,0,8,335
6,2,6010,326,3,185,157,38,9,0,389,1,11,401
6,2,6010,327,3,45,61,8,2,0,116,0,3,119
6,2,6010,328,3,89,135,81,3,1,309,0,10,319
6,2,6010,329,3,289,417,129,15,4,854,0,23,877
6,2,6010,330,3,41,34,5,4,0,84,0,2,86
6,2,6010,331,3,39,49,18,0,0,106,0,4,110
6,2,6010,332,3,103,44,9,0,0,156,0,8,164
6,2,6010,333,3,67,90,4,4,0,165,0,0,165
6,2,6010,334,3,276,208,120,14,4,622,0,17,639
6,2,6010,335,3,247,286,150,5,1,689,0,27,716
6,2,6010,336,3,244,377,160,2,3,786,1,33,820
7,1,7016,186,3,51,192,221,12,54,530,1,4,535
7,1,7016,187,3,61,318,484,17,112,992,0,34,1026
7,1,7016,188,3,81,433,248,1,0,763,1,44,808
7,1,7016,189,3,58,202,129,1,2,392,0,16,408
7,1,7016,190,3,12,131,125,1,1,270,0,10,280
7,1,7016,191,3,13,72,201,4,0,290,0,12,302
7,1,7016,192,3,53,306,281,7,11,658,0,18,676
7,1,7016,193,3,56,414,652,21,5,1148,0,37,1185
7,1,7016,194,3,61,381,374,3,7,826,0,38,864
7,1,7016,195,3,16,72,221,1,3,313,1,14,328
7,1,7016,196,3,16,126,128,1,2,273,0,9,282
7,1,7031,456,3,47,492,294,6,2,841,1,40,882
7,1,7031,457,3,89,519,283,6,8,905,2,36,943
7,1,7031,458,3,26,573,372,1,0,972,2,32,1006
7,1,7031,459,3,28,292,379,0,0,699,0,38,737
7,1,7031,460,3,56,129,183,1,1,370,0,15,385
7,1,7031,461,3,13,404,478,0,1,896,0,17,913
7,1,7031,462,3,13,608,564,2,1,1188,0,31,1219
7,1,7031,463,3,27,298,406,10,0,741,0,43,784
7,1,7031,464,3,14,360,518,1,3,896,0,57,953
7,1,7031,465,3,23,261,428,1,3,716,0,24,740
7,1,7031,466,3,42,432,380,1,3,858,0,48,906
7,1,7031,467,3,9,262,314,1,1,587,1,24,612
7,1,7031,468,3,17,241,279,1,3,541,1,13,555
7,1,7031,469,3,23,288,335,0,8,654,1,23,678
7,1,7031,470,3,5,209,396,3,3,616,0,38,654
7,1,7031,471,3,39,471,585,1,4,1100,1,53,1154
7,1,7031,472,3,14,156,273,0,0,443,0,23,466
7,1,7031,473,3,11,400,634,0,1,1046,0,60,1106
7,1,7031,474,3,35,135,131,0,0,301,0,10,311
7,1,7031,475,3,22,237,280,2,3,544,1,23,568
7,1,7031,476,3,90,320,268,0,2,680,0,18,698
7,1,7031,477,3,9,397,389,0,2,797,0,39,836
7,1,7031,478,3,37,588,407,3,4,1039,1,43,1083
7,1,7031,479,3,14,178,387,0,0,579,0,39,618
7,1,7031,480,3,8,210,392,0,2,612,0,22,634
7,1,7031,481,3,37,743,398,2,1,1181,0,42,1223
7,1,7031,482,3,19,482,330,0,0,831,1,54,886
7,1,7031,483,3,17,231,206,3,0,457,3,23,483
7,1,7031,484,3,60,269,279,8,7,623,1,30,654
7,1,7031,485,3,48,274,240,3,4,569,0,28,597
7,1,7031,486,3,50,592,312,2,1,957,0,42,999
7,1,7031,487,3,10,623,629,0,0,1262,0,57,1319
7,1,7031,488,3,11,373,798,1,1,1184,0,29,1213
7,1,7050,692,3,151,74,75,0,3,303,0,3,306
7,1,7050,693,3,332,219,133,4,8,696,0,7,703
7,1,7050,694,3,194,152,154,2,0,502,1,9,512
7,1,7050,695,3,219,139,53,4,0,415,0,7,422
7,1,7050,696,3,401,271,82,2,5,761,1,15,777
7,1,7065,944,3,128,326,313,30,12,809,5,51,865
7,1,7065,945,3,204,446,895,33,26,1604,4,37,1645
7,1,7065,946,3,146,315,757,31,10,1259,4,37,1300
7,1,7065,947,3,219,603,1138,51,31,2042,0,65,2107
7,1,7065,948,3,104,314,568,53,23,1062,0,33,1095
7,1,7065,949,3,172,548,829,44,17,1610,5,49,1664
7,1,7065,950,3,230,731,1197,69,48,2275,12,57,2344
7,1,7065,951,3,135,504,723,42,24,1428,3,40,1471
7,1,7065,952,3,96,406,471,25,16,1014,1,22,1037
7,1,7065,953,3,59,319,441,9,8,836,2,34,872
7,1,7065,954,3,85,247,415,7,4,758,0,35,793
7,1,7065,955,3,70,138,260,6,8,482,0,18,500
7,1,7065,956,3,42,177,262,6,5,492,2,34,528
7,1,7065,957,3,40,259,188,22,4,513,0,29,542
7,1,7065,958,3,45,229,190,4,2,470,2,23,495
7,1,7065,959,3,26,101,287,6,4,424,5,27,456
7,1,7065,960,3,99,161,288,28,3,579,0,22,601
7,1,7065,961,3,32,160,37,2,3,234,0,14,248
7,1,7065,962,3,52,347,293,5,2,699,0,26,725
7,1,7065,963,3,33,256,262,4,1,556,0,30,586
7,1,7065,964,3,123,390,336,11,6,866,1,37,904
7,1,7065,965,3,85,360,383,9,10,847,1,77,925
7,1,7065,966,3,29,77,144,1,0,251,0,20,271
7,1,7065,967,3,11,23,170,4,2,210,0,11,221
7,1,7065,968,3,59,349,322,5,7,742,1,41,784
7,1,7065,969,3,67,300,218,9,9,603,3,26,632
7,1,7065,970,3,15,314,225,1,0,555,0,28,583
7,1,7065,971,3,46,397,291,16,8,758,0,73,831
7,1,7065,972,3,44,224,629,5,4,906,4,32,942
7,1,7065,973,3,44,300,356,3,9,712,7,68,787
7,1,7065,974,3,36,130,548,15,3,732,3,40,775
7,1,7065,975,3,18,588,304,2,3,915,0,36,951
7,1,7065,976,3,53,173,189,6,2,423,0,48,471
7,1,7075,1082,3,39,366,393,5,6,809,0,59,868
7,1,7075,1083,3,14,626,140,0,1,781,0,56,837
7,1,7075,1084,3,36,366,332,0,0,734,0,38,772
7,1,7075,1085,3,43,350,332,6,2,733,0,80,813
7,1,7075,1086,3,8,158,99,0,2,267,0,13,280
7,1,7075,1087,3,66,653,612,0,3,1334,0,42,1376
7,1,7075,1088,3,31,364,438,4,2,839,0,16,855
7,1,7075,1089,3,14,483,156,0,1,654,0,269,923
7,1,7075,1090,3,8,295,215,2,2,522,0,28,550
7,1,7075,1091,3,17,410,85,0,7,519,0,23,542
7,1,7076,1092,3,77,475,364,19,9,944,1,34,979
7,1,7076,1093,3,55,375,220,12,9,671,2,37,710
7,1,7076,1094,3,37,144,118,2,3,304,2,19,325
7,1,7076,1095,3,16,140,103,1,0,260,0,11,271
7,1,7076,1096,3,88,430,279,4,5,806,1,41,848
7,1,7076,1097,3,35,237,244,2,2,520,6,41,567
7,1,7076,1098,3,20,489,345,5,4,863,3,73,939
7,1,7076,1099,3,4,122,215,1,2,344,0,25,369
7,1,7076,1100,3,19,505,315,0,6,845,0,56,901
7,1,7076,1101,3,5,135,149,0,0,289,0,8,297
7,1,7076,1102,3,55,264,209,4,6,538,2,53,593
7,1,7076,1103,3,12,162,402,6,7,589,0,39,628
7,1,7076,1104,3,11,254,396,2,1,664,1,21,686
7,1,7076,1105,3,12,374,167,1,4,558,0,24,582
7,1,7076,1106,3,18,617,177,10,2,824,0,57,881
7,1,7076,1107,3,36,411,328,2,3,780,0,22,802
7,1,7076,1108,3,49,549,258,8,3,867,0,64,931
7,1,7076,1109,3,18,273,157,3,3,454,0,15,469
7,1,7076,1110,3,26,247,198,20,1,492,0,21,513
7,1,7076,1111,3,21,473,352,20,5,871,0,57,928
7,1,7076,1112,3,39,673,128,5,2,847,0,39,886
7,1,7096,1464,3,35,187,326,9,26,583,1,60,644
7,1,7096,1465,3,57,164,348,11,26,606,0,89,695
7,1,7096,1466,3,33,191,291,11,17,543,4,50,597
7,1,7096,1467,3,10,316,182,0,1,509,5,17,531
7,1,7096,1468,3,41,463,354,1,4,863,0,60,923
7,1,7096,1469,3,19,166,249,3,3,440,2,57,499
7,1,7096,1470,3,23,422,345,0,8,798,3,81,882
7,1,7096,1471,3,16,356,407,1,5,785,1,38,824
7,1,7096,1472,3,10,339,475,2,3,829,0,36,865
7,1,7096,1473,3,110,484,90,0,2,686,0,40,726
7,1,7096,1474,3,77,614,149,1,3,844,3,48,895
7,1,7096,1475,3,41,655,168,1,6,871,3,27,901
7,1,7096,1476,3,39,506,115,3,11,674,4,47,725
7,1,7096,1477,3,36,459,92,2,4,593,1,38,632
7,1,7096,1478,3,16,408,177,9,4,614,1,43,658
7,1,7096,1479,3,6,507,148,2,3,666,2,57,725
7,1,7096,1480,3,82,207,217,4,2,512,1,76,589
7,1,7096,1481,3,42,212,214,2,10,480,5,48,533
7,1,7096,1482,3,202,219,179,0,9,609,0,35,644
7,1,7096,1483,3,16,447,250,3,2,718,4,48,770
7,1,7096,1484,3,57,748,489,3,4,1301,2,45,1348
7,1,7096,1485,3,22,512,227,14,2,777,1,81,859
7,1,7100,1568,3,139,512,214,9,8,882,1,48,931
7,1,7100,1569,3,31,403,153,3,4,594,0,29,623
7,1,7100,1570,3,32,267,199,19,7,524,1,53,578
7,1,7100,1571,3,38,320,473,21,2,854,0,36,890
7,1,7100,1572,3,62,765,187,4,5,1023,1,50,1074
7,1,7100,1573,3,30,120,76,1,1,228,0,12,240
7,1,7100,1574,3,21,340,281,14,3,659,0,39,698
7,1,7100,1575,3,31,310,241,10,5,597,0,38,635
7,1,7100,1576,3,107,476,156,2,6,747,1,39,787
7,1,7100,1577,3,51,237,86,2,0,376,0,25,401
7,1,7100,1578,3,72,430,332,10,2,846,1,28,875
7,1,7100,1579,3,34,501,199,0,1,735,3,27,765
7,1,7110,1902,3,178,544,239,10,13,984,1,40,1025
7,1,7110,1903,3,99,426,269,11,11,816,0,40,856
7,1,7110,1904,3,203,512,379,13,9,1116,8,56,1180
7,1,7110,1905,3,104,355,95,7,9,570,0,49,619
7,1,7110,1906,3,145,433,267,9,17,871,6,47,924
7,1,7110,1907,3,46,185,71,1,0,303,1,8,312
7,1,7110,1908,3,59,250,168,1,2,480,0,21,501
7,1,7110,1909,3,23,98,87,1,1,210,0,15,225
7,1,7110,1910,3,27,288,48,0,1,364,0,15,379
7,1,7110,1911,3,58,159,90,1,2,310,0,44,354
7,1,7110,1912,3,36,242,76,1,0,355,1,38,394
7,1,7110,1913,3,8,161,154,2,1,326,1,21,348
7,1,7110,1914,3,7,276,150,0,1,434,0,19,453
7,2,7013,144,3,78,395,266,33,35,807,0,56,863
7,2,7013,145,3,82,454,316,36,21,909,3,30,942
7,2,7013,146,3,131,341,272,31,15,790,0,43,833
7,2,7013,147,3,75,448,207,17,13,760,1,54,815
7,2,7013,148,3,17,180,217,1,10,425,0,24,449
7,2,7013,149,3,45,414,191,4,35,689,0,22,711
7,2,7013,150,3,3,293,243,0,1,540,0,11,551
7,2,7013,151,3,4,553,344,6,0,907,1,19,927
7,2,7013,152,3,25,598,104,3,8,738,0,23,761
7,2,7013,153,3,4,290,26,2,2,324,0,17,341
7,2,7013,154,3,10,373,115,22,1,521,0,26,547
7,2,7014,155,3,71,317,116,7,8,519,0,66,585
7,2,7014,156,3,69,261,100,12,2,444,0,74,518
7,2,7014,157,3,4,102,156,1,2,265,0,17,282
7,2,7014,158,3,11,28,28,2,0,69,0,7,76
7,2,7014,159,3,34,241,51,24,0,350,0,57,407
7,2,7014,160,3,88,299,105,5,6,503,0,30,533
7,2,7014,161,3,10,191,17,2,1,221,0,19,240
7,2,7014,162,3,13,130,133,4,3,283,1,16,300
7,2,7022,331,3,38,102,77,2,2,221,1,14,236
7,2,7022,332,3,129,313,160,2,2,606,1,53,660
7,2,7022,333,3,147,330,349,8,7,841,0,86,927
7,2,7022,334,3,97,282,125,2,2,508,3,79,590
7,2,7022,335,3,102,233,290,5,12,642,2,57,701
7,2,7025,381,3,276,455,293,13,10,1047,6,35,1088
7,2,7025,382,3,142,142,191,2,9,486,0,26,512
7,2,7025,383,3,105,253,332,1,6,697,0,34,731
7,2,7026,384,3,49,423,130,1,5,608,0,27,635
7,2,7026,385,3,7,207,28,0,0,242,0,2,244
7,2,7026,386,3,3,340,41,0,1,385,0,14,399
7,2,7026,387,3,9,147,18,0,0,174,0,7,181
7,2,7026,388,3,36,321,39,0,0,396,0,15,411
7,2,7026,389,3,7,301,129,2,2,441,0,11,452
7,2,7026,390,3,8,106,27,0,0,141,0,0,141
7,2,7026,391,3,48,150,110,0,0,308,0,10,318
7,2,7026,392,3,21,198,70,0,2,291,0,2,293
7,2,7026,393,3,126,679,45,2,4,856,0,27,883
7,2,7026,394,3,76,275,18,0,3,372,0,7,379
7,2,7026,395,3,28,242,23,3,3,299,0,4,303
7,2,7026,396,3,68,267,36,2,6,379,0,17,396
7,2,7026,397,3,10,609,11,0,3,633,0,23,656
7,2,7026,398,3,42,407,17,3,1,470,3,39,512
7,2,7026,399,3,77,510,23,6,5,621,7,51,679
7,2,7026,400,3,48,331,28,6,2,415,2,48,465
7,2,7026,401,3,58,314,38,0,1,411,0,36,447
7,2,7033,502,3,406,166,709,4,6,1291,3,40,1334
7,2,7033,503,3,330,171,149,1,2,653,1,23,677
7,2,7038,556,3,100,313,246,9,8,676,1,31,708
7,2,7038,557,3,0,211,264,0,1,476,0,98,574
7,2,7038,558,3,21,261,162,3,0,447,0,35,482
7,2,7038,559,3,10,289,376,1,0,676,0,20,696
7,2,7038,560,3,15,366,80,2,2,465,0,34,499
7,2,7038,561,3,18,317,187,6,0,528,3,40,571
7,2,7038,562,3,4,227,163,0,0,394,2,21,417
7,2,7038,563,3,46,202,86,0,2,336,1,28,365
7,2,7038,564,3,9,190,84,1,1,285,0,24,309
7,2,7038,565,3,3,153,209,0,1,366,0,15,381
7,2,7042,617,3,57,197,157,3,0,414,5,24,443
7,2,7042,618,3,100,384,363,7,3,857,4,52,913
7,2,7042,619,3,23,250,194,3,2,472,3,38,513
7,2,7042,620,3,23,223,350,3,1,600,1,31,632
7,2,7047,662,3,39,368,456,11,5,879,2,41,922
7,2,7047,663,3,97,430,460,11,7,1005,1,28,1034
7,2,7047,664,3,17,338,386,1,2,744,0,36,780
7,2,7047,665,3,1,21,424,1,0,447,0,14,461
7,2,7047,666,3,11,289,397,1,1,699,2,47,748
7,2,7047,667,3,38,535,596,2,8,1179,2,80,1261
7,2,7047,668,3,8,88,296,4,0,396,0,7,403
7,2,7049,682,3,34,327,85,8,6,460,4,25,489
7,2,7049,683,3,56,376,89,3,3,527,1,47,575
7,2,7049,684,3,15,307,36,2,4,364,6,14,384
7,2,7049,685,3,122,616,209,1,1,949,0,38,987
7,2,7049,686,3,15,386,17,1,2,421,0,20,441
7,2,7049,687,3,34,448,50,0,7,539,0,10,549
7,2,7049,688,3,8,228,26,3,1,266,0,10,276
7,2,7049,689,3,16,365,20,4,1,406,0,21,427
7,2,7049,690,3,19,520,10,1,4,554,3,24,581
7,2,7049,691,3,10,381,18,3,2,414,0,30,444
7,2,7060,882,3,47,546,420,3,3,1019,0,64,1083
7,2,7060,883,3,31,450,387,9,3,880,1,46,927
7,2,7060,884,3,123,493,265,3,6,890,1,40,931
7,2,7066,977,3,17,238,35,1,0,291,0,13,304
7,2,7066,978,3,18,517,126,4,6,671,2,23,696
7,2,7066,979,3,18,423,233,8,1,683,2,23,708
7,2,7066,980,3,8,273,115,1,0,397,0,15,412
7,2,7066,981,3,8,404,188,2,3,605,0,21,626
7,2,7066,982,3,7,354,286,1,2,650,0,18,668
7,2,7066,983,3,4,94,165,1,0,264,0,7,271
7,2,7066,984,3,8,212,301,7,2,530,0,40,570
7,2,7067,985,3,163,466,462,5,5,1101,0,50,1151
7,2,7067,986,3,211,314,192,0,7,724,0,34,758
7,2,7067,987,3,31,194,257,1,0,483,0,9,492
7,2,7067,988,3,8,214,369,1,0,592,0,16,608
7,2,7067,989,3,86,155,264,2,0,507,1,19,527
7,2,7071,1039,3,130,418,223,1,4,776,0,40,816
7,2,7071,1040,3,179,450,250,7,7,893,0,27,920
7,2,7071,1041,3,326,536,378,13,3,1256,3,41,1300
7,2,7071,1042,3,51,266,226,0,0,543,0,20,563
7,2,7071,1043,3,2,159,107,0,1,269,0,16,285
7,2,7071,1044,3,57,289,521,2,3,872,0,64,936
7,2,7071,1045,3,0,0,1551,0,0,1551,0,19,1570
7,2,7071,1046,3,0,0,650,0,0,650,0,7,657
7,2,7071,1047,3,77,436,335,4,3,855,0,80,935
7,2,7071,1048,3,56,498,168,0,0,722,0,50,772
7,2,7072,1049,3,254,208,198,7,7,674,0,67,741
7,2,7072,1050,3,393,308,411,25,11,1148,2,54,1204
7,2,7072,1051,3,84,234,145,3,4,470,1,54,525
7,2,7079,1178,3,51,429,168,3,2,653,5,34,692
7,2,7079,1179,3,68,401,202,4,3,678,2,57,737
7,2,7079,1180,3,13,458,297,0,1,769,0,39,808
7,2,7079,1181,3,17,294,116,4,3,434,0,27,461
7,2,7079,1182,3,20,403,315,1,1,740,0,15,755
7,2,7079,1183,3,16,319,472,3,3,813,1,45,859
7,2,7079,1184,3,63,289,211,1,5,569,0,25,594
7,2,7079,1185,3,52,224,403,2,5,686,0,80,766
7,2,7079,1186,3,34,313,91,1,2,441,0,14,455
7,2,7082,1207,3,104,265,201,17,6,593,5,31,629
7,2,7082,1208,3,135,548,466,25,7,1181,4,48,1233
7,2,7082,1209,3,135,298,216,21,5,675,3,31,709
7,2,7082,1210,3,11,399,436,0,0,846,0,51,897
7,2,7082,1211,3,50,164,42,0,1,257,1,15,273
7,2,7082,1212,3,6,113,117,1,1,238,0,33,271
7,2,7082,1213,3,274,433,301,0,0,1008,0,34,1042
7,2,7082,1214,3,4,35,71,0,0,110,1,5,116
7,2,7082,1215,3,21,209,306,4,4,544,0,29,573
7,2,7082,1216,3,3,119,42,1,2,167,2,18,187
7,2,7082,1217,3,15,319,148,0,0,482,0,45,527
7,2,7082,1218,3,6,347,75,0,0,428,1,90,519
7,2,7082,1219,3,3,340,86,1,2,432,0,10,442
7,2,7082,1220,3,27,516,53,2,3,601,2,47,650
7,2,7082,1221,3,0,250,28,2,0,280,0,10,290
7,2,7083,1222,3,35,304,309,4,8,660,1,27,688
7,2,7083,1223,3,14,222,396,0,0,632,1,16,649
7,2,7083,1224,3,6,308,412,0,0,726,0,12,738
7,2,7083,1225,3,11,467,597,0,1,1076,0,18,1094
7,2,7091,1404,3,37,560,396,3,3,999,1,25,1025
7,2,7091,1405,3,22,315,279,1,1,618,0,13,631
7,2,7092,1406,3,114,318,635,19,10,1096,1,32,1129
7,2,7092,1407,3,113,178,123,11,4,429,1,18,448
7,2,7092,1408,3,188,166,128,9,2,493,4,17,514
7,2,7092,1409,3,197,283,186,15,7,688,4,29,721
7,2,7092,1410,3,120,346,220,6,1,693,2,43,738
7,3,7004,35,3,41,391,470,15,11,928,3,40,971
7,3,7004,36,3,57,274,330,13,12,686,0,36,722
7,3,7004,37,3,74,408,375,18,13,888,0,33,921
7,3,7004,38,3,21,209,66,0,3,299,0,14,313
7,3,7004,39,3,22,140,185,2,3,352,0,32,384
7,3,7004,40,3,35,374,273,1,1,684,0,46,730
7,3,7004,41,3,7,543,150,14,4,718,1,43,762
7,3,7004,42,3,19,508,187,0,4,718,0,74,792
7,3,7004,43,3,4,172,254,0,1,431,0,47,478
7,3,7024,375,3,54,392,92,3,2,543,0,28,571
7,3,7024,376,3,59,547,86,1,1,694,0,40,734
7,3,7024,377,3,18,198,61,3,1,281,3,24,308
7,3,7024,378,3,22,115,22,2,4,165,0,102,267
7,3,7024,379,3,9,88,81,0,0,178,0,3,181
7,3,7024,380,3,114,150,420,1,1,686,1,34,721
7,3,7052,718,3,53,415,320,13,7,808,1,29,838
7,3,7052,719,3,93,757,591,36,15,1492,6,40,1538
7,3,7052,720,3,67,668,413,20,7,1175,1,38,1214
7,3,7052,721,3,53,614,530,24,15,1236,4,39,1279
7,3,7052,722,3,77,564,234,6,8,889,1,29,919
7,3,7052,723,3,26,232,1106,8,8,1380,0,132,1512
7,3,7052,724,3,14,324,1046,1,10,1395,1,54,1450
7,3,7052,725,3,10,396,812,4,11,1233,0,75,1308
7,3,7052,726,3,2,142,270,1,1,416,0,15,431
7,3,7052,727,3,5,89,273,0,0,367,0,27,394
7,3,7052,728,3,8,58,106,1,1,174,0,18,192
7,3,7052,729,3,16,107,154,4,4,285,5,26,316
7,3,7052,730,3,4,90,60,5,0,159,0,21,180
7,3,7052,731,3,12,109,191,1,1,314,1,17,332
7,3,7052,732,3,9,138,614,0,8,769,0,34,803
7,3,7052,733,3,26,574,631,4,5,1240,1,76,1317
7,3,7052,734,3,9,519,619,6,4,1157,0,69,1226
7,3,7052,735,3,21,328,560,6,1,916,1,26,943
7,3,7052,736,3,5,168,853,2,2,1030,1,148,1179
7,3,7052,737,3,21,151,759,0,2,933,1,47,981
7,3,7052,738,3,19,58,559,3,1,640,2,22,664
7,3,7052,739,3,9,163,668,0,1,841,0,32,873
7,3,7052,740,3,42,451,427,5,7,932,2,37,971
7,3,7052,741,3,17,353,738,3,3,1114,1,37,1152
7,3,7052,742,3,14,95,470,74,1,654,0,28,682
7,3,7052,743,3,20,304,488,1,2,815,0,41,856
7,3,7052,744,3,33,168,122,8,9,340,3,25,368
7,3,7052,745,3,3,142,146,0,1,292,0,30,322
7,3,7052,746,3,0,147,3,0,1,151,0,7,158
7,3,7052,747,3,1,40,29,0,0,70,0,4,74
7,3,7052,748,3,51,185,100,0,1,337,0,6,343
7,3,7052,749,3,14,185,351,3,4,557,0,11,568
7,3,7052,750,3,9,200,200,0,3,412,0,14,426
7,3,7052,751,3,21,380,560,1,3,965,0,40,1005
7,3,7052,752,3,15,111,390,2,1,519,0,25,544
7,3,7052,753,3,20,123,250,3,4,400,1,19,420
7,3,7052,754,3,10,241,224,3,3,481,0,26,507
7,3,7052,755,3,26,116,234,1,2,379,0,15,394
7,3,7052,756,3,8,58,16,0,0,82,0,2,84
7,3,7052,757,3,63,125,177,2,1,368,0,39,407
7,3,7052,758,3,83,233,162,5,4,487,5,30,522
7,3,7052,759,3,47,178,511,8,7,751,1,36,788
7,3,7059,815,3,112,606,462,26,22,1228,7,54,1289
7,3,7059,816,3,231,997,988,59,40,2315,7,101,2423
7,3,7059,817,3,176,439,366,27,20,1028,0,38,1066
7,3,7059,818,3,93,666,527,42,18,1346,5,56,1407
7,3,7059,819,3,104,637,528,35,19,1323,2,53,1378
7,3,7059,820,3,187,848,739,46,28,1848,2,101,1951
7,3,7059,821,3,16,64,56,0,1,137,0,9,146
7,3,7059,822,3,47,210,163,0,4,424,0,18,442
7,3,7059,823,3,72,168,249,1,4,494,0,23,517
7,3,7059,824,3,23,119,281,2,4,429,0,19,448
7,3,7059,825,3,29,250,128,1,1,409,0,11,420
7,3,7059,826,3,75,599,245,4,6,929,1,31,961
7,3,7059,827,3,18,68,474,0,1,561,0,28,589
7,3,7059,828,3,17,207,123,2,1,350,1,21,372
7,3,7059,829,3,83,277,203,1,2,566,4,31,601
7,3,7059,830,3,63,231,147,1,1,443,1,23,467
7,3,7059,831,3,31,251,190,0,2,474,2,33,509
7,3,7059,832,3,27,167,274,1,3,472,0,13,485
7,3,7059,833,3,31,378,144,3,0,556,8,23,587
7,3,7059,834,3,25,319,56,2,4,406,1,37,444
7,3,7059,835,3,46,253,243,13,7,562,0,40,602
7,3,7059,836,3,7,317,256,1,0,581,1,14,596
7,3,7059,837,3,40,431,107,6,1,585,7,29,621
7,3,7059,838,3,33,120,216,1,3,373,1,27,401
7,3,7059,839,3,12,555,274,5,4,850,3,56,909
7,3,7059,840,3,24,395,58,15,2,494,1,26,521
7,3,7059,841,3,17,146,188,1,1,353,0,16,369
7,3,7059,842,3,66,398,468,4,3,939,1,78,1018
7,3,7059,843,3,60,402,212,23,9,706,4,67,777
7,3,7059,844,3,38,203,199,1,0,441,0,25,466
7,3,7059,845,3,14,152,280,0,1,447,4,8,459
7,3,7059,846,3,9,447,100,2,1,559,0,24,583
7,3,7059,847,3,16,343,92,1,1,453,4,21,478
7,3,7059,848,3,31,552,229,3,0,815,3,38,856
7,3,7059,849,3,135,526,309,3,3,976,2,36,1014
7,3,7059,850,3,19,269,99,2,1,390,0,20,410
7,3,7059,851,3,5,34,30,0,0,69,0,12,81
7,3,7059,852,3,5,101,6,14,0,126,0,7,133
7,3,7059,853,3,51,389,117,16,5,578,0,37,615
7,3,7059,854,3,49,320,71,8,3,451,0,22,473
7,3,7059,855,3,123,436,98,6,3,666,0,36,702
7,3,7059,856,3,9,198,414,1,13,635,0,37,672
7,3,7059,857,3,77,629,346,3,6,1061,2,59,1122
7,3,7059,858,3,8,666,77,7,0,758,0,15,773
7,3,7059,859,3,6,325,135,0,2,468,0,11,479
7,3,7059,860,3,9,232,161,1,2,405,0,46,451
7,3,7059,861,3,8,184,180,1,1,374,0,15,389
7,3,7059,862,3,91,217,169,2,3,482,0,45,527
7,3,7059,863,3,38,157,310,1,0,506,0,27,533
7,3,7059,864,3,32,215,235,0,3,485,1,41,527
7,3,7059,865,3,111,298,110,11,6,536,2,42,580
7,3,7059,866,3,78,244,119,23,3,467,1,33,501
7,3,7059,867,3,90,200,162,10,7,469,2,25,496
7,3,7059,868,3,86,279,345,22,10,742,2,39,783
7,3,7059,869,3,82,165,226,3,2,478,1,17,496
7,3,7059,870,3,7,344,240,0,3,594,2,27,623
7,3,7059,871,3,9,392,58,13,7,479,0,18,497
7,3,7059,872,3,28,196,138,17,4,383,1,24,408
7,3,7059,873,3,66,156,163,0,2,387,0,19,406
7,3,7059,874,3,87,252,165,8,2,514,0,20,534
7,3,7059,875,3,80,112,208,5,7,412,0,19,431
7,3,7059,876,3,140,234,420,28,4,826,0,31,857
7,3,7059,877,3,32,84,97,4,6,223,1,9,233
7,3,7059,878,3,43,351,161,3,3,561,0,42,603
7,3,7059,879,3,74,312,353,19,11,769,2,28,799
7,3,7059,880,3,9,29,125,0,1,164,0,3,167
7,3,7059,881,3,172,113,142,4,9,440,0,20,460
7,3,7064,925,3,40,269,329,13,10,661,0,38,699
7,3,7064,926,3,58,279,401,11,9,758,0,23,781
7,3,7064,927,3,20,333,145,13,3,514,1,16,531
7,3,7064,928,3,21,187,156,12,4,380,0,23,403
7,3,7064,929,3,88,435,195,33,2,753,1,57,811
7,3,7064,930,3,32,492,78,10,0,612,0,47,659
7,3,7064,931,3,44,573,134,6,3,760,3,68,831
7,3,7064,932,3,14,246,287,4,0,551,0,41,592
7,3,7064,933,3,12,563,20,1,2,598,0,48,646
7,3,7064,934,3,36,264,266,3,3,572,2,38,612
7,3,7064,935,3,36,702,278,7,4,1027,1,66,1094
7,3,7064,936,3,24,377,251,2,1,655,0,20,675
7,3,7064,937,3,6,219,133,0,0,358,0,10,368
7,3,7064,938,3,35,325,275,11,7,653,0,58,711
7,3,7064,939,3,12,530,129,0,3,674,0,26,700
7,3,7064,940,3,19,551,328,4,2,904,0,37,941
7,3,7064,941,3,17,255,86,1,1,360,0,32,392
7,3,7064,942,3,12,227,60,1,2,302,0,0,302
7,3,7064,943,3,25,494,139,4,1,663,0,73,736
7,4,7005,44,3,273,598,326,10,11,1218,6,58,1282
7,4,7005,45,3,14,117,35,0,0,166,0,10,176
7,4,7005,46,3,42,57,81,5,2,187,1,7,195
7,4,7005,47,3,5,15,45,0,0,65,0,1,66
7,4,7005,48,3,98,335,247,5,3,688,0,22,710
7,4,7005,49,3,59,212,82,2,1,356,0,59,415
7,4,7005,50,3,46,241,59,7,2,355,0,26,381
7,4,7005,51,3,127,147,167,2,1,444,0,11,455
7,4,7005,52,3,99,159,149,2,0,409,0,18,427
7,4,7005,53,3,152,306,198,1,5,662,0,51,713
7,4,7012,130,3,153,294,370,47,13,877,1,47,925
7,4,7012,131,3,241,254,321,51,16,883,8,32,923
7,4,7012,132,3,216,183,266,55,9,729,5,21,755
7,4,7012,133,3,164,164,176,32,4,540,1,11,552
7,4,7012,134,3,245,191,341,55,19,851,6,22,879
7,4,7012,135,3,221,314,417,56,18,1026,19,26,1071
7,4,7012,136,3,292,450,427,46,10,1225,6,53,1284
7,4,7012,137,3,46,153,100,0,3,302,0,12,314
7,4,7012,138,3,42,181,230,3,1,457,0,21,478
7,4,7012,139,3,35,93,41,0,0,169,0,7,176
7,4,7012,140,3,17,89,99,2,0,207,0,7,214
7,4,7012,141,3,20,49,34,1,0,104,0,4,108
7,4,7012,142,3,119,230,169,3,1,522,4,26,552
7,4,7012,143,3,53,67,87,4,0,211,0,5,216
7,4,7018,234,3,42,235,268,13,7,565,1,15,581
7,4,7018,235,3,58,292,231,10,4,595,2,11,608
7,4,7018,236,3,30,178,139,2,0,349,0,4,353
7,4,7018,237,3,30,299,256,3,2,590,0,0,590
7,4,7018,238,3,6,236,195,0,0,437,0,7,444
7,4,7021,317,3,228,126,121,21,9,505,1,29,535
7,4,7021,318,3,228,117,124,15,12,496,1,14,511
7,4,7021,319,3,152,138,190,16,6,502,3,10,515
7,4,7021,320,3,229,136,127,17,6,515,0,23,538
7,4,7021,321,3,95,244,142,1,5,487,0,22,509
7,4,7021,322,3,119,104,156,1,2,382,0,27,409
7,4,7021,323,3,60,89,48,3,2,202,0,9,211
7,4,7021,324,3,55,90,91,6,3,245,1,17,263
7,4,7021,325,3,40,168,135,6,5,354,4,8,366
7,4,7021,326,3,48,256,165,2,2,473,0,16,489
7,4,7021,327,3,52,152,132,3,5,344,0,14,358
7,4,7021,328,3,56,184,84,6,2,332,0,10,342
7,4,7021,329,3,94,153,188,8,6,449,2,12,463
7,4,7021,330,3,22,197,82,3,4,308,0,20,328
7,4,7043,621,3,194,287,254,21,4,760,1,24,785
7,4,7043,622,3,257,340,332,20,6,955,0,23,978
7,4,7043,623,3,80,230,140,6,6,462,0,15,477
7,4,7043,624,3,68,118,42,1,2,231,2,14,247
7,4,7043,625,3,40,78,65,0,3,186,0,6,192
7,4,7043,626,3,95,304,205,3,3,610,2,46,658
7,4,7045,636,3,288,322,137,10,6,763,0,30,793
7,4,7045,637,3,341,340,207,5,2,895,2,32,929
7,4,7048,669,3,126,382,364,28,4,904,1,34,939
7,4,7048,670,3,139,262,337,14,6,758,0,25,783
7,4,7048,671,3,94,365,392,15,5,871,1,31,903
7,4,7048,672,3,55,285,293,9,3,645,2,35,682
7,4,7048,673,3,57,201,219,10,3,490,2,28,520
7,4,7048,674,3,133,161,207,7,4,512,10,46,568
7,4,7048,675,3,6,47,76,5,3,137,0,6,143
7,4,7048,676,3,101,145,219,18,8,491,7,17,515
7,4,7048,677,3,38,123,77,4,1,243,0,17,260
7,4,7048,678,3,44,151,158,5,13,371,1,13,385
7,4,7048,679,3,54,187,164,14,5,424,3,21,448
7,4,7048,680,3,67,121,189,7,0,384,2,29,415
7,4,7048,681,3,31,222,113,4,7,377,2,12,391
7,4,7061,885,3,280,187,210,21,12,710,2,19,731
7,4,7061,886,3,219,161,265,32,11,688,0,33,721
7,4,7061,887,3,467,223,276,40,12,1018,16,36,1070
7,4,7061,888,3,435,195,293,35,10,968,5,38,1011
7,4,7061,889,3,340,225,326,28,11,930,2,32,964
7,4,7061,890,3,228,162,220,37,13,660,8,15,683
7,4,7061,891,3,304,124,242,21,11,702,0,2,704
7,4,7061,892,3,402,232,332,37,17,1020,9,29,1058
7,4,7061,893,3,426,238,313,33,23,1033,7,31,1071
7,4,7061,894,3,402,451,329,50,17,1249,8,75,1332
7,4,7061,895,3,429,287,281,46,16,1059,8,31,1098
7,4,7061,896,3,20,213,34,0,1,268,0,13,281
7,4,7061,897,3,81,535,174,4,5,799,4,52,855
7,4,7061,898,3,82,413,168,3,2,668,2,26,696
7,4,7061,899,3,153,245,76,5,4,483,1,32,516
7,4,7061,900,3,135,324,294,3,3,759,1,37,797
7,4,7061,901,3,136,437,526,20,4,1123,7,52,1182
7,4,7061,902,3,117,43,32,4,0,196,1,7,204
7,4,7061,903,3,178,198,98,5,6,485,0,24,509
7,4,7061,904,3,58,128,59,5,4,254,0,18,272
7,4,7061,905,3,181,196,145,8,3,533,0,19,552
7,4,7061,906,3,65,87,104,3,2,261,4,11,276
7,4,7061,907,3,76,63,125,5,2,271,0,17,288
7,4,7061,908,3,47,171,95,1,4,318,4,0,322
7,4,7061,909,3,98,332,152,6,2,590,2,48,640
7,4,7061,910,3,62,253,146,3,1,465,0,20,485
7,4,7061,911,3,72,248,81,2,2,405,1,21,427
7,4,7061,912,3,100,250,114,9,0,473,0,30,503
7,4,7062,913,3,160,420,296,78,12,966,0,59,1025
7,4,7062,914,3,204,333,247,49,7,840,0,6,846
7,4,7062,915,3,101,112,88,9,1,311,0,12,323
7,4,7062,916,3,84,256,194,22,3,559,1,16,576
7,4,7062,917,3,57,64,102,20,4,247,3,24,274
7,4,7062,918,3,79,300,129,15,5,528,0,13,541
7,4,7062,919,3,118,178,95,15,4,410,0,33,443
7,4,7062,920,3,70,303,96,8,1,478,1,36,515
7,4,7062,921,3,30,106,45,5,1,187,0,9,196
7,4,7062,922,3,21,56,92,6,3,178,1,17,196
7,4,7068,990,3,307,469,564,39,10,1389,3,45,1437
7,4,7068,991,3,191,357,288,36,6,878,1,14,893
7,4,7068,992,3,190,292,269,26,8,785,0,42,827
7,4,7068,993,3,157,279,222,38,16,712,7,35,754
7,4,7068,994,3,146,275,197,36,4,658,5,32,695
7,4,7068,995,3,198,375,426,51,24,1074,0,39,1113
7,4,7068,996,3,50,114,210,3,2,379,6,22,407
7,4,7068,997,3,58,238,281,13,5,595,1,55,651
7,4,7068,998,3,85,152,180,6,3,426,0,30,456
7,4,7068,999,3,89,218,186,10,6,509,4,44,557
7,4,7068,1000,3,66,178,70,5,5,324,3,20,347
7,4,7068,1001,3,107,101,180,5,3,396,4,17,417
7,4,7068,1002,3,56,151,229,6,4,446,1,37,484
7,4,7068,1003,3,151,198,126,12,4,491,0,22,513
7,4,7068,1004,3,150,175,35,2,0,362,2,15,379
7,4,7068,1005,3,30,67,58,2,1,158,0,8,166
7,4,7068,1006,3,29,104,75,6,0,214,0,9,223
7,4,7068,1007,3,146,268,270,11,9,704,1,68,773
7,4,7073,1052,3,95,396,707,54,19,1271,2,24,1297
7,4,7073,1053,3,57,203,297,23,13,593,0,13,606
7,4,7073,1054,3,45,242,276,17,16,596,0,11,607
7,4,7073,1055,3,42,163,330,11,11,557,1,5,563
7,4,7073,1056,3,39,249,310,21,11,630,0,13,643
7,4,7073,1057,3,91,345,738,47,18,1239,7,39,1285
7,4,7073,1058,3,45,148,332,15,11,551,6,15,572
7,4,7073,1059,3,49,131,389,19,8,596,5,26,627
7,4,7073,1060,3,72,260,451,27,9,819,0,20,839
7,4,7073,1061,3,53,188,427,6,5,679,1,11,691
7,4,7073,1062,3,119,420,687,44,19,1289,5,30,1324
7,4,7073,1063,3,20,264,219,8,3,514,2,12,528
7,4,7073,1064,3,49,346,349,8,2,754,5,38,797
7,4,7073,1065,3,56,133,366,13,5,573,1,12,586
7,4,7073,1066,3,38,163,521,20,11,753,1,11,765
7,4,7073,1067,3,71,216,160,4,9,460,6,28,494
7,4,7073,1068,3,61,173,152,4,1,391,0,11,402
7,4,7073,1069,3,79,247,410,9,4,749,2,35,786
7,4,7078,1165,3,276,205,286,44,9,820,2,42,864
7,4,7078,1166,3,149,162,207,34,6,558,1,22,581
7,4,7078,1167,3,192,175,228,24,11,630,3,26,659
7,4,7078,1168,3,224,247,346,32,3,852,1,36,889
7,4,7078,1169,3,25,46,82,1,0,154,0,9,163
7,4,7078,1170,3,46,172,70,7,2,297,2,12,311
7,4,7078,1171,3,49,68,60,10,4,191,0,16,207
7,4,7078,1172,3,161,141,183,13,5,503,2,31,536
7,4,7078,1173,3,105,194,85,43,1,428,2,33,463
7,4,7078,1174,3,130,124,142,17,3,416,0,22,438
7,4,7078,1175,3,174,208,80,4,1,467,4,14,485
7,4,7078,1176,3,87,206,130,8,5,436,4,11,451
7,4,7078,1177,3,244,347,227,28,7,853,10,34,897
7,4,7085,1233,3,125,433,367,21,5,951,0,43,994
7,4,7085,1234,3,48,272,154,9,2,485,0,14,499
7,4,7085,1235,3,25,394,495,8,6,928,0,66,994
7,4,7089,1264,3,103,545,165,4,2,819,0,20,839
7,4,7093,1411,3,58,308,201,22,11,600,0,21,621
7,4,7093,1412,3,51,115,102,8,3,279,0,6,285
7,4,7093,1413,3,61,207,147,7,5,427,0,21,448
7,4,7093,1414,3,49,172,177,9,4,411,2,10,423
7,4,7093,1415,3,14,162,17,0,1,194,0,0,194
7,4,7093,1416,3,53,178,193,6,5,435,4,27,466
7,4,7093,1417,3,28,297,152,0,1,478,0,18,496
7,4,7093,1418,3,20,60,185,1,0,266,0,19,285
7,4,7093,1419,3,32,180,101,1,2,316,0,10,326
7,4,7093,1420,3,23,162,79,2,1,267,1,21,289
7,4,7093,1421,3,71,95,104,9,5,284,12,20,316
7,4,7093,1422,3,21,228,79,15,2,345,0,24,369
7,4,7093,1423,3,9,150,157,4,0,320,0,12,332
7,4,7093,1424,3,26,110,155,7,0,298,0,36,334
7,4,7093,1425,3,6,113,45,0,0,164,0,7,171
7,4,7093,1426,3,29,338,78,3,6,454,0,23,477
7,4,7093,1427,3,49,90,267,2,0,408,0,12,420
7,4,7093,1428,3,42,159,50,0,2,253,0,6,259
7,4,7093,1429,3,111,232,138,7,30,518,2,23,543
7,4,7093,1430,3,156,159,133,9,37,494,1,19,514
7,4,7093,1431,3,130,161,109,4,18,422,0,10,432
7,4,7093,1432,3,131,270,184,11,87,683,3,27,713
7,4,7093,1433,3,105,217,70,0,6,398,0,5,403
7,4,7093,1434,3,39,279,81,5,3,407,0,15,422
7,4,7093,1435,3,11,183,54,3,1,252,1,16,269
7,4,7093,1436,3,1,50,5,0,0,56,0,0,56
7,4,7093,1437,3,9,293,64,0,1,367,0,12,379
7,5,7007,68,3,27,375,250,2,1,655,3,25,683
7,5,7007,69,3,5,278,94,1,3,381,0,17,398
7,5,7007,70,3,13,95,136,2,0,246,0,12,258
7,5,7007,71,3,5,136,108,4,1,254,0,20,274
7,5,7023,336,3,11,194,17,4,1,227,0,23,250
7,5,7023,337,3,21,201,74,9,2,307,1,35,343
7,5,7023,338,3,15,121,30,1,1,168,0,12,180
7,5,7023,339,3,20,153,117,3,0,293,4,24,321
7,5,7023,340,3,8,260,14,3,0,285,3,33,321
7,5,7023,341,3,9,361,24,3,0,397,0,34,431
7,5,7023,342,3,22,304,113,3,9,451,0,44,495
7,5,7023,343,3,15,348,32,1,2,398,0,12,410
7,5,7023,344,3,26,282,78,3,2,391,0,51,442
7,5,7023,345,3,26,313,99,9,5,452,5,41,498
7,5,7023,346,3,32,226,155,7,3,423,0,41,464
7,5,7023,347,3,13,171,130,4,1,319,1,36,356
7,5,7023,348,3,16,247,69,1,1,334,0,54,388
7,5,7023,349,3,25,274,36,5,0,340,1,37,378
7,5,7023,350,3,22,250,48,0,1,321,2,33,356
7,5,7023,351,3,25,483,55,3,2,568,0,21,589
7,5,7023,352,3,7,462,39,1,1,510,0,3,513
7,5,7023,353,3,32,383,90,0,4,509,0,48,557
7,5,7023,354,3,28,285,41,1,1,356,0,16,372
7,5,7023,355,3,8,498,60,3,1,570,1,27,598
7,5,7023,356,3,23,101,155,6,5,290,2,36,328
7,5,7023,357,3,37,209,168,2,4,420,0,42,462
7,5,7023,358,3,20,182,153,2,3,360,4,23,387
7,5,7023,359,3,6,373,148,1,8,536,0,36,572
7,5,7023,360,3,41,388,36,5,0,470,2,24,496
7,5,7023,361,3,31,163,129,4,1,328,1,26,355
7,5,7023,362,3,38,429,48,9,0,524,0,67,591
7,5,7023,363,3,35,220,59,6,3,323,0,45,368
7,5,7023,364,3,65,309,92,9,8,483,2,50,535
7,5,7023,365,3,10,311,21,4,1,347,0,8,355
7,5,7023,366,3,25,319,20,27,1,392,1,14,407
7,5,7023,367,3,18,280,63,4,4,369,2,19,390
7,5,7023,368,3,48,396,89,12,0,545,7,47,599
7,5,7023,369,3,16,163,49,3,1,232,8,21,261
7,5,7023,370,3,9,362,157,3,1,532,1,30,563
7,5,7023,371,3,15,103,589,7,2,716,0,39,755
7,5,7023,372,3,9,87,26,4,1,127,0,6,133
7,5,7023,373,3,16,240,68,7,3,334,11,30,375
7,5,7023,374,3,42,240,48,12,1,343,0,38,381
7,5,7039,566,3,34,237,102,13,2,388,0,30,418
7,5,7039,567,3,18,71,112,4,0,205,1,38,244
7,5,7039,568,3,34,223,119,1,1,378,2,41,421
7,5,7039,569,3,199,239,198,1,4,641,0,19,660
7,5,7039,570,3,37,196,463,3,1,700,3,29,732
7,5,7039,571,3,86,301,190,4,1,582,4,29,615
7,5,7039,572,3,35,285,193,0,1,514,0,19,533
7,5,7039,573,3,33,52,79,0,1,165,0,13,178
7,5,7039,574,3,36,308,243,1,1,589,0,49,638
7,5,7039,575,3,24,289,131,7,2,453,2,45,500
7,5,7039,576,3,76,134,143,3,1,357,1,36,394
7,5,7056,782,3,22,112,32,0,4,170,0,26,196
7,5,7056,783,3,45,140,42,0,0,227,0,42,269
7,5,7056,784,3,48,383,71,9,4,515,12,51,578
7,5,7056,785,3,21,234,178,7,6,446,0,42,488
7,5,7056,786,3,20,306,67,2,6,401,7,43,451
7,5,7077,1113,3,191,398,396,48,23,1056,8,50,1114
7,5,7077,1114,3,359,760,1171,91,43,2424,15,121,2560
7,5,7077,1115,3,73,247,344,11,6,681,5,84,770
7,5,7077,1116,3,189,421,550,48,33,1241,5,52,1298
7,5,7077,1117,3,189,425,454,43,21,1132,1,29,1162
7,5,7077,1118,3,80,276,268,35,14,673,9,30,712
7,5,7077,1119,3,99,194,293,20,11,617,2,21,640
7,5,7077,1120,3,188,370,333,33,18,942,1,35,978
7,5,7077,1121,3,200,420,512,57,28,1217,7,47,1271
7,5,7077,1122,3,175,350,372,56,23,976,6,39,1021
7,5,7077,1123,3,109,274,246,40,17,686,0,30,716
7,5,7077,1124,3,210,392,290,44,13,949,3,34,986
7,5,7077,1125,3,234,396,390,50,30,1100,14,26,1140
7,5,7077,1126,3,169,384,289,39,17,898,6,30,934
7,5,7077,1127,3,256,464,418,59,13,1210,3,54,1267
7,5,7077,1128,3,291,676,830,92,41,1930,9,45,1984
7,5,7077,1129,3,215,376,390,40,22,1043,2,26,1071
7,5,7077,1130,3,146,321,232,36,15,750,8,37,795
7,5,7077,1131,3,354,685,569,76,41,1725,7,60,1792
7,5,7077,1132,3,114,323,156,32,13,638,7,29,674
7,5,7077,1133,3,179,301,265,28,7,780,1,41,822
7,5,7077,1134,3,129,303,218,37,9,696,1,29,726
7,5,7077,1135,3,187,384,340,38,16,965,3,37,1005
7,5,7077,1136,3,140,239,189,18,14,600,3,37,640
7,5,7077,1137,3,231,309,324,33,22,919,0,56,975
7,5,7077,1138,3,201,254,215,19,16,705,2,13,720
7,5,7077,1139,3,152,253,209,25,11,650,6,30,686
7,5,7077,1140,3,115,177,133,13,5,443,0,20,463
7,5,7077,1141,3,180,351,221,27,12,791,1,33,825
7,5,7077,1142,3,249,415,422,42,15,1143,3,13,1159
7,5,7077,1143,3,348,690,622,87,36,1783,6,60,1849
7,5,7077,1144,3,319,647,733,97,34,1830,14,71,1915
7,5,7077,1145,3,259,574,462,46,35,1376,4,55,1435
7,5,7077,1146,3,215,504,377,36,22,1154,2,40,1196
7,5,7077,1147,3,150,260,332,27,12,781,2,27,810
7,5,7077,1148,3,149,221,245,21,13,649,7,6,662
7,5,7077,1149,3,185,424,335,32,27,1003,4,38,1045
7,5,7077,1150,3,237,493,561,26,23,1340,6,68,1414
7,5,7077,1151,3,489,864,808,82,60,2303,12,87,2402
7,5,7077,1152,3,37,143,151,4,6,341,5,24,370
7,5,7077,1153,3,23,214,99,6,5,347,4,37,388
7,5,7077,1154,3,19,146,71,4,2,242,0,19,261
7,5,7077,1155,3,49,183,94,1,5,332,1,23,356
7,5,7077,1156,3,83,167,119,4,8,381,1,35,417
7,5,7077,1157,3,55,116,233,18,8,430,1,38,469
7,5,7077,1158,3,54,163,143,8,2,370,2,16,388
7,5,7077,1159,3,7,44,138,7,0,196,0,20,216
7,5,7077,1160,3,64,316,160,7,6,553,2,28,583
7,5,7077,1161,3,5,23,8,0,0,36,0,2,38
7,5,7077,1162,3,20,97,33,3,2,155,0,9,164
7,5,7077,1163,3,10,28,31,2,0,71,1,13,85
7,5,7077,1164,3,3,23,107,4,2,139,0,10,149
7,5,7094,1438,3,90,240,101,5,6,442,3,21,466
7,5,7094,1439,3,13,516,195,0,1,725,0,15,740
7,5,7094,1440,3,43,194,167,5,5,414,0,23,437
7,5,7094,1441,3,21,426,186,5,2,640,3,30,673
7,5,7094,1442,3,20,301,111,2,1,435,0,14,449
7,5,7094,1443,3,77,445,83,9,8,622,2,39,663
7,5,7094,1444,3,17,378,137,13,3,548,3,27,578
7,5,7094,1445,3,16,303,152,3,1,475,0,35,510
7,5,7094,1446,3,35,240,112,4,2,393,1,35,429
7,5,7094,1447,3,6,158,82,4,0,250,4,16,270
7,5,7094,1448,3,32,238,94,6,0,370,0,24,394
7,5,7094,1449,3,28,238,145,11,0,422,1,19,442
7,5,7094,1450,3,112,302,95,35,3,547,3,34,584
7,5,7094,1451,3,55,236,195,4,3,493,1,38,532
7,5,7094,1452,3,33,212,194,12,3,454,2,20,476
7,5,7094,1453,3,37,119,84,15,2,257,1,10,268
7,5,7095,1454,3,96,335,170,12,5,618,4,49,671
7,5,7095,1455,3,155,306,157,13,11,642,3,16,661
7,5,7095,1456,3,145,324,203,9,7,688,6,44,738
7,5,7095,1457,3,91,235,157,11,5,499,2,30,531
7,5,7095,1458,3,98,228,122,11,5,464,4,24,492
7,5,7095,1459,3,87,213,121,13,4,438,0,43,481
7,5,7095,1460,3,53,221,244,15,1,534,5,15,554
7,5,7095,1461,3,74,262,122,10,2,470,1,55,526
7,5,7095,1462,3,136,349,202,4,4,695,1,75,771
7,5,7095,1463,3,48,333,135,5,5,526,5,54,585
7,5,7111,1915,3,11,424,261,3,2,701,1,22,724
7,5,7111,1916,3,26,422,225,6,1,680,1,17,698
7,5,7111,1917,3,7,208,249,4,1,469,0,0,469
7,5,7111,1918,3,18,367,426,2,2,815,3,23,841
7,5,7111,1919,3,4,417,107,2,0,530,0,13,543
7,5,7111,1920,3,89,132,1028,6,5,1260,0,52,1312
7,5,7111,1921,3,18,129,451,0,3,601,1,5,607
7,5,7111,1922,3,169,468,268,4,0,909,3,30,942
7,5,7111,1923,3,229,437,203,2,2,873,0,42,915
7,5,7111,1924,3,8,366,386,4,3,767,0,30,797
7,5,7111,1925,3,9,499,450,5,4,967,0,37,1004
7,5,7111,1926,3,8,220,238,1,2,469,3,15,487
7,5,7111,1927,3,7,17,1281,3,1,1309,0,23,1332
7,5,7111,1928,3,3,140,320,0,0,463,0,22,485
7,5,7111,1929,3,6,209,429,1,2,647,2,35,684
7,6,7002,7,3,206,211,129,18,2,566,7,16,589
7,6,7002,8,3,118,148,159,11,4,440,3,19,465
7,6,7002,9,3,156,151,151,7,3,468,0,7,475
7,6,7002,10,3,166,307,247,21,5,746,2,31,779
7,6,7002,11,3,120,242,220,20,3,605,2,2,609
7,6,7002,12,3,115,171,168,25,7,486,1,13,500
7,6,7002,13,3,94,181,111,9,0,395,0,5,400
7,6,7002,14,3,129,93,253,1,3,479,2,26,507
7,6,7002,15,3,110,160,95,3,3,371,2,14,387
7,6,7002,16,3,123,207,223,10,3,566,3,38,607
7,6,7002,17,3,193,285,324,24,4,830,1,39,870
7,6,7002,18,3,97,57,85,3,0,242,1,10,253
7,6,7002,19,3,156,228,263,6,3,656,3,37,696
7,6,7002,20,3,158,135,180,2,4,479,5,28,512
7,6,7027,402,3,419,674,976,72,24,2165,13,92,2270
7,6,7027,403,3,149,194,416,31,8,798,5,28,831
7,6,7027,404,3,192,293,399,39,11,934,5,45,984
7,6,7027,405,3,191,250,332,52,11,836,2,23,861
7,6,7027,406,3,97,195,274,19,8,593,6,28,627
7,6,7027,407,3,175,305,464,46,12,1002,2,23,1027
7,6,7027,408,3,206,215,310,25,12,768,2,22,792
7,6,7027,409,3,178,255,338,53,10,834,0,29,863
7,6,7027,410,3,189,222,300,29,8,748,4,26,778
7,6,7027,411,3,173,304,545,54,14,1090,0,33,1123
7,6,7027,412,3,151,306,445,32,20,954,8,21,983
7,6,7027,413,3,68,412,341,3,1,825,3,22,850
7,6,7027,414,3,119,436,272,1,2,830,1,43,874
7,6,7027,415,3,115,229,467,26,3,840,8,24,872
7,6,7027,416,3,152,200,192,12,4,560,0,19,579
7,6,7027,417,3,187,238,230,3,3,661,3,30,694
7,6,7027,418,3,9,60,93,0,0,162,0,13,175
7,6,7027,419,3,68,104,238,15,0,425,2,20,447
7,6,7027,420,3,143,98,102,4,2,349,0,7,356
7,6,7027,421,3,136,126,140,11,5,418,2,9,429
7,6,7027,422,3,45,200,101,18,0,364,4,25,393
7,6,7027,423,3,106,189,142,8,2,447,3,19,469
7,6,7027,424,3,56,185,304,23,3,571,9,26,606
7,6,7027,425,3,162,210,156,25,3,556,2,23,581
7,6,7027,426,3,48,262,143,3,2,458,6,21,485
7,6,7027,427,3,75,97,113,6,2,293,3,24,320
7,6,7027,428,3,165,124,141,2,2,434,0,17,451
7,6,7027,429,3,105,275,134,89,3,606,1,25,632
7,6,7027,430,3,169,213,129,7,3,521,1,42,564
7,6,7027,431,3,163,246,331,18,1,759,1,25,785
7,6,7027,432,3,166,114,170,8,4,462,0,22,484
7,6,7028,433,3,126,210,225,3,0,564,1,26,591
7,6,7028,434,3,157,236,251,7,3,654,0,24,678
7,6,7028,435,3,70,85,63,7,2,227,2,9,238
7,6,7029,436,3,215,218,142,10,0,585,1,8,594
7,6,7029,437,3,384,339,160,11,1,895,1,20,916
7,6,7029,438,3,96,105,78,1,2,282,0,1,283
7,6,7044,627,3,121,275,436,26,8,866,2,29,897
7,6,7044,628,3,93,304,622,87,3,1109,1,77,1187
7,6,7044,629,3,77,466,310,9,0,862,0,19,881
7,6,7044,630,3,4,372,293,4,0,673,0,24,697
7,6,7044,631,3,21,223,645,47,1,937,3,41,981
7,6,7044,632,3,13,434,239,7,1,694,0,12,706
7,6,7044,633,3,18,164,337,22,6,547,0,27,574
7,6,7044,634,3,31,321,446,44,7,849,1,54,904
7,6,7044,635,3,126,191,479,32,12,840,0,64,904
7,6,7058,814,3,2,69,786,0,1,858,9,48,915
7,6,7063,923,3,320,340,140,14,7,821,0,15,836
7,6,7063,924,3,172,212,63,3,1,451,1,10,462
7,6,7074,1070,3,108,99,103,17,4,331,1,27,359
7,6,7074,1071,3,116,108,124,26,1,375,3,11,389
7,6,7074,1072,3,76,84,116,13,3,292,2,0,294
7,6,7074,1073,3,108,100,100,14,2,324,4,12,340
7,6,7074,1074,3,123,168,147,8,5,451,3,11,465
7,6,7074,1075,3,100,183,150,10,5,448,0,18,466
7,6,7074,1076,3,120,129,244,7,2,502,0,38,540
7,6,7074,1077,3,80,134,220,10,2,446,5,20,471
7,6,7074,1078,3,225,172,165,12,4,578,2,11,591
7,6,7074,1079,3,93,188,170,8,5,464,10,42,516
7,6,7074,1080,3,57,51,122,2,2,234,1,20,255
7,6,7074,1081,3,45,114,90,5,2,256,0,8,264
7,6,7080,1187,3,188,407,378,3,10,986,3,51,1040
7,6,7080,1188,3,189,451,284,6,9,939,8,35,982
7,6,7086,1236,3,85,292,466,21,7,871,4,55,930
7,6,7086,1237,3,65,161,447,19,7,699,0,39,738
7,6,7086,1238,3,15,86,200,2,1,304,0,9,310
7,6,7086,1239,3,26,772,307,3,4,1112,0,46,1158
7,6,7087,1240,3,152,156,269,24,5,606,3,18,627
7,6,7087,1241,3,197,146,382,26,8,759,13,38,810
7,6,7087,1242,3,202,169,357,25,6,759,1,33,793
7,6,7087,1243,3,284,192,373,35,8,892,0,43,935
7,6,7087,1244,3,166,202,140,21,3,532,0,24,556
7,6,7087,1245,3,164,162,353,15,4,698,4,24,726
7,6,7087,1246,3,118,134,439,24,1,716,0,44,760
7,6,7098,1530,3,72,269,342,65,5,753,5,16,774
7,6,7098,1531,3,86,455,319,17,4,881,0,55,936
7,6,7102,1637,3,429,305,401,44,22,1201,3,23,1227
7,6,7102,1638,3,369,445,785,55,36,1690,0,82,1772
7,6,7102,1639,3,226,193,409,26,14,868,1,27,896
7,6,7102,1640,3,962,791,1099,119,68,3039,12,69,3120
7,6,7102,1641,3,481,433,316,65,26,1321,0,36,1357
7,6,7102,1642,3,217,165,250,37,11,680,0,15,695
7,6,7102,1643,3,321,201,280,39,4,845,0,27,872
7,6,7102,1644,3,343,205,262,38,14,862,0,27,889
7,6,7102,1672,3,362,316,258,31,15,982,2,28,1012
7,6,7102,1673,3,610,414,378,50,24,1476,11,29,1516
7,6,7102,1701,3,193,178,285,20,11,687,4,22,713
7,6,7102,1702,3,269,225,364,27,17,902,2,22,926
7,6,7102,1703,3,455,269,471,36,17,1248,7,30,1285
7,6,7102,1704,3,341,237,360,22,16,976,0,23,999
7,6,7102,1705,3,230,220,389,36,28,903,3,34,940
7,6,7102,1706,3,494,277,505,42,21,1339,3,46,1388
7,6,7102,1735,3,551,514,872,90,45,2072,4,56,2132
7,6,7102,1736,3,1113,846,1377,127,62,3525,8,118,3651
7,6,7102,1737,3,358,267,567,30,19,1241,9,51,1301
7,6,7102,1738,3,368,220,398,45,11,1042,1,45,1088
7,6,7102,1739,3,350,264,383,25,13,1035,5,45,1085
7,6,7102,1742,3,399,391,674,63,26,1553,3,46,1602
7,6,7102,1745,3,354,247,256,31,17,905,0,34,939
7,6,7102,1746,3,258,268,221,19,8,774,8,36,818
7,6,7102,1747,3,432,302,459,44,30,1267,1,36,1304
7,6,7102,1748,3,175,122,219,2,3,521,0,25,546
7,6,7102,1749,3,849,569,742,170,50,2380,10,41,2431
7,6,7102,1753,3,90,92,76,13,3,274,0,5,279
7,6,7106,1786,3,50,107,117,13,4,291,0,13,304
7,6,7106,1787,3,88,198,139,21,6,452,0,29,481
7,6,7106,1788,3,100,258,166,28,6,558,0,47,605
7,6,7106,1789,3,42,172,168,11,4,397,0,34,431
7,6,7106,1790,3,72,226,201,15,6,520,9,30,559
7,6,7106,1791,3,104,225,147,21,11,508,5,23,536
7,6,7106,1792,3,54,209,97,19,5,384,1,26,411
7,6,7106,1793,3,40,232,190,12,2,476,9,31,516
7,6,7106,1794,3,28,162,51,7,2,250,1,38,289
7,6,7106,1795,3,26,107,183,2,1,319,1,24,344
7,6,7106,1796,3,66,201,282,3,7,559,3,19,581
7,6,7106,1797,3,37,96,229,0,5,367,1,25,393
7,6,7106,1798,3,82,235,395,11,5,728,5,50,783
7,6,7106,1799,3,70,149,243,5,6,473,12,19,504
7,6,7106,1800,3,97,120,159,17,3,396,11,22,429
7,6,7106,1801,3,119,134,122,8,7,390,8,9,407
7,6,7106,1802,3,103,167,194,19,2,485,5,46,536
7,6,7106,1803,3,30,28,86,2,0,146,2,7,155
7,6,7106,1804,3,64,80,313,7,7,471,0,27,498
7,6,7106,1805,3,92,165,285,11,2,555,5,36,596
7,6,7106,1806,3,69,96,386,14,5,570,2,46,618
7,6,7106,1807,3,77,126,263,13,5,484,3,26,513
7,6,7106,1808,3,29,133,303,8,4,477,4,28,509
7,6,7106,1809,3,23,51,52,2,0,128,0,0,128
7,6,7106,1810,3,23,85,186,4,1,299,0,17,316
7,6,7106,1811,3,32,82,146,8,4,272,1,42,315
7,7,7001,1,3,232,345,321,66,9,973,1,70,1044
7,7,7001,2,3,264,213,305,89,11,882,2,24,908
7,7,7001,3,3,244,282,321,66,5,918,3,31,952
7,7,7001,4,3,14,94,37,1,0,146,0,11,157
7,7,7001,5,3,97,153,146,8,4,408,0,14,422
7,7,7001,6,3,123,237,300,13,6,679,5,35,719
7,7,7003,21,3,90,123,146,18,2,379,0,13,392
7,7,7003,22,3,87,185,174,30,9,485,1,11,497
7,7,7003,23,3,107,153,214,19,9,502,1,16,519
7,7,7003,24,3,130,230,281,19,6,666,0,22,688
7,7,7003,25,3,78,154,251,23,4,510,0,18,528
7,7,7003,26,3,166,101,392,22,6,687,3,39,729
7,7,7003,27,3,109,68,307,14,2,500,4,27,531
7,7,7003,28,3,213,106,208,31,5,563,0,31,594
7,7,7003,29,3,119,61,201,35,1,417,0,28,445
7,7,7003,30,3,62,83,179,28,3,355,0,20,375
7,7,7003,31,3,141,95,164,16,2,418,1,22,441
7,7,7003,32,3,199,67,94,19,1,380,0,60,440
7,7,7003,33,3,67,40,41,9,0,157,0,12,169
7,7,7003,34,3,162,182,256,46,8,654,0,34,688
7,7,7009,88,3,183,173,142,58,8,564,2,13,579
7,7,7009,89,3,133,115,108,68,3,427,0,11,438
7,7,7009,90,3,97,93,116,20,3,329,1,8,338
7,7,7009,91,3,316,179,298,53,10,856,3,44,903
7,7,7009,92,3,102,157,106,14,1,380,1,11,392
7,7,7009,93,3,147,97,108,25,6,383,0,16,399
7,7,7009,94,3,129,153,62,11,3,358,0,8,366
7,7,7009,95,3,176,102,151,38,12,479,0,13,492
7,7,7009,96,3,216,139,131,38,10,534,3,12,549
7,7,7009,97,3,208,181,133,39,5,566,4,9,579
7,7,7009,98,3,404,250,298,69,10,1031,1,19,1051
7,7,7009,99,3,223,196,192,36,5,652,0,19,671
7,7,7009,100,3,204,223,171,73,8,679,0,15,694
7,7,7009,101,3,43,51,35,5,2,136,1,8,145
7,7,7009,102,3,73,72,38,11,0,194,2,14,210
7,7,7009,103,3,117,116,186,31,6,456,0,15,471
7,7,7009,104,3,169,56,123,60,3,411,0,21,432
7,7,7009,105,3,102,68,94,30,6,300,0,15,315
7,7,7009,106,3,230,141,330,20,6,727,3,16,746
7,7,7009,107,3,49,30,77,20,1,177,0,0,177
7,7,7009,108,3,22,3,10,1,0,36,0,4,40
7,7,7009,109,3,142,52,326,77,5,602,0,31,633
7,7,7009,110,3,529,242,142,23,1,937,0,105,1042
7,7,7009,111,3,260,70,63,73,2,468,1,36,505
7,7,7009,112,3,318,164,151,196,6,835,0,56,891
7,7,7032,489,3,199,189,243,81,5,717,0,45,762
7,7,7032,490,3,261,199,335,68,4,867,0,33,900
7,7,7032,491,3,412,216,463,71,9,1171,1,31,1203
7,7,7032,492,3,40,95,132,5,2,274,0,28,302
7,7,7032,493,3,36,198,50,28,1,313,0,20,333
7,7,7032,494,3,66,76,101,3,2,248,0,15,263
7,7,7032,495,3,35,47,103,20,2,207,0,30,237
7,7,7032,496,3,82,264,246,14,2,608,0,44,652
7,7,7032,497,3,154,201,101,12,3,471,0,38,509
7,7,7032,498,3,41,93,273,23,0,430,0,28,458
7,7,7032,499,3,52,149,62,22,0,285,1,40,326
7,7,7032,500,3,256,145,427,23,11,862,4,24,890
7,7,7032,501,3,193,171,169,54,4,591,1,17,609
7,7,7051,697,3,209,248,440,34,8,939,5,50,994
7,7,7051,698,3,132,161,373,20,6,692,1,16,709
7,7,7051,699,3,157,181,226,8,7,579,0,12,591
7,7,7051,700,3,204,202,282,33,10,731,2,23,756
7,7,7051,701,3,205,97,211,35,6,554,4,32,590
7,7,7051,702,3,157,90,165,13,0,425,0,8,433
7,7,7051,703,3,195,86,162,11,5,459,0,11,470
7,7,7051,704,3,192,82,200,20,11,505,0,14,519
7,7,7051,705,3,82,220,147,2,7,458,0,35,493
7,7,7051,706,3,111,179,271,19,6,586,0,40,626
7,7,7051,707,3,55,59,57,0,5,176,0,11,187
7,7,7051,708,3,163,115,153,7,4,442,0,6,448
7,7,7051,709,3,161,98,82,48,3,392,0,18,410
7,7,7051,710,3,237,91,46,8,2,384,2,25,411
7,7,7051,711,3,28,24,47,3,2,104,0,0,104
7,7,7051,712,3,159,113,166,15,0,453,4,29,486
7,7,7051,713,3,164,116,235,24,7,546,3,35,584
7,7,7051,714,3,129,230,309,21,5,694,0,32,726
7,7,7051,715,3,120,148,46,11,7,332,1,25,358
7,7,7051,716,3,238,106,115,5,3,467,1,22,490
7,7,7051,717,3,56,248,72,3,4,383,1,17,401
7,7,7069,1008,3,103,189,463,25,7,787,2,30,819
7,7,7069,1009,3,108,249,211,27,5,600,1,19,620
7,7,7069,1010,3,229,359,381,72,13,1054,4,23,1081
7,7,7069,1011,3,187,205,341,67,6,806,0,23,829
7,7,7069,1012,3,172,155,201,31,6,565,0,23,588
7,7,7069,1013,3,54,45,144,10,1,254,0,15,269
7,7,7069,1014,3,222,271,511,67,13,1084,4,58,1146
7,7,7069,1015,3,58,53,89,7,0,207,7,18,232
7,7,7069,1016,3,103,64,150,34,1,352,0,56,408
7,7,7069,1017,3,111,214,356,21,5,707,0,43,750
7,7,7069,1018,3,211,286,197,26,6,726,0,60,786
7,7,7069,1019,3,120,126,122,7,3,378,2,47,427
7,7,7069,1020,3,101,92,141,4,3,341,1,12,354
7,7,7069,1021,3,324,89,164,7,4,588,4,67,659
7,7,7069,1022,3,228,180,105,15,3,531,0,37,568
7,7,7069,1023,3,41,46,106,2,0,195,0,9,204
7,7,7069,1024,3,91,273,92,4,4,464,0,8,472
7,7,7069,1025,3,85,93,86,17,0,281,0,16,297
7,7,7069,1026,3,121,140,234,21,7,523,2,41,566
7,7,7069,1027,3,160,75,39,7,3,284,0,13,297
7,7,7069,1028,3,456,111,167,5,6,745,0,56,801
7,7,7069,1029,3,277,63,37,7,2,386,0,29,415
7,7,7069,1030,3,171,160,212,12,3,558,0,36,594
7,7,7069,1031,3,39,257,76,3,2,377,0,14,391
7,7,7069,1032,3,164,236,127,38,9,574,3,41,618
7,7,7069,1033,3,68,196,222,15,0,501,1,74,576
7,7,7097,1486,3,220,145,155,57,11,588,2,9,599
7,7,7097,1487,3,247,230,188,94,33,792,1,26,819
7,7,7097,1488,3,237,199,190,50,6,682,2,27,711
7,7,7097,1489,3,373,144,260,134,16,927,2,39,968
7,7,7097,1490,3,425,199,312,92,15,1043,2,35,1080
7,7,7097,1491,3,306,138,193,66,14,717,0,15,732
7,7,7097,1492,3,205,149,196,89,8,647,0,25,672
7,7,7097,1493,3,218,128,163,99,18,626,1,13,640
7,7,7097,1494,3,183,144,159,64,25,575,0,20,595
7,7,7097,1495,3,188,172,158,75,16,609,0,11,620
7,7,7097,1496,3,304,175,306,114,8,907,0,30,937
7,7,7097,1497,3,163,115,162,45,4,489,6,21,516
7,7,7097,1498,3,256,134,190,66,13,659,0,18,677
7,7,7097,1499,3,429,172,291,109,11,1012,6,31,1049
7,7,7097,1500,3,175,134,178,65,8,560,1,16,577
7,7,7097,1501,3,290,194,282,106,9,881,2,23,906
7,7,7097,1502,3,330,222,395,120,21,1088,4,29,1121
7,7,7097,1503,3,41,96,48,82,2,269,0,21,290
7,7,7097,1504,3,186,98,97,46,5,432,1,15,448
7,7,7097,1505,3,75,79,30,7,2,193,1,10,204
7,7,7097,1506,3,121,94,136,61,9,421,1,33,455
7,7,7097,1507,3,187,84,55,36,3,365,0,11,376
7,7,7097,1508,3,233,121,142,479,7,982,0,92,1074
7,7,7097,1509,3,257,84,140,498,8,987,0,80,1067
7,7,7097,1510,3,439,273,211,117,9,1049,0,74,1123
7,7,7097,1511,3,544,103,103,20,4,774,0,28,802
7,7,7097,1512,3,560,152,196,48,18,974,4,40,1018
7,7,7097,1513,3,244,83,102,21,8,458,0,10,468
7,7,7097,1514,3,83,118,84,7,1,293,1,12,306
7,7,7097,1515,3,239,99,125,42,13,518,0,41,559
7,7,7097,1516,3,340,207,273,185,4,1009,1,54,1064
7,7,7097,1517,3,400,149,175,74,12,810,0,28,838
7,7,7097,1518,3,307,148,115,110,7,687,0,56,743
7,7,7097,1519,3,88,49,75,6,6,224,0,9,233
7,7,7097,1520,3,263,183,179,46,7,678,0,24,702
7,7,7097,1521,3,294,210,180,103,5,792,1,34,827
7,7,7097,1522,3,19,20,36,3,4,82,0,3,85
7,7,7097,1523,3,148,157,157,19,5,486,0,34,520
7,7,7097,1524,3,40,77,9,16,1,143,0,6,149
7,7,7097,1525,3,325,173,29,93,1,621,0,29,650
7,7,7097,1526,3,164,71,6,3,2,246,0,10,256
7,7,7097,1527,3,186,113,86,65,2,452,5,25,482
7,7,7097,1528,3,96,41,99,15,3,254,0,17,271
7,7,7097,1529,3,48,82,48,7,4,189,0,7,196
7,7,7107,1812,3,92,118,227,88,9,534,1,36,571
7,7,7107,1813,3,105,139,216,100,10,570,0,20,590
7,7,7107,1814,3,111,157,297,84,16,665,4,37,706
7,7,7107,1815,3,163,250,355,147,12,927,4,61,992
7,7,7107,1816,3,12,118,115,9,0,254,0,16,270
7,7,7107,1817,3,75,111,57,7,1,251,0,9,260
7,7,7107,1818,3,88,126,26,2,0,242,0,5,247
7,7,7107,1819,3,81,189,176,17,3,466,0,41,507
7,7,7107,1820,3,54,73,143,11,2,283,1,11,295
7,7,7107,1821,3,101,252,380,70,6,809,2,27,838
7,7,7107,1822,3,51,144,102,11,6,314,1,15,330
7,7,7107,1823,3,31,128,252,97,6,514,1,81,596
7,7,7107,1824,3,27,103,163,6,1,300,0,11,311
7,7,7107,1825,3,127,167,130,20,7,451,1,26,478
7,7,7107,1826,3,89,113,133,11,1,347,0,12,359
7,7,7107,1827,3,26,93,115,15,4,253,0,11,264
7,8,7011,116,3,29,220,134,2,1,386,10,4,400
7,8,7011,117,3,20,315,207,5,1,548,4,13,565
7,8,7011,118,3,3,114,65,0,2,184,1,7,192
7,8,7011,119,3,1,66,4,0,0,71,0,1,72
7,8,7011,120,3,26,197,125,3,0,351,0,17,368
7,8,7011,121,3,17,250,228,2,2,499,0,10,509
7,8,7011,122,3,17,127,119,5,1,269,0,9,278
7,8,7011,123,3,14,112,223,3,0,352,2,9,363
7,8,7011,124,3,35,230,115,5,0,385,0,19,404
7,8,7011,125,3,5,110,36,2,0,153,0,3,156
7,8,7011,126,3,5,264,167,0,1,437,0,19,456
7,8,7011,127,3,17,144,84,0,0,245,0,8,253
7,8,7011,128,3,30,263,253,40,1,587,0,35,622
7,8,7011,129,3,3,135,47,0,0,185,0,9,194
7,8,7019,239,3,129,483,299,44,9,964,5,51,1020
7,8,7019,240,3,101,486,199,44,15,845,4,54,903
7,8,7019,241,3,51,294,131,32,4,512,2,24,538
7,8,7019,242,3,122,396,241,46,8,813,0,46,859
7,8,7019,243,3,56,221,179,36,5,497,5,42,544
7,8,7019,244,3,101,481,277,30,14,903,5,34,942
7,8,7019,245,3,79,327,221,48,6,681,1,30,712
7,8,7019,246,3,75,337,134,47,4,597,1,29,627
7,8,7019,247,3,81,437,130,77,13,738,0,18,756
7,8,7019,248,3,109,493,298,55,10,965,1,38,1004
7,8,7019,249,3,91,389,249,49,7,785,4,19,808
7,8,7019,250,3,98,460,193,51,6,808,0,14,822
7,8,7019,251,3,77,435,147,52,5,716,0,23,739
7,8,7019,252,3,65,333,119,44,8,569,1,6,576
7,8,7019,253,3,58,305,92,36,6,497,0,15,512
7,8,7019,254,3,80,493,230,45,8,856,3,55,914
7,8,7019,255,3,86,387,199,33,6,711,10,35,756
7,8,7019,256,3,107,388,226,22,10,753,1,39,793
7,8,7019,257,3,131,631,292,43,15,1112,1,33,1146
7,8,7019,258,3,40,359,96,19,3,517,2,18,537
7,8,7019,259,3,101,516,273,46,8,944,1,40,985
7,8,7019,260,3,203,891,453,116,24,1687,5,44,1736
7,8,7019,261,3,144,474,357,49,9,1033,1,21,1055
7,8,7019,262,3,172,523,354,52,20,1121,5,31,1157
7,8,7019,263,3,114,553,302,19,10,998,4,30,1032
7,8,7019,264,3,104,322,195,20,13,654,5,16,675
7,8,7019,265,3,119,315,253,15,16,718,4,32,754
7,8,7019,266,3,248,734,485,80,45,1592,10,82,1684
7,8,7019,267,3,46,153,115,15,7,336,0,14,350
7,8,7019,268,3,13,222,81,3,2,321,1,38,360
7,8,7019,269,3,4,87,54,4,2,151,0,14,165
7,8,7019,270,3,7,165,133,8,4,317,0,24,341
7,8,7019,271,3,22,229,196,0,0,447,0,34,481
7,8,7019,272,3,5,115,52,1,1,174,0,16,190
7,8,7019,273,3,30,229,92,2,1,354,0,64,418
7,8,7019,274,3,9,94,92,1,0,196,1,13,210
7,8,7019,275,3,22,225,43,13,3,306,1,23,330
7,8,7019,276,3,6,198,76,6,0,286,4,29,319
7,8,7019,277,3,14,144,169,4,1,332,1,30,363
7,8,7019,278,3,6,87,91,1,2,187,0,26,213
7,8,7019,279,3,39,263,110,49,7,468,0,70,538
7,8,7019,280,3,15,87,82,5,5,194,1,26,221
7,8,7019,281,3,11,134,94,6,3,248,3,22,273
7,8,7019,282,3,30,77,163,7,3,280,3,44,327
7,8,7019,283,3,31,181,61,9,4,286,2,29,317
7,8,7019,284,3,63,224,155,15,1,458,6,27,491
7,8,7019,285,3,52,150,97,1,6,306,0,39,345
7,8,7019,286,3,35,232,96,8,1,372,0,23,395
7,8,7019,287,3,29,161,146,5,4,345,0,25,370
7,8,7019,288,3,46,210,89,14,1,360,1,16,377
7,8,7019,289,3,94,280,236,45,6,661,1,31,693
7,8,7019,290,3,15,261,227,3,4,510,0,34,544
7,8,7019,291,3,48,228,146,7,4,433,1,28,462
7,8,7030,439,3,31,185,218,3,3,440,3,17,460
7,8,7030,440,3,128,257,301,14,6,706,2,30,738
7,8,7030,441,3,58,175,257,4,2,496,4,6,506
7,8,7030,442,3,44,176,168,1,1,390,1,17,408
7,8,7030,443,3,14,84,93,1,1,193,0,14,207
7,8,7030,444,3,55,302,311,10,3,681,1,65,747
7,8,7030,445,3,16,146,197,2,1,362,0,31,393
7,8,7030,446,3,38,116,118,3,3,278,0,24,302
7,8,7030,447,3,14,352,197,4,0,567,0,24,591
7,8,7030,448,3,10,120,237,1,0,368,0,19,387
7,8,7030,449,3,27,143,262,2,6,440,6,29,475
7,8,7030,450,3,23,141,220,2,2,388,0,8,396
7,8,7030,451,3,19,283,306,31,1,640,0,39,679
7,8,7030,452,3,15,348,122,2,0,487,3,10,500
7,8,7030,453,3,24,30,164,1,4,223,0,17,240
7,8,7030,454,3,10,259,226,2,2,499,2,20,521
7,8,7030,455,3,12,126,199,1,0,338,0,19,357
7,8,7034,504,3,51,217,439,26,2,735,0,35,770
7,8,7034,505,3,86,300,389,22,16,813,1,41,855
7,8,7034,506,3,84,319,331,38,14,786,6,46,838
7,8,7034,507,3,76,456,460,43,6,1041,5,44,1090
7,8,7034,508,3,53,196,243,16,4,512,2,20,534
7,8,7034,509,3,34,135,100,4,3,276,0,17,293
7,8,7034,510,3,5,36,24,2,0,67,0,5,72
7,8,7034,511,3,24,36,169,7,2,238,1,12,251
7,8,7034,512,3,60,66,279,5,5,415,2,13,430
7,8,7034,513,3,26,96,109,3,3,237,0,18,255
7,8,7034,514,3,34,234,250,8,3,529,1,30,560
7,8,7034,515,3,8,33,61,2,1,105,0,7,112
7,8,7034,516,3,6,247,18,1,1,273,1,4,278
7,8,7034,517,3,12,158,216,10,0,396,0,26,422
7,8,7034,518,3,7,60,121,9,1,198,0,7,205
7,8,7034,519,3,11,33,11,0,0,55,0,3,58
7,8,7034,520,3,55,205,322,8,8,598,0,54,652
7,8,7034,521,3,11,104,52,4,1,172,0,14,186
7,8,7034,522,3,21,83,75,5,0,184,0,12,196
7,8,7034,523,3,15,101,102,3,1,222,2,14,238
7,8,7034,524,3,12,152,170,6,1,341,2,16,359
7,8,7034,525,3,6,150,171,2,1,330,1,22,353
7,8,7034,526,3,41,178,55,5,6,285,0,22,307
7,8,7034,527,3,19,147,114,4,3,287,1,45,333
7,8,7034,528,3,3,97,95,1,0,196,0,15,211
7,8,7034,529,3,79,351,307,23,4,764,0,46,810
7,8,7034,530,3,89,243,226,9,2,569,0,44,613
7,8,7034,531,3,10,128,139,2,0,279,2,13,294
7,8,7041,602,3,95,464,184,35,2,780,2,47,829
7,8,7041,603,3,44,236,117,28,6,431,0,25,456
7,8,7041,604,3,45,284,113,95,4,541,0,62,603
7,8,7041,605,3,18,68,55,43,3,187,0,14,201
7,8,7041,606,3,23,146,386,14,4,573,0,53,626
7,8,7041,607,3,71,169,248,55,5,548,0,43,591
7,8,7041,608,3,114,297,263,0,2,676,2,14,692
7,8,7041,609,3,11,35,105,0,1,152,1,9,162
7,8,7041,610,3,68,511,128,32,10,749,0,48,797
7,8,7041,611,3,8,136,43,0,0,187,0,30,217
7,8,7041,612,3,83,212,117,6,1,419,1,10,430
7,8,7041,613,3,35,288,62,1,9,395,0,68,463
7,8,7041,614,3,36,130,40,22,2,230,0,19,249
7,8,7041,615,3,34,66,31,32,2,165,1,9,175
7,8,7041,616,3,7,71,13,17,1,109,2,7,118
7,8,7084,1226,3,65,290,418,14,4,791,3,38,832
7,8,7084,1227,3,42,202,434,12,10,700,2,34,736
7,8,7084,1228,3,34,108,338,4,3,487,3,26,516
7,8,7084,1229,3,21,59,81,3,0,164,0,13,177
7,8,7084,1230,3,30,224,250,9,5,518,22,10,550
7,8,7084,1231,3,53,143,235,4,2,437,8,44,489
7,8,7084,1232,3,46,365,223,6,5,645,3,20,668
7,8,7099,1532,3,17,42,52,2,2,115,3,3,121
7,8,7099,1533,3,78,236,263,30,13,620,1,40,661
7,8,7099,1534,3,60,134,159,18,3,374,2,23,399
7,8,7099,1535,3,70,186,244,31,8,539,2,11,552
7,8,7099,1536,3,207,282,311,58,13,871,1,22,894
7,8,7099,1537,3,137,114,290,8,6,555,4,26,585
7,8,7099,1538,3,24,101,415,16,3,559,0,32,591
7,8,7099,1539,3,36,239,366,16,5,662,1,29,692
7,8,7099,1540,3,31,190,246,1,1,469,0,33,502
7,8,7099,1541,3,49,325,587,6,6,973,1,25,999
7,8,7099,1542,3,18,178,274,7,3,480,1,37,518
7,8,7099,1543,3,22,120,294,5,5,446,0,28,474
7,8,7099,1544,3,34,288,257,7,4,590,0,46,636
7,8,7099,1545,3,38,207,185,2,3,435,6,51,492
7,8,7099,1546,3,15,198,302,9,2,526,0,43,569
7,8,7099,1547,3,7,86,182,2,4,281,0,23,304
7,8,7099,1548,3,9,435,357,1,5,807,0,48,855
7,8,7099,1549,3,13,99,187,2,1,302,1,17,320
7,8,7099,1550,3,31,58,104,6,0,199,0,22,221
7,8,7099,1551,3,17,40,229,11,2,299,0,30,329
7,8,7099,1552,3,16,199,433,1,1,650,3,52,705
7,8,7099,1553,3,6,83,227,16,1,333,0,0,333
7,8,7099,1554,3,40,222,290,4,1,557,3,36,596
7,8,7099,1555,3,56,101,191,3,4,355,0,39,394
7,8,7099,1556,3,41,181,197,1,0,420,0,29,449
7,8,7099,1557,3,16,88,228,22,4,358,0,24,382
7,8,7099,1558,3,46,120,294,9,6,475,2,78,555
7,8,7099,1559,3,27,205,325,4,5,566,3,44,613
7,8,7099,1560,3,13,118,76,4,2,213,0,30,243
7,8,7099,1561,3,22,176,259,3,0,460,0,31,491
7,8,7099,1562,3,15,138,124,1,0,278,3,19,300
7,8,7099,1563,3,10,57,39,0,1,107,0,1,108
7,8,7099,1564,3,47,133,427,3,10,620,2,43,665
7,8,7099,1565,3,27,166,234,8,1,436,2,27,465
7,8,7099,1566,3,40,244,101,2,3,390,2,20,412
7,8,7099,1567,3,14,135,178,4,0,331,0,0,331
7,8,7104,1771,3,103,305,187,4,5,604,0,34,638
7,8,7104,1772,3,27,126,174,4,0,331,0,16,347
7,8,7104,1773,3,101,365,363,6,4,839,0,3,842
7,8,7104,1774,3,20,89,142,1,0,252,1,17,270
7,8,7104,1775,3,60,392,151,4,1,608,8,36,652
7,8,7104,1776,3,54,325,140,9,1,529,7,22,558
7,8,7104,1777,3,55,207,123,1,2,388,3,24,415
7,9,7102,1602,3,410,747,695,40,17,1909,6,79,1994
7,9,7102,1603,3,180,408,278,9,4,879,6,46,931
7,9,7102,1604,3,231,398,365,19,9,1022,5,43,1070
7,9,7102,1605,3,190,377,313,18,1,899,2,26,927
7,9,7102,1606,3,1323,1672,2227,111,73,5406,38,179,5623
7,9,7102,1607,3,344,181,258,9,9,801,0,38,839
7,9,7102,1608,3,228,551,532,21,10,1342,8,53,1403
7,9,7102,1609,3,379,558,644,33,16,1630,7,54,1691
7,9,7102,1610,3,400,688,721,51,38,1898,3,53,1954
7,9,7102,1611,3,277,417,688,36,15,1433,3,43,1479
7,9,7102,1612,3,261,345,492,31,11,1140,9,34,1183
7,9,7102,1613,3,208,317,404,40,13,982,2,24,1008
7,9,7102,1614,3,314,351,426,32,21,1144,7,42,1193
7,9,7102,1615,3,329,461,618,34,10,1452,7,36,1495
7,9,7102,1616,3,914,945,1287,69,56,3271,10,87,3368
7,9,7102,1617,3,375,413,751,44,26,1609,2,48,1659
7,9,7102,1618,3,251,288,434,26,25,1024,3,29,1056
7,9,7102,1619,3,243,287,434,24,20,1008,1,30,1039
7,9,7102,1620,3,323,348,462,30,26,1189,2,19,1210
7,9,7102,1621,3,137,128,200,19,4,488,0,9,497
7,9,7102,1622,3,317,483,502,29,11,1342,5,38,1385
7,9,7102,1623,3,121,195,335,10,7,668,2,27,697
7,9,7102,1624,3,168,283,394,20,8,873,1,33,907
7,9,7102,1625,3,222,412,563,14,22,1233,3,32,1268
7,9,7102,1626,3,245,231,342,22,13,853,0,22,875
7,9,7102,1627,3,288,229,333,23,31,904,0,18,922
7,9,7102,1628,3,228,327,339,38,22,954,0,10,964
7,9,7102,1629,3,433,473,710,52,33,1701,1,48,1750
7,9,7102,1630,3,285,274,423,28,27,1037,2,23,1062
7,9,7102,1631,3,238,266,412,32,23,971,2,25,998
7,9,7102,1632,3,158,188,239,23,6,614,0,12,626
7,9,7102,1633,3,360,289,382,30,17,1078,3,38,1119
7,9,7102,1634,3,205,265,345,28,33,876,1,17,894
7,9,7102,1635,3,195,152,129,13,4,493,0,9,502
7,9,7102,1636,3,404,267,348,23,15,1057,7,21,1085
7,9,7102,1645,3,395,289,364,17,19,1084,2,22,1108
7,9,7102,1646,3,459,333,339,20,20,1171,3,25,1199
7,9,7102,1647,3,417,270,428,18,22,1155,4,27,1186
7,9,7102,1648,3,312,282,271,20,7,892,0,26,918
7,9,7102,1649,3,404,276,329,37,14,1060,0,23,1083
7,9,7102,1650,3,143,191,192,19,8,553,2,10,565
7,9,7102,1651,3,255,325,377,31,19,1007,4,23,1034
7,9,7102,1652,3,278,251,298,25,12,864,2,28,894
7,9,7102,1653,3,315,301,441,47,27,1131,2,30,1163
7,9,7102,1654,3,240,208,337,34,13,832,3,11,846
7,9,7102,1655,3,335,334,402,37,25,1133,2,21,1156
7,9,7102,1656,3,224,234,352,26,17,853,1,6,860
7,9,7102,1657,3,425,458,627,64,39,1613,6,20,1639
7,9,7102,1658,3,602,449,559,31,22,1663,1,37,1701
7,9,7102,1659,3,251,377,526,35,16,1205,4,24,1233
7,9,7102,1660,3,178,331,520,22,18,1069,5,26,1100
7,9,7102,1661,3,197,333,524,27,11,1092,8,20,1120
7,9,7102,1662,3,444,377,483,34,25,1363,6,17,1386
7,9,7102,1663,3,456,438,696,46,27,1663,5,32,1700
7,9,7102,1664,3,253,236,374,26,17,906,5,23,934
7,9,7102,1665,3,218,195,270,24,15,722,3,11,736
7,9,7102,1666,3,282,229,368,27,20,926,4,19,949
7,9,7102,1667,3,201,117,191,25,12,546,1,19,566
7,9,7102,1668,3,323,217,355,16,15,926,3,24,953
7,9,7102,1669,3,307,290,329,15,18,959,2,33,994
7,9,7102,1670,3,172,227,284,22,12,717,3,7,727
7,9,7102,1671,3,261,241,276,30,17,825,3,18,846
7,9,7102,1674,3,284,228,250,24,17,803,1,19,823
7,9,7102,1675,3,322,173,157,10,7,669,0,15,684
7,9,7102,1676,3,293,167,182,20,14,676,4,14,694
7,9,7102,1677,3,174,125,136,16,10,461,0,153,614
7,9,7102,1678,3,163,209,220,16,10,618,1,14,633
7,9,7102,1679,3,255,201,230,18,14,718,0,11,729
7,9,7102,1680,3,258,211,286,22,12,789,1,18,808
7,9,7102,1681,3,289,222,276,16,11,814,2,15,831
7,9,7102,1682,3,262,242,434,33,11,982,2,18,1002
7,9,7102,1683,3,368,271,425,34,21,1119,1,30,1150
7,9,7102,1684,3,249,317,318,17,17,918,0,28,946
7,9,7102,1685,3,542,513,529,46,21,1651,2,29,1682
7,9,7102,1686,3,270,376,489,31,26,1192,0,32,1224
7,9,7102,1687,3,167,191,284,30,18,690,0,19,709
7,9,7102,1688,3,175,185,284,18,22,684,1,16,701
7,9,7102,1689,3,314,264,419,36,19,1052,2,17,1071
7,9,7102,1690,3,258,275,374,43,15,965,4,20,989
7,9,7102,1691,3,248,243,321,25,14,851,5,23,879
7,9,7102,1692,3,201,170,320,28,18,737,4,14,755
7,9,7102,1693,3,233,185,279,16,13,726,0,25,751
7,9,7102,1694,3,245,169,219,11,5,649,0,17,666
7,9,7102,1695,3,262,217,217,13,13,722,1,20,743
7,9,7102,1696,3,225,158,237,11,8,639,1,8,648
7,9,7102,1697,3,181,140,172,20,20,533,0,15,548
7,9,7102,1698,3,373,290,406,34,24,1127,7,18,1152
7,9,7102,1699,3,396,246,282,22,11,957,3,22,982
7,9,7102,1700,3,498,338,504,32,19,1391,3,17,1411
7,9,7102,1707,3,543,405,523,46,32,1549,3,39,1591
7,9,7102,1708,3,380,285,406,41,26,1138,4,28,1170
7,9,7102,1709,3,376,259,327,31,20,1013,3,29,1045
7,9,7102,1710,3,150,136,171,10,6,473,1,20,494
7,9,7102,1711,3,223,116,232,11,12,594,0,16,610
7,9,7102,1712,3,234,183,370,28,21,836,2,7,845
7,9,7102,1713,3,192,214,387,28,17,838,2,29,869
7,9,7102,1714,3,278,289,406,36,19,1028,2,22,1052
7,9,7102,1715,3,192,250,382,27,16,867,2,27,896
7,9,7102,1716,3,196,287,454,29,23,989,0,32,1021
7,9,7102,1717,3,295,380,573,50,30,1328,4,29,1361
7,9,7102,1718,3,190,220,315,21,16,762,1,12,775
7,9,7102,1719,3,211,179,235,29,22,676,1,17,694
7,9,7102,1720,3,253,261,383,29,19,945,1,35,981
7,9,7102,1721,3,244,206,410,21,9,890,3,21,914
7,9,7102,1722,3,163,214,234,20,10,641,0,16,657
7,9,7102,1723,3,306,255,405,27,11,1004,1,23,1028
7,9,7102,1724,3,244,263,363,18,13,901,0,18,919
7,9,7102,1725,3,231,248,357,37,16,889,2,31,922
7,9,7102,1726,3,260,261,354,34,15,924,3,21,948
7,9,7102,1727,3,228,251,316,26,13,834,4,20,858
7,9,7102,1728,3,184,186,241,17,10,638,0,22,660
7,9,7102,1729,3,401,480,716,47,38,1682,6,55,1743
7,9,7102,1730,3,404,411,722,52,29,1618,2,49,1669
7,9,7102,1731,3,335,447,555,48,24,1409,2,28,1439
7,9,7102,1732,3,266,319,441,27,21,1074,3,33,1110
7,9,7102,1733,3,252,305,489,20,16,1082,1,20,1103
7,9,7102,1734,3,259,245,341,25,17,887,5,31,923
7,9,7102,1740,3,373,365,490,29,17,1274,11,31,1316
7,9,7102,1741,3,253,262,419,24,19,977,16,26,1019
7,9,7102,1743,3,461,707,903,56,32,2159,12,67,2238
7,9,7102,1744,3,838,1348,1661,122,44,4013,3,124,4140
7,9,7102,1750,3,535,735,925,55,44,2294,5,60,2359
7,9,7102,1751,3,182,314,328,18,22,864,0,37,901
7,9,7102,1752,3,71,135,62,3,7,278,1,6,285
7,9,7102,1754,3,164,204,214,18,7,607,0,13,620
7,10,7008,72,3,109,295,187,4,6,601,2,0,603
7,10,7008,73,3,140,294,216,15,7,672,4,41,717
7,10,7008,74,3,167,203,154,2,2,528,0,28,556
7,10,7008,75,3,122,207,158,6,8,501,1,41,543
7,10,7008,76,3,115,374,200,1,4,694,2,105,801
7,10,7008,77,3,107,248,239,2,3,599,0,42,641
7,10,7008,78,3,335,280,316,2,5,938,0,60,998
7,10,7008,79,3,60,86,102,2,0,250,2,13,265
7,10,7008,80,3,38,206,267,0,1,512,0,42,554
7,10,7008,81,3,129,169,40,15,1,354,1,25,380
7,10,7008,82,3,20,181,205,2,2,410,1,25,436
7,10,7008,83,3,337,324,139,8,2,810,0,18,828
7,10,7008,84,3,120,191,170,0,2,483,0,16,499
7,10,7008,85,3,33,5,37,2,0,77,0,6,83
7,10,7008,86,3,184,163,66,0,2,415,0,35,450
7,10,7008,87,3,248,183,38,0,2,471,6,25,502
7,10,7017,197,3,49,144,231,26,4,454,4,18,476
7,10,7017,198,3,77,116,271,45,6,515,0,22,537
7,10,7017,199,3,95,225,416,75,9,820,0,35,855
7,10,7017,200,3,99,255,413,105,13,885,0,28,913
7,10,7017,201,3,133,162,328,82,4,709,0,15,724
7,10,7017,202,3,70,175,315,73,6,639,1,37,677
7,10,7017,203,3,86,115,382,49,10,642,1,23,666
7,10,7017,204,3,116,136,296,87,10,645,0,15,660
7,10,7017,205,3,89,150,356,123,8,726,0,18,744
7,10,7017,206,3,96,111,396,74,10,687,2,20,709
7,10,7017,207,3,139,213,516,122,13,1003,8,41,1052
7,10,7017,208,3,75,227,481,67,11,861,4,37,902
7,10,7017,209,3,103,114,270,45,4,536,5,35,576
7,10,7017,210,3,117,152,370,58,7,704,4,11,719
7,10,7017,211,3,100,251,476,75,10,912,5,47,964
7,10,7017,212,3,94,107,331,35,2,569,6,29,604
7,10,7017,213,3,40,123,187,1,3,354,3,31,388
7,10,7017,214,3,75,306,228,9,6,624,3,39,666
7,10,7017,215,3,61,243,284,12,4,604,1,18,623
7,10,7017,216,3,10,40,47,4,0,101,0,4,105
7,10,7017,217,3,38,130,345,42,2,557,4,39,600
7,10,7017,218,3,33,128,148,8,1,318,0,13,331
7,10,7017,219,3,21,201,239,0,0,461,1,16,478
7,10,7017,220,3,31,95,114,11,0,251,0,7,258
7,10,7017,221,3,35,161,210,30,7,443,0,20,463
7,10,7017,222,3,56,72,122,40,1,291,0,9,300
7,10,7017,223,3,109,188,519,55,10,881,1,50,932
7,10,7017,224,3,49,98,249,38,5,439,0,9,448
7,10,7017,225,3,76,158,243,34,3,514,1,53,568
7,10,7017,226,3,47,67,41,13,1,169,1,9,179
7,10,7017,227,3,19,31,46,2,0,98,0,3,101
7,10,7017,228,3,44,51,109,6,1,211,9,12,232
7,10,7017,229,3,19,173,123,15,5,335,0,17,352
7,10,7017,230,3,170,181,188,16,4,559,2,75,636
7,10,7017,231,3,31,133,243,18,5,430,0,8,438
7,10,7017,232,3,74,302,309,19,4,708,2,4,714
7,10,7017,233,3,28,202,159,13,1,403,0,8,411
7,10,7020,293,3,212,286,164,9,7,678,0,69,747
7,10,7020,294,3,173,209,254,7,8,651,0,58,709
7,10,7020,295,3,126,144,113,2,4,389,0,17,406
7,10,7020,296,3,102,137,101,10,3,353,0,8,361
7,10,7020,297,3,2,9,14,1,0,26,0,4,30
7,10,7020,298,3,38,312,120,2,3,475,3,48,526
7,10,7020,299,3,67,456,311,10,11,855,3,38,896
7,10,7020,300,3,86,302,157,5,6,556,5,62,623
7,10,7020,301,3,68,210,213,6,4,501,1,0,502
7,10,7020,302,3,25,186,159,1,3,374,0,21,395
7,10,7020,303,3,15,88,154,4,0,261,0,18,279
7,10,7020,304,3,9,11,13,0,0,33,0,0,33
7,10,7020,305,3,47,166,115,0,4,332,0,39,371
7,10,7020,306,3,45,205,235,1,0,486,3,45,534
7,10,7020,307,3,65,132,135,0,4,336,0,19,355
7,10,7020,308,3,20,97,191,2,1,311,1,24,336
7,10,7020,309,3,18,79,43,0,0,140,0,21,161
7,10,7020,310,3,9,165,178,0,1,353,0,9,362
7,10,7020,311,3,35,278,188,3,11,515,3,58,576
7,10,7020,312,3,61,324,475,11,6,877,1,31,909
7,10,7020,313,3,36,128,89,1,1,255,0,28,283
7,10,7020,314,3,66,179,130,2,1,378,6,35,419
7,10,7020,315,3,153,203,133,8,5,502,3,65,570
7,10,7020,316,3,25,129,145,3,6,308,2,36,346
7,10,7046,638,3,17,122,163,10,2,314,0,5,319
7,10,7046,639,3,60,268,549,28,3,908,3,23,934
7,10,7046,640,3,40,293,353,32,8,726,1,12,739
7,10,7046,641,3,71,259,444,25,4,803,5,34,842
7,10,7046,642,3,41,159,279,11,5,495,0,22,517
7,10,7046,643,3,21,319,260,10,1,611,1,17,629
7,10,7046,644,3,43,363,276,23,6,711,1,17,729
7,10,7046,645,3,69,183,133,5,2,392,1,14,407
7,10,7046,646,3,32,90,188,9,0,319,0,15,334
7,10,7046,647,3,70,183,349,6,3,611,1,16,628
7,10,7046,648,3,19,109,242,2,0,372,1,12,385
7,10,7046,649,3,30,171,214,4,3,422,0,40,462
7,10,7046,650,3,37,139,209,12,1,398,2,20,420
7,10,7046,651,3,42,178,416,18,3,657,0,38,695
7,10,7046,652,3,34,225,401,5,6,671,0,38,709
7,10,7046,653,3,44,98,346,5,1,494,0,25,519
7,10,7046,654,3,36,171,235,4,2,448,0,29,477
7,10,7046,655,3,63,90,272,1,2,428,2,19,449
7,10,7046,656,3,12,40,158,0,0,210,0,19,229
7,10,7046,657,3,29,84,223,13,2,351,0,38,389
7,10,7046,658,3,25,199,404,53,8,689,3,26,718
7,10,7046,659,3,36,62,334,39,7,478,0,26,504
7,10,7046,660,3,35,52,268,20,2,377,0,26,403
7,10,7046,661,3,22,66,357,7,5,457,1,34,492
7,10,7108,1828,3,294,290,340,7,4,935,2,38,975
7,10,7108,1829,3,193,312,161,14,7,687,2,18,707
7,10,7108,1830,3,181,305,205,8,4,703,0,30,733
7,10,7108,1831,3,252,311,232,11,1,807,0,20,827
7,10,7108,1832,3,160,202,318,9,6,695,8,43,746
7,10,7108,1833,3,180,225,272,18,7,702,1,46,749
7,10,7108,1834,3,157,215,223,8,5,608,1,33,642
7,10,7108,1835,3,178,255,303,7,4,747,7,29,783
7,10,7108,1836,3,60,130,106,6,2,304,0,27,331
7,10,7108,1837,3,66,323,397,10,6,802,1,26,829
7,10,7108,1838,3,64,66,95,0,3,228,0,19,247
7,10,7108,1839,3,112,252,331,2,3,700,0,25,725
7,10,7108,1840,3,142,361,610,45,12,1170,8,41,1219
7,10,7108,1841,3,68,390,635,50,9,1152,5,59,1216
7,10,7108,1842,3,55,71,108,2,1,237,0,0,237
7,10,7108,1843,3,52,121,162,5,3,343,0,16,359
7,10,7108,1844,3,98,333,209,4,7,651,0,21,672
7,10,7108,1845,3,243,421,499,8,6,1177,2,59,1238
7,10,7108,1846,3,121,298,566,5,9,999,2,59,1060
7,10,7108,1847,3,14,37,89,2,0,142,0,1,143
7,10,7108,1848,3,34,97,310,0,3,444,0,7,451
7,10,7108,1849,3,112,208,258,16,5,599,0,17,616
7,10,7108,1850,3,59,118,222,3,5,407,0,15,422
7,10,7108,1851,3,124,93,171,4,5,397,1,16,414
7,10,7108,1852,3,125,189,135,2,1,452,2,30,484
7,10,7108,1853,3,174,151,163,3,1,492,1,26,519
7,10,7108,1854,3,53,61,128,0,0,242,0,18,260
7,10,7108,1855,3,135,86,136,0,1,358,1,19,378
7,10,7109,1856,3,142,267,149,17,4,579,0,9,588
7,10,7109,1857,3,185,243,146,18,4,596,6,13,615
7,10,7109,1858,3,212,334,218,26,10,800,1,37,838
7,10,7109,1859,3,231,201,156,24,4,616,1,24,641
7,10,7109,1860,3,295,290,280,26,11,902,1,21,924
7,10,7109,1861,3,123,148,88,20,3,382,0,7,389
7,10,7109,1862,3,166,153,180,22,3,524,0,18,542
7,10,7109,1863,3,90,135,135,22,6,388,0,16,404
7,10,7109,1864,3,100,226,162,17,2,507,0,15,522
7,10,7109,1865,3,296,327,250,16,6,895,0,15,910
7,10,7109,1866,3,133,128,146,9,3,419,3,21,443
7,10,7109,1867,3,218,257,258,27,12,772,0,25,797
7,10,7109,1868,3,213,236,246,24,11,730,0,17,747
7,10,7109,1869,3,190,207,254,18,25,694,0,12,706
7,10,7109,1870,3,98,199,140,13,6,456,1,22,479
7,10,7109,1871,3,339,385,327,30,16,1097,6,35,1138
7,10,7109,1872,3,70,126,202,13,1,412,6,20,438
7,10,7109,1873,3,130,101,150,11,3,395,2,10,407
7,10,7109,1874,3,44,268,283,15,1,611,2,23,636
7,10,7109,1875,3,37,70,22,2,0,131,2,0,133
7,10,7109,1876,3,74,145,111,0,4,334,0,21,355
7,10,7109,1877,3,111,244,249,9,5,618,3,15,636
7,10,7109,1878,3,347,136,136,8,2,629,5,31,665
7,10,7109,1879,3,63,122,221,9,2,417,1,19,437
7,10,7109,1880,3,59,137,115,5,0,316,2,12,330
7,10,7109,1881,3,213,143,293,15,10,674,1,28,703
7,10,7109,1882,3,191,222,333,12,8,766,0,31,797
7,10,7109,1883,3,143,204,143,7,2,499,1,23,523
7,10,7109,1884,3,228,130,164,7,3,532,1,32,565
7,10,7109,1885,3,89,215,264,8,1,577,0,26,603
7,10,7109,1886,3,139,351,358,3,3,854,1,35,890
7,10,7109,1887,3,40,97,109,2,2,250,0,7,257
7,10,7109,1888,3,63,217,262,2,3,547,1,32,580
7,10,7109,1889,3,121,188,80,4,1,394,1,26,421
7,10,7109,1890,3,273,302,354,1,5,935,3,51,989
7,10,7109,1891,3,107,150,219,3,3,482,1,20,503
7,10,7109,1892,3,74,116,199,6,0,395,0,17,412
7,10,7109,1893,3,121,123,162,6,1,413,0,18,431
7,10,7109,1894,3,76,205,217,7,0,505,0,43,548
7,10,7109,1895,3,68,291,299,0,2,660,2,26,688
7,10,7109,1896,3,122,131,168,4,0,425,1,21,447
7,10,7109,1897,3,69,210,161,2,3,445,0,10,455
7,10,7109,1898,3,194,210,246,8,4,662,0,48,710
7,10,7109,1899,3,91,130,164,3,9,397,0,23,420
7,10,7109,1900,3,14,57,99,1,0,171,0,6,177
7,10,7109,1901,3,81,386,341,17,14,839,3,41,883
7,11,7006,54,3,34,239,298,15,6,592,0,19,611
7,11,7006,55,3,33,156,175,2,2,368,2,21,391
7,11,7006,56,3,43,133,192,3,2,373,0,21,394
7,11,7006,57,3,12,107,475,0,1,595,1,32,628
7,11,7006,58,3,6,131,153,2,0,292,0,7,299
7,11,7006,59,3,13,190,260,1,4,468,1,17,486
7,11,7006,60,3,21,257,349,3,5,635,3,16,654
7,11,7006,61,3,51,296,335,3,7,692,1,76,769
7,11,7006,62,3,236,332,237,13,9,827,1,48,876
7,11,7006,63,3,45,62,50,2,2,161,0,12,173
7,11,7006,64,3,9,169,220,7,4,409,1,5,415
7,11,7006,65,3,27,188,388,5,6,614,0,29,643
7,11,7006,66,3,10,281,387,5,3,686,0,30,716
7,11,7006,67,3,19,201,289,2,2,513,4,21,538
7,11,7010,113,3,18,177,219,10,2,426,0,21,447
7,11,7010,114,3,17,342,169,0,0,528,1,27,556
7,11,7010,115,3,14,288,75,1,0,378,0,14,392
7,11,7015,163,3,85,170,314,11,15,595,0,36,631
7,11,7015,164,3,188,408,437,24,13,1070,15,54,1139
7,11,7015,165,3,79,218,224,19,7,547,4,19,570
7,11,7015,166,3,65,205,189,9,4,472,1,17,490
7,11,7015,167,3,84,172,278,8,8,550,0,35,585
7,11,7015,168,3,79,185,160,12,3,439,2,16,457
7,11,7015,169,3,64,146,220,11,8,449,0,27,476
7,11,7015,170,3,120,133,108,0,3,364,1,13,378
7,11,7015,171,3,49,105,86,1,5,246,1,13,260
7,11,7015,172,3,76,68,92,0,2,238,1,17,256
7,11,7015,173,3,105,96,230,3,3,437,2,11,450
7,11,7015,174,3,57,82,150,5,1,295,0,0,295
7,11,7015,175,3,88,146,206,7,9,456,4,38,498
7,11,7015,176,3,76,227,300,16,6,625,8,43,676
7,11,7015,177,3,24,152,119,3,5,303,3,21,327
7,11,7015,178,3,36,239,440,7,5,727,8,35,770
7,11,7015,179,3,24,210,262,3,5,504,1,26,531
7,11,7015,180,3,41,179,311,4,1,536,0,29,565
7,11,7015,181,3,85,251,343,4,4,687,7,28,722
7,11,7015,182,3,48,178,356,11,5,598,4,36,638
7,11,7015,183,3,28,176,369,4,1,578,7,22,607
7,11,7015,184,3,108,240,457,6,2,813,2,47,862
7,11,7015,185,3,37,122,176,5,3,343,1,19,363
7,11,7036,537,3,36,284,264,12,5,601,3,24,628
7,11,7036,538,3,25,244,163,1,4,437,1,10,448
7,11,7036,539,3,15,205,248,6,5,479,1,10,490
7,11,7037,540,3,180,377,268,6,5,836,2,43,881
7,11,7037,541,3,165,395,289,19,12,880,2,36,918
7,11,7037,542,3,143,254,268,31,5,701,5,38,744
7,11,7037,543,3,158,320,360,17,8,863,5,12,880
7,11,7037,544,3,25,145,171,0,4,345,0,15,360
7,11,7037,545,3,30,280,247,4,1,562,0,32,594
7,11,7037,546,3,102,85,361,8,1,557,0,23,580
7,11,7037,547,3,60,104,415,3,6,588,2,21,611
7,11,7037,548,3,107,191,543,37,11,889,2,48,939
7,11,7037,549,3,17,71,167,0,1,256,0,15,271
7,11,7037,550,3,8,133,98,3,0,242,12,12,266
7,11,7037,551,3,17,109,160,2,5,293,0,17,310
7,11,7037,552,3,142,200,542,23,13,920,14,65,999
7,11,7037,553,3,131,255,527,32,14,959,0,26,985
7,11,7037,554,3,66,219,329,11,6,631,12,30,673
7,11,7037,555,3,37,300,187,2,4,530,1,15,546
7,11,7040,577,3,247,165,166,6,0,584,4,18,606
7,11,7040,578,3,262,189,224,25,3,703,1,28,732
7,11,7040,579,3,269,169,251,16,7,712,1,11,724
7,11,7040,580,3,263,183,212,12,4,674,9,20,703
7,11,7040,581,3,248,178,182,11,10,629,4,28,661
7,11,7040,582,3,220,90,139,16,5,470,3,21,494
7,11,7040,583,3,249,127,139,12,1,528,0,12,540
7,11,7040,584,3,333,180,253,9,7,782,0,28,810
7,11,7040,585,3,229,140,111,13,4,497,0,15,512
7,11,7040,586,3,331,220,201,44,11,807,0,26,833
7,11,7040,587,3,388,249,235,37,3,912,0,32,944
7,11,7040,588,3,277,157,155,15,9,613,0,29,642
7,11,7040,589,3,494,204,239,39,8,984,2,34,1020
7,11,7040,590,3,296,152,171,20,4,643,0,21,664
7,11,7040,591,3,116,143,87,0,2,348,0,21,369
7,11,7040,592,3,133,58,78,2,1,272,1,19,292
7,11,7040,593,3,218,139,75,1,1,434,2,32,468
7,11,7040,594,3,156,117,138,7,8,426,1,9,436
7,11,7040,595,3,260,200,73,6,6,545,0,14,559
7,11,7040,596,3,298,108,112,5,2,525,0,30,555
7,11,7040,597,3,149,210,145,11,7,522,1,14,537
7,11,7040,598,3,339,367,83,7,2,798,0,26,824
7,11,7040,599,3,363,367,140,9,3,882,0,33,915
7,11,7040,600,3,170,155,62,7,2,396,0,13,409
7,11,7040,601,3,132,33,7,0,0,172,0,4,176
7,11,7053,760,3,16,356,348,22,4,746,0,50,796
7,11,7053,761,3,8,178,82,2,0,270,0,3,273
7,11,7053,762,3,62,184,248,1,0,495,0,8,503
7,11,7053,763,3,4,109,192,0,0,305,0,7,312
7,11,7053,764,3,9,267,43,1,0,320,0,7,327
7,11,7054,765,3,130,353,571,25,10,1089,0,30,1119
7,11,7054,766,3,122,354,489,25,5,995,2,18,1015
7,11,7054,767,3,156,277,386,10,7,836,0,29,865
7,11,7054,768,3,26,84,55,0,0,165,7,11,183
7,11,7054,769,3,62,113,299,15,8,497,6,13,516
7,11,7054,770,3,56,127,232,3,1,419,6,17,442
7,11,7054,771,3,41,66,200,6,2,315,23,23,361
7,11,7054,772,3,59,251,227,1,3,541,7,8,556
7,11,7054,773,3,97,283,362,6,6,754,0,24,778
7,11,7054,774,3,62,278,329,8,3,680,2,20,702
7,11,7054,775,3,76,124,101,2,0,303,0,5,308
7,11,7054,776,3,25,144,229,1,9,408,1,13,422
7,11,7054,777,3,77,172,232,2,1,484,1,10,495
7,11,7054,778,3,58,141,167,4,3,373,2,15,390
7,11,7054,779,3,87,44,92,1,4,228,3,16,247
7,11,7057,787,3,36,241,216,18,4,515,0,22,537
7,11,7057,788,3,49,206,306,45,7,613,0,20,633
7,11,7057,789,3,107,403,450,57,37,1054,1,52,1107
7,11,7057,790,3,56,261,390,25,17,749,4,38,791
7,11,7057,791,3,30,210,135,3,10,388,0,26,414
7,11,7057,792,3,66,252,419,49,19,805,2,45,852
7,11,7057,793,3,114,368,416,36,16,950,3,45,998
7,11,7057,794,3,20,289,219,11,7,546,0,21,567
7,11,7057,795,3,21,195,102,0,2,320,0,32,352
7,11,7057,796,3,14,208,76,1,0,299,1,16,316
7,11,7057,797,3,23,147,237,5,3,415,1,27,443
7,11,7057,798,3,44,146,206,4,2,402,1,21,424
7,11,7057,799,3,50,211,95,1,1,358,2,19,379
7,11,7057,800,3,20,51,36,8,1,116,0,8,124
7,11,7057,801,3,24,153,130,2,3,312,4,24,340
7,11,7057,802,3,53,201,138,7,5,404,0,37,441
7,11,7057,803,3,17,146,61,5,2,231,0,21,252
7,11,7057,804,3,10,191,62,2,1,266,0,22,288
7,11,7057,805,3,19,333,148,0,1,501,0,33,534
7,11,7057,806,3,107,462,499,7,3,1078,0,75,1153
7,11,7057,807,3,15,125,73,3,2,218,0,38,256
7,11,7057,808,3,38,206,195,1,0,440,1,65,506
7,11,7057,809,3,32,131,168,3,2,336,0,30,366
7,11,7057,810,3,98,250,101,4,3,456,1,22,479
7,11,7057,811,3,38,375,157,0,3,573,0,24,597
7,11,7057,812,3,49,283,117,1,6,456,1,28,485
7,11,7057,813,3,61,311,379,11,3,765,0,51,816
7,11,7070,1034,3,53,561,296,7,1,918,0,27,945
7,11,7070,1035,3,24,297,222,3,1,547,0,11,558
7,11,7070,1036,3,20,427,122,1,2,572,0,22,594
7,11,7070,1037,3,27,282,256,2,3,570,0,7,577
7,11,7070,1038,3,24,349,190,1,4,568,0,13,581
7,11,7081,1189,3,32,292,197,8,6,535,0,37,572
7,11,7081,1190,3,42,384,328,8,5,767,0,48,815
7,11,7081,1191,3,2,61,51,1,1,116,0,10,126
7,11,7081,1192,3,6,199,179,0,0,384,0,14,398
7,11,7081,1193,3,6,148,184,0,2,340,0,16,356
7,11,7081,1194,3,33,131,342,2,2,510,0,24,534
7,11,7081,1195,3,64,96,371,1,0,532,2,42,576
7,11,7081,1196,3,27,70,321,3,0,421,3,44,468
7,11,7081,1197,3,19,166,383,3,2,573,2,39,614
7,11,7081,1198,3,7,134,186,0,0,327,1,28,356
7,11,7081,1199,3,10,151,245,3,3,412,0,20,432
7,11,7081,1200,3,14,268,131,10,0,423,0,32,455
7,11,7081,1201,3,25,245,98,2,0,370,1,17,388
7,11,7081,1202,3,18,311,54,0,2,385,1,13,399
7,11,7081,1203,3,30,179,138,1,1,349,2,23,374
7,11,7081,1204,3,9,58,275,0,2,344,0,10,354
7,11,7081,1205,3,10,263,340,5,1,619,1,32,652
7,11,7081,1206,3,9,318,148,2,5,482,0,23,505
7,11,7090,1344,3,225,216,104,4,5,554,5,56,615
7,11,7090,1345,3,30,171,109,0,0,310,0,51,361
7,11,7090,1346,3,70,427,305,8,10,820,8,118,946
7,11,7090,1347,3,41,181,54,1,0,277,1,22,300
7,11,7090,1348,3,5,51,16,0,2,74,1,13,88
7,11,7090,1349,3,74,37,109,4,2,226,0,21,247
7,11,7090,1350,3,71,75,52,3,1,202,0,15,217
7,11,7090,1351,3,85,194,142,4,6,431,6,40,477
7,11,7090,1352,3,94,113,178,3,3,391,5,25,421
7,11,7090,1353,3,22,37,67,1,0,127,0,14,141
7,11,7090,1354,3,34,115,178,2,1,330,7,33,370
7,11,7090,1355,3,35,132,148,0,1,316,0,26,342
7,11,7090,1356,3,34,95,95,3,4,231,3,25,259
7,11,7090,1357,3,44,104,49,2,0,199,0,8,207
7,11,7090,1358,3,88,98,176,2,3,367,1,46,414
7,11,7090,1359,3,53,102,181,5,6,347,5,50,402
7,11,7090,1360,3,25,128,115,0,1,269,4,23,296
7,11,7090,1361,3,69,96,300,9,2,476,0,44,520
7,11,7090,1362,3,96,134,239,8,6,483,1,34,518
7,11,7103,1755,3,257,272,364,14,8,915,9,41,965
7,11,7103,1756,3,157,117,166,1,0,441,0,15,456
7,11,7103,1757,3,121,69,124,2,1,317,3,19,339
7,11,7103,1758,3,67,58,192,0,2,319,0,14,333
7,11,7103,1759,3,202,147,110,2,4,465,1,23,489
7,11,7103,1760,3,117,59,154,2,4,336,0,13,349
7,11,7103,1761,3,54,69,91,4,0,218,1,16,235
7,11,7103,1762,3,102,70,152,4,0,328,0,16,344
7,11,7103,1763,3,121,83,147,6,0,357,0,10,367
7,11,7103,1764,3,295,155,305,9,5,769,6,13,788
7,11,7103,1765,3,221,145,150,4,0,520,2,27,549
7,11,7103,1766,3,125,116,128,2,3,374,2,20,396
7,11,7103,1767,3,199,94,214,1,1,509,0,17,526
7,11,7103,1768,3,86,37,65,0,0,188,0,6,194
7,11,7103,1769,3,172,192,214,5,5,588,2,20,610
7,11,7103,1770,3,323,242,144,4,5,718,3,19,740
7,11,7105,1778,3,207,400,311,16,9,943,8,44,995
7,11,7105,1779,3,110,218,263,5,2,598,2,40,640
7,11,7105,1780,3,28,215,190,5,6,444,0,15,459
7,11,7105,1781,3,93,198,307,4,4,606,0,18,624
7,11,7105,1782,3,91,182,216,2,2,493,0,64,557
7,11,7105,1783,3,25,145,173,4,2,349,0,23,372
7,11,7105,1784,3,129,142,387,10,8,676,7,51,734
7,11,7105,1785,3,81,128,266,15,5,495,0,31,526
7,12,7035,532,3,251,398,320,21,13,1003,11,53,1067
7,12,7035,533,3,80,313,269,10,0,672,4,22,698
7,12,7035,534,3,83,137,114,3,5,342,8,15,365
7,12,7035,535,3,89,164,186,9,6,454,0,25,479
7,12,7035,536,3,172,232,238,10,11,663,3,32,698
7,12,7055,780,3,362,427,480,17,6,1292,2,34,1328
7,12,7055,781,3,246,227,202,6,6,687,2,13,702
7,12,7088,1247,3,114,204,155,22,9,504,2,18,524
7,12,7088,1248,3,105,262,172,29,10,578,1,41,620
7,12,7088,1249,3,174,289,214,49,9,735,5,28,768
7,12,7088,1250,3,128,213,220,19,10,590,0,35,625
7,12,7088,1251,3,198,180,269,32,8,687,3,39,729
7,12,7088,1252,3,109,168,182,28,5,492,10,252,754
7,12,7088,1253,3,78,72,67,18,3,238,1,19,258
7,12,7088,1254,3,117,127,143,11,9,407,4,34,445
7,12,7088,1255,3,68,36,72,4,3,183,0,48,231
7,12,7088,1256,3,97,67,131,6,3,304,0,25,329
7,12,7088,1257,3,117,129,194,10,4,454,12,34,500
7,12,7088,1258,3,85,126,225,15,8,459,3,23,485
7,12,7088,1259,3,117,189,202,18,14,540,0,59,599
7,12,7088,1260,3,140,118,155,7,10,430,6,32,468
7,12,7088,1261,3,81,87,128,3,5,304,1,13,318
7,12,7088,1262,3,73,35,96,3,1,208,10,17,235
7,12,7088,1263,3,127,161,144,15,8,455,1,33,489
7,12,7090,1265,3,215,366,306,24,14,925,7,29,961
7,12,7090,1266,3,133,239,242,21,10,645,4,16,665
7,12,7090,1267,3,282,279,371,27,11,970,9,50,1029
7,12,7090,1268,3,200,302,336,37,14,889,6,14,909
7,12,7090,1269,3,109,242,229,15,5,600,3,16,619
7,12,7090,1270,3,401,564,569,60,20,1614,6,52,1672
7,12,7090,1271,3,133,295,357,22,20,827,1,22,850
7,12,7090,1272,3,129,261,351,22,6,769,11,25,805
7,12,7090,1273,3,216,308,340,36,16,916,10,51,977
7,12,7090,1274,3,111,238,228,17,12,606,5,18,629
7,12,7090,1275,3,131,282,281,38,9,741,1,15,757
7,12,7090,1276,3,211,231,190,26,12,670,0,39,709
7,12,7090,1277,3,129,315,242,23,14,723,0,22,745
7,12,7090,1278,3,116,242,299,33,22,712,0,4,716
7,12,7090,1279,3,175,350,243,28,8,804,3,20,827
7,12,7090,1280,3,271,342,310,27,13,963,1,36,1000
7,12,7090,1281,3,241,380,337,40,18,1016,5,24,1045
7,12,7090,1282,3,171,359,271,31,8,840,0,27,867
7,12,7090,1283,3,113,263,172,17,17,582,0,15,597
7,12,7090,1284,3,85,206,119,17,4,431,2,12,445
7,12,7090,1285,3,86,223,146,21,10,486,2,11,499
7,12,7090,1286,3,90,219,158,18,3,488,3,18,509
7,12,7090,1287,3,58,195,184,8,2,447,1,10,458
7,12,7090,1288,3,49,152,68,12,2,283,0,3,286
7,12,7090,1289,3,82,210,125,7,5,429,2,8,439
7,12,7090,1290,3,97,209,145,13,9,473,2,12,487
7,12,7090,1291,3,90,204,197,14,12,517,3,15,535
7,12,7090,1292,3,124,195,167,20,13,519,4,21,544
7,12,7090,1293,3,172,340,211,34,19,776,3,22,801
7,12,7090,1294,3,140,366,312,30,16,864,6,16,886
7,12,7090,1295,3,164,335,276,46,14,835,2,16,853
7,12,7090,1296,3,172,368,259,37,5,841,0,25,866
7,12,7090,1297,3,118,236,126,3,14,497,4,7,508
7,12,7090,1298,3,46,173,104,9,5,337,0,8,345
7,12,7090,1299,3,60,163,88,16,5,332,0,5,337
7,12,7090,1300,3,74,182,196,23,12,487,4,15,506
7,12,7090,1301,3,105,217,168,18,14,522,2,16,540
7,12,7090,1302,3,88,174,174,7,2,445,0,15,460
7,12,7090,1303,3,137,152,170,16,2,477,2,16,495
7,12,7090,1304,3,138,270,213,23,10,654,3,24,681
7,12,7090,1305,3,40,105,86,15,11,257,0,7,264
7,12,7090,1306,3,64,192,105,9,9,379,0,8,387
7,12,7090,1307,3,117,245,213,21,16,612,2,17,631
7,12,7090,1308,3,86,193,123,14,13,429,0,10,439
7,12,7090,1309,3,133,278,249,21,17,698,6,15,719
7,12,7090,1310,3,152,245,192,24,12,625,4,15,644
7,12,7090,1311,3,246,544,344,53,26,1213,0,17,1230
7,12,7090,1312,3,135,218,147,24,7,531,1,18,550
7,12,7090,1313,3,104,140,180,19,9,452,0,5,457
7,12,7090,1314,3,87,189,160,24,11,471,2,9,482
7,12,7090,1315,3,63,161,145,24,6,399,0,7,406
7,12,7090,1316,3,73,167,92,12,3,347,0,11,358
7,12,7090,1317,3,94,191,145,16,18,464,0,9,473
7,12,7090,1318,3,67,130,65,6,20,288,1,4,293
7,12,7090,1319,3,55,131,164,9,7,366,2,8,376
7,12,7090,1320,3,103,245,226,32,10,616,4,15,635
7,12,7090,1321,3,96,168,210,11,2,487,4,33,524
7,12,7090,1322,3,123,244,194,15,9,585,2,17,604
7,12,7090,1323,3,173,245,256,21,9,704,1,26,731
7,12,7090,1324,3,128,232,192,25,8,585,1,20,606
7,12,7090,1325,3,76,204,140,13,5,438,9,6,453
7,12,7090,1326,3,101,189,194,24,7,515,5,10,530
7,12,7090,1327,3,177,311,330,21,22,861,5,19,885
7,12,7090,1328,3,164,251,207,29,9,660,2,9,671
7,12,7090,1329,3,221,465,318,44,21,1069,4,20,1093
7,12,7090,1330,3,134,337,226,25,10,732,2,10,744
7,12,7090,1331,3,159,324,250,23,13,769,0,23,792
7,12,7090,1332,3,294,533,407,36,35,1305,11,27,1343
7,12,7090,1333,3,144,317,333,41,13,848,7,21,876
7,12,7090,1334,3,200,343,338,45,17,943,6,29,978
7,12,7090,1335,3,165,288,314,25,38,830,5,19,854
7,12,7090,1336,3,270,389,393,51,16,1119,3,35,1157
7,12,7090,1337,3,134,210,279,28,3,654,0,24,678
7,12,7090,1338,3,244,267,366,45,10,932,9,22,963
7,12,7090,1339,3,192,190,270,17,15,684,5,18,707
7,12,7090,1340,3,701,897,799,118,41,2556,17,86,2659
7,12,7090,1341,3,218,252,269,29,6,774,5,34,813
7,12,7090,1342,3,167,172,192,21,6,558,5,25,588
7,12,7090,1343,3,298,344,391,47,23,1103,13,45,1161
7,12,7090,1363,3,31,94,164,6,4,299,1,29,329
7,12,7090,1364,3,37,109,210,4,2,362,4,20,386
7,12,7090,1365,3,72,97,85,6,3,263,4,22,289
7,12,7090,1366,3,52,97,181,7,1,338,0,50,388
7,12,7090,1367,3,69,145,276,13,3,506,0,30,536
7,12,7090,1368,3,37,112,48,7,0,204,3,19,226
7,12,7090,1369,3,33,93,239,6,3,374,5,29,408
7,12,7090,1370,3,166,370,302,44,4,886,4,23,913
7,12,7090,1371,3,102,154,134,10,1,401,5,34,440
7,12,7090,1372,3,33,153,88,4,0,278,0,16,294
7,12,7090,1373,3,95,202,240,14,4,555,12,18,585
7,12,7090,1374,3,108,165,112,8,7,400,0,36,436
7,12,7090,1375,3,72,129,104,14,3,322,6,23,351
7,12,7090,1376,3,72,63,70,6,0,211,0,14,225
7,12,7090,1377,3,50,130,289,18,7,494,3,28,525
7,12,7090,1378,3,201,328,336,29,7,901,9,33,943
7,12,7090,1379,3,185,365,242,19,9,820,4,28,852
7,12,7090,1380,3,42,153,104,4,4,307,5,20,332
7,12,7090,1381,3,132,286,306,16,8,748,8,35,791
7,12,7090,1382,3,28,113,137,12,5,295,4,21,320
7,12,7090,1383,3,45,166,168,18,3,400,1,21,422
7,12,7090,1384,3,183,357,430,48,3,1021,18,27,1066
7,12,7090,1385,3,145,130,143,29,6,453,2,32,487
7,12,7090,1386,3,235,243,244,20,5,747,8,39,794
7,12,7090,1387,3,191,215,404,16,4,830,11,45,886
7,12,7090,1388,3,90,144,125,12,2,373,0,17,390
7,12,7090,1389,3,59,112,178,59,2,410,1,28,439
7,12,7090,1390,3,99,112,249,9,4,473,4,44,521
7,12,7090,1391,3,29,230,213,21,5,498,2,17,517
7,12,7090,1392,3,57,162,267,5,4,495,4,23,522
7,12,7090,1393,3,138,261,304,11,8,722,8,39,769
7,12,7090,1395,3,156,293,316,12,9,786,11,28,825
7,12,7090,1396,3,134,278,272,10,9,703,4,25,732
7,12,7090,1397,3,229,469,393,13,9,1113,13,54,1180
7,12,7090,1398,3,128,140,218,4,2,492,2,32,526
7,12,7090,1399,3,86,198,288,10,4,586,5,37,628
7,12,7090,1400,3,110,100,173,5,6,394,7,31,432
7,12,7090,1402,3,44,61,18,5,4,132,1,0,133
7,12,7090,1403,3,1106,1826,1810,181,99,5022,13,121,5156
7,12,7101,1580,3,82,193,59,8,8,350,0,9,359
7,12,7101,1581,3,154,269,143,21,6,593,0,13,606
7,12,7101,1582,3,178,243,145,14,6,586,0,8,594
7,12,7101,1583,3,189,324,166,34,10,723,3,23,749
7,12,7101,1584,3,160,233,128,41,7,569,1,16,586
7,12,7101,1585,3,71,209,177,7,4,468,0,19,487
7,12,7101,1586,3,90,277,326,5,5,703,2,48,753
7,12,7101,1587,3,103,195,113,8,2,421,4,11,436
7,12,7101,1588,3,115,170,90,9,2,386,3,21,410
7,12,7101,1589,3,66,154,99,4,1,324,1,16,341
7,12,7101,1590,3,186,165,129,20,4,504,5,27,536
7,12,7101,1591,3,258,227,119,8,2,614,4,40,658
7,12,7101,1592,3,246,305,259,27,7,844,8,31,883
7,12,7101,1593,3,226,184,142,4,6,562,3,18,583
7,12,7101,1594,3,320,291,218,26,9,864,1,35,900
7,12,7101,1595,3,102,78,51,1,1,233,0,14,247
7,12,7101,1596,3,214,227,27,5,0,473,0,32,505
7,12,7101,1597,3,175,130,72,12,5,394,1,6,401
7,12,7101,1598,3,199,262,141,15,6,623,1,34,658
7,12,7101,1599,3,46,141,101,5,2,295,2,0,297
7,12,7101,1600,3,91,147,148,10,3,399,0,12,411
7,12,7101,1601,3,110,153,164,3,10,440,2,23,465
8,1,8001,1,3,133,135,43,25,25,361,1,5,367
8,1,8001,2,3,136,145,43,21,2,347,0,12,359
8,1,8001,3,3,185,183,69,51,8,496,0,16,512
8,1,8001,4,3,158,182,65,47,8,460,0,9,469
8,1,8001,5,3,206,216,60,21,5,508,0,13,521
8,1,8001,6,3,214,223,73,29,4,543,4,13,560
8,1,8001,7,3,87,130,48,16,2,283,0,12,295
8,1,8001,8,3,105,212,62,32,6,417,1,16,434
8,1,8001,10,3,17,47,4,2,1,71,0,1,72
8,1,8001,11,3,12,45,15,0,0,72,0,5,77
8,1,8001,12,3,21,77,36,2,2,138,0,5,143
8,1,8001,13,3,67,72,25,5,1,170,0,8,178
8,1,8001,14,3,33,104,37,11,1,186,0,6,192
8,1,8001,15,3,18,26,9,3,2,58,1,1,60
8,1,8001,16,3,7,44,5,3,1,60,0,1,61
8,1,8005,60,3,214,94,94,19,5,426,1,7,434
8,1,8005,61,3,99,112,58,15,3,287,0,8,295
8,1,8005,62,3,91,117,60,13,4,285,0,13,298
8,1,8005,63,3,179,158,72,16,5,430,0,10,440
8,1,8005,64,3,82,101,79,21,6,289,0,4,293
8,1,8005,65,3,86,87,43,16,8,240,0,3,243
8,1,8005,66,3,92,131,60,15,6,304,2,4,310
8,1,8005,67,3,94,111,62,17,5,289,0,12,301
8,1,8005,68,3,97,95,48,11,5,256,0,0,256
8,1,8005,69,3,130,68,65,13,0,276,0,11,287
8,1,8005,70,3,141,123,63,10,6,343,1,12,356
8,1,8005,71,3,102,125,40,18,2,287,3,8,298
8,1,8005,72,3,149,207,69,9,7,441,0,14,455
8,1,8005,73,3,65,103,34,9,3,214,0,9,223
8,1,8005,74,3,233,212,108,31,5,589,1,13,603
8,1,8005,75,3,100,106,65,14,2,287,0,6,293
8,1,8005,76,3,151,152,60,13,4,380,0,13,393
8,1,8005,77,3,6,26,6,1,0,39,0,1,40
8,1,8005,78,3,177,252,48,16,4,497,0,11,508
8,1,8005,79,3,115,135,76,21,2,349,0,10,359
8,1,8005,80,3,23,42,9,1,3,78,0,2,80
8,1,8005,81,3,94,67,46,18,11,236,0,6,242
8,1,8028,1126,3,142,205,161,22,5,535,0,29,564
8,1,8028,1127,3,167,193,88,25,10,483,0,22,505
8,1,8028,1128,3,84,138,83,11,4,320,0,14,334
8,1,8028,1129,3,44,69,194,4,3,314,0,15,329
8,1,8028,1130,3,154,241,62,15,12,484,0,12,496
8,1,8028,1131,3,86,134,47,12,0,279,0,13,292
8,1,8028,1132,3,42,88,19,3,3,155,0,5,160
8,1,8028,1133,3,6,9,4,0,0,19,0,0,19
8,1,8028,1134,3,187,265,107,31,8,598,1,20,619
8,1,8035,1375,3,99,122,84,19,1,325,0,10,335
8,1,8035,1376,3,94,124,57,16,3,294,0,9,303
8,1,8035,1377,3,87,140,89,20,12,348,0,10,358
8,1,8035,1378,3,9,33,15,2,0,59,0,0,59
8,1,8035,1379,3,30,207,26,1,6,270,0,4,274
8,1,8035,1380,3,34,117,20,12,2,185,0,4,189
8,1,8035,1381,3,100,111,53,18,7,289,0,8,297
8,1,8035,1382,3,6,24,3,3,0,36,0,1,37
8,1,8035,1383,3,46,106,45,3,2,202,0,7,209
8,1,8035,1384,3,99,59,21,3,1,183,0,2,185
8,1,8035,1385,3,30,39,9,1,0,79,0,2,81
8,1,8035,1386,3,12,93,4,4,2,115,0,1,116
8,1,8037,1562,3,105,461,102,19,7,694,14,16,724
8,1,8037,1826,3,412,697,248,91,41,1489,2,32,1523
8,1,8037,1857,3,173,190,58,70,17,508,0,25,533
8,1,8037,1858,3,314,311,97,94,34,850,3,10,863
8,1,8037,1859,3,113,135,45,29,9,331,0,13,344
8,1,8037,1860,3,167,244,85,73,14,583,1,22,606
8,1,8037,1861,3,88,108,36,24,3,259,0,9,268
8,1,8037,1862,3,111,113,34,35,4,297,0,4,301
8,1,8037,1863,3,107,137,55,26,10,335,0,14,349
8,1,8037,1864,3,74,83,17,26,5,205,0,4,209
8,1,8037,1865,3,127,113,56,44,8,348,0,9,357
8,1,8037,1870,3,102,154,51,21,10,338,1,6,345
8,1,8037,1871,3,241,263,114,156,24,798,1,19,818
8,1,8037,1872,3,117,158,45,42,3,365,0,19,384
8,1,8037,1873,3,73,88,37,27,5,230,0,12,242
8,1,8037,1874,3,77,100,39,32,6,254,0,0,254
8,1,8037,1875,3,67,124,16,24,3,234,1,9,244
8,1,8037,1876,3,79,105,24,24,4,236,5,14,255
8,1,8037,1877,3,376,511,155,114,32,1188,2,34,1224
8,1,8037,1878,3,339,437,135,76,41,1028,7,20,1055
8,1,8037,1879,3,174,418,145,62,28,827,6,8,841
8,1,8037,1883,3,110,219,71,16,11,427,0,7,434
8,1,8037,1884,3,16,54,7,3,0,80,0,8,88
8,1,8037,1885,3,982,1050,559,252,90,2933,6,71,3010
8,1,8037,1886,3,142,219,74,34,11,480,1,19,500
8,1,8037,1888,3,215,386,198,66,22,887,10,30,927
8,1,8037,1889,3,501,939,391,143,44,2018,8,63,2089
8,1,8037,1890,3,32,94,8,2,4,140,0,3,143
8,1,8037,1891,3,160,253,89,38,9,549,1,16,566
8,1,8037,1892,3,189,440,121,35,16,801,2,14,817
8,1,8037,1901,3,84,225,70,22,5,406,1,6,413
8,1,8037,1902,3,110,199,72,32,10,423,0,8,431
8,1,8037,1903,3,153,189,65,8,11,426,1,13,440
8,1,8037,1904,3,91,248,86,17,10,452,1,11,464
8,1,8037,1905,3,50,140,26,12,6,234,0,0,234
8,1,8037,1906,3,110,203,49,17,10,389,0,14,403
8,1,8037,1907,3,160,321,101,42,12,636,0,28,664
8,1,8037,1908,3,151,233,89,33,10,516,0,4,520
8,1,8037,1911,3,94,179,48,18,9,348,0,15,363
8,1,8037,1912,3,111,180,57,26,11,385,0,8,393
8,1,8037,1914,3,258,345,166,88,33,890,7,22,919
8,1,8037,1915,3,19,45,11,3,0,78,0,2,80
8,1,8037,1916,3,711,885,357,118,74,2145,1,58,2204
8,1,8037,1929,3,399,452,188,73,33,1145,0,19,1164
8,1,8037,1930,3,371,479,198,65,46,1159,2,25,1186
8,1,8037,1931,3,74,172,62,19,4,331,0,0,331
8,1,8037,1932,3,158,369,67,41,19,654,0,19,673
8,1,8037,1933,3,464,435,234,146,37,1316,7,31,1354
8,1,8037,1934,3,187,165,56,56,8,472,0,6,478
8,1,8037,1935,3,171,131,75,56,14,447,0,5,452
8,1,8037,1936,3,392,402,219,165,37,1215,4,13,1232
8,1,8037,1937,3,83,100,38,53,8,282,0,6,288
8,1,8037,1938,3,105,127,44,34,18,328,1,9,338
8,1,8037,1939,3,410,388,114,90,34,1036,0,18,1054
8,1,8037,1940,3,581,568,296,173,45,1663,1,19,1683
8,1,8037,1941,3,131,230,90,37,10,498,0,18,516
8,1,8037,1942,3,369,361,136,27,9,902,4,31,937
8,1,8037,1943,3,186,345,82,23,10,646,2,29,677
8,1,8037,1944,3,80,178,57,14,7,336,1,6,343
8,1,8037,1945,3,99,202,92,13,10,416,0,11,427
8,1,8037,2192,3,289,303,134,36,25,787,3,15,805
8,1,8037,2195,3,365,611,255,68,27,1326,3,39,1368
8,1,8037,2196,3,79,142,59,11,7,298,1,10,309
8,1,8037,2197,3,178,375,107,23,11,694,10,20,724
8,1,8053,2509,3,157,142,83,13,3,398,0,7,405
8,1,8053,2510,3,124,214,91,19,6,454,0,5,459
8,1,8053,2511,3,164,185,192,19,7,567,2,15,584
8,1,8053,2512,3,155,75,28,4,8,270,0,0,270
8,1,8053,2513,3,152,145,61,3,7,368,0,13,381
8,1,8053,2514,3,98,71,42,6,2,219,0,6,225
8,1,8053,2515,3,187,94,27,7,2,317,2,9,328
8,1,8053,2516,3,204,157,49,11,5,426,2,10,438
8,1,8053,2517,3,72,155,31,7,1,266,0,16,282
8,1,8037,2711,3,294,195,139,65,24,717,2,8,727
8,1,8037,2712,3,100,84,70,19,15,288,1,5,294
8,1,8037,2713,3,94,81,51,17,13,256,0,3,259
8,1,8037,2714,3,140,126,66,44,10,386,1,0,387
8,1,8037,2715,3,101,130,70,17,14,332,0,4,336
8,1,8037,2716,3,95,82,44,20,10,251,0,3,254
8,1,8037,2717,3,59,47,27,9,5,147,2,4,153
8,1,8037,2718,3,107,120,36,17,5,285,2,2,289
8,1,8037,2719,3,201,116,67,33,18,435,2,2,439
8,1,8037,2720,3,156,109,38,36,20,359,0,0,359
8,1,8037,2721,3,99,49,21,10,12,191,0,1,192
8,1,8037,2722,3,135,79,44,28,17,303,0,4,307
8,1,8037,2723,3,118,84,39,28,10,279,0,3,282
8,1,8037,2724,3,100,90,30,31,10,261,1,3,265
8,1,8037,2725,3,135,103,49,14,7,308,0,5,313
8,1,8037,2726,3,166,149,65,29,14,423,0,16,439
8,1,8037,2727,3,110,122,49,20,13,314,0,6,320
8,1,8037,2728,3,98,72,34,25,13,242,0,1,243
8,1,8037,2729,3,159,124,51,34,10,378,3,3,384
8,1,8037,2730,3,124,73,30,22,6,255,0,3,258
8,1,8037,2731,3,127,84,59,25,13,308,1,0,309
8,1,8037,2732,3,54,98,44,15,3,214,0,7,221
8,1,8037,2733,3,147,174,99,21,7,448,1,10,459
8,1,8037,2734,3,120,137,49,20,5,331,1,8,340
8,1,8037,2735,3,55,70,31,17,5,178,0,1,179
8,1,8037,2736,3,97,131,70,25,4,327,0,11,338
8,1,8037,2737,3,107,117,37,20,5,286,0,0,286
8,1,8037,2738,3,76,111,40,0,0,227,0,3,230
8,1,8037,2739,3,126,117,53,17,8,321,1,4,326
8,1,8037,2740,3,147,114,44,28,10,343,2,7,352
8,1,8037,2741,3,167,90,63,22,8,350,0,5,355
8,1,8037,2742,3,152,129,53,29,8,371,0,5,376
8,1,8037,2743,3,105,98,60,19,8,290,1,3,294
8,1,8037,2744,3,133,87,45,25,20,310,0,4,314
8,1,8037,2745,3,115,81,40,26,13,275,0,1,276
8,1,8037,2746,3,159,73,44,28,13,317,0,1,318
8,1,8037,2747,3,104,87,48,23,8,270,2,1,273
8,1,8037,2748,3,192,104,52,32,14,394,0,3,397
8,1,8037,2749,3,146,77,40,24,12,299,0,2,301
8,1,8037,2750,3,131,72,22,16,9,250,0,4,254
8,1,8037,2751,3,125,91,45,5,16,282,1,1,284
8,1,8037,2752,3,258,183,87,46,27,601,0,6,607
8,1,8037,2753,3,98,51,44,21,10,224,1,2,227
8,1,8037,2754,3,125,60,38,22,8,253,0,2,255
8,1,8037,2755,3,109,71,38,20,12,250,1,8,259
8,1,8037,2756,3,138,77,48,24,10,297,0,3,300
8,1,8037,2757,3,94,82,53,15,12,256,1,7,264
8,1,8037,2758,3,112,71,56,20,3,262,1,3,266
8,1,8037,2759,3,82,70,57,16,12,237,2,5,244
8,1,8037,2760,3,42,33,24,4,3,106,0,0,106
8,1,8037,2761,3,115,267,94,35,15,526,0,14,540
8,1,8037,2762,3,61,69,39,15,7,191,1,2,194
8,1,8037,2763,3,107,76,59,18,9,269,1,3,273
8,1,8037,2764,3,88,89,52,13,12,254,0,4,258
8,1,8037,2765,3,99,70,50,21,10,250,1,2,253
8,1,8037,2766,3,85,94,43,15,12,249,0,4,253
8,1,8037,2767,3,124,72,49,20,5,270,1,5,276
8,1,8037,2768,3,142,109,59,34,10,354,0,2,356
8,1,8037,2769,3,135,110,51,26,17,339,0,3,342
8,1,8037,2770,3,109,108,54,27,0,298,2,3,303
8,1,8037,2771,3,157,109,72,25,13,376,0,6,382
8,1,8037,2772,3,110,104,43,26,5,288,1,0,289
8,1,8037,2773,3,149,107,75,30,13,374,0,6,380
8,1,8037,2774,3,108,74,47,24,7,260,4,5,269
8,1,8037,2775,3,71,58,37,20,8,194,2,1,197
8,1,8037,2776,3,113,67,45,10,5,240,2,5,247
8,1,8037,2777,3,103,62,42,17,13,237,1,6,244
8,1,8037,2778,3,144,110,46,25,12,337,0,10,347
8,1,8037,2779,3,85,148,45,20,5,303,0,6,309
8,1,8037,2780,3,83,79,44,4,6,216,1,5,222
8,1,8037,2781,3,469,454,259,66,25,1273,3,31,1307
8,1,8037,2782,3,117,129,87,19,8,360,0,7,367
8,1,8037,2783,3,26,69,29,5,1,130,0,7,137
8,1,8037,2784,3,40,97,32,10,1,180,0,5,185
8,1,8037,2785,3,36,136,40,8,6,226,0,4,230
8,1,8037,2786,3,105,173,68,29,3,378,1,10,389
8,1,8037,2787,3,65,116,48,18,5,252,0,4,256
8,1,8037,2788,3,196,390,171,37,11,805,0,13,818
8,1,8037,2789,3,71,149,64,20,10,314,1,6,321
8,1,8037,2790,3,108,76,26,10,7,227,1,0,228
8,1,8037,2791,3,125,121,45,19,15,325,0,6,331
8,1,8037,2792,3,109,85,24,12,9,239,4,4,247
8,1,8037,2793,3,95,94,58,20,18,285,0,8,293
8,1,8037,2794,3,116,75,43,14,10,258,0,6,264
8,1,8037,2795,3,106,99,72,12,13,302,0,7,309
8,1,8037,2796,3,152,162,87,23,16,440,2,4,446
8,1,8037,2797,3,146,112,56,31,13,358,1,8,367
8,1,8037,2798,3,72,48,22,17,4,163,2,1,166
8,1,8037,2799,3,116,66,50,20,7,259,0,3,262
8,1,8037,2800,3,89,60,33,15,13,210,0,0,210
8,1,8037,2801,3,79,58,47,24,8,216,0,2,218
8,1,8037,2802,3,119,110,53,40,6,328,1,7,336
8,1,8037,2803,3,114,148,61,33,13,369,3,4,376
8,1,8037,2804,3,103,126,64,22,9,324,0,4,328
8,1,8037,2805,3,113,98,51,16,15,293,3,1,297
8,1,8037,2806,3,75,98,47,21,11,252,0,0,252
8,1,8037,2807,3,105,73,50,19,11,258,1,1,260
8,1,8037,2808,3,107,98,56,19,11,291,4,3,298
8,1,8037,2809,3,71,95,57,15,9,247,4,1,252
8,1,8037,2810,3,154,104,65,26,14,363,3,0,366
8,1,8037,2811,3,296,252,197,74,31,850,1,10,861
8,1,8037,2812,3,85,122,80,33,18,338,1,8,347
8,1,8037,2813,3,152,140,80,29,21,422,0,3,425
8,1,8037,2814,3,60,125,83,50,13,331,0,4,335
8,1,8037,2815,3,182,187,117,27,24,537,0,1,538
8,1,8037,2816,3,60,74,40,12,8,194,1,3,198
8,1,8037,2817,3,76,66,49,18,7,216,0,4,220
8,1,8037,2818,3,209,170,103,38,18,538,0,10,548
8,1,8037,2819,3,130,170,85,16,12,413,0,5,418
8,1,8037,2820,3,126,110,42,17,5,300,0,10,310
8,1,8037,2821,3,550,521,310,113,70,1564,6,27,1597
8,1,8037,2822,3,100,64,49,14,12,239,3,3,245
8,1,8037,2823,3,505,508,303,108,54,1478,3,21,1502
8,1,8037,2824,3,75,183,71,21,6,356,0,16,372
8,1,8037,2825,3,110,220,96,22,8,456,0,10,466
8,1,8037,2826,3,65,153,61,18,13,310,0,4,314
8,1,8037,2827,3,82,131,53,21,10,297,0,0,297
8,1,8037,2828,3,88,153,97,15,9,362,1,8,371
8,1,8037,2829,3,77,85,52,37,10,261,0,5,266
8,1,8037,2830,3,150,299,115,25,6,595,1,11,607
8,1,8037,2831,3,81,168,48,23,4,324,0,11,335
8,1,8037,2832,3,102,146,57,17,6,328,2,9,339
8,1,8037,2833,3,223,131,84,49,13,500,2,10,512
8,1,8037,2834,3,75,71,31,18,9,204,0,5,209
8,1,8037,2835,3,118,120,56,25,10,329,1,1,331
8,1,8037,2836,3,137,88,36,20,8,289,0,0,289
8,1,8037,2837,3,99,47,15,14,17,192,1,0,193
8,1,8037,2838,3,148,75,51,22,8,304,0,4,308
8,1,8037,2839,3,186,57,45,31,9,328,0,3,331
8,1,8037,2840,3,111,72,24,17,6,230,0,2,232
8,1,8037,2841,3,82,45,23,27,6,183,1,3,187
8,1,8037,2842,3,119,86,48,21,8,282,0,3,285
8,1,8037,2843,3,141,127,65,15,11,359,4,2,365
8,1,8037,2903,3,56,111,38,8,5,218,0,11,229
8,1,8037,2904,3,77,56,42,17,5,197,0,2,199
8,1,8037,2905,3,78,94,29,28,11,240,0,3,243
8,1,8037,2906,3,78,79,32,19,18,226,0,9,235
8,1,8037,2907,3,70,69,22,13,2,176,2,3,181
8,1,8037,2908,3,144,64,47,25,12,292,1,4,297
8,1,8037,2909,3,117,62,37,30,4,250,0,3,253
8,1,8037,2910,3,120,73,40,32,12,277,0,2,279
8,1,8037,2911,3,100,60,33,17,8,218,0,3,221
8,1,8037,2912,3,72,107,60,15,0,254,1,6,261
8,1,8037,2913,3,108,86,45,21,4,264,1,2,267
8,1,8037,2914,3,92,71,38,27,6,234,0,2,236
8,1,8037,2915,3,97,93,71,19,4,284,0,3,287
8,1,8037,2916,3,119,99,70,32,12,332,2,1,335
8,1,8037,2917,3,114,98,54,17,6,289,1,5,295
8,1,8037,2918,3,136,64,46,22,11,279,0,4,283
8,1,8037,2919,3,58,118,33,15,5,229,0,5,234
8,1,8037,2920,3,85,70,32,11,4,202,1,1,204
8,1,8037,2921,3,94,79,39,14,4,230,0,10,240
8,1,8037,2922,3,128,123,46,18,3,318,0,5,323
8,1,8037,2923,3,56,110,31,15,7,219,1,8,228
8,1,8037,2924,3,86,181,42,10,2,321,3,12,336
8,1,8037,2925,3,53,121,41,10,0,225,2,5,232
8,1,8037,2926,3,95,107,43,13,7,265,0,6,271
8,1,8037,2927,3,72,85,40,13,2,212,1,5,218
8,1,8037,2928,3,79,104,46,8,5,242,0,2,244
8,1,8037,2929,3,96,126,48,8,4,282,1,3,286
8,1,8037,2930,3,45,90,31,10,4,180,0,4,184
8,1,8037,2931,3,86,90,44,8,4,232,0,0,232
8,1,8037,2932,3,45,89,31,6,2,173,0,4,177
8,1,8037,2933,3,77,83,52,9,3,224,0,3,227
8,1,8037,2934,3,79,153,51,16,9,308,1,13,322
8,1,8037,2935,3,43,76,22,14,6,161,0,2,163
8,1,8037,2936,3,69,98,40,12,8,227,2,5,234
8,2,8037,1424,3,154,931,153,30,21,1289,4,35,1328
8,2,8037,1425,3,129,594,105,18,11,857,2,29,888
8,2,8037,1426,3,150,286,54,21,12,523,0,20,543
8,2,8037,1427,3,64,110,30,10,4,218,0,0,218
8,2,8037,1428,3,139,264,87,20,7,517,0,15,532
8,2,8037,1429,3,123,198,45,13,4,383,2,0,385
8,2,8037,1430,3,271,586,149,46,11,1063,3,38,1104
8,2,8037,1431,3,109,163,31,11,13,327,0,5,332
8,2,8037,1432,3,119,194,49,15,2,379,0,17,396
8,2,8037,1433,3,87,217,32,21,4,361,1,12,374
8,2,8037,1434,3,84,129,52,10,2,277,1,3,281
8,2,8037,1435,3,106,113,38,24,5,286,0,19,305
8,2,8037,1436,3,129,136,55,11,7,338,0,14,352
8,2,8037,1437,3,143,140,48,10,10,351,1,7,359
8,2,8037,1438,3,114,135,42,1,7,299,0,11,310
8,2,8037,1439,3,54,55,18,3,9,139,0,5,144
8,2,8037,1440,3,99,85,26,10,4,224,0,8,232
8,2,8037,1441,3,100,70,27,12,1,210,1,8,219
8,2,8037,1442,3,107,88,45,32,2,274,2,8,284
8,2,8037,1443,3,75,62,23,8,3,171,1,6,178
8,2,8037,1444,3,84,63,42,12,3,204,0,15,219
8,2,8037,1452,3,49,61,32,6,2,150,0,9,159
8,2,8037,1453,3,85,72,35,7,5,204,0,0,204
8,2,8037,1454,3,98,73,35,11,4,221,0,7,228
8,2,8037,1455,3,117,69,35,15,8,244,1,5,250
8,2,8037,1456,3,93,72,25,8,2,200,0,13,213
8,2,8037,1457,3,84,84,48,10,3,229,1,8,238
8,2,8037,1458,3,159,142,70,20,7,398,2,1,401
8,2,8037,1459,3,136,101,20,8,6,271,0,7,278
8,2,8037,1460,3,96,107,31,12,5,251,0,7,258
8,2,8037,1461,3,148,100,13,22,1,284,0,10,294
8,2,8037,1462,3,106,100,37,15,8,266,0,18,284
8,2,8037,1463,3,139,128,36,15,8,326,1,11,338
8,2,8037,1464,3,124,119,30,15,4,292,0,5,297
8,2,8037,1465,3,81,79,26,14,4,204,1,0,205
8,2,8037,1466,3,133,111,58,11,7,320,1,11,332
8,2,8037,1467,3,80,92,38,4,5,219,0,10,229
8,2,8037,1468,3,86,106,30,8,3,233,0,12,245
8,2,8037,1469,3,181,254,64,20,15,534,0,12,546
8,2,8037,1470,3,94,156,31,13,9,303,1,14,318
8,2,8037,1471,3,117,228,85,17,12,459,1,12,472
8,2,8037,1472,3,126,260,87,14,4,491,0,18,509
8,2,8037,1473,3,92,128,39,2,4,265,0,6,271
8,2,8037,1474,3,127,97,35,9,9,277,0,13,290
8,2,8037,1475,3,96,69,36,1,1,203,0,4,207
8,2,8037,1476,3,118,130,24,14,13,299,0,20,319
8,2,8037,1477,3,98,119,24,11,5,257,0,11,268
8,2,8037,1478,3,155,153,47,19,6,380,1,4,385
8,2,8037,1479,3,132,163,52,9,3,359,0,10,369
8,2,8037,1480,3,101,86,36,10,6,239,0,7,246
8,2,8037,1481,3,141,95,29,12,4,281,2,7,290
8,2,8037,1482,3,105,111,43,10,6,275,1,14,290
8,2,8037,1483,3,93,216,35,20,4,368,1,8,377
8,2,8037,1484,3,135,223,32,14,8,412,2,10,424
8,2,8037,1485,3,125,89,38,5,8,265,1,1,267
8,2,8037,1486,3,97,99,36,7,6,245,0,11,256
8,2,8037,1487,3,128,72,37,10,2,249,0,8,257
8,2,8037,1488,3,129,131,36,18,6,320,0,19,339
8,2,8037,1489,3,98,73,18,13,8,210,1,6,217
8,2,8037,1490,3,74,85,39,12,7,217,0,7,224
8,2,8037,1491,3,91,91,42,12,8,244,0,8,252
8,2,8037,1492,3,76,92,39,11,7,225,0,12,237
8,2,8037,1493,3,79,76,27,15,4,201,0,4,205
8,2,8037,1498,3,17,20,14,5,3,59,1,3,63
8,2,8037,1499,3,217,140,113,16,16,502,1,15,518
8,2,8037,1500,3,64,49,32,7,3,155,0,6,161
8,2,8037,1501,3,79,51,20,7,3,160,0,4,164
8,2,8037,1502,3,95,77,55,12,5,244,0,10,254
8,2,8037,1503,3,150,131,35,20,8,344,1,6,351
8,2,8037,1504,3,165,207,66,30,6,474,2,18,494
8,2,8037,1505,3,164,140,81,19,8,412,3,13,428
8,2,8037,1506,3,159,171,71,18,5,424,2,14,440
8,2,8037,1507,3,212,193,66,8,5,484,1,15,500
8,2,8037,1508,3,198,165,56,24,10,453,0,9,462
8,2,8037,1509,3,199,186,60,23,5,473,0,10,483
8,2,8037,1510,3,182,401,132,25,10,750,0,36,786
8,2,8037,1511,3,126,218,66,21,9,440,1,11,452
8,2,8037,1512,3,145,123,58,11,6,343,2,5,350
8,2,8037,1513,3,88,125,31,5,3,252,3,8,263
8,2,8037,1514,3,94,144,57,18,1,314,0,15,329
8,2,8037,1515,3,104,100,38,7,2,251,0,0,251
8,2,8037,1516,3,91,101,35,14,4,245,0,16,261
8,2,8037,1517,3,128,127,27,9,6,297,0,8,305
8,2,8037,1518,3,113,106,65,5,11,300,2,7,309
8,2,8037,1519,3,142,121,67,27,12,369,0,24,393
8,2,8037,1520,3,91,87,28,13,4,223,0,0,223
8,2,8037,1521,3,96,103,50,15,2,266,2,3,271
8,2,8037,1522,3,71,78,33,5,3,190,0,5,195
8,2,8037,1523,3,99,98,64,15,2,278,0,8,286
8,2,8037,1524,3,55,59,32,5,4,155,0,10,165
8,2,8037,1525,3,62,96,53,8,7,226,1,12,239
8,2,8037,1526,3,86,92,47,9,5,239,0,6,245
8,2,8037,1528,3,46,80,25,11,1,163,1,7,171
8,2,8037,1529,3,63,75,29,6,3,176,1,4,181
8,2,8037,1530,3,42,66,40,10,3,161,0,0,161
8,2,8037,1531,3,96,149,55,18,5,323,0,6,329
8,2,8037,1532,3,42,53,28,7,2,132,2,1,135
8,2,8037,1533,3,60,35,24,5,4,128,0,5,133
8,2,8037,1534,3,49,50,26,9,3,137,0,5,142
8,2,8037,1535,3,76,107,42,13,10,248,0,6,254
8,2,8037,1536,3,128,121,45,15,8,317,1,7,325
8,2,8037,1537,3,165,134,43,21,5,368,1,18,387
8,2,8037,1538,3,205,200,65,34,12,516,1,5,522
8,2,8037,1539,3,75,106,31,7,6,225,0,7,232
8,2,8037,1540,3,83,110,24,8,7,232,0,14,246
8,2,8037,1541,3,97,118,28,10,2,255,0,13,268
8,2,8037,1542,3,164,255,69,20,11,519,0,30,549
8,2,8037,1543,3,43,101,27,5,3,179,1,0,180
8,2,8037,1544,3,114,115,53,21,3,306,1,13,320
8,2,8037,1545,3,111,94,29,9,4,247,0,5,252
8,2,8037,1546,3,156,309,101,9,2,577,1,23,601
8,2,8037,1547,3,186,408,115,22,9,740,10,12,762
8,2,8037,1548,3,105,178,52,17,3,355,0,9,364
8,2,8037,1549,3,171,239,68,16,9,503,0,9,512
8,2,8037,1550,3,82,96,33,11,5,227,0,6,233
8,2,8037,1551,3,57,109,35,7,2,210,0,7,217
8,2,8037,1552,3,51,84,34,11,2,182,0,9,191
8,2,8037,1553,3,110,64,22,5,5,206,1,8,215
8,2,8037,1554,3,165,90,58,18,6,337,1,13,351
8,2,8037,1555,3,53,79,36,12,2,182,0,6,188
8,2,8037,1556,3,141,274,73,26,3,517,0,11,528
8,2,8037,1557,3,121,236,40,21,18,436,2,7,445
8,2,8037,1558,3,88,178,68,12,8,354,0,10,364
8,2,8037,1559,3,200,359,118,28,15,720,1,14,735
8,2,8037,1560,3,263,799,180,31,17,1290,2,25,1317
8,2,8037,1561,3,96,117,29,11,6,259,2,8,269
8,2,8037,1563,3,144,681,103,24,10,962,4,41,1007
8,2,8037,1564,3,80,270,52,10,6,418,0,9,427
8,2,8037,1565,3,113,110,43,11,4,281,1,3,285
8,2,8037,1951,3,149,168,44,15,3,379,0,0,379
8,2,8037,1952,3,77,123,19,5,5,229,1,10,240
8,2,8037,1953,3,97,118,32,17,5,269,0,11,280
8,2,8037,1954,3,61,103,20,8,5,197,0,9,206
8,2,8037,1955,3,144,112,49,15,7,327,0,11,338
8,2,8037,1956,3,108,134,35,8,1,286,1,8,295
8,2,8037,1957,3,90,93,42,6,6,237,0,2,239
8,2,8037,1958,3,85,79,32,14,6,216,2,7,225
8,2,8037,1959,3,89,95,27,10,0,221,0,8,229
8,2,8037,1960,3,79,94,32,12,6,223,2,5,230
8,2,8037,1961,3,95,121,23,14,7,260,0,5,265
8,2,8037,1962,3,71,79,31,10,5,196,1,14,211
8,2,8037,1963,3,69,59,27,7,2,164,0,6,170
8,2,8037,1964,3,70,99,32,8,4,213,1,10,224
8,2,8037,1965,3,84,77,28,12,8,209,1,4,214
8,2,8037,1967,3,99,72,32,14,8,225,0,5,230
8,2,8037,1968,3,87,112,26,5,3,233,0,8,241
8,2,8037,1969,3,87,75,28,11,5,206,0,10,216
8,2,8037,1970,3,60,68,31,12,6,177,0,5,182
8,2,8037,1971,3,94,128,36,9,3,270,3,5,278
8,2,8037,1972,3,108,79,40,9,0,236,0,3,239
8,2,8037,1973,3,100,121,46,12,10,289,1,0,290
8,2,8037,1974,3,141,265,57,21,6,490,0,14,504
8,2,8037,1975,3,119,145,42,15,12,333,0,11,344
8,2,8037,1976,3,114,178,47,11,4,354,0,18,372
8,2,8037,1977,3,90,127,41,22,4,284,0,12,296
8,2,8037,1978,3,185,191,66,18,8,468,2,14,484
8,2,8037,1979,3,112,143,49,16,19,339,1,20,360
8,2,8037,1980,3,95,58,36,4,2,195,0,8,203
8,2,8037,1981,3,122,75,28,10,0,235,0,3,238
8,2,8037,1982,3,85,95,26,20,3,229,0,11,240
8,2,8037,1983,3,99,99,17,3,5,223,0,5,228
8,2,8037,1984,3,86,75,31,9,4,205,0,6,211
8,2,8037,1985,3,113,112,39,13,8,285,3,13,301
8,2,8037,1986,3,207,180,60,22,11,480,0,13,493
8,2,8037,1987,3,149,162,55,14,10,390,1,6,397
8,2,8037,1988,3,129,177,45,12,4,367,0,18,385
8,2,8037,1989,3,86,113,44,8,12,263,2,7,272
8,2,8037,1990,3,128,125,50,13,7,323,2,8,333
8,2,8037,1991,3,88,131,47,10,6,282,0,15,297
8,2,8037,1992,3,134,158,53,16,8,369,0,7,376
8,2,8037,1993,3,168,169,54,15,5,411,3,12,426
8,2,8037,1994,3,172,162,82,10,8,434,2,9,445
8,2,8037,1995,3,129,123,54,4,3,313,0,15,328
8,2,8037,1996,3,132,91,91,8,8,330,1,13,344
8,2,8037,1997,3,95,112,34,16,7,264,0,12,276
8,2,8037,1998,3,109,84,25,7,8,233,0,0,233
8,2,8037,1999,3,92,118,36,9,1,256,0,26,282
8,2,8037,2000,3,196,175,79,26,15,491,0,6,497
8,2,8037,2001,3,141,116,40,19,1,317,0,12,329
8,2,8037,2002,3,103,150,47,10,5,315,1,4,320
8,2,8037,2003,3,118,179,47,20,5,369,0,9,378
8,2,8037,2004,3,138,98,38,16,5,295,0,0,295
8,2,8037,2005,3,85,114,44,23,3,269,1,6,276
8,2,8037,2006,3,60,147,31,13,9,260,5,5,270
8,2,8037,2007,3,84,167,51,13,5,320,1,8,329
8,2,8037,2008,3,142,345,112,17,11,627,5,21,653
8,2,8037,2009,3,103,139,36,9,6,293,0,11,304
8,2,8037,2010,3,151,175,78,25,5,434,0,14,448
8,2,8037,2011,3,121,128,50,20,11,330,2,18,350
8,2,8037,2012,3,196,187,70,28,8,489,0,13,502
8,2,8037,2013,3,115,154,54,15,5,343,0,13,356
8,2,8037,2014,3,160,161,46,22,8,397,0,8,405
8,2,8037,2015,3,130,115,43,17,9,314,0,6,320
8,2,8037,2016,3,98,156,29,19,8,310,0,6,316
8,2,8037,2017,3,140,184,58,20,12,414,2,16,432
8,2,8037,2018,3,118,122,33,12,1,286,1,10,297
8,2,8037,2019,3,149,159,42,17,3,370,0,12,382
8,2,8037,2020,3,128,121,38,16,7,310,0,11,321
8,2,8037,2021,3,86,114,41,20,5,266,0,8,274
8,2,8037,2022,3,127,129,51,14,4,325,3,4,332
8,2,8037,2023,3,119,100,78,17,4,318,2,11,331
8,2,8037,2024,3,136,161,59,18,11,385,0,15,400
8,2,8037,2025,3,137,155,52,30,9,383,3,12,398
8,2,8037,2026,3,210,165,49,26,15,465,1,11,477
8,2,8037,2033,3,143,185,55,11,11,405,0,13,418
8,2,8037,2034,3,112,114,47,7,10,290,1,7,298
8,2,8037,2035,3,104,139,38,16,5,302,2,9,313
8,2,8037,2036,3,172,100,53,19,5,349,0,5,354
8,2,8037,2037,3,176,142,50,16,9,393,2,18,413
8,2,8037,2038,3,266,203,109,29,6,613,1,17,631
8,2,8037,2039,3,129,133,50,21,9,342,1,15,358
8,2,8037,2040,3,119,116,28,16,4,283,1,0,284
8,2,8037,2041,3,137,183,55,16,3,394,1,15,410
8,2,8037,2042,3,105,204,38,18,6,371,0,11,382
8,2,8037,2043,3,50,133,35,13,5,236,0,0,236
8,2,8037,2044,3,126,136,54,18,6,340,1,9,350
8,2,8037,2045,3,155,147,37,15,7,361,2,16,379
8,2,8037,2046,3,110,75,42,11,3,241,0,0,241
8,2,8037,2047,3,108,114,34,17,6,279,1,6,286
8,2,8037,2048,3,148,166,81,20,4,419,0,14,433
8,2,8037,2049,3,115,120,72,15,14,336,0,8,344
8,2,8037,2050,3,88,130,43,11,2,274,0,2,276
8,2,8037,2051,3,90,92,52,9,3,246,0,15,261
8,2,8037,2052,3,232,245,66,27,14,584,0,26,610
8,2,8037,2053,3,193,299,75,20,12,599,0,18,617
8,2,8037,2054,3,157,388,136,36,5,722,0,18,740
8,2,8037,2055,3,169,495,159,30,15,868,0,30,898
8,2,8037,2056,3,180,383,84,32,6,685,0,19,704
8,2,8037,2057,3,147,312,118,41,20,638,3,23,664
8,2,8037,2058,3,106,180,56,12,6,360,0,8,368
8,2,8037,2059,3,65,78,39,6,4,192,0,0,192
8,2,8037,2060,3,192,173,83,24,11,483,0,20,503
8,2,8037,2061,3,131,194,30,23,7,385,1,8,394
8,2,8037,2062,3,71,143,47,9,10,280,0,15,295
8,2,8037,2063,3,58,126,25,6,1,216,1,8,225
8,2,8037,2064,3,90,158,20,10,2,280,0,10,290
8,2,8037,2065,3,201,458,104,37,7,807,3,29,839
8,2,8037,2066,3,135,154,58,20,9,376,0,12,388
8,2,8037,2067,3,107,145,30,17,10,309,0,13,322
8,2,8037,2068,3,173,175,76,23,21,468,1,17,486
8,2,8037,2069,3,168,159,62,19,5,413,0,11,424
8,2,8037,2089,3,129,151,67,21,14,382,0,20,402
8,2,8037,2090,3,85,204,40,9,8,346,0,12,358
8,2,8037,2091,3,104,110,48,12,6,280,1,9,290
8,2,8037,2092,3,109,106,30,13,7,265,0,0,265
8,2,8037,2093,3,129,131,59,10,5,334,1,15,350
8,2,8037,2094,3,202,175,91,6,9,483,2,12,497
8,2,8037,2114,3,187,212,62,18,8,487,0,10,497
8,2,8037,2116,3,118,177,54,14,10,373,0,14,387
8,2,8037,2117,3,55,103,12,6,1,177,0,8,185
8,2,8037,2118,3,74,170,27,4,4,279,0,12,291
8,3,8037,1445,3,65,59,29,7,11,171,1,3,175
8,3,8037,1446,3,144,58,39,27,3,271,2,6,279
8,3,8037,1447,3,78,103,28,13,3,225,0,11,236
8,3,8037,1448,3,121,70,38,11,6,246,1,6,253
8,3,8037,1449,3,143,68,44,10,7,272,2,5,279
8,3,8037,1450,3,123,80,58,14,8,283,0,3,286
8,3,8037,1451,3,98,86,38,10,6,238,1,12,251
8,3,8037,1494,3,137,85,44,23,9,298,0,7,305
8,3,8037,1495,3,119,48,29,9,5,210,1,7,218
8,3,8037,1496,3,119,94,75,10,4,302,0,6,308
8,3,8037,1497,3,101,50,49,15,8,223,0,6,229
8,3,8037,1527,3,147,95,55,16,12,325,1,5,331
8,3,8037,1566,3,127,78,30,14,8,257,0,2,259
8,3,8037,1567,3,408,267,134,59,15,883,1,8,892
8,3,8037,1568,3,440,152,78,35,10,715,0,7,722
8,3,8037,1569,3,180,112,40,20,6,358,0,5,363
8,3,8037,1570,3,288,181,72,36,11,588,2,15,605
8,3,8037,1571,3,207,76,48,14,14,359,0,10,369
8,3,8037,1572,3,287,101,60,26,10,484,2,14,500
8,3,8037,1573,3,221,137,58,22,9,447,0,8,455
8,3,8037,1574,3,394,180,57,34,11,676,1,5,682
8,3,8037,1575,3,376,221,77,40,23,737,0,9,746
8,3,8037,1576,3,333,219,70,38,24,684,1,14,699
8,3,8037,1577,3,333,128,55,27,29,572,1,5,578
8,3,8037,1578,3,715,299,143,67,40,1264,0,12,1276
8,3,8037,1579,3,372,190,77,25,8,672,1,12,685
8,3,8037,1580,3,88,35,18,7,2,150,0,2,152
8,3,8037,1581,3,190,89,67,10,7,363,0,3,366
8,3,8037,1582,3,229,131,73,16,19,468,0,11,479
8,3,8037,1583,3,184,111,53,21,4,373,0,5,378
8,3,8037,1584,3,120,74,39,8,1,242,1,4,247
8,3,8037,1585,3,145,101,60,10,8,324,0,2,326
8,3,8037,1586,3,103,69,37,11,5,225,0,8,233
8,3,8037,1587,3,158,86,51,16,11,322,0,11,333
8,3,8037,1588,3,153,91,40,18,7,309,0,9,318
8,3,8037,1589,3,115,50,31,15,5,216,0,2,218
8,3,8037,1590,3,96,60,24,11,5,196,0,0,196
8,3,8037,1591,3,168,74,54,25,8,329,1,5,335
8,3,8037,1592,3,243,114,46,17,7,427,0,3,430
8,3,8037,1593,3,179,86,43,15,13,336,2,5,343
8,3,8037,1594,3,248,134,61,26,10,479,1,9,489
8,3,8037,1595,3,346,153,68,27,10,604,2,4,610
8,3,8037,1596,3,253,135,76,85,16,565,1,10,576
8,3,8037,1597,3,239,120,87,31,14,491,0,4,495
8,3,8037,1598,3,556,227,114,47,32,976,0,13,989
8,3,8037,1599,3,315,114,64,28,14,535,0,7,542
8,3,8037,1600,3,457,124,76,41,17,715,0,6,721
8,3,8037,1601,3,347,148,60,29,7,591,0,4,595
8,3,8037,1602,3,217,83,51,17,8,376,0,7,383
8,3,8037,1603,3,382,191,94,32,19,718,0,14,732
8,3,8037,1604,3,75,48,32,8,3,166,1,5,172
8,3,8037,1605,3,140,90,53,26,9,318,0,8,326
8,3,8037,1606,3,211,67,33,13,8,332,0,3,335
8,3,8037,1607,3,154,84,104,18,11,371,1,4,376
8,3,8037,1608,3,186,95,47,15,10,353,2,6,361
8,3,8037,1609,3,197,68,37,16,8,326,0,5,331
8,3,8037,1610,3,171,66,49,19,7,312,0,6,318
8,3,8037,1611,3,142,72,45,17,4,280,0,6,286
8,3,8037,1612,3,156,74,77,14,11,332,4,12,348
8,3,8037,1613,3,200,87,58,14,9,368,0,8,376
8,3,8037,1614,3,195,106,53,15,7,376,0,2,378
8,3,8037,1615,3,52,47,17,5,9,130,0,3,133
8,3,8037,1616,3,271,114,84,31,15,515,0,7,522
8,3,8037,1617,3,214,84,49,20,9,376,1,8,385
8,3,8037,1618,3,514,224,125,58,20,941,0,13,954
8,3,8037,1619,3,262,91,49,19,10,431,0,7,438
8,3,8037,1620,3,113,88,24,20,7,252,0,1,253
8,3,8037,1621,3,641,246,161,73,25,1146,1,12,1159
8,3,8037,1622,3,208,54,38,19,7,326,1,3,330
8,3,8037,1623,3,513,184,77,65,20,859,0,6,865
8,3,8037,1624,3,171,132,59,28,9,399,0,7,406
8,3,8037,1625,3,148,107,58,31,9,353,1,4,358
8,3,8037,1626,3,198,87,46,18,5,354,1,7,362
8,3,8037,1627,3,51,48,26,8,4,137,0,1,138
8,3,8037,1628,3,217,124,57,15,13,426,0,7,433
8,3,8037,1629,3,160,90,55,15,7,327,0,11,338
8,3,8037,1630,3,130,64,46,11,15,266,1,9,276
8,3,8037,1631,3,175,162,63,16,8,424,0,13,437
8,3,8037,1632,3,215,154,66,22,5,462,4,4,470
8,3,8037,1633,3,240,114,74,34,10,472,1,10,483
8,3,8037,1634,3,198,117,47,25,10,397,0,5,402
8,3,8037,1635,3,313,132,64,17,11,537,1,4,542
8,3,8037,1636,3,426,139,80,30,17,692,1,7,700
8,3,8037,1637,3,278,96,67,19,6,466,0,15,481
8,3,8037,1638,3,403,140,74,27,15,659,0,5,664
8,3,8037,1639,3,480,155,45,29,12,721,1,4,726
8,3,8037,1640,3,182,103,10,0,0,295,0,2,297
8,3,8037,1641,3,704,274,94,32,24,1128,0,10,1138
8,3,8037,1642,3,807,263,123,62,26,1281,5,13,1299
8,3,8037,1643,3,250,132,66,28,10,486,0,9,495
8,3,8037,1644,3,145,45,29,11,7,237,0,6,243
8,3,8037,1645,3,244,97,68,25,9,443,4,7,454
8,3,8037,1646,3,545,201,88,43,24,901,0,15,916
8,3,8037,1647,3,223,93,37,19,7,379,0,5,384
8,3,8037,1648,3,254,80,26,10,7,377,0,5,382
8,3,8037,1649,3,371,154,83,21,14,643,0,7,650
8,3,8037,1650,3,165,138,39,19,9,370,0,6,376
8,3,8037,1651,3,250,134,68,32,12,496,2,7,505
8,3,8037,1652,3,139,111,40,18,7,315,0,9,324
8,3,8037,1653,3,199,109,60,26,18,412,0,9,421
8,3,8037,1654,3,254,156,63,37,14,524,0,14,538
8,3,8037,1655,3,237,159,60,27,22,505,3,6,514
8,3,8037,1656,3,118,63,41,15,8,245,1,5,251
8,3,8037,1657,3,250,121,68,21,9,469,3,8,480
8,3,8037,1658,3,173,86,47,13,6,325,0,5,330
8,3,8037,1659,3,248,95,42,31,9,425,0,5,430
8,3,8037,1660,3,262,99,72,14,11,458,0,8,466
8,3,8037,1661,3,256,104,45,16,9,430,0,6,436
8,3,8037,1662,3,173,116,72,28,10,399,0,4,403
8,3,8037,1663,3,243,154,47,27,8,479,0,5,484
8,3,8037,1664,3,242,164,74,34,9,523,0,10,533
8,3,8037,1665,3,500,157,96,42,16,811,0,11,822
8,3,8037,1666,3,568,225,119,62,28,1002,3,12,1017
8,3,8037,1667,3,217,98,47,20,9,391,2,5,398
8,3,8037,1668,3,240,98,48,23,4,413,0,3,416
8,3,8037,1669,3,211,102,31,15,9,368,1,4,373
8,3,8037,1670,3,153,107,51,17,8,336,0,3,339
8,3,8037,1671,3,154,52,53,19,6,284,0,2,286
8,3,8037,1672,3,263,111,79,25,8,486,0,12,498
8,3,8037,1673,3,316,133,66,35,14,564,0,12,576
8,3,8037,1674,3,206,155,51,21,9,442,1,6,449
8,3,8037,1675,3,225,133,108,23,8,497,5,14,516
8,3,8037,1676,3,215,114,52,22,9,412,1,3,416
8,3,8037,1677,3,189,73,47,31,5,345,0,2,347
8,3,8037,1678,3,449,164,110,49,26,798,1,11,810
8,3,8037,1679,3,378,137,72,26,13,626,0,4,630
8,3,8037,1680,3,489,146,78,40,15,768,2,13,783
8,3,8037,1681,3,334,117,53,30,19,553,2,4,559
8,3,8037,1682,3,845,250,132,69,29,1325,6,9,1340
8,3,8037,1683,3,524,143,53,52,20,792,0,5,797
8,3,8037,1684,3,535,205,103,55,24,922,2,10,934
8,3,8037,1685,3,185,98,38,25,10,356,0,2,358
8,3,8037,1686,3,236,105,47,26,9,423,1,11,435
8,3,8037,1687,3,247,152,65,23,9,496,1,13,510
8,3,8037,1688,3,179,99,39,14,6,337,0,7,344
8,3,8037,1689,3,164,132,63,15,8,382,2,6,390
8,3,8037,1690,3,212,118,67,18,5,420,0,7,427
8,3,8037,1691,3,99,42,58,21,7,227,0,3,230
8,3,8037,1692,3,358,105,76,26,14,579,0,8,587
8,3,8037,1693,3,622,192,90,37,20,961,1,9,971
8,3,8037,1694,3,1318,439,206,92,41,2096,6,26,2128
8,3,8037,1695,3,132,109,53,22,12,328,0,4,332
8,3,8037,1696,3,306,118,63,28,19,534,1,6,541
8,3,8037,1697,3,205,135,75,22,4,441,1,6,448
8,3,8037,1698,3,148,152,56,30,7,393,1,3,397
8,3,8037,1699,3,150,104,56,15,6,331,0,5,336
8,3,8037,1700,3,291,142,68,26,7,534,1,12,547
8,3,8037,1701,3,388,175,90,39,20,712,0,9,721
8,3,8037,1702,3,358,156,65,22,12,613,1,5,619
8,3,8037,1703,3,411,155,96,35,24,721,0,17,738
8,3,8037,1704,3,530,173,122,61,25,911,2,15,928
8,3,8037,1705,3,731,245,131,66,26,1199,1,11,1211
8,3,8037,1706,3,645,260,153,62,36,1156,4,21,1181
8,3,8037,1707,3,418,175,99,35,21,748,1,9,758
8,3,8037,1708,3,268,143,49,29,14,503,0,0,503
8,3,8037,1709,3,205,87,45,16,7,360,2,5,367
8,3,8037,1710,3,220,94,57,23,10,404,1,12,417
8,3,8037,1711,3,411,258,78,32,11,790,0,4,794
8,3,8037,1712,3,158,157,146,37,14,512,1,9,522
8,3,8037,1713,3,72,93,65,12,6,248,1,3,252
8,3,8037,1714,3,134,73,50,13,2,272,1,1,274
8,3,8037,1715,3,171,119,64,19,6,379,0,7,386
8,3,8037,1716,3,275,180,50,40,14,559,1,7,567
8,3,8037,1717,3,303,177,77,34,16,607,0,12,619
8,3,8037,1718,3,166,80,32,11,4,293,1,2,296
8,3,8037,1719,3,260,71,44,18,8,401,0,1,402
8,3,8037,1720,3,436,139,84,37,26,722,1,11,734
8,3,8037,1721,3,167,102,56,21,18,364,0,4,368
8,3,8037,1722,3,139,75,26,14,7,261,0,0,261
8,3,8037,1723,3,244,82,26,14,5,371,5,5,381
8,3,8037,1724,3,251,141,70,21,9,492,0,8,500
8,3,8037,1725,3,141,91,38,16,4,290,0,7,297
8,3,8037,1726,3,198,170,68,26,18,480,0,5,485
8,3,8037,1727,3,87,71,39,10,1,208,0,9,217
8,3,8037,1728,3,89,66,23,9,6,193,0,4,197
8,3,8037,1729,3,347,182,105,27,13,674,0,13,687
8,3,8037,1730,3,238,99,53,23,8,421,0,10,431
8,3,8037,1731,3,188,106,41,24,9,368,0,5,373
8,3,8037,1732,3,805,285,143,85,41,1359,3,10,1372
8,3,8037,1733,3,524,188,83,45,28,868,1,11,880
8,3,8037,1734,3,529,483,234,39,23,1308,2,41,1351
8,3,8037,1735,3,167,137,48,20,6,378,0,14,392
8,3,8037,1736,3,305,134,56,24,13,532,0,5,537
8,3,8037,1737,3,163,63,41,14,5,286,0,8,294
8,3,8037,1738,3,264,159,35,25,11,494,1,8,503
8,3,8037,1739,3,171,106,53,22,10,362,0,7,369
8,3,8037,1740,3,151,131,54,19,3,358,0,10,368
8,3,8037,1741,3,65,23,8,6,2,104,0,9,113
8,3,8037,1742,3,49,33,19,9,0,110,0,1,111
8,3,8037,1743,3,429,151,47,46,10,683,1,4,688
8,3,8037,1744,3,261,122,58,20,14,475,1,10,486
8,3,8037,1745,3,683,275,181,84,29,1252,1,18,1271
8,3,8037,1746,3,229,110,65,13,10,427,0,8,435
8,3,8037,1747,3,94,91,20,20,4,229,0,3,232
8,3,8037,1748,3,162,83,45,12,7,309,0,9,318
8,3,8037,1749,3,392,229,119,46,17,803,1,17,821
8,3,8037,1750,3,131,197,92,15,14,449,1,9,459
8,3,8037,1751,3,144,79,26,8,7,264,0,4,268
8,3,8037,1752,3,1225,949,615,207,78,3074,9,42,3125
8,3,8037,1753,3,235,166,81,24,21,527,1,10,538
8,3,8037,1754,3,305,143,68,29,13,558,0,11,569
8,3,8037,1755,3,498,297,141,75,31,1042,1,20,1063
8,3,8037,1756,3,604,224,160,59,31,1078,1,15,1094
8,3,8037,1757,3,433,230,161,52,17,893,1,9,903
8,3,8037,1758,3,1416,839,451,143,73,2922,8,32,2962
8,3,8037,1759,3,122,123,44,20,7,316,3,0,319
8,3,8037,1760,3,186,155,59,25,11,436,6,13,455
8,3,8037,1761,3,125,100,44,6,9,284,1,2,287
8,3,8037,1762,3,76,91,36,15,15,233,0,9,242
8,3,8037,1763,3,203,397,163,40,14,817,1,26,844
8,3,8037,1764,3,134,230,173,24,13,574,0,19,593
8,3,8037,1765,3,190,112,34,16,16,368,1,8,377
8,3,8037,1766,3,229,161,90,21,12,513,1,15,529
8,3,8037,1770,3,138,76,46,11,9,280,0,7,287
8,3,8037,1771,3,90,66,35,30,4,225,1,6,232
8,3,8037,1772,3,666,392,269,192,35,1554,0,19,1573
8,3,8037,1773,3,159,152,69,42,20,442,0,9,451
8,3,8037,1774,3,285,126,92,29,18,550,0,10,560
8,3,8037,1775,3,242,124,90,38,16,510,1,6,517
8,3,8037,1791,3,178,82,53,20,6,339,0,8,347
8,3,8037,1792,3,107,68,18,24,6,223,1,1,225
8,3,8037,1793,3,231,151,61,24,3,470,2,4,476
8,3,8037,1794,3,256,210,103,43,15,627,0,14,641
8,3,8037,1795,3,294,169,84,44,18,609,3,8,620
8,3,8037,1796,3,276,185,46,32,9,548,1,12,561
8,3,8037,1811,3,218,157,66,24,10,475,0,10,485
8,3,8037,1827,3,496,432,197,94,46,1265,2,22,1289
8,3,8037,1828,3,170,198,62,36,8,474,1,12,487
8,3,8037,1829,3,196,152,53,30,8,439,1,7,447
8,3,8037,1830,3,191,217,58,38,8,512,1,8,521
8,3,8037,1946,3,193,101,42,16,9,361,1,8,370
8,3,8037,1947,3,305,145,76,30,8,564,1,9,574
8,3,8037,1948,3,335,149,59,20,10,573,0,11,584
8,3,8037,1949,3,276,73,31,21,10,411,0,3,414
8,3,8037,1950,3,265,401,162,96,14,938,1,17,956
8,3,8037,1966,3,90,53,33,7,2,185,0,0,185
8,4,8037,1767,3,149,151,92,11,7,410,0,13,423
8,4,8037,1768,3,178,143,60,20,10,411,1,4,416
8,4,8037,1769,3,230,156,86,28,4,504,0,9,513
8,4,8037,1776,3,189,78,45,13,7,332,0,11,343
8,4,8037,1777,3,119,70,31,9,6,235,2,5,242
8,4,8037,1778,3,213,175,82,27,8,505,2,15,522
8,4,8037,1779,3,133,229,85,29,17,493,3,13,509
8,4,8037,1780,3,68,74,32,8,6,188,0,6,194
8,4,8037,1781,3,146,75,51,22,6,300,1,3,304
8,4,8037,1782,3,184,118,53,22,12,389,0,7,396
8,4,8037,1783,3,235,127,52,29,11,454,2,2,458
8,4,8037,1784,3,265,147,60,19,17,508,0,12,520
8,4,8037,1785,3,153,107,39,19,3,321,3,2,326
8,4,8037,1786,3,171,98,54,19,4,346,1,7,354
8,4,8037,1787,3,301,164,74,37,14,590,0,22,612
8,4,8037,1788,3,147,66,24,14,7,258,0,0,258
8,4,8037,1789,3,144,84,32,24,7,291,0,3,294
8,4,8037,1790,3,261,139,41,15,13,469,4,7,480
8,4,8037,1797,3,176,157,55,32,17,437,0,3,440
8,4,8037,1798,3,167,115,47,15,9,353,2,4,359
8,4,8037,1799,3,348,182,64,40,25,659,2,11,672
8,4,8037,1800,3,207,85,83,27,14,416,0,4,420
8,4,8037,1801,3,152,102,29,18,9,310,0,5,315
8,4,8037,1802,3,109,60,24,11,10,214,0,3,217
8,4,8037,1803,3,180,94,49,22,9,354,1,4,359
8,4,8037,1804,3,92,105,21,11,6,235,0,0,235
8,4,8037,1805,3,172,102,66,16,10,366,0,8,374
8,4,8037,1806,3,135,70,54,15,6,280,0,11,291
8,4,8037,1807,3,149,127,47,18,11,352,0,8,360
8,4,8037,1808,3,139,167,48,32,7,393,0,5,398
8,4,8037,1809,3,160,109,37,22,12,340,1,6,347
8,4,8037,1810,3,146,161,51,36,11,405,2,6,413
8,4,8037,1812,3,232,194,75,39,12,552,0,12,564
8,4,8037,1813,3,135,139,50,26,9,359,2,5,366
8,4,8037,1814,3,181,191,67,30,10,479,1,8,488
8,4,8037,1815,3,182,172,67,7,16,444,0,0,444
8,4,8037,1816,3,89,139,50,17,5,300,3,18,321
8,4,8037,1817,3,87,89,66,15,10,267,0,8,275
8,4,8037,1818,3,128,93,35,14,10,280,0,11,291
8,4,8037,1819,3,165,138,48,20,3,374,0,10,384
8,4,8037,1820,3,92,126,31,11,2,262,0,10,272
8,4,8037,1821,3,170,202,57,18,2,449,0,14,463
8,4,8037,1822,3,110,148,54,31,12,355,1,8,364
8,4,8037,1823,3,163,122,60,23,6,374,1,6,381
8,4,8037,1824,3,140,143,51,26,10,370,0,11,381
8,4,8037,1825,3,172,212,66,24,8,482,0,12,494
8,4,8037,1831,3,70,173,44,18,6,311,2,12,325
8,4,8037,1832,3,149,185,68,21,8,431,0,8,439
8,4,8037,1833,3,113,125,29,14,8,289,0,6,295
8,4,8037,1834,3,229,142,69,41,12,493,1,3,497
8,4,8037,1835,3,154,83,48,17,5,307,0,10,317
8,4,8037,1836,3,145,106,44,17,5,317,0,7,324
8,4,8037,1837,3,418,230,136,61,28,873,4,10,887
8,4,8037,1838,3,112,257,65,37,8,479,1,12,492
8,4,8037,1839,3,150,95,78,12,7,342,179,10,531
8,4,8037,1840,3,141,151,54,13,7,366,0,11,377
8,4,8037,1841,3,198,143,72,32,17,462,0,10,472
8,4,8037,1842,3,215,124,54,22,13,428,1,10,439
8,4,8037,1843,3,124,126,68,20,7,345,0,12,357
8,4,8037,1844,3,180,133,56,18,11,398,1,5,404
8,4,8037,1845,3,132,163,72,22,7,396,0,5,401
8,4,8037,1846,3,106,183,38,19,9,355,0,8,363
8,4,8037,1847,3,130,100,46,32,8,316,0,10,326
8,4,8037,1848,3,137,91,44,11,5,288,2,10,300
8,4,8037,1849,3,158,119,23,24,3,327,0,8,335
8,4,8037,1850,3,122,75,42,21,6,266,0,2,268
8,4,8037,1851,3,144,231,83,15,12,485,0,5,490
8,4,8037,1852,3,168,91,57,34,9,359,1,7,367
8,4,8037,1853,3,154,130,48,20,10,362,0,3,365
8,4,8037,1854,3,107,228,86,24,12,457,1,10,468
8,4,8037,1855,3,132,198,64,19,3,416,1,13,430
8,4,8037,1856,3,93,108,40,14,4,259,2,8,269
8,4,8037,1866,3,99,168,51,17,7,342,2,8,352
8,4,8037,1867,3,164,84,47,29,14,338,0,0,338
8,4,8037,1868,3,340,188,99,36,28,691,1,14,706
8,4,8037,1869,3,210,149,64,39,8,470,0,7,477
8,4,8037,1880,3,226,181,45,35,8,495,2,12,509
8,4,8037,1881,3,148,104,34,27,8,321,1,4,326
8,4,8037,1882,3,151,139,45,26,9,370,0,3,373
8,4,8037,1893,3,68,133,73,29,2,305,2,11,318
8,4,8037,1894,3,68,106,34,14,8,230,2,11,243
8,4,8037,1895,3,84,136,40,18,7,285,0,8,293
8,4,8037,1896,3,116,196,52,13,7,384,0,13,397
8,4,8037,1897,3,90,165,52,13,9,329,1,10,340
8,4,8037,1898,3,84,146,85,24,10,349,1,18,368
8,4,8037,1899,3,109,149,69,23,4,354,0,2,356
8,4,8037,1900,3,57,172,85,20,6,340,3,6,349
8,4,8037,1909,3,74,156,69,18,15,332,1,6,339
8,4,8037,1910,3,114,187,63,17,2,383,1,7,391
8,4,8037,1917,3,143,165,52,32,4,396,0,12,408
8,4,8037,1918,3,142,187,52,21,18,420,0,8,428
8,4,8037,1919,3,505,336,161,81,29,1112,1,17,1130
8,4,8037,1920,3,168,184,70,25,6,453,0,5,458
8,4,8037,1921,3,187,199,53,34,4,477,0,8,485
8,4,8037,1922,3,191,144,44,25,9,413,0,5,418
8,4,8037,1923,3,202,171,69,23,10,475,2,10,487
8,4,8037,1924,3,127,170,30,20,16,363,1,0,364
8,4,8037,1925,3,183,195,70,37,12,497,2,8,507
8,4,8037,1926,3,192,191,43,35,6,467,0,14,481
8,4,8037,1927,3,174,184,41,34,6,439,2,4,445
8,4,8037,1928,3,281,189,80,31,17,598,0,15,613
8,4,8037,2027,3,141,121,49,11,8,330,0,7,337
8,4,8037,2028,3,186,161,70,22,14,453,0,12,465
8,4,8037,2029,3,227,157,70,22,11,487,0,6,493
8,4,8037,2030,3,171,151,85,24,11,442,0,14,456
8,4,8037,2031,3,196,183,64,29,13,485,1,10,496
8,4,8037,2032,3,125,111,22,11,4,273,0,15,288
8,4,8037,2070,3,160,300,63,27,9,559,0,16,575
8,4,8037,2071,3,78,114,27,14,7,240,0,5,245
8,4,8037,2072,3,157,87,23,2,13,282,0,0,282
8,4,8037,2073,3,131,117,52,21,2,323,1,13,337
8,4,8037,2074,3,244,176,53,22,5,500,5,9,514
8,4,8037,2075,3,118,113,56,19,10,316,9,8,333
8,4,8037,2076,3,111,143,34,21,10,319,0,6,325
8,4,8037,2077,3,229,185,74,27,16,531,0,8,539
8,4,8037,2078,3,201,214,85,27,12,539,0,14,553
8,4,8037,2079,3,126,161,51,18,6,362,3,5,370
8,4,8037,2080,3,87,144,52,12,8,303,1,0,304
8,4,8037,2081,3,134,216,60,15,10,435,5,7,447
8,4,8037,2082,3,138,200,67,20,5,430,0,15,445
8,4,8037,2083,3,145,166,54,19,6,390,0,5,395
8,4,8037,2084,3,97,114,48,15,9,283,0,4,287
8,4,8037,2085,3,170,126,47,24,9,376,1,15,392
8,4,8037,2086,3,203,153,66,14,18,454,1,13,468
8,4,8037,2087,3,129,115,44,11,6,305,1,9,315
8,4,8037,2088,3,130,94,38,17,6,285,1,11,297
8,4,8037,2095,3,157,124,30,16,7,334,2,12,348
8,4,8037,2096,3,109,119,50,19,3,300,3,16,319
8,4,8037,2097,3,175,205,67,32,7,486,0,14,500
8,4,8037,2098,3,177,171,79,15,10,452,0,14,466
8,4,8037,2099,3,81,112,35,14,8,250,2,4,256
8,4,8037,2100,3,102,182,54,20,3,361,2,6,369
8,4,8037,2101,3,153,223,64,16,5,461,1,10,472
8,4,8037,2102,3,265,365,131,32,11,804,0,35,839
8,4,8037,2103,3,241,217,119,46,21,644,1,15,660
8,4,8037,2104,3,275,194,109,29,9,616,0,0,616
8,4,8037,2105,3,83,181,98,11,3,376,0,12,388
8,4,8037,2106,3,117,226,119,28,5,495,2,16,513
8,4,8037,2107,3,142,267,119,25,12,565,1,17,583
8,4,8037,2108,3,157,217,124,34,9,541,1,22,564
8,4,8037,2109,3,141,250,65,19,5,480,0,18,498
8,4,8037,2110,3,54,45,24,9,6,138,1,1,140
8,4,8037,2111,3,180,210,101,27,9,527,0,7,534
8,4,8037,2112,3,150,225,75,23,5,478,0,21,499
8,4,8037,2113,3,106,138,53,39,7,343,0,13,356
8,4,8037,2115,3,82,100,62,15,3,262,2,7,271
8,4,8037,2119,3,241,258,85,36,7,627,5,13,645
8,4,8037,2120,3,250,301,110,43,13,717,3,12,732
8,4,8037,2121,3,195,263,91,19,6,574,0,31,605
8,4,8037,2122,3,101,109,55,17,5,287,0,11,298
8,4,8037,2123,3,196,289,113,34,23,655,2,14,671
8,4,8037,2124,3,85,104,64,13,5,271,2,7,280
8,4,8037,2125,3,101,121,31,21,6,280,1,3,284
8,4,8037,2126,3,115,86,58,17,4,280,0,7,287
8,4,8037,2127,3,153,178,58,18,9,416,3,8,427
8,4,8037,2128,3,120,134,48,5,3,310,0,11,321
8,4,8037,2129,3,163,186,72,23,8,452,4,13,469
8,4,8037,2130,3,252,298,225,36,18,829,3,26,858
8,4,8037,2131,3,324,422,268,66,21,1101,3,26,1130
8,4,8037,2132,3,159,150,42,20,8,379,0,5,384
8,4,8037,2133,3,208,211,82,23,12,536,2,12,550
8,4,8037,2134,3,283,247,122,41,21,714,16,16,746
8,4,8037,2135,3,218,229,99,34,10,590,4,17,611
8,4,8037,2136,3,126,127,79,23,6,361,0,16,377
8,4,8037,2137,3,230,185,97,11,9,532,3,12,547
8,4,8037,2138,3,82,156,36,8,2,284,1,12,297
8,4,8037,2139,3,114,153,42,11,5,325,1,10,336
8,4,8037,2140,3,195,402,98,23,11,729,2,28,759
8,4,8037,2141,3,127,182,73,31,4,417,1,19,437
8,4,8037,2142,3,183,217,86,29,7,522,5,18,545
8,4,8037,2143,3,99,154,53,11,6,323,0,11,334
8,4,8037,2144,3,87,108,40,16,8,259,0,14,273
8,4,8037,2145,3,177,243,78,9,9,516,1,3,520
8,4,8037,2146,3,127,124,51,18,7,327,1,9,337
8,4,8037,2147,3,112,116,28,8,2,266,0,8,274
8,4,8037,2148,3,109,131,23,9,3,275,0,7,282
8,4,8037,2149,3,154,185,43,16,12,410,1,15,426
8,4,8037,2150,3,79,98,38,16,4,235,0,8,243
8,4,8037,2151,3,105,159,44,17,9,334,1,14,349
8,4,8037,2152,3,219,266,108,21,11,625,2,32,659
8,4,8037,2153,3,170,248,73,24,15,530,2,21,553
8,4,8037,2154,3,132,174,78,24,8,416,0,6,422
8,4,8037,2155,3,319,549,199,67,13,1147,3,38,1188
8,4,8037,2156,3,158,188,68,15,6,435,1,13,449
8,4,8037,2157,3,79,98,27,10,2,216,0,0,216
8,4,8037,2158,3,135,267,65,33,10,510,1,18,529
8,4,8037,2159,3,292,321,137,37,21,808,6,6,820
8,4,8037,2160,3,93,194,46,13,5,351,2,6,359
8,4,8037,2161,3,103,199,59,13,8,382,5,8,395
8,4,8037,2162,3,70,130,49,17,4,270,3,4,277
8,4,8037,2163,3,110,154,39,18,6,327,0,16,343
8,4,8037,2164,3,77,146,53,4,11,291,0,8,299
8,4,8037,2165,3,188,189,72,27,9,485,1,19,505
8,4,8037,2166,3,178,199,70,26,12,485,5,17,507
8,4,8037,2167,3,154,194,60,20,11,439,0,14,453
8,4,8037,2168,3,93,74,24,14,4,209,0,8,217
8,4,8037,2169,3,86,112,39,17,8,262,0,6,268
8,4,8037,2170,3,104,96,27,9,2,238,1,8,247
8,4,8037,2171,3,154,196,78,21,14,463,0,5,468
8,4,8037,2172,3,235,396,124,45,12,812,6,47,865
8,4,8037,2173,3,220,261,103,27,11,622,3,13,638
8,4,8037,2174,3,202,267,87,36,5,597,1,20,618
8,4,8037,2175,3,89,103,33,8,6,239,0,6,245
8,4,8037,2176,3,123,134,32,15,6,310,1,4,315
8,4,8037,2177,3,171,170,89,16,8,454,0,7,461
8,4,8037,2178,3,158,191,54,24,15,442,0,6,448
8,4,8037,2179,3,211,209,68,23,13,524,0,19,543
8,4,8037,2180,3,209,206,76,29,11,531,2,10,543
8,4,8037,2181,3,142,97,59,34,18,350,1,1,352
8,4,8037,2182,3,187,109,85,32,13,426,0,8,434
8,4,8037,2183,3,181,85,53,25,11,355,0,5,360
8,4,8037,2184,3,127,116,60,21,12,336,0,6,342
8,4,8037,2185,3,117,113,47,16,4,297,1,7,305
8,4,8037,2186,3,105,162,61,22,5,355,0,14,369
8,4,8037,2187,3,227,267,109,26,11,640,1,20,661
8,4,8037,2188,3,638,721,359,132,59,1909,2,62,1973
8,4,8037,2189,3,299,334,116,73,19,841,0,14,855
8,4,8037,2190,3,48,98,40,13,5,204,0,5,209
8,4,8037,2191,3,176,368,93,24,7,668,1,38,707
8,4,8037,2193,3,154,228,92,36,17,527,4,12,543
8,4,8037,2194,3,106,162,62,15,8,353,0,17,370
8,4,8037,2198,3,2096,1578,977,329,167,5147,14,72,5233
8,5,8002,17,3,442,358,78,54,13,945,2,8,955
8,5,8002,18,3,299,248,58,26,4,635,0,15,650
8,5,8002,19,3,200,148,94,25,4,471,0,8,479
8,5,8002,20,3,324,223,48,28,7,630,2,20,652
8,5,8002,21,3,158,165,48,28,5,404,4,6,414
8,5,8002,22,3,165,173,62,31,9,440,1,24,465
8,5,8002,23,3,229,221,89,28,6,573,1,24,598
8,5,8002,24,3,213,220,63,40,8,544,0,16,560
8,5,8002,25,3,138,99,38,6,6,287,1,3,291
8,5,8002,26,3,146,148,40,17,3,354,0,4,358
8,5,8002,27,3,280,212,75,31,12,610,0,13,623
8,5,8002,28,3,224,252,71,18,13,578,0,16,594
8,5,8002,29,3,7,21,0,0,0,28,0,4,32
8,5,8002,30,3,29,60,32,1,0,122,0,4,126
8,5,8002,31,3,26,65,8,5,0,104,0,5,109
8,5,8002,32,3,76,132,26,10,1,245,0,6,251
8,5,8002,33,3,4,15,2,7,0,28,0,0,28
8,5,8002,34,3,208,329,67,22,3,629,3,19,651
8,5,8002,35,3,72,55,11,1,0,139,2,3,144
8,5,8002,36,3,25,50,4,0,1,80,1,3,84
8,5,8002,37,3,43,27,6,2,0,78,0,2,80
8,5,8003,38,3,156,241,60,34,2,493,1,17,511
8,5,8003,39,3,170,227,46,41,6,490,0,12,502
8,5,8003,40,3,128,173,32,16,2,351,1,10,362
8,5,8003,41,3,126,173,24,15,2,340,0,18,358
8,5,8003,42,3,6,25,4,2,0,37,0,0,37
8,5,8003,43,3,52,61,8,1,1,123,0,5,128
8,5,8003,44,3,6,16,6,3,0,31,0,0,31
8,5,8003,45,3,18,25,6,1,0,50,0,3,53
8,5,8003,46,3,16,33,11,1,0,61,0,3,64
8,5,8003,47,3,32,31,4,3,0,70,0,1,71
8,5,8003,48,3,67,43,9,0,0,119,0,5,124
8,5,8003,49,3,18,70,7,2,1,98,0,3,101
8,5,8003,50,3,41,51,4,4,2,102,0,1,103
8,5,8003,51,3,31,30,7,3,0,71,0,6,77
8,5,8003,52,3,31,47,8,8,1,95,2,7,104
8,5,8003,53,3,84,159,21,35,3,302,0,6,308
8,5,8003,54,3,50,166,19,21,1,257,0,8,265
8,5,8003,55,3,118,81,13,44,0,256,0,13,269
8,5,8004,56,3,257,352,92,58,5,764,0,26,790
8,5,8004,57,3,49,87,23,12,3,174,1,0,175
8,5,8004,58,3,5,15,2,2,2,26,0,0,26
8,5,8004,59,3,189,227,54,34,5,509,1,20,530
8,5,8011,175,3,115,35,10,9,2,171,0,7,178
8,5,8011,176,3,246,144,65,24,9,488,0,4,492
8,5,8011,177,3,204,113,22,13,6,358,0,7,365
8,5,8011,178,3,243,91,25,22,9,390,0,2,392
8,5,8011,179,3,124,84,16,8,12,244,0,1,245
8,5,8011,180,3,143,148,45,14,8,358,0,10,368
8,5,8011,181,3,129,67,26,11,2,235,0,2,237
8,5,8011,182,3,149,69,19,12,6,255,0,3,258
8,5,8011,183,3,227,122,30,24,5,408,0,5,413
8,5,8011,184,3,204,97,31,10,3,345,0,4,349
8,5,8011,185,3,506,229,49,23,16,823,0,3,826
8,5,8011,186,3,366,195,39,26,8,634,0,2,636
8,5,8011,187,3,172,90,35,15,3,315,0,11,326
8,5,8011,188,3,169,95,27,13,3,307,2,5,314
8,5,8011,189,3,235,125,33,21,5,419,0,11,430
8,5,8011,190,3,238,141,46,17,4,446,0,4,450
8,5,8011,191,3,427,360,83,57,8,935,1,17,953
8,5,8011,192,3,464,446,147,63,13,1133,2,15,1150
8,5,8011,193,3,186,116,43,38,4,387,0,5,392
8,5,8011,194,3,252,173,60,29,4,518,0,6,524
8,5,8011,195,3,178,114,27,11,4,334,2,2,338
8,5,8011,196,3,305,237,76,44,9,671,0,15,686
8,5,8011,197,3,235,170,61,30,6,502,0,8,510
8,5,8011,198,3,46,26,11,7,0,90,0,0,90
8,5,8011,199,3,459,215,52,21,8,755,2,25,782
8,5,8011,200,3,244,230,61,42,6,583,1,19,603
8,5,8011,201,3,232,136,36,26,9,439,0,13,452
8,5,8011,202,3,360,296,83,47,10,796,2,30,828
8,5,8011,203,3,428,332,94,58,13,925,0,25,950
8,5,8011,204,3,341,339,79,38,4,801,3,25,829
8,5,8011,205,3,261,274,90,52,7,684,4,17,705
8,5,8011,206,3,295,245,47,43,16,646,0,12,658
8,5,8011,207,3,40,57,18,1,0,116,0,1,117
8,5,8011,208,3,20,47,6,2,0,75,0,2,77
8,5,8011,209,3,11,12,7,1,0,31,0,0,31
8,5,8011,211,3,6,6,3,0,0,15,0,0,15
8,5,8011,212,3,13,13,5,0,0,31,0,0,31
8,5,8011,214,3,90,53,18,7,1,169,0,5,174
8,5,8011,215,3,273,123,17,24,5,442,0,18,460
8,5,8011,216,3,216,152,36,21,5,430,0,6,436
8,5,8011,217,3,153,117,27,8,2,307,0,4,311
8,5,8011,218,3,90,68,11,5,0,174,0,6,180
8,5,8011,219,3,114,137,29,2,0,282,2,9,293
8,5,8011,220,3,49,6,8,2,0,65,0,1,66
8,5,8014,253,3,265,188,21,14,3,491,0,4,495
8,5,8014,254,3,18,50,6,0,0,74,0,2,76
8,5,8014,255,3,14,31,2,0,0,47,0,0,47
8,5,8014,256,3,68,65,3,0,0,136,0,9,145
8,5,8014,257,3,52,47,2,0,0,101,0,3,104
8,5,8014,258,3,29,37,3,0,0,69,0,0,69
8,5,8014,259,3,23,43,2,1,0,69,0,0,69
8,5,8014,260,3,36,13,4,0,0,53,0,1,54
8,5,8015,261,3,171,187,9,3,1,371,0,14,385
8,5,8015,263,3,28,18,2,1,0,49,0,1,50
8,5,8015,264,3,37,46,22,1,1,107,0,2,109
8,5,8015,265,3,46,46,21,2,1,116,0,4,120
8,5,8016,266,3,260,203,25,7,4,499,1,11,511
8,5,8016,267,3,121,87,4,4,1,217,0,7,224
8,5,8016,268,3,69,104,6,1,0,180,0,5,185
8,5,8016,269,3,190,129,18,15,4,356,1,6,363
8,5,8016,270,3,205,126,32,12,2,377,0,6,383
8,5,8021,921,3,119,241,52,30,5,447,0,17,464
8,5,8021,922,3,160,191,61,25,8,445,0,6,451
8,5,8021,923,3,392,427,40,38,10,907,0,16,923
8,5,8021,924,3,178,214,40,8,3,443,0,3,446
8,5,8021,925,3,155,187,18,12,6,378,1,10,389
8,5,8021,926,3,233,266,21,4,1,525,0,7,532
8,5,8021,927,3,227,256,31,14,1,529,1,8,538
8,5,8021,928,3,101,127,21,10,4,263,0,13,276
8,5,8021,929,3,140,183,44,26,3,396,2,7,405
8,5,8021,930,3,123,168,36,18,3,348,0,7,355
8,5,8021,931,3,114,131,23,10,2,280,0,3,283
8,5,8021,932,3,135,221,39,21,6,422,0,6,428
8,5,8021,933,3,174,186,40,19,5,424,0,7,431
8,5,8021,934,3,132,149,33,5,4,323,0,8,331
8,5,8021,935,3,137,171,35,22,10,375,0,5,380
8,5,8021,936,3,111,136,19,14,2,282,0,6,288
8,5,8021,937,3,112,160,48,13,3,336,0,6,342
8,5,8021,938,3,86,103,21,12,4,226,1,3,230
8,5,8021,939,3,123,161,37,9,6,336,0,11,347
8,5,8021,940,3,139,110,14,9,4,276,0,6,282
8,5,8021,941,3,124,168,30,10,3,335,1,10,346
8,5,8021,942,3,153,167,11,4,3,338,0,6,344
8,5,8021,943,3,150,155,21,6,1,333,0,8,341
8,5,8021,944,3,333,425,67,44,16,885,1,10,896
8,5,8021,945,3,139,213,24,10,8,394,0,10,404
8,5,8021,946,3,220,182,39,15,3,459,0,14,473
8,5,8021,947,3,154,134,17,12,3,320,0,9,329
8,5,8021,948,3,113,159,22,10,0,304,1,3,308
8,5,8021,949,3,127,114,23,3,2,269,0,9,278
8,5,8021,950,3,169,174,46,15,5,409,0,0,409
8,5,8021,951,3,109,163,34,4,3,313,0,6,319
8,5,8021,952,3,142,167,39,22,1,371,0,5,376
8,5,8021,953,3,217,353,68,31,7,676,0,6,682
8,5,8021,954,3,172,221,43,16,5,457,0,9,466
8,5,8021,955,3,135,159,25,13,1,333,0,2,335
8,5,8021,956,3,144,197,34,23,1,399,1,7,407
8,5,8021,957,3,212,182,41,8,4,447,0,18,465
8,5,8021,958,3,304,393,49,8,6,760,1,6,767
8,5,8021,959,3,233,274,30,17,2,556,0,4,560
8,5,8021,960,3,301,281,18,16,2,618,0,3,621
8,5,8021,961,3,171,185,28,13,3,400,0,4,404
8,5,8021,962,3,235,250,31,18,5,539,0,9,548
8,5,8021,963,3,502,527,84,28,5,1146,0,10,1156
8,5,8021,964,3,115,148,23,16,2,304,0,8,312
8,5,8021,965,3,208,235,44,29,1,517,0,5,522
8,5,8021,966,3,174,160,28,15,6,383,0,6,389
8,5,8021,967,3,145,199,37,66,2,449,0,9,458
8,5,8021,968,3,185,220,32,14,4,455,1,13,469
8,5,8021,969,3,241,386,59,27,9,722,0,3,725
8,5,8021,970,3,189,204,36,15,10,454,0,3,457
8,5,8021,971,3,170,231,34,25,5,465,0,8,473
8,5,8021,972,3,750,816,159,116,16,1857,0,18,1875
8,5,8021,973,3,225,269,50,18,4,566,0,2,568
8,5,8021,974,3,176,213,35,25,5,454,0,15,469
8,5,8021,975,3,125,189,32,12,2,360,1,16,377
8,5,8021,976,3,135,182,38,13,2,370,0,4,374
8,5,8021,977,3,115,186,40,10,3,354,0,12,366
8,5,8021,978,3,153,175,45,13,0,386,0,5,391
8,5,8021,979,3,110,151,35,10,7,313,0,5,318
8,5,8021,980,3,150,155,35,20,6,366,1,11,378
8,5,8021,981,3,190,161,33,21,2,407,2,10,419
8,5,8021,982,3,110,166,36,17,5,334,1,8,343
8,5,8021,983,3,155,208,38,7,3,411,3,6,420
8,5,8021,984,3,414,688,86,41,5,1234,1,19,1254
8,5,8021,985,3,162,217,26,26,2,433,0,4,437
8,5,8021,986,3,102,132,34,22,1,291,0,4,295
8,5,8021,987,3,136,166,71,21,8,402,0,9,411
8,5,8021,988,3,159,182,48,15,6,410,1,15,426
8,5,8021,989,3,168,216,65,17,5,471,0,5,476
8,5,8021,990,3,133,197,43,7,2,382,0,12,394
8,5,8021,991,3,546,760,136,65,21,1528,2,21,1551
8,5,8021,992,3,182,283,34,25,5,529,0,18,547
8,5,8021,993,3,134,180,32,18,6,370,0,7,377
8,5,8021,994,3,129,191,43,25,4,392,1,13,406
8,5,8021,995,3,141,207,47,13,6,414,1,2,417
8,5,8021,996,3,220,296,72,45,10,643,2,19,664
8,5,8021,997,3,93,140,53,10,2,298,1,0,299
8,5,8021,998,3,65,119,18,21,1,224,0,0,224
8,5,8021,999,3,100,148,13,45,3,309,1,5,315
8,5,8021,1000,3,169,263,82,18,7,539,3,17,559
8,5,8021,1001,3,471,651,127,51,17,1317,1,42,1360
8,5,8021,1002,3,238,361,82,37,5,723,2,16,741
8,5,8021,1003,3,97,148,30,51,4,330,0,5,335
8,5,8021,1004,3,89,147,13,26,0,275,0,7,282
8,5,8021,1005,3,101,115,11,13,2,242,0,3,245
8,5,8021,1006,3,368,650,168,41,10,1237,2,24,1263
8,5,8021,1007,3,103,135,19,14,2,273,1,4,278
8,5,8021,1008,3,155,202,45,16,3,421,0,11,432
8,5,8021,1009,3,79,60,16,2,1,158,0,4,162
8,5,8021,1010,3,38,65,8,2,0,113,0,4,117
8,5,8021,1011,3,125,56,23,1,2,207,0,0,207
8,5,8021,1012,3,43,33,7,7,1,91,1,2,94
8,5,8021,1013,3,219,285,73,42,12,631,0,20,651
8,5,8021,1014,3,101,140,30,7,4,282,3,10,295
8,5,8021,1015,3,179,166,37,40,7,429,1,13,443
8,5,8021,1016,3,93,132,35,25,4,289,2,12,303
8,5,8021,1017,3,53,39,10,0,3,105,0,2,107
8,5,8021,1018,3,90,69,8,8,4,179,0,9,188
8,5,8021,1019,3,93,53,8,4,0,158,0,8,166
8,5,8021,1020,3,153,184,33,14,2,386,0,15,401
8,5,8021,1021,3,109,102,25,17,2,255,1,10,266
8,5,8021,1022,3,69,44,13,2,0,128,1,6,135
8,5,8021,1023,3,231,158,31,12,4,436,1,12,449
8,5,8021,1024,3,250,277,51,16,9,603,0,20,623
8,5,8021,1025,3,13,22,1,2,0,38,0,1,39
8,5,8021,1026,3,111,190,41,10,3,355,1,3,359
8,5,8021,1027,3,142,122,13,8,3,288,0,12,300
8,5,8021,1028,3,151,133,37,11,6,338,0,10,348
8,5,8021,1029,3,162,67,19,4,3,255,0,8,263
8,5,8021,1030,3,280,193,43,8,2,526,4,24,554
8,5,8036,1387,3,109,81,177,14,6,387,0,13,400
8,5,8036,1388,3,145,90,64,12,2,313,2,13,328
8,5,8036,1389,3,202,219,68,22,3,514,0,14,528
8,5,8036,1390,3,194,231,53,22,12,512,0,9,521
8,5,8036,1391,3,132,175,31,38,1,377,0,5,382
8,5,8036,1392,3,134,99,41,9,1,284,1,6,291
8,5,8036,1393,3,147,175,65,30,2,419,0,6,425
8,5,8036,1394,3,89,125,31,25,1,271,0,5,276
8,5,8036,1395,3,225,200,36,36,1,498,0,14,512
8,5,8036,1396,3,235,207,61,32,1,536,2,8,546
8,5,8036,1397,3,147,120,21,22,1,311,1,7,319
8,5,8036,1398,3,268,250,77,20,1,616,5,23,644
8,5,8036,1399,3,267,200,99,50,5,621,0,21,642
8,5,8036,1400,3,217,176,63,35,3,494,2,7,503
8,5,8036,1401,3,100,124,45,14,3,286,1,12,299
8,5,8036,1402,3,107,164,85,18,3,377,2,15,394
8,5,8036,1403,3,136,169,78,24,5,412,0,17,429
8,5,8036,1404,3,128,145,48,24,1,346,0,8,354
8,5,8036,1405,3,137,137,52,33,4,363,2,13,378
8,5,8036,1406,3,254,349,120,37,6,766,4,26,796
8,5,8036,1407,3,394,317,153,79,15,958,1,13,972
8,5,8036,1408,3,121,108,48,21,2,300,1,8,309
8,5,8036,1409,3,157,117,42,15,6,337,7,9,353
8,5,8036,1410,3,146,121,53,10,7,337,0,7,344
8,5,8036,1411,3,327,336,148,69,16,896,0,16,912
8,5,8036,1412,3,178,224,100,30,7,539,3,21,563
8,5,8036,1413,3,95,84,43,7,1,230,2,4,236
8,5,8036,1414,3,47,50,69,6,1,173,1,4,178
8,5,8036,1415,3,57,39,110,16,4,226,0,9,235
8,5,8036,1416,3,56,69,81,3,0,209,2,11,222
8,5,8036,1417,3,60,41,37,4,0,142,1,4,147
8,5,8036,1418,3,94,176,30,5,0,305,0,9,314
8,5,8036,1419,3,118,119,61,7,0,305,0,16,321
8,5,8036,1421,3,78,115,20,3,0,216,0,10,226
8,5,8036,1422,3,70,47,22,2,1,142,0,7,149
8,5,8036,1423,3,206,194,27,1,4,432,2,7,441
8,5,8038,2199,3,155,157,41,34,1,388,0,22,410
8,5,8038,2200,3,218,173,34,33,1,459,1,15,475
8,5,8038,2201,3,119,79,10,5,0,213,0,7,220
8,5,8038,2203,3,236,194,20,6,3,459,1,13,473
8,5,8038,2204,3,133,103,10,4,0,250,0,6,256
8,5,8038,2205,3,102,168,16,15,3,304,0,15,319
8,5,8039,2206,3,176,162,127,15,2,482,0,7,489
8,5,8039,2207,3,129,160,110,9,2,410,0,9,419
8,5,8039,2208,3,32,36,39,4,0,111,0,4,115
8,5,8039,2209,3,35,28,21,1,0,85,0,4,89
8,5,8039,2210,3,36,15,3,1,0,55,0,0,55
8,5,8039,2211,3,61,128,20,13,2,224,0,13,237
8,5,8039,2212,3,104,75,48,6,3,236,0,16,252
8,5,8039,2213,3,23,27,11,0,0,61,0,0,61
8,5,8042,2266,3,87,79,22,2,2,192,0,6,198
8,5,8042,2267,3,89,104,14,4,2,213,0,10,223
8,5,8042,2268,3,27,20,6,1,0,54,0,2,56
8,5,8042,2269,3,20,25,0,0,0,45,0,3,48
8,5,8042,2270,3,30,39,3,0,0,72,0,3,75
8,5,8045,2288,3,343,227,62,73,6,711,0,10,721
8,5,8045,2289,3,244,198,65,43,5,555,0,4,559
8,5,8045,2290,3,248,168,148,38,12,614,0,19,633
8,5,8045,2291,3,356,321,81,87,17,862,2,9,873
8,5,8045,2292,3,248,221,79,37,13,598,1,17,616
8,5,8045,2293,3,133,121,88,16,7,365,0,6,371
8,5,8045,2294,3,282,150,66,17,4,519,0,11,530
8,5,8045,2295,3,176,122,32,15,1,346,1,9,356
8,5,8045,2296,3,193,158,59,24,4,438,0,4,442
8,5,8045,2297,3,273,152,26,51,3,505,0,8,513
8,5,8045,2298,3,165,129,32,27,4,357,0,3,360
8,5,8045,2299,3,191,110,28,34,4,367,0,13,380
8,5,8045,2300,3,254,205,48,46,1,554,0,6,560
8,5,8045,2301,3,203,167,39,35,4,448,2,11,461
8,5,8045,2302,3,191,130,134,36,13,504,1,18,523
8,5,8045,2303,3,152,122,27,18,3,322,1,7,330
8,5,8045,2304,3,144,120,30,13,3,310,3,14,327
8,5,8045,2305,3,209,210,34,22,1,476,2,14,492
8,5,8045,2306,3,101,123,19,6,3,252,0,2,254
8,5,8045,2307,3,129,121,34,14,3,301,0,6,307
8,5,8045,2308,3,134,149,31,11,3,328,1,16,345
8,5,8045,2309,3,170,197,40,20,4,431,0,13,444
8,5,8045,2310,3,84,69,18,6,1,178,0,1,179
8,5,8045,2311,3,364,318,97,24,3,806,8,11,825
8,5,8045,2312,3,135,75,24,3,3,240,0,0,240
8,5,8045,2313,3,30,91,9,3,1,134,0,6,140
8,5,8045,2314,3,176,229,50,8,3,466,1,8,475
8,5,8045,2315,3,120,120,15,10,5,270,0,9,279
8,5,8045,2316,3,148,155,59,9,6,377,1,23,401
8,5,8045,2317,3,119,87,24,7,0,237,0,10,247
8,5,8045,2318,3,105,121,24,10,3,263,0,11,274
8,5,8045,2319,3,180,168,22,10,4,384,1,13,398
8,5,8045,2320,3,71,69,19,8,1,168,1,1,170
8,5,8045,2321,3,328,243,40,18,6,635,2,13,650
8,5,8045,2322,3,211,101,44,11,2,369,1,15,385
8,5,8052,2477,3,182,122,77,5,3,389,0,7,396
8,5,8052,2478,3,74,105,45,10,6,240,0,3,243
8,5,8052,2479,3,146,179,81,15,3,424,1,3,428
8,5,8052,2480,3,128,150,66,15,6,365,0,4,369
8,5,8052,2481,3,314,238,108,19,7,686,2,15,703
8,5,8052,2482,3,142,143,44,6,3,338,0,3,341
8,5,8052,2483,3,248,120,45,6,4,423,0,9,432
8,5,8052,2484,3,145,117,41,5,5,313,0,2,315
8,5,8052,2485,3,172,119,49,12,7,359,2,5,366
8,5,8052,2486,3,257,114,65,7,3,446,1,8,455
8,5,8052,2487,3,179,154,56,7,4,400,0,7,407
8,5,8052,2488,3,177,156,75,11,2,421,0,10,431
8,5,8052,2489,3,157,179,52,23,4,415,0,8,423
8,5,8052,2490,3,197,156,79,17,5,454,0,13,467
8,5,8052,2491,3,183,130,49,8,3,373,0,5,378
8,5,8052,2492,3,369,234,118,20,4,745,2,16,763
8,5,8052,2493,3,386,225,102,11,5,729,6,14,749
8,5,8052,2494,3,7,14,2,0,0,23,1,0,24
8,5,8052,2495,3,32,27,1,2,1,63,0,0,63
8,5,8052,2496,3,16,12,1,0,0,29,0,0,29
8,5,8052,2497,3,20,16,2,0,0,38,0,0,38
8,5,8052,2498,3,33,61,4,1,0,99,0,1,100
8,5,8052,2499,3,104,73,5,2,2,186,0,5,191
8,5,8052,2500,3,178,84,16,7,0,285,1,2,288
8,5,8052,2501,3,149,40,17,2,0,208,0,1,209
8,5,8052,2502,3,53,50,9,1,0,113,0,2,115
8,5,8052,2503,3,57,13,5,0,0,75,0,3,78
8,5,8052,2504,3,89,48,3,1,0,141,0,2,143
8,5,8052,2505,3,71,24,6,0,0,101,0,7,108
8,5,8052,2506,3,26,2,2,0,0,30,0,2,32
8,5,8052,2507,3,102,66,3,0,1,172,0,4,176
8,5,8052,2508,3,36,15,7,0,0,58,0,2,60
8,5,8055,2528,3,213,273,52,42,8,588,1,11,600
8,5,8055,2529,3,187,205,55,29,3,479,0,9,488
8,5,8055,2530,3,150,176,40,24,5,395,0,10,405
8,5,8055,2531,3,253,199,62,30,7,551,0,22,573
8,5,8055,2532,3,30,64,10,5,1,110,0,7,117
8,5,8055,2533,3,112,126,24,3,0,265,0,5,270
8,5,8055,2534,3,80,168,25,5,2,280,0,6,286
8,5,8055,2535,3,103,44,22,3,2,174,0,3,177
8,5,8055,2536,3,21,31,3,1,0,56,0,2,58
8,5,8055,2537,3,234,177,28,13,0,452,1,9,462
8,5,8055,2538,3,245,179,30,27,3,484,0,17,501
8,5,8055,2539,3,47,87,10,5,2,151,0,5,156
8,5,8055,2540,3,46,43,20,13,2,124,1,5,130
8,5,8055,2541,3,120,204,9,12,1,346,0,0,346
8,5,8055,2542,3,411,223,80,29,5,748,2,20,770
8,5,8055,2543,3,158,121,12,7,2,300,0,13,313
8,5,8055,2544,3,127,191,36,24,1,379,0,20,399
8,5,8058,2559,3,110,120,81,18,3,332,0,13,345
8,5,8058,2560,3,126,69,51,17,4,267,2,8,277
8,5,8058,2561,3,178,82,68,21,4,353,0,4,357
8,5,8058,2562,3,38,34,24,5,0,101,0,3,104
8,5,8058,2563,3,39,13,14,1,2,69,0,3,72
8,5,8058,2564,3,52,48,6,4,1,111,0,1,112
8,5,8058,2565,3,32,9,23,1,0,65,0,3,68
8,5,8062,2615,3,290,242,67,51,5,655,0,14,669
8,5,8062,2616,3,186,147,53,15,4,405,0,4,409
8,5,8062,2617,3,138,45,22,7,1,213,0,7,220
8,5,8062,2618,3,121,71,21,17,1,231,0,3,234
8,5,8062,2619,3,190,78,30,12,0,310,10,10,330
8,5,8062,2620,3,311,234,40,36,6,627,0,14,641
8,5,8062,2621,3,163,134,20,19,2,338,0,5,343
8,5,8062,2622,3,285,156,43,38,1,523,1,8,532
8,5,8062,2623,3,186,112,32,9,3,342,0,0,342
8,5,8062,2624,3,284,177,35,14,4,514,0,4,518
8,5,8062,2625,3,335,167,40,28,8,578,1,9,588
8,5,8062,2626,3,193,113,10,3,0,319,0,15,334
8,5,8062,2627,3,308,193,27,27,3,558,1,12,571
8,5,8062,2628,3,140,164,86,9,8,407,1,6,414
8,5,8062,2629,3,193,380,74,20,10,677,0,13,690
8,5,8062,2630,3,68,85,23,3,2,181,1,4,186
8,5,8062,2631,3,103,139,42,7,10,301,2,6,309
8,5,8062,2632,3,123,123,46,6,3,301,0,7,308
8,5,8062,2633,3,79,116,46,15,1,257,0,4,261
8,5,8062,2634,3,202,192,17,12,3,426,5,9,440
8,5,8062,2635,3,139,124,14,8,1,286,2,14,302
8,5,8062,2636,3,219,134,32,11,5,401,0,15,416
8,5,8062,2637,3,151,92,26,14,0,283,0,8,291
8,5,8062,2638,3,253,148,26,11,0,438,0,10,448
8,5,8062,2639,3,168,141,27,9,4,349,1,15,365
8,5,8062,2640,3,264,108,23,18,5,418,1,13,432
8,5,8062,2641,3,164,107,21,3,4,299,0,12,311
8,5,8062,2642,3,233,69,25,1,4,332,0,4,336
8,5,8062,2643,3,209,94,13,3,1,320,2,11,333
8,5,8062,2644,3,171,72,32,7,1,283,0,0,283
8,5,8062,2645,3,87,96,19,10,1,213,0,1,214
8,5,8062,2646,3,170,45,9,15,3,242,0,4,246
8,6,8019,402,3,142,161,52,15,10,380,5,10,395
8,6,8019,403,3,110,211,45,18,6,390,1,29,420
8,6,8019,404,3,109,109,40,16,7,281,2,10,293
8,6,8019,405,3,148,188,46,26,5,413,0,13,426
8,6,8019,406,3,103,153,36,14,4,310,1,8,319
8,6,8019,407,3,114,175,40,12,1,342,4,18,364
8,6,8019,408,3,130,191,41,22,4,388,5,20,413
8,6,8019,409,3,108,170,52,11,1,342,0,11,353
8,6,8019,410,3,140,245,81,21,4,491,3,13,507
8,6,8019,411,3,82,143,33,16,3,277,0,16,293
8,6,8019,412,3,76,142,40,13,2,273,2,9,284
8,6,8019,413,3,215,135,52,22,5,429,2,14,445
8,6,8019,414,3,247,219,63,17,2,548,3,22,573
8,6,8019,415,3,259,176,69,19,2,525,1,14,540
8,6,8019,416,3,294,226,70,20,5,615,0,10,625
8,6,8019,417,3,198,136,62,6,4,406,4,14,424
8,6,8019,418,3,217,198,54,27,1,497,0,21,518
8,6,8019,419,3,187,162,58,27,2,436,4,13,453
8,6,8019,420,3,323,342,106,30,9,810,1,29,840
8,6,8019,421,3,256,159,44,31,2,492,0,6,498
8,6,8019,422,3,256,222,64,33,7,582,5,15,602
8,6,8019,423,3,205,161,43,20,5,434,0,15,449
8,6,8019,424,3,194,147,55,34,1,431,0,24,455
8,6,8019,425,3,282,191,61,38,4,576,1,11,588
8,6,8019,426,3,179,115,38,19,3,354,1,20,375
8,6,8019,427,3,220,112,46,14,6,398,2,12,412
8,6,8019,428,3,268,173,49,18,3,511,1,4,516
8,6,8019,429,3,285,230,51,32,4,602,2,7,611
8,6,8019,430,3,165,91,23,8,2,289,1,4,294
8,6,8019,431,3,199,166,44,19,4,432,0,5,437
8,6,8019,432,3,174,111,45,5,4,339,1,11,351
8,6,8019,433,3,290,135,46,7,5,483,0,4,487
8,6,8019,434,3,147,115,74,14,2,352,0,11,363
8,6,8019,435,3,122,125,25,10,5,287,1,1,289
8,6,8019,436,3,173,137,41,12,1,364,4,6,374
8,6,8019,447,3,212,120,65,17,7,421,0,4,425
8,6,8019,448,3,186,175,42,24,1,428,0,4,432
8,6,8019,449,3,164,155,34,10,1,364,0,6,370
8,6,8019,450,3,244,223,81,34,1,583,2,9,594
8,6,8019,451,3,95,75,34,5,2,211,0,6,217
8,6,8019,452,3,194,203,77,25,8,507,0,8,515
8,6,8019,453,3,108,106,34,15,10,273,0,5,278
8,6,8019,454,3,182,127,47,11,4,371,0,3,374
8,6,8019,455,3,251,164,58,34,5,512,0,17,529
8,6,8019,456,3,123,109,41,10,1,284,1,9,294
8,6,8019,457,3,205,123,43,16,7,394,1,3,398
8,6,8019,458,3,144,95,45,12,3,299,0,4,303
8,6,8019,459,3,235,127,60,18,7,447,0,9,456
8,6,8019,460,3,377,173,54,17,10,631,1,16,648
8,6,8019,461,3,317,135,45,11,3,511,0,4,515
8,6,8019,462,3,261,122,55,14,4,456,0,5,461
8,6,8019,463,3,252,165,58,23,3,501,0,6,507
8,6,8019,464,3,335,268,86,37,5,731,1,11,743
8,6,8019,465,3,247,190,108,14,7,566,0,11,577
8,6,8019,466,3,367,188,76,16,10,657,0,13,670
8,6,8019,467,3,171,290,73,17,6,557,1,11,569
8,6,8019,468,3,368,300,73,30,6,777,3,15,795
8,6,8019,469,3,199,134,36,11,5,385,2,9,396
8,6,8019,470,3,203,137,46,21,3,410,3,10,423
8,6,8019,471,3,132,131,48,21,5,337,2,11,350
8,6,8019,472,3,223,169,44,17,2,455,1,10,466
8,6,8019,473,3,182,193,59,15,2,451,0,18,469
8,6,8019,474,3,150,127,41,12,6,336,0,8,344
8,6,8019,475,3,161,122,39,20,2,344,4,12,360
8,6,8019,476,3,255,152,69,18,2,496,0,11,507
8,6,8019,477,3,247,206,57,18,3,531,1,9,541
8,6,8019,478,3,279,187,58,19,4,547,5,15,567
8,6,8019,479,3,199,125,33,12,2,371,0,18,389
8,6,8019,480,3,280,240,91,24,7,642,6,11,659
8,6,8019,481,3,205,225,78,25,6,539,2,11,552
8,6,8019,482,3,248,213,83,35,7,586,1,9,596
8,6,8019,483,3,181,211,70,31,8,501,1,10,512
8,6,8019,484,3,135,137,35,15,1,323,2,15,340
8,6,8019,485,3,161,215,58,25,3,462,4,12,478
8,6,8019,486,3,208,261,97,27,1,594,1,16,611
8,6,8019,487,3,289,254,86,36,9,674,1,6,681
8,6,8019,488,3,186,196,89,23,7,501,4,13,518
8,6,8019,489,3,176,173,55,23,7,434,3,4,441
8,6,8019,490,3,249,218,80,36,4,587,0,14,601
8,6,8019,491,3,123,97,42,20,2,284,2,10,296
8,6,8019,492,3,170,193,68,20,4,455,0,20,475
8,6,8019,493,3,151,242,67,22,3,485,3,22,510
8,6,8019,494,3,230,178,100,28,12,548,8,13,569
8,6,8019,495,3,279,281,77,37,5,679,0,20,699
8,6,8019,496,3,219,193,64,28,8,512,0,20,532
8,6,8019,497,3,185,164,60,35,4,448,0,11,459
8,6,8019,498,3,119,124,38,17,4,302,0,11,313
8,6,8019,499,3,183,161,47,26,3,420,2,13,435
8,6,8019,500,3,282,184,71,20,4,561,2,7,570
8,6,8019,501,3,209,136,53,11,1,410,1,2,413
8,6,8019,502,3,280,172,60,21,2,535,1,7,543
8,6,8019,503,3,112,101,22,8,4,247,0,4,251
8,6,8019,504,3,216,160,51,10,5,442,0,9,451
8,6,8019,505,3,216,160,63,22,6,467,0,6,473
8,6,8019,506,3,267,157,88,31,7,550,0,15,565
8,6,8019,507,3,207,134,44,27,1,413,1,8,422
8,6,8019,510,3,183,164,38,20,3,408,0,10,418
8,6,8019,511,3,207,114,26,8,2,357,1,5,363
8,6,8019,512,3,208,163,73,22,4,470,2,7,479
8,6,8019,513,3,219,268,98,21,3,609,3,17,629
8,6,8019,514,3,244,238,106,23,10,621,2,7,630
8,6,8019,515,3,331,211,81,34,8,665,3,15,683
8,6,8019,516,3,186,121,42,9,5,363,1,6,370
8,6,8019,517,3,248,185,48,28,4,513,0,9,522
8,6,8019,518,3,320,184,57,18,5,584,0,10,594
8,6,8019,519,3,275,118,48,31,8,480,1,8,489
8,6,8019,520,3,242,147,58,17,2,466,2,14,482
8,6,8019,521,3,306,222,83,34,4,649,1,13,663
8,6,8019,522,3,238,168,65,19,7,497,0,12,509
8,6,8019,523,3,180,133,46,20,5,384,0,2,386
8,6,8019,524,3,235,140,41,16,3,435,1,7,443
8,6,8019,525,3,140,123,47,27,1,338,2,11,351
8,6,8019,526,3,124,128,44,10,4,310,0,9,319
8,6,8019,527,3,346,213,92,29,3,683,0,6,689
8,6,8019,528,3,282,190,86,27,8,593,2,17,612
8,6,8019,529,3,229,169,71,29,3,501,0,12,513
8,6,8019,530,3,328,219,106,30,8,691,0,13,704
8,6,8019,531,3,175,152,54,32,2,415,1,5,421
8,6,8019,532,3,153,200,78,25,6,462,3,14,479
8,6,8019,533,3,141,222,62,11,7,443,1,20,464
8,6,8019,534,3,350,399,127,40,12,928,8,29,965
8,6,8019,536,3,154,265,68,13,1,501,7,16,524
8,6,8019,544,3,368,234,82,42,10,736,1,15,752
8,6,8019,548,3,252,203,86,19,8,568,0,12,580
8,6,8019,549,3,212,132,49,21,3,417,0,6,423
8,6,8019,550,3,317,199,106,38,6,666,0,15,681
8,6,8019,551,3,404,291,112,37,10,854,1,16,871
8,6,8019,552,3,233,189,87,35,5,549,2,13,564
8,6,8019,553,3,272,202,61,28,5,568,4,2,574
8,6,8019,554,3,313,231,98,30,8,680,3,20,703
8,6,8019,555,3,112,124,44,11,4,295,0,6,301
8,6,8019,556,3,216,237,73,36,9,571,4,11,586
8,6,8019,557,3,219,233,83,20,6,561,1,21,583
8,6,8019,558,3,153,225,64,19,3,464,2,21,487
8,6,8019,559,3,142,113,67,20,2,344,3,20,367
8,6,8019,560,3,201,222,68,19,5,515,6,19,540
8,6,8019,561,3,171,161,62,15,3,412,2,7,421
8,6,8019,621,3,665,559,204,50,17,1495,7,17,1519
8,6,8019,622,3,99,97,49,15,5,265,0,3,268
8,6,8019,623,3,305,306,121,66,4,802,0,9,811
8,6,8019,624,3,156,233,41,39,1,470,3,11,484
8,6,8019,625,3,158,149,66,21,1,395,0,0,395
8,6,8019,626,3,211,334,106,53,9,713,4,9,726
8,6,8019,638,3,140,134,53,16,3,346,1,13,360
8,6,8019,639,3,83,130,50,9,1,273,2,5,280
8,6,8019,640,3,122,172,55,14,4,367,3,11,381
8,6,8019,641,3,1733,1220,403,142,30,3528,6,52,3586
8,6,8019,642,3,128,152,44,13,5,342,6,9,357
8,6,8019,643,3,134,163,55,31,5,388,3,11,402
8,6,8019,653,3,715,483,133,70,18,1419,1,10,1430
8,6,8019,654,3,169,164,80,18,2,433,3,13,449
8,6,8019,655,3,144,136,44,14,1,339,2,6,347
8,6,8019,656,3,72,121,42,19,4,258,2,6,266
8,6,8019,657,3,164,245,69,26,3,507,1,19,527
8,6,8019,658,3,119,161,50,20,5,355,0,8,363
8,6,8019,659,3,114,158,68,28,4,372,3,10,385
8,6,8019,660,3,120,192,73,22,4,411,2,11,424
8,6,8019,661,3,436,606,237,64,14,1357,7,39,1403
8,6,8019,675,3,161,157,42,18,3,381,1,11,393
8,6,8019,676,3,221,253,52,25,5,556,1,6,563
8,6,8019,677,3,246,191,56,27,8,528,0,3,531
8,6,8019,678,3,248,208,61,33,5,555,2,4,561
8,6,8019,679,3,304,205,64,43,10,626,3,9,638
8,6,8019,680,3,281,203,73,25,4,586,0,8,594
8,6,8019,681,3,177,145,70,13,5,410,3,16,429
8,6,8019,682,3,152,133,70,19,1,375,1,8,384
8,6,8019,696,3,436,281,85,26,11,839,5,18,862
8,6,8019,697,3,370,314,122,41,8,855,0,11,866
8,6,8019,698,3,171,149,36,15,0,371,4,4,379
8,6,8019,699,3,279,211,78,25,5,598,0,10,608
8,6,8019,700,3,197,149,87,14,3,450,1,9,460
8,6,8019,701,3,137,114,37,17,2,307,0,6,313
8,6,8019,702,3,123,155,65,22,4,369,4,13,386
8,6,8019,703,3,341,296,129,35,10,811,2,14,827
8,6,8019,704,3,308,227,67,30,4,636,0,15,651
8,6,8019,705,3,318,328,98,31,10,785,1,12,798
8,6,8019,706,3,205,150,63,10,4,432,1,4,437
8,6,8019,707,3,204,211,38,8,3,464,2,5,471
8,6,8019,708,3,204,138,49,30,7,428,0,10,438
8,6,8019,709,3,209,163,53,20,6,451,1,5,457
8,6,8019,710,3,296,168,71,18,8,561,1,7,569
8,6,8019,711,3,55,23,11,2,1,92,0,0,92
8,6,8019,720,3,353,278,82,38,15,766,1,13,780
8,6,8019,721,3,259,202,88,30,8,587,0,8,595
8,6,8019,722,3,293,219,70,30,4,616,0,10,626
8,6,8019,723,3,274,217,64,28,5,588,1,13,602
8,6,8019,724,3,164,188,73,15,6,446,2,13,461
8,6,8019,725,3,306,340,159,41,11,857,1,26,884
8,6,8019,726,3,383,315,118,49,8,873,2,16,891
8,6,8019,727,3,131,119,49,19,9,327,0,4,331
8,6,8019,728,3,163,99,66,15,4,347,0,4,351
8,6,8019,729,3,150,90,47,27,2,316,0,6,322
8,6,8019,730,3,169,191,84,19,6,469,0,6,475
8,6,8019,731,3,176,138,62,17,2,395,1,8,404
8,6,8019,732,3,163,103,42,22,1,331,1,4,336
8,6,8019,733,3,162,139,60,19,4,384,1,6,391
8,6,8019,734,3,422,267,103,38,12,842,1,16,859
8,6,8019,735,3,227,125,50,21,5,428,0,7,435
8,6,8019,736,3,372,251,111,46,10,790,2,16,808
8,6,8019,737,3,195,171,65,23,5,459,0,10,469
8,6,8019,738,3,169,100,60,16,6,351,1,11,363
8,6,8019,741,3,219,132,47,35,4,437,0,7,444
8,6,8019,742,3,185,148,34,17,5,389,0,12,401
8,6,8019,743,3,258,161,76,24,15,534,0,10,544
8,6,8019,744,3,212,171,66,21,4,474,0,8,482
8,6,8019,745,3,267,212,86,25,6,596,1,9,606
8,6,8019,746,3,244,174,60,29,2,509,0,10,519
8,6,8019,747,3,173,120,51,21,4,369,0,8,377
8,6,8019,748,3,272,182,57,37,5,553,1,14,568
8,6,8019,749,3,255,121,39,15,4,434,2,3,439
8,6,8019,750,3,271,104,44,14,1,434,0,4,438
8,6,8019,751,3,240,143,43,18,1,445,0,5,450
8,6,8019,752,3,225,166,54,23,3,471,1,0,472
8,6,8019,753,3,599,380,128,55,8,1170,0,10,1180
8,6,8019,754,3,287,182,55,20,7,551,1,5,557
8,6,8019,755,3,168,78,44,10,0,300,0,5,305
8,6,8019,756,3,317,173,104,22,5,621,2,9,632
8,6,8019,757,3,232,237,84,20,8,581,0,12,593
8,6,8019,758,3,304,254,76,15,7,656,0,8,664
8,6,8019,759,3,351,253,92,26,9,731,2,8,741
8,6,8019,760,3,396,306,154,26,3,885,0,14,899
8,6,8019,761,3,460,337,82,33,8,920,0,12,932
8,6,8019,762,3,310,217,79,28,9,643,0,10,653
8,6,8019,763,3,317,197,71,28,8,621,1,10,632
8,6,8019,764,3,203,144,69,18,5,439,0,10,449
8,6,8019,765,3,219,136,45,20,4,424,0,9,433
8,6,8019,766,3,264,155,62,15,6,502,1,11,514
8,6,8019,769,3,251,153,62,21,7,494,1,8,503
8,6,8019,770,3,222,136,56,15,2,431,0,7,438
8,6,8019,771,3,365,195,104,39,5,708,1,11,720
8,6,8019,772,3,378,213,105,36,5,737,2,18,757
8,6,8019,773,3,386,185,100,31,4,706,0,16,722
8,6,8019,774,3,486,254,94,27,6,867,0,6,873
8,6,8019,775,3,539,297,120,16,7,979,0,14,993
8,6,8019,776,3,37,69,25,3,2,136,0,8,144
8,6,8019,777,3,499,272,86,22,11,890,0,5,895
8,6,8019,778,3,559,268,106,17,9,959,0,4,963
8,6,8019,779,3,612,305,55,21,6,999,2,8,1009
8,6,8019,780,3,271,311,51,23,2,658,0,0,658
8,6,8019,781,3,267,162,42,13,4,488,0,6,494
8,6,8019,782,3,291,293,74,46,8,712,0,20,732
8,6,8019,783,3,255,168,63,10,3,499,0,9,508
8,6,8019,784,3,295,196,69,24,3,587,0,8,595
8,6,8019,795,3,502,231,62,12,3,810,2,7,819
8,6,8019,796,3,298,147,29,10,0,484,0,7,491
8,6,8019,797,3,300,165,40,10,3,518,0,6,524
8,6,8019,798,3,339,168,44,10,7,568,1,4,573
8,6,8019,799,3,289,107,32,7,1,436,0,4,440
8,6,8019,800,3,368,357,87,40,7,859,0,9,868
8,6,8019,801,3,618,257,91,24,11,1001,3,16,1020
8,6,8019,802,3,134,100,38,15,1,288,0,6,294
8,6,8019,803,3,89,109,48,11,4,261,2,8,271
8,6,8019,804,3,396,245,92,22,4,759,1,9,769
8,6,8019,805,3,1839,873,237,62,26,3037,1,21,3059
8,6,8019,806,3,495,289,55,12,10,861,0,10,871
8,6,8019,807,3,323,419,85,61,2,890,0,20,910
8,6,8019,808,3,448,259,51,21,2,781,1,2,784
8,6,8019,809,3,387,213,42,14,7,663,2,2,667
8,6,8019,810,3,317,198,61,14,9,599,0,13,612
8,6,8019,817,3,321,225,91,29,5,671,2,12,685
8,6,8019,818,3,264,158,60,22,4,508,0,12,520
8,6,8019,819,3,474,198,54,9,8,743,6,6,755
8,6,8019,820,3,228,129,41,12,3,413,0,10,423
8,6,8019,821,3,48,24,10,5,1,88,0,2,90
8,6,8019,822,3,62,140,34,6,5,247,2,13,262
8,6,8019,823,3,860,428,120,19,14,1441,0,9,1450
8,6,8019,824,3,256,270,67,12,3,608,0,4,612
8,6,8019,825,3,284,294,80,32,7,697,0,12,709
8,6,8019,826,3,446,284,80,15,8,833,1,9,843
8,6,8019,827,3,330,202,68,25,6,631,0,5,636
8,6,8019,828,3,218,152,55,8,2,435,0,6,441
8,6,8019,829,3,188,181,87,21,8,485,3,24,512
8,6,8019,830,3,185,143,68,28,5,429,4,12,445
8,6,8019,831,3,177,134,54,19,3,387,0,4,391
8,6,8019,832,3,183,165,58,16,10,432,0,6,438
8,6,8019,833,3,159,160,50,13,2,384,1,11,396
8,6,8019,834,3,109,97,31,15,2,254,0,2,256
8,6,8019,835,3,180,101,31,13,4,329,1,1,331
8,6,8019,836,3,396,147,55,11,6,615,1,10,626
8,6,8019,837,3,426,229,52,24,2,733,1,4,738
8,6,8019,838,3,743,342,72,15,7,1179,0,2,1181
8,6,8019,839,3,954,456,80,27,8,1525,1,8,1534
8,6,8019,840,3,492,213,63,12,3,783,1,5,789
8,6,8019,841,3,429,201,36,3,2,671,1,4,676
8,6,8019,842,3,303,183,56,9,6,557,0,11,568
8,6,8019,843,3,139,80,27,7,6,259,0,5,264
8,6,8019,844,3,136,134,56,11,2,339,1,9,349
8,6,8019,845,3,399,309,90,29,7,834,2,5,841
8,6,8019,846,3,481,372,139,37,4,1033,0,5,1038
8,6,8019,847,3,191,271,71,24,6,563,0,9,572
8,6,8019,885,3,183,113,55,16,4,371,2,6,379
8,6,8019,893,3,55,108,10,1,0,174,1,12,187
8,6,8019,894,3,100,137,25,8,2,272,1,8,281
8,6,8019,897,3,123,151,36,9,1,320,3,8,331
8,6,8019,898,3,120,75,16,4,0,215,0,9,224
8,6,8019,899,3,72,101,20,7,1,201,0,6,207
8,6,8019,901,3,48,81,13,2,1,145,0,4,149
8,6,8019,902,3,30,56,19,2,0,107,4,3,114
8,6,8019,903,3,103,53,20,0,0,176,0,8,184
8,6,8019,904,3,47,77,21,1,1,147,0,12,159
8,6,8019,905,3,184,100,11,3,1,299,0,14,313
8,6,8019,906,3,363,206,60,29,2,660,0,7,667
8,6,8019,911,3,2837,1603,605,268,57,5370,7,38,5415
8,7,8006,82,3,88,110,28,5,0,231,0,7,238
8,7,8006,83,3,45,68,67,7,1,188,2,4,194
8,7,8006,84,3,16,62,35,0,0,113,0,8,121
8,7,8006,85,3,30,71,44,5,3,153,0,10,163
8,7,8006,86,3,6,39,13,0,0,58,0,2,60
8,7,8006,87,3,17,119,105,15,2,258,0,14,272
8,7,8006,88,3,32,71,49,3,0,155,0,8,163
8,7,8006,89,3,9,55,34,1,2,101,0,2,103
8,7,8006,90,3,28,21,48,4,0,101,0,6,107
8,7,8006,91,3,4,18,22,2,1,47,0,0,47
8,7,8006,92,3,5,25,24,2,0,56,2,1,59
8,7,8006,93,3,5,20,16,1,0,42,0,1,43
8,7,8006,94,3,26,27,22,2,0,77,0,6,83
8,7,8006,95,3,7,54,59,0,0,120,0,6,126
8,7,8006,97,3,20,31,21,2,0,74,0,0,74
8,7,8006,98,3,5,27,85,3,0,120,0,1,121
8,7,8006,99,3,51,42,51,14,0,158,0,2,160
8,7,8006,100,3,36,53,68,6,0,163,0,0,163
8,7,8006,101,3,21,60,95,3,0,179,0,7,186
8,7,8010,149,3,108,120,30,16,4,278,0,9,287
8,7,8010,150,3,86,147,23,5,1,262,0,4,266
8,7,8010,151,3,122,180,33,10,2,347,0,13,360
8,7,8010,152,3,113,151,21,8,2,295,0,10,305
8,7,8010,153,3,163,260,56,14,5,498,0,6,504
8,7,8010,154,3,59,90,21,7,0,177,1,7,185
8,7,8010,155,3,60,75,13,5,0,153,0,2,155
8,7,8010,156,3,88,129,22,7,0,246,1,5,252
8,7,8010,157,3,90,195,84,10,6,385,0,24,409
8,7,8010,158,3,61,150,82,4,3,300,0,18,318
8,7,8010,159,3,44,126,69,7,2,248,0,7,255
8,7,8010,160,3,110,184,89,16,3,402,0,15,417
8,7,8010,161,3,72,178,81,11,3,345,0,13,358
8,7,8010,162,3,51,133,70,6,7,267,1,10,278
8,7,8010,163,3,49,187,38,13,1,288,0,16,304
8,7,8010,164,3,60,167,31,7,1,266,0,10,276
8,7,8010,165,3,21,74,17,7,0,119,0,5,124
8,7,8010,166,3,36,168,42,15,0,261,0,5,266
8,7,8010,167,3,111,188,124,18,2,443,0,16,459
8,7,8010,168,3,72,187,134,20,9,422,2,7,431
8,7,8010,169,3,19,39,6,2,0,66,0,1,67
8,7,8010,170,3,26,44,4,0,0,74,0,0,74
8,7,8010,171,3,10,59,22,3,0,94,0,5,99
8,7,8010,172,3,162,290,42,13,0,507,0,14,521
8,7,8010,173,3,145,185,35,14,2,381,4,10,395
8,7,8010,174,3,106,206,60,10,4,386,0,15,401
8,7,8013,238,3,69,126,44,4,4,247,0,9,256
8,7,8013,239,3,113,123,47,15,3,301,0,7,308
8,7,8013,240,3,210,251,112,18,8,599,0,21,620
8,7,8013,241,3,219,275,123,28,6,651,1,24,676
8,7,8013,242,3,30,182,56,8,0,276,0,11,287
8,7,8013,243,3,83,183,47,4,3,320,0,15,335
8,7,8013,244,3,69,68,18,4,2,161,0,9,170
8,7,8013,245,3,267,169,68,17,5,526,0,23,549
8,7,8013,246,3,5,39,7,0,0,51,0,5,56
8,7,8013,247,3,19,18,13,0,0,50,0,1,51
8,7,8013,248,3,19,78,8,0,0,105,0,3,108
8,7,8013,249,3,8,82,5,1,0,96,0,2,98
8,7,8013,250,3,29,53,27,4,3,116,0,6,122
8,7,8013,251,3,135,278,64,20,2,499,0,23,522
8,7,8013,252,3,22,18,7,0,1,48,0,1,49
8,7,8017,271,3,100,131,121,17,4,373,0,6,379
8,7,8017,272,3,186,97,111,9,2,405,0,8,413
8,7,8017,273,3,75,135,101,10,5,326,0,2,328
8,7,8017,274,3,96,120,141,18,3,378,0,7,385
8,7,8017,275,3,176,219,256,31,2,684,0,7,691
8,7,8017,276,3,134,182,144,17,2,479,0,8,487
8,7,8017,277,3,194,259,231,24,6,714,1,12,727
8,7,8017,278,3,213,309,247,29,6,804,1,11,816
8,7,8017,279,3,204,429,261,23,7,924,0,22,946
8,7,8017,280,3,92,196,119,15,2,424,0,18,442
8,7,8017,281,3,106,147,122,14,4,393,0,21,414
8,7,8017,282,3,90,121,93,11,6,321,0,0,321
8,7,8017,283,3,79,179,118,11,3,390,0,14,404
8,7,8017,284,3,158,359,254,27,10,808,1,18,827
8,7,8017,285,3,47,135,80,16,6,284,0,11,295
8,7,8017,286,3,162,651,277,41,7,1138,0,43,1181
8,7,8017,287,3,63,126,89,12,1,291,0,2,293
8,7,8017,288,3,127,199,161,11,4,502,0,18,520
8,7,8017,289,3,172,145,135,15,2,469,0,11,480
8,7,8017,290,3,136,165,141,21,4,467,0,11,478
8,7,8017,291,3,170,172,176,15,5,538,0,6,544
8,7,8017,292,3,150,86,114,4,3,357,0,6,363
8,7,8017,293,3,74,69,97,10,4,254,0,4,258
8,7,8017,294,3,100,77,90,13,1,281,0,5,286
8,7,8017,295,3,82,85,78,6,1,252,0,8,260
8,7,8017,296,3,61,176,68,8,2,315,1,23,339
8,7,8017,297,3,534,1319,743,71,21,2688,3,90,2781
8,7,8017,298,3,78,94,98,7,0,277,0,4,281
8,7,8017,299,3,162,152,143,14,0,471,0,2,473
8,7,8017,300,3,144,109,132,11,3,399,0,0,399
8,7,8017,301,3,101,94,98,7,6,306,0,8,314
8,7,8017,302,3,93,211,92,12,0,408,0,13,421
8,7,8017,303,3,38,104,54,8,1,205,0,14,219
8,7,8017,304,3,41,122,76,9,3,251,0,13,264
8,7,8017,305,3,118,160,127,15,1,421,1,12,434
8,7,8017,306,3,292,389,317,30,7,1035,1,25,1061
8,7,8017,307,3,202,481,364,116,9,1172,0,23,1195
8,7,8017,308,3,126,292,149,15,3,585,0,24,609
8,7,8017,309,3,69,91,74,9,3,246,0,4,250
8,7,8017,310,3,171,198,233,19,9,630,0,13,643
8,7,8017,311,3,188,156,239,14,4,601,1,10,612
8,7,8017,312,3,204,260,221,25,4,714,0,11,725
8,7,8017,313,3,128,116,109,14,2,369,0,3,372
8,7,8017,314,3,172,188,149,26,2,537,0,7,544
8,7,8017,315,3,67,101,93,18,1,280,1,6,287
8,7,8017,316,3,48,74,54,3,0,179,0,3,182
8,7,8017,317,3,56,104,91,7,3,261,1,11,273
8,7,8017,318,3,57,125,160,36,2,380,0,4,384
8,7,8017,319,3,129,140,160,46,5,480,0,13,493
8,7,8017,320,3,75,182,67,11,2,337,0,11,348
8,7,8017,321,3,135,352,221,33,9,750,0,14,764
8,7,8017,322,3,55,129,71,10,4,269,0,8,277
8,7,8017,323,3,116,143,141,15,4,419,0,16,435
8,7,8017,324,3,59,190,83,7,3,342,0,16,358
8,7,8017,325,3,132,209,179,37,6,563,0,7,570
8,7,8017,326,3,215,221,280,24,11,751,2,19,772
8,7,8017,327,3,187,265,236,25,5,718,1,18,737
8,7,8017,328,3,71,122,81,17,4,295,0,4,299
8,7,8017,329,3,49,123,71,11,0,254,0,14,268
8,7,8017,330,3,77,157,112,11,4,361,0,19,380
8,7,8017,331,3,53,175,86,8,1,323,0,13,336
8,7,8017,332,3,264,447,334,96,12,1153,2,30,1185
8,7,8017,333,3,143,153,162,18,5,481,0,6,487
8,7,8017,334,3,138,322,189,21,7,677,0,35,712
8,7,8017,335,3,113,235,128,17,2,495,1,17,513
8,7,8017,336,3,85,137,68,4,4,298,0,16,314
8,7,8017,337,3,72,217,65,6,2,362,0,15,377
8,7,8017,338,3,219,342,234,26,7,828,0,41,869
8,7,8017,339,3,114,253,115,8,4,494,2,18,514
8,7,8017,340,3,147,304,123,15,6,595,0,36,631
8,7,8017,341,3,143,174,100,10,3,430,0,10,440
8,7,8017,342,3,167,220,98,9,2,496,0,11,507
8,7,8017,343,3,161,295,224,19,8,707,0,23,730
8,7,8017,344,3,124,127,141,11,4,407,1,22,430
8,7,8017,345,3,40,49,39,4,2,134,0,1,135
8,7,8017,346,3,47,98,76,9,2,232,1,7,240
8,7,8017,347,3,64,120,78,11,4,277,0,6,283
8,7,8017,348,3,184,259,235,24,8,710,0,18,728
8,7,8017,349,3,93,181,128,21,3,426,0,16,442
8,7,8017,350,3,108,107,166,26,3,410,1,8,419
8,7,8017,351,3,61,69,81,6,6,223,0,6,229
8,7,8017,352,3,50,31,33,5,3,122,0,1,123
8,7,8017,353,3,67,59,61,4,4,195,0,1,196
8,7,8017,355,3,30,57,15,0,1,103,0,2,105
8,7,8017,356,3,52,168,84,2,0,306,0,18,324
8,7,8017,357,3,15,25,4,0,1,45,0,2,47
8,7,8017,358,3,20,32,4,0,0,56,0,3,59
8,7,8017,359,3,151,169,25,3,0,348,0,0,348
8,7,8017,360,3,18,21,6,3,2,50,0,3,53
8,7,8017,361,3,11,28,5,0,0,44,0,3,47
8,7,8017,362,3,47,22,38,5,0,112,0,0,112
8,7,8017,363,3,37,65,24,0,2,128,0,9,137
8,7,8017,364,3,148,81,100,4,1,334,0,9,343
8,7,8017,365,3,82,127,63,3,3,278,0,12,290
8,7,8017,366,3,11,18,12,1,0,42,0,0,42
8,7,8017,367,3,12,54,9,3,0,78,0,4,82
8,7,8017,368,3,38,90,17,4,0,149,1,6,156
8,7,8017,369,3,67,91,40,4,2,204,0,10,214
8,7,8017,370,3,35,129,24,1,0,189,0,4,193
8,7,8017,371,3,6,31,15,0,0,52,0,3,55
8,7,8017,372,3,9,11,28,3,0,51,0,0,51
8,7,8017,373,3,154,61,44,3,0,262,0,9,271
8,7,8017,374,3,11,51,21,6,0,89,0,4,93
8,7,8017,375,3,15,44,19,0,1,79,0,0,79
8,7,8017,376,3,16,21,27,0,1,65,0,0,65
8,7,8017,377,3,4,63,16,3,0,86,0,4,90
8,7,8017,378,3,5,44,21,3,2,75,0,5,80
8,7,8017,379,3,12,25,4,0,0,41,0,0,41
8,7,8017,380,3,20,76,41,5,1,143,0,8,151
8,7,8017,381,3,20,55,14,2,0,91,0,4,95
8,7,8017,382,3,11,44,33,0,2,90,0,4,94
8,7,8017,383,3,28,124,41,5,1,199,0,13,212
8,7,8017,384,3,21,46,27,3,0,97,0,3,100
8,7,8017,385,3,27,70,15,0,0,112,0,4,116
8,7,8017,386,3,37,27,24,1,2,91,2,7,100
8,7,8017,387,3,13,18,26,2,0,59,0,3,62
8,7,8023,1042,3,107,173,29,5,0,314,0,4,318
8,7,8023,1044,3,162,222,48,14,2,448,1,10,459
8,7,8023,1045,3,155,299,119,14,5,592,2,18,612
8,7,8025,1053,3,60,130,72,7,3,272,0,11,283
8,7,8025,1054,3,89,132,48,11,0,280,0,9,289
8,7,8025,1055,3,50,85,24,3,2,164,0,10,174
8,7,8025,1056,3,33,75,27,2,1,138,0,5,143
8,7,8025,1057,3,82,137,76,13,2,310,0,13,323
8,7,8025,1058,3,94,181,90,18,3,386,0,10,396
8,7,8025,1059,3,66,84,49,6,3,208,0,16,224
8,7,8025,1060,3,53,81,31,3,3,171,0,12,183
8,7,8025,1061,3,67,94,49,6,3,219,0,8,227
8,7,8025,1062,3,25,56,10,2,1,94,0,2,96
8,7,8025,1063,3,34,59,23,3,2,121,0,1,122
8,7,8025,1064,3,25,63,13,0,1,102,1,3,106
8,7,8025,1065,3,53,199,48,7,2,309,0,7,316
8,7,8025,1066,3,31,25,5,2,0,63,0,3,66
8,7,8025,1067,3,55,150,55,5,1,266,1,10,277
8,7,8031,1182,3,114,172,70,43,2,401,0,11,412
8,7,8031,1183,3,89,126,57,24,1,297,0,11,308
8,7,8031,1184,3,135,162,55,34,1,387,1,5,393
8,7,8031,1185,3,70,191,26,7,4,298,0,12,310
8,7,8031,1186,3,154,192,81,48,3,478,1,13,492
8,7,8031,1187,3,105,204,55,27,7,398,0,22,420
8,7,8031,1188,3,70,146,41,16,1,274,0,19,293
8,7,8031,1189,3,58,134,46,9,4,251,0,4,255
8,7,8031,1190,3,70,106,51,10,1,238,0,5,243
8,7,8031,1191,3,46,56,24,12,1,139,0,5,144
8,7,8031,1192,3,29,65,20,13,4,131,0,0,131
8,7,8031,1193,3,33,46,23,7,0,109,0,6,115
8,7,8031,1194,3,69,103,61,22,3,258,0,7,265
8,7,8031,1195,3,117,153,78,35,2,385,0,12,397
8,7,8031,1196,3,61,127,39,19,2,248,0,8,256
8,7,8031,1197,3,26,50,23,6,0,105,0,0,105
8,7,8031,1198,3,73,188,51,16,2,330,0,15,345
8,7,8031,1199,3,97,245,67,28,2,439,0,16,455
8,7,8031,1200,3,86,147,48,6,0,287,0,14,301
8,7,8031,1201,3,17,62,58,3,5,145,0,9,154
8,7,8031,1202,3,16,41,21,4,0,82,0,2,84
8,7,8031,1203,3,9,26,7,1,0,43,0,4,47
8,7,8031,1204,3,12,63,43,3,0,121,0,5,126
8,7,8031,1205,3,18,51,29,2,1,101,0,1,102
8,7,8031,1206,3,3,43,0,1,1,48,0,6,54
8,7,8031,1207,3,8,19,12,8,0,47,0,0,47
8,7,8031,1208,3,6,20,16,1,1,44,0,2,46
8,7,8031,1209,3,47,27,22,1,1,98,0,2,100
8,7,8031,1210,3,36,64,60,9,1,170,0,2,172
8,7,8031,1211,3,29,47,21,3,2,102,0,4,106
8,7,8031,1212,3,40,57,12,1,0,110,0,6,116
8,7,8031,1213,3,61,104,48,6,1,220,0,8,228
8,7,8031,1214,3,19,112,18,18,1,168,1,0,169
8,7,8031,1215,3,47,121,98,23,3,292,1,0,293
8,7,8031,1216,3,24,39,21,2,0,86,1,3,90
8,7,8031,1217,3,32,67,16,5,0,120,0,6,126
8,7,8031,1218,3,138,161,130,54,4,487,1,26,514
8,7,8031,1219,3,28,69,46,8,2,153,1,7,161
8,7,8031,1220,3,2,24,13,3,0,42,0,1,43
8,7,8031,1221,3,32,81,20,6,0,139,0,8,147
8,7,8031,1222,3,24,27,22,2,0,75,1,3,79
8,7,8031,1223,3,14,31,9,7,0,61,2,3,66
8,7,8031,1224,3,27,114,34,5,3,183,0,8,191
8,7,8031,1225,3,30,100,5,4,2,141,0,4,145
8,7,8031,1226,3,29,62,37,3,3,134,1,3,138
8,7,8031,1227,3,8,42,19,1,1,71,0,0,71
8,7,8031,1228,3,25,79,63,4,2,173,1,6,180
8,7,8031,1229,3,39,76,39,4,0,158,3,5,166
8,7,8031,1230,3,13,43,27,3,2,88,0,4,92
8,7,8031,1231,3,22,22,19,1,1,65,1,1,67
8,7,8031,1232,3,17,44,18,3,0,82,0,5,87
8,7,8031,1233,3,7,8,18,3,0,36,0,0,36
8,7,8031,1234,3,3,32,6,0,0,41,0,1,42
8,7,8031,1235,3,39,180,75,13,1,308,0,11,319
8,7,8031,1236,3,3,29,8,0,0,40,0,1,41
8,7,8031,1237,3,59,288,122,29,6,504,0,30,534
8,7,8031,1238,3,1,43,4,1,0,49,0,2,51
8,7,8031,1239,3,4,56,14,0,1,75,0,20,95
8,7,8031,1240,3,3,18,10,1,0,32,0,1,33
8,7,8031,1241,3,3,14,13,4,0,34,0,1,35
8,7,8031,1242,3,54,85,81,5,1,226,0,8,234
8,7,8031,1243,3,5,47,23,2,0,77,0,0,77
8,7,8031,1244,3,17,93,177,7,0,294,0,16,310
8,7,8031,1245,3,22,67,45,4,1,139,0,4,143
8,7,8031,1246,3,12,95,6,1,1,115,0,7,122
8,7,8031,1247,3,3,28,13,2,1,47,0,3,50
8,7,8031,1248,3,25,124,81,6,2,238,0,0,238
8,7,8031,1249,3,12,57,27,1,0,97,0,1,98
8,7,8031,1250,3,12,121,19,1,1,154,0,8,162
8,7,8031,1251,3,4,28,5,1,2,40,0,0,40
8,7,8031,1253,3,0,33,8,1,0,42,0,4,46
8,7,8031,1255,3,14,58,19,1,1,93,0,5,98
8,7,8031,1257,3,27,167,30,3,4,231,0,26,257
8,7,8031,1258,3,5,53,14,2,0,74,0,2,76
8,7,8031,1259,3,8,23,6,1,1,39,0,2,41
8,7,8031,1260,3,6,34,15,0,1,56,0,1,57
8,7,8031,1261,3,17,52,13,3,0,85,0,9,94
8,7,8031,1263,3,6,45,6,0,0,57,0,2,59
8,7,8031,1264,3,6,68,8,1,0,83,0,7,90
8,7,8031,1265,3,10,48,8,2,0,68,0,7,75
8,7,8034,1357,3,30,66,67,6,1,170,0,11,181
8,7,8034,1358,3,73,203,143,3,1,423,2,14,439
8,7,8034,1359,3,88,239,194,19,4,544,0,15,559
8,7,8034,1360,3,33,44,18,8,0,103,0,7,110
8,7,8034,1361,3,18,43,19,1,2,83,0,6,89
8,7,8034,1362,3,19,35,27,4,1,86,0,2,88
8,7,8034,1363,3,20,46,13,4,0,83,0,5,88
8,7,8034,1364,3,2,29,7,1,1,40,0,0,40
8,7,8034,1365,3,3,28,13,0,0,44,0,1,45
8,7,8034,1366,3,11,52,18,2,0,83,0,5,88
8,7,8034,1367,3,28,86,48,2,1,165,0,0,165
8,7,8034,1368,3,54,154,37,14,1,260,0,9,269
8,7,8034,1369,3,37,104,55,2,1,199,0,9,208
8,7,8034,1371,3,8,52,33,1,0,94,0,2,96
8,7,8034,1372,3,19,23,25,1,0,68,0,3,71
8,7,8034,1373,3,6,18,32,0,0,56,0,0,56
8,7,8034,1374,3,32,94,32,2,1,161,1,6,168
8,7,8040,2214,3,89,117,19,7,4,236,0,13,249
8,7,8040,2215,3,216,176,51,50,7,500,0,14,514
8,7,8040,2216,3,152,112,21,14,4,303,0,10,313
8,7,8040,2217,3,163,102,27,14,2,308,0,0,308
8,7,8040,2218,3,122,122,18,7,3,272,0,9,281
8,7,8040,2219,3,143,109,27,12,0,291,0,8,299
8,7,8040,2220,3,110,92,29,16,1,248,0,5,253
8,7,8040,2221,3,138,108,16,18,1,281,0,11,292
8,7,8040,2222,3,71,76,22,11,4,184,0,3,187
8,7,8040,2223,3,154,120,31,24,4,333,0,8,341
8,7,8040,2224,3,140,154,19,10,1,324,0,6,330
8,7,8040,2225,3,173,173,31,16,3,396,0,18,414
8,7,8040,2226,3,222,260,36,25,5,548,1,29,578
8,7,8040,2227,3,143,123,33,13,2,314,1,13,328
8,7,8040,2228,3,116,86,8,6,0,216,0,6,222
8,7,8040,2229,3,120,132,27,18,1,298,0,6,304
8,7,8040,2230,3,124,94,31,26,3,278,0,7,285
8,7,8040,2231,3,61,65,35,3,2,166,0,4,170
8,7,8040,2232,3,45,70,38,6,6,165,0,7,172
8,7,8040,2233,3,54,84,31,0,2,171,0,3,174
8,7,8040,2234,3,52,68,44,5,2,171,0,4,175
8,7,8040,2235,3,54,64,23,2,0,143,0,10,153
8,7,8040,2236,3,34,55,7,1,1,98,0,8,106
8,7,8040,2237,3,83,147,30,8,0,268,0,0,268
8,7,8040,2238,3,74,164,16,8,2,264,0,9,273
8,7,8040,2239,3,156,146,34,6,5,347,0,17,364
8,7,8040,2240,3,78,205,26,3,2,314,0,13,327
8,7,8040,2241,3,112,171,35,8,2,328,0,13,341
8,7,8040,2242,3,97,95,15,1,7,215,2,7,224
8,7,8040,2243,3,78,76,18,5,3,180,0,10,190
8,7,8040,2244,3,54,54,8,4,0,120,0,8,128
8,7,8040,2245,3,63,69,8,3,1,144,0,9,153
8,7,8040,2246,3,49,120,23,6,0,198,1,6,205
8,7,8040,2247,3,78,159,20,9,2,268,0,7,275
8,7,8040,2248,3,24,52,8,4,0,88,0,4,92
8,7,8040,2249,3,26,66,10,0,0,102,0,9,111
8,7,8040,2250,3,105,195,15,12,3,330,0,17,347
8,7,8040,2251,3,72,109,13,4,1,199,1,9,209
8,7,8040,2252,3,23,67,8,1,1,100,0,5,105
8,7,8040,2253,3,39,92,25,8,0,164,0,0,164
8,7,8040,2254,3,56,35,16,2,1,110,0,4,114
8,7,8040,2255,3,130,96,44,6,1,277,0,19,296
8,7,8040,2256,3,122,30,1,4,0,157,0,11,168
8,7,8040,2257,3,13,48,4,7,0,72,0,9,81
8,7,8040,2258,3,62,60,25,7,2,156,0,10,166
8,7,8040,2259,3,63,62,16,7,1,149,0,6,155
8,7,8040,2260,3,18,24,3,0,0,45,1,1,47
8,7,8043,2271,3,14,47,17,1,2,81,0,8,89
8,7,8043,2272,3,158,229,72,9,1,469,1,4,474
8,7,8043,2273,3,82,91,33,8,2,216,0,3,219
8,7,8043,2274,3,78,56,16,1,3,154,0,5,159
8,7,8043,2275,3,19,16,32,1,1,69,1,7,77
8,7,8043,2276,3,57,78,31,2,2,170,0,11,181
8,7,8043,2277,3,18,63,23,0,1,105,0,4,109
8,7,8047,2331,3,157,251,14,2,4,428,0,18,446
8,7,8047,2332,3,23,77,3,1,0,104,0,0,104
8,7,8047,2333,3,68,68,13,2,0,151,0,5,156
8,7,8047,2334,3,19,46,0,4,1,70,0,3,73
8,7,8047,2335,3,133,178,6,6,3,326,1,12,339
8,7,8047,2336,3,139,111,22,0,1,273,0,9,282
8,7,8047,2337,3,60,84,3,1,1,149,0,1,150
8,7,8047,2338,3,46,45,2,2,0,95,0,5,100
8,7,8048,2339,3,45,188,40,11,1,285,0,7,292
8,7,8048,2340,3,35,115,38,8,2,198,0,10,208
8,7,8048,2341,3,18,33,17,3,0,71,0,3,74
8,7,8048,2342,3,62,189,101,10,0,362,0,22,384
8,7,8048,2343,3,49,170,94,6,0,319,0,12,331
8,7,8048,2344,3,153,47,29,9,1,239,0,9,248
8,7,8048,2345,3,89,28,12,3,2,134,0,4,138
8,7,8048,2346,3,57,58,34,12,1,162,0,0,162
8,7,8048,2347,3,76,72,38,9,0,195,0,10,205
8,7,8048,2348,3,83,59,35,1,0,178,0,13,191
8,7,8048,2349,3,67,86,97,11,5,266,0,11,277
8,7,8048,2350,3,100,129,138,18,1,386,3,5,394
8,7,8048,2351,3,44,100,95,8,0,247,0,0,247
8,7,8048,2352,3,104,72,58,6,0,240,0,11,251
8,7,8048,2353,3,164,95,76,13,2,350,0,9,359
8,7,8048,2354,3,143,116,82,12,2,355,0,7,362
8,7,8048,2355,3,25,19,13,1,1,59,0,0,59
8,7,8048,2356,3,32,43,7,5,1,88,0,3,91
8,7,8048,2357,3,13,36,10,0,0,59,0,3,62
8,7,8048,2358,3,29,58,16,2,0,105,1,2,108
8,7,8048,2359,3,12,35,3,2,0,52,0,3,55
8,7,8048,2360,3,20,52,4,1,0,77,0,4,81
8,7,8048,2361,3,29,72,17,11,0,129,0,6,135
8,7,8048,2362,3,24,57,13,4,0,98,0,3,101
8,7,8048,2363,3,24,60,28,1,2,115,0,4,119
8,7,8048,2364,3,20,41,19,5,2,87,0,4,91
8,7,8048,2365,3,78,60,68,4,2,212,0,0,212
8,7,8048,2366,3,2,40,6,1,0,49,0,3,52
8,7,8048,2367,3,58,48,35,1,0,142,1,3,146
8,7,8048,2368,3,42,17,13,6,1,79,0,3,82
8,7,8048,2369,3,5,11,6,1,0,23,0,1,24
8,7,8048,2371,3,9,18,16,0,0,43,1,1,45
8,7,8048,2372,3,10,19,1,0,0,30,0,0,30
8,7,8048,2373,3,7,10,6,1,0,24,0,1,25
8,7,8048,2374,3,20,30,23,1,0,74,0,2,76
8,7,8048,2375,3,40,47,37,2,1,127,0,2,129
8,7,8048,2376,3,15,14,7,0,0,36,0,0,36
8,7,8048,2377,3,9,9,7,2,0,27,0,1,28
8,7,8048,2378,3,7,56,11,3,0,77,0,7,84
8,7,8048,2379,3,44,33,19,2,1,99,1,2,102
8,7,8048,2380,3,15,55,27,2,0,99,0,0,99
8,7,8048,2381,3,84,83,100,6,1,274,0,11,285
8,7,8048,2382,3,11,73,31,2,1,118,0,2,120
8,7,8048,2383,3,15,28,9,2,0,54,0,2,56
8,7,8048,2384,3,39,28,63,9,2,141,0,11,152
8,7,8048,2385,3,36,30,90,3,1,160,0,0,160
8,7,8048,2386,3,7,22,32,2,1,64,0,4,68
8,7,8048,2387,3,11,51,23,5,0,90,0,4,94
8,7,8048,2388,3,88,79,41,5,1,214,0,5,219
8,7,8048,2389,3,105,37,11,8,0,161,0,0,161
8,7,8050,2396,3,213,192,86,37,5,533,0,11,544
8,7,8050,2397,3,285,186,72,21,7,571,0,2,573
8,7,8050,2398,3,515,447,194,58,17,1231,1,25,1257
8,7,8050,2399,3,116,250,66,20,5,457,0,10,467
8,7,8050,2400,3,173,98,42,13,3,329,0,11,340
8,7,8050,2401,3,100,99,50,36,5,290,0,9,299
8,7,8050,2402,3,127,113,29,13,2,284,0,6,290
8,7,8050,2403,3,99,56,28,7,3,193,1,4,198
8,7,8050,2404,3,109,70,26,4,3,212,0,7,219
8,7,8050,2405,3,78,86,19,10,5,198,0,2,200
8,7,8050,2406,3,78,160,53,9,6,306,0,9,315
8,7,8050,2407,3,131,222,62,19,10,444,2,21,467
8,7,8050,2408,3,117,125,59,8,2,311,2,9,322
8,7,8050,2409,3,132,86,31,8,4,261,1,9,271
8,7,8050,2410,3,89,122,49,11,3,274,1,7,282
8,7,8050,2411,3,89,93,34,16,1,233,0,8,241
8,7,8050,2412,3,119,94,44,14,3,274,0,7,281
8,7,8050,2413,3,117,118,73,5,5,318,1,6,325
8,7,8050,2414,3,165,165,111,26,3,470,0,18,488
8,7,8050,2415,3,98,135,109,8,3,353,1,17,371
8,7,8050,2416,3,155,186,102,9,7,459,1,7,467
8,7,8050,2417,3,102,112,57,19,4,294,0,11,305
8,7,8050,2418,3,116,114,50,11,1,292,0,0,292
8,7,8050,2419,3,109,137,51,14,1,312,0,10,322
8,7,8050,2420,3,80,9,78,3,34,204,1,9,214
8,7,8050,2421,3,72,104,45,13,1,235,1,9,245
8,7,8050,2422,3,102,117,47,18,3,287,0,7,294
8,7,8050,2423,3,84,128,38,11,3,264,1,10,275
8,7,8050,2424,3,106,104,40,17,3,270,2,6,278
8,7,8050,2425,3,85,96,56,13,6,256,1,7,264
8,7,8050,2426,3,122,152,54,14,2,344,1,13,358
8,7,8050,2427,3,66,138,37,17,5,263,2,0,265
8,7,8050,2428,3,61,171,50,7,1,290,0,12,302
8,7,8050,2429,3,100,227,67,20,8,422,1,10,433
8,7,8050,2430,3,250,364,179,39,10,842,8,31,881
8,7,8050,2431,3,156,160,76,9,1,402,1,21,424
8,7,8050,2432,3,68,139,53,12,2,274,1,17,292
8,7,8050,2433,3,70,69,33,9,4,185,1,3,189
8,7,8050,2434,3,95,109,25,11,2,242,1,2,245
8,7,8050,2435,3,111,149,44,9,3,316,1,9,326
8,7,8050,2436,3,110,84,46,11,7,258,0,8,266
8,7,8050,2437,3,118,102,37,15,1,273,0,7,280
8,7,8050,2438,3,158,211,75,22,22,488,1,5,494
8,7,8050,2439,3,194,189,79,43,8,513,2,12,527
8,7,8050,2440,3,191,231,145,18,7,592,0,25,617
8,7,8050,2441,3,63,65,66,8,3,205,0,9,214
8,7,8050,2442,3,66,100,50,7,3,226,0,6,232
8,7,8050,2443,3,69,69,61,13,3,215,0,6,221
8,7,8050,2444,3,119,181,61,8,4,373,0,9,382
8,7,8050,2445,3,85,138,46,6,3,278,0,0,278
8,7,8050,2446,3,204,326,120,32,8,690,1,23,714
8,7,8050,2447,3,95,107,57,33,5,297,0,10,307
8,7,8050,2448,3,58,75,41,13,2,189,0,1,190
8,7,8050,2449,3,90,39,13,7,1,150,0,0,150
8,7,8050,2450,3,211,107,40,12,4,374,3,11,388
8,7,8050,2451,3,188,121,33,11,2,355,3,14,372
8,7,8050,2452,3,192,124,31,10,8,365,0,14,379
8,7,8050,2453,3,195,56,21,9,1,282,0,2,284
8,7,8050,2454,3,186,109,61,12,4,372,1,0,373
8,7,8050,2455,3,25,31,6,3,0,65,0,0,65
8,7,8050,2456,3,34,95,20,5,1,155,1,1,157
8,7,8050,2457,3,84,112,38,8,2,244,0,12,256
8,7,8050,2458,3,116,80,44,9,5,254,0,11,265
8,7,8050,2459,3,31,96,34,8,4,173,0,5,178
8,7,8051,2460,3,57,78,12,4,0,151,0,7,158
8,7,8051,2461,3,8,32,5,1,1,47,0,1,48
8,7,8051,2462,3,39,42,16,5,0,102,0,4,106
8,7,8051,2463,3,28,35,4,0,0,67,0,6,73
8,7,8051,2464,3,36,57,8,1,0,102,0,2,104
8,7,8051,2466,3,127,193,31,12,4,367,0,17,384
8,7,8051,2467,3,110,126,37,9,1,283,0,12,295
8,7,8051,2468,3,6,21,1,0,0,28,0,1,29
8,7,8051,2469,3,14,138,9,2,0,163,0,0,163
8,7,8051,2470,3,10,37,13,1,0,61,0,4,65
8,7,8051,2471,3,4,94,21,1,0,120,0,3,123
8,7,8051,2472,3,69,249,20,7,2,347,0,19,366
8,7,8051,2473,3,27,46,6,1,0,80,0,1,81
8,7,8051,2474,3,9,16,3,1,0,29,0,1,30
8,7,8051,2475,3,27,97,6,1,0,131,2,8,141
8,7,8051,2476,3,17,55,8,0,1,81,0,4,85
8,7,8054,2518,3,65,119,14,116,2,316,0,28,344
8,7,8054,2519,3,24,43,24,0,0,91,0,3,94
8,7,8054,2520,3,85,66,100,4,0,255,0,12,267
8,7,8054,2521,3,13,38,17,9,0,77,0,6,83
8,7,8054,2522,3,14,37,10,5,1,67,0,4,71
8,7,8054,2523,3,50,55,12,18,0,135,0,16,151
8,7,8054,2524,3,24,34,3,17,1,79,0,4,83
8,7,8054,2525,3,5,26,4,13,0,48,0,6,54
8,7,8054,2526,3,9,17,2,8,0,36,1,1,38
8,7,8054,2527,3,6,28,7,6,0,47,0,3,50
8,7,8063,2648,3,47,130,14,23,2,216,5,6,227
8,7,8063,2649,3,149,221,58,5,3,436,1,18,455
8,7,8063,2650,3,42,62,12,4,1,121,0,5,126
8,7,8063,2651,3,24,61,10,1,0,96,0,1,97
8,7,8063,2652,3,41,57,9,3,3,113,0,9,122
8,7,8063,2653,3,86,150,25,6,1,268,0,14,282
8,7,8063,2654,3,45,35,22,3,0,105,0,4,109
8,7,8063,2655,3,11,154,4,4,1,174,0,6,180
8,7,8063,2656,3,49,109,36,5,0,199,0,0,199
8,7,8063,2657,3,18,59,10,1,1,89,0,12,101
8,7,8063,2658,3,3,45,1,0,0,49,0,1,50
8,7,8063,2659,3,27,146,39,9,3,224,1,12,237
8,7,8063,2660,3,29,59,16,1,0,105,0,12,117
8,8,8019,437,3,137,173,45,28,6,389,1,11,401
8,8,8019,438,3,202,171,42,20,5,440,5,16,461
8,8,8019,439,3,211,201,36,21,11,480,3,6,489
8,8,8019,440,3,179,283,44,27,8,541,0,8,549
8,8,8019,441,3,241,159,53,29,9,491,2,10,503
8,8,8019,442,3,217,145,30,30,6,428,0,10,438
8,8,8019,443,3,230,130,27,24,3,414,1,8,423
8,8,8019,444,3,217,137,35,22,1,412,0,14,426
8,8,8019,445,3,167,114,29,21,2,333,0,5,338
8,8,8019,446,3,236,202,44,29,12,523,1,13,537
8,8,8019,508,3,207,172,51,36,7,473,0,3,476
8,8,8019,509,3,327,280,88,50,8,753,3,18,774
8,8,8019,535,3,156,191,51,21,7,426,2,21,449
8,8,8019,537,3,185,237,48,26,8,504,8,15,527
8,8,8019,538,3,493,486,114,80,15,1188,9,36,1233
8,8,8019,539,3,246,276,55,39,18,634,14,24,672
8,8,8019,540,3,170,261,54,34,6,525,0,15,540
8,8,8019,541,3,417,643,127,59,14,1260,8,10,1278
8,8,8019,542,3,165,131,53,19,7,375,1,8,384
8,8,8019,543,3,574,395,133,77,17,1196,5,27,1228
8,8,8019,545,3,329,129,32,18,6,514,0,5,519
8,8,8019,546,3,211,154,42,19,5,431,0,16,447
8,8,8019,547,3,129,123,24,21,4,301,0,13,314
8,8,8019,562,3,167,220,52,34,5,478,0,0,478
8,8,8019,563,3,178,183,50,29,6,446,4,14,464
8,8,8019,564,3,212,249,46,37,9,553,4,22,579
8,8,8019,565,3,160,177,46,26,4,413,0,16,429
8,8,8019,566,3,235,191,50,20,5,501,11,13,525
8,8,8019,567,3,151,128,26,18,6,329,2,6,337
8,8,8019,568,3,168,201,37,15,5,426,7,15,448
8,8,8019,569,3,251,220,53,32,3,559,1,11,571
8,8,8019,570,3,294,312,57,82,13,758,2,9,769
8,8,8019,571,3,221,234,61,26,8,550,4,23,577
8,8,8019,572,3,373,287,91,69,7,827,2,20,849
8,8,8019,573,3,247,143,54,35,12,491,3,19,513
8,8,8019,574,3,506,392,75,78,11,1062,1,24,1087
8,8,8019,575,3,427,323,76,58,4,888,1,17,906
8,8,8019,576,3,333,186,31,48,6,604,3,7,614
8,8,8019,577,3,123,167,35,22,3,350,8,6,364
8,8,8019,578,3,225,240,49,47,13,574,2,23,599
8,8,8019,579,3,200,137,24,42,6,409,0,1,410
8,8,8019,580,3,304,203,44,47,9,607,0,13,620
8,8,8019,581,3,188,185,51,35,8,467,0,13,480
8,8,8019,582,3,138,163,33,16,3,353,0,16,369
8,8,8019,583,3,265,294,71,50,9,689,5,11,705
8,8,8019,584,3,133,180,51,23,8,395,0,23,418
8,8,8019,585,3,204,201,40,17,7,469,1,15,485
8,8,8019,586,3,206,157,31,41,11,446,2,13,461
8,8,8019,587,3,196,206,55,26,2,485,1,20,506
8,8,8019,588,3,143,153,30,20,1,347,0,7,354
8,8,8019,589,3,103,121,37,17,3,281,1,0,282
8,8,8019,590,3,234,175,45,27,5,486,3,13,502
8,8,8019,591,3,229,239,42,35,6,551,6,14,571
8,8,8019,592,3,212,160,41,12,3,428,0,24,452
8,8,8019,593,3,355,405,86,33,10,889,3,16,908
8,8,8019,594,3,215,216,56,33,10,530,4,12,546
8,8,8019,595,3,215,156,34,47,8,460,1,4,465
8,8,8019,596,3,545,569,131,82,30,1357,8,44,1409
8,8,8019,597,3,231,170,41,32,9,483,1,14,498
8,8,8019,598,3,264,183,47,29,6,529,1,5,535
8,8,8019,599,3,289,265,55,43,6,658,1,13,672
8,8,8019,600,3,292,322,53,61,12,740,0,21,761
8,8,8019,601,3,267,214,59,58,11,609,1,6,616
8,8,8019,602,3,208,196,38,38,4,484,2,11,497
8,8,8019,603,3,196,165,56,44,5,466,3,3,472
8,8,8019,604,3,381,346,94,71,17,909,6,19,934
8,8,8019,605,3,490,430,115,75,14,1124,3,34,1161
8,8,8019,606,3,145,154,42,21,5,367,0,12,379
8,8,8019,607,3,181,134,35,24,1,375,1,11,387
8,8,8019,608,3,1417,1269,297,300,43,3326,14,90,3430
8,8,8019,609,3,730,662,179,171,34,1776,12,34,1822
8,8,8019,610,3,1552,1314,318,278,60,3522,12,74,3608
8,8,8019,611,3,753,750,208,104,20,1835,7,50,1892
8,8,8019,612,3,954,870,240,263,34,2361,6,29,2396
8,8,8019,613,3,705,580,139,147,19,1590,13,19,1622
8,8,8019,614,3,232,254,78,36,7,607,10,14,631
8,8,8019,615,3,162,202,44,18,3,429,2,11,442
8,8,8019,616,3,258,232,58,19,9,576,4,16,596
8,8,8019,617,3,308,298,68,58,15,747,7,17,771
8,8,8019,618,3,196,140,35,22,7,400,2,7,409
8,8,8019,619,3,257,162,39,22,3,483,3,6,492
8,8,8019,620,3,221,160,44,27,15,467,1,7,475
8,8,8019,627,3,171,173,38,30,9,421,1,12,434
8,8,8019,628,3,156,139,33,18,8,354,2,6,362
8,8,8019,629,3,145,139,41,25,6,356,0,0,356
8,8,8019,630,3,129,141,44,24,6,344,2,0,346
8,8,8019,631,3,156,142,32,27,9,366,1,9,376
8,8,8019,632,3,132,201,46,18,4,401,2,14,417
8,8,8019,633,3,222,290,85,20,10,627,4,28,659
8,8,8019,634,3,122,113,41,17,2,295,0,6,301
8,8,8019,635,3,104,105,32,15,5,261,0,2,263
8,8,8019,636,3,164,137,24,20,3,348,2,16,366
8,8,8019,637,3,180,79,48,10,4,321,1,9,331
8,8,8019,644,3,138,182,59,17,10,406,4,9,419
8,8,8019,645,3,105,186,39,22,4,356,0,9,365
8,8,8019,646,3,199,216,114,24,9,562,4,17,583
8,8,8019,647,3,220,227,49,43,4,543,4,9,556
8,8,8019,648,3,114,135,60,11,9,329,2,17,348
8,8,8019,649,3,157,188,51,29,9,434,2,23,459
8,8,8019,650,3,121,134,32,18,7,312,0,9,321
8,8,8019,651,3,128,151,89,27,6,401,1,14,416
8,8,8019,652,3,154,127,38,19,5,343,3,12,358
8,8,8019,662,3,161,112,34,29,4,340,2,11,353
8,8,8019,663,3,156,129,54,17,6,362,0,12,374
8,8,8019,664,3,127,138,42,14,2,323,3,1,327
8,8,8019,665,3,83,82,41,12,6,224,0,7,231
8,8,8019,666,3,132,143,58,14,3,350,1,7,358
8,8,8019,667,3,98,160,45,15,6,324,5,12,341
8,8,8019,668,3,174,225,53,33,3,488,11,14,513
8,8,8019,669,3,266,246,67,37,11,627,5,17,649
8,8,8019,671,3,245,310,84,40,10,689,2,20,711
8,8,8019,672,3,138,115,39,24,7,323,3,18,344
8,8,8019,673,3,158,115,27,10,6,316,3,12,331
8,8,8019,674,3,282,221,60,34,5,602,1,9,612
8,8,8019,683,3,158,131,40,21,6,356,0,16,372
8,8,8019,684,3,233,189,61,41,9,533,2,32,567
8,8,8019,685,3,145,110,42,22,5,324,0,7,331
8,8,8019,686,3,281,169,40,29,3,522,0,5,527
8,8,8019,687,3,208,155,37,35,9,444,0,8,452
8,8,8019,688,3,187,193,36,17,7,440,1,19,460
8,8,8019,689,3,405,254,83,35,9,786,2,40,828
8,8,8019,690,3,166,228,35,28,9,466,2,13,481
8,8,8019,691,3,333,171,51,60,6,621,0,8,629
8,8,8019,692,3,451,283,65,46,12,857,3,12,872
8,8,8019,693,3,327,155,39,34,6,561,2,5,568
8,8,8019,694,3,204,126,51,21,4,406,0,7,413
8,8,8019,695,3,254,235,79,56,14,638,3,13,654
8,8,8019,712,3,213,134,33,31,4,415,0,10,425
8,8,8019,713,3,436,216,72,37,10,771,0,13,784
8,8,8019,714,3,468,325,71,54,15,933,0,18,951
8,8,8019,715,3,258,115,14,24,6,417,0,4,421
8,8,8019,716,3,308,217,42,32,11,610,1,16,627
8,8,8019,717,3,366,171,43,25,7,612,1,9,622
8,8,8019,718,3,1147,565,138,120,19,1989,3,24,2016
8,8,8019,719,3,449,259,76,53,10,847,0,9,856
8,8,8019,739,3,344,119,43,29,8,543,0,8,551
8,8,8019,740,3,556,294,84,83,17,1034,4,10,1048
8,8,8019,767,3,407,241,53,43,8,752,1,12,765
8,8,8019,768,3,218,205,31,22,6,482,6,10,498
8,8,8019,785,3,218,182,50,29,11,490,2,14,506
8,8,8019,786,3,118,81,17,17,4,237,0,4,241
8,8,8019,787,3,472,286,67,61,10,896,1,17,914
8,8,8019,788,3,450,205,81,48,15,799,1,9,809
8,8,8019,789,3,347,183,60,44,13,647,1,4,652
8,8,8019,790,3,126,148,40,15,3,332,0,18,350
8,8,8019,791,3,162,142,36,15,4,359,0,18,377
8,8,8019,792,3,423,184,59,30,8,704,4,14,722
8,8,8019,793,3,235,186,54,28,5,508,1,13,522
8,8,8019,794,3,170,119,30,11,5,335,7,7,349
8,8,8019,811,3,92,72,21,18,2,205,3,5,213
8,8,8019,812,3,164,123,36,24,9,356,2,4,362
8,8,8019,813,3,214,194,43,25,8,484,0,10,494
8,8,8019,814,3,141,208,41,13,7,410,2,8,420
8,8,8019,815,3,83,140,21,23,4,271,1,5,277
8,8,8019,816,3,161,149,26,18,6,360,0,12,372
8,8,8019,848,3,428,363,54,62,16,923,2,15,940
8,8,8019,849,3,1140,853,238,178,54,2463,13,29,2505
8,8,8019,850,3,229,206,38,33,4,510,1,7,518
8,8,8019,851,3,137,184,29,21,7,378,0,12,390
8,8,8019,852,3,356,258,57,34,10,715,5,22,742
8,8,8019,853,3,149,100,27,15,3,294,1,4,299
8,8,8019,854,3,364,287,93,34,10,788,2,24,814
8,8,8019,855,3,111,56,32,6,2,207,2,4,213
8,8,8019,856,3,50,41,7,4,2,104,0,5,109
8,8,8019,857,3,181,140,59,36,9,425,2,14,441
8,8,8019,858,3,283,273,53,36,7,652,2,13,667
8,8,8019,859,3,195,172,33,24,6,430,1,4,435
8,8,8019,860,3,206,214,42,24,8,494,1,9,504
8,8,8019,861,3,113,116,29,19,2,279,0,3,282
8,8,8019,862,3,258,224,66,32,7,587,12,14,613
8,8,8019,863,3,271,219,38,22,6,556,0,17,573
8,8,8019,864,3,155,154,31,21,3,364,1,8,373
8,8,8019,865,3,317,243,48,30,11,649,0,24,673
8,8,8019,866,3,145,157,37,21,3,363,3,9,375
8,8,8019,867,3,250,250,53,31,7,591,2,5,598
8,8,8019,868,3,280,227,44,22,10,583,3,9,595
8,8,8019,869,3,347,297,41,49,7,741,4,24,769
8,8,8019,870,3,394,319,72,34,10,829,3,22,854
8,8,8019,871,3,400,354,79,48,7,888,14,11,913
8,8,8019,872,3,323,364,76,64,14,841,4,29,874
8,8,8019,873,3,226,347,56,30,13,672,3,17,692
8,8,8019,874,3,266,302,52,53,10,683,8,18,709
8,8,8019,875,3,329,286,60,42,10,727,0,23,750
8,8,8019,876,3,383,361,49,49,7,849,3,19,871
8,8,8019,877,3,178,233,50,21,7,489,3,16,508
8,8,8019,878,3,200,223,69,41,14,547,0,15,562
8,8,8019,879,3,421,438,103,65,21,1048,7,26,1081
8,8,8019,880,3,269,358,63,33,7,730,1,17,748
8,8,8019,881,3,230,327,86,48,12,703,0,11,714
8,8,8019,882,3,297,353,90,48,11,799,10,25,834
8,8,8019,883,3,442,458,109,52,14,1075,2,34,1111
8,8,8019,884,3,410,457,126,72,12,1077,5,18,1100
8,8,8019,886,3,35,59,5,4,0,103,0,4,107
8,8,8019,887,3,96,209,33,12,1,351,1,13,365
8,8,8019,888,3,8,23,7,1,1,40,0,2,42
8,8,8019,889,3,106,209,20,31,1,367,4,37,408
8,8,8019,890,3,97,93,16,7,2,215,0,15,230
8,8,8019,891,3,69,98,33,8,2,210,4,9,223
8,8,8019,892,3,29,11,5,1,1,47,0,4,51
8,8,8019,895,3,280,314,49,35,11,689,1,34,724
8,8,8019,896,3,412,361,102,54,8,937,6,18,961
8,8,8019,900,3,21,16,4,1,0,42,0,1,43
8,8,8019,908,3,79,64,17,8,2,170,0,6,176
8,8,8019,909,3,56,56,22,8,1,143,2,4,149
8,8,8019,910,3,246,151,39,24,3,463,0,8,471
8,8,8019,2844,3,272,201,53,36,8,570,1,14,585
8,8,8019,2845,3,96,48,14,16,4,178,0,3,181
8,8,8019,2846,3,49,37,5,12,2,105,1,1,107
8,8,8019,2847,3,81,65,12,14,4,176,0,2,178
8,8,8019,2848,3,150,123,24,42,5,344,0,9,353
8,8,8019,2849,3,56,147,21,13,4,241,5,8,254
8,8,8019,2850,3,109,99,27,16,8,259,5,6,270
8,8,8019,2851,3,104,92,19,18,5,238,1,6,245
8,8,8019,2852,3,79,65,18,19,8,189,3,4,196
8,8,8019,2853,3,136,111,23,21,5,296,3,8,307
8,8,8019,2854,3,98,77,25,27,4,231,1,3,235
8,8,8019,2855,3,167,77,17,11,6,278,2,1,281
8,8,8019,2856,3,122,67,22,17,4,232,1,2,235
8,8,8019,2857,3,118,59,11,9,6,203,0,4,207
8,8,8019,2858,3,127,177,36,17,4,361,1,10,372
8,8,8019,2859,3,95,105,22,13,2,237,0,7,244
8,8,8019,2860,3,190,100,10,23,3,326,2,0,328
8,8,8019,2861,3,110,71,11,21,4,217,0,1,218
8,8,8019,2862,3,166,120,36,19,7,348,4,2,354
8,8,8019,2863,3,58,46,4,10,1,119,3,0,122
8,8,8019,2864,3,122,103,17,19,0,261,1,4,266
8,8,8019,2865,3,87,122,24,16,1,250,2,9,261
8,8,8019,2866,3,68,41,14,8,1,132,0,3,135
8,8,8019,2867,3,158,104,24,23,5,314,1,3,318
8,8,8019,2868,3,168,113,20,23,3,327,0,4,331
8,8,8019,2869,3,139,146,23,16,1,325,6,7,338
8,8,8019,2870,3,104,99,18,16,3,240,4,2,246
8,8,8019,2871,3,80,136,19,14,3,252,0,0,252
8,8,8019,2872,3,107,132,22,15,4,280,3,10,293
8,8,8019,2873,3,131,78,9,18,2,238,1,3,242
8,8,8019,2874,3,207,117,31,41,4,400,1,1,402
8,8,8019,2875,3,208,120,23,21,4,376,0,6,382
8,8,8019,2876,3,126,146,40,11,4,327,1,7,335
8,8,8019,2877,3,116,135,31,17,8,307,1,12,320
8,8,8019,2878,3,146,160,39,16,12,373,5,2,380
8,8,8019,2879,3,84,119,21,14,3,241,1,8,250
8,8,8019,2880,3,73,147,32,15,4,271,3,6,280
8,8,8019,2881,3,48,81,14,13,1,157,0,6,163
8,8,8019,2882,3,85,121,20,12,2,240,0,10,250
8,8,8019,2883,3,82,174,31,10,2,299,2,12,313
8,8,8019,2884,3,97,162,17,16,2,294,0,15,309
8,8,8019,2885,3,146,97,22,22,4,291,3,1,295
8,8,8019,2886,3,128,68,18,18,7,239,3,3,245
8,8,8019,2887,3,109,97,20,14,7,247,1,4,252
8,8,8019,2888,3,171,128,35,32,8,374,6,3,383
8,8,8019,2889,3,133,114,27,21,5,300,2,5,307
8,8,8019,2890,3,166,115,28,24,2,335,3,3,341
8,8,8019,2891,3,168,77,21,17,6,289,0,3,292
8,8,8019,2892,3,176,110,15,31,5,337,0,0,337
8,8,8019,2893,3,170,137,26,30,4,367,0,10,377
8,8,8019,2894,3,190,138,36,34,6,404,0,8,412
8,8,8019,2895,3,188,112,25,26,8,359,0,3,362
8,8,8019,2896,3,197,109,29,18,3,356,1,1,358
8,8,8019,2897,3,82,50,28,37,2,199,0,3,202
8,8,8019,2898,3,186,109,36,23,2,356,1,4,361
8,8,8019,2899,3,210,94,32,17,6,359,1,0,360
8,8,8019,2900,3,249,116,21,20,6,412,2,1,415
8,8,8019,2901,3,233,92,24,29,9,387,1,5,393
8,8,8019,2902,3,255,139,31,33,10,468,2,0,470
8,9,8007,102,3,144,214,39,17,1,415,1,24,440
8,9,8007,103,3,132,185,31,20,2,370,1,19,390
8,9,8007,104,3,22,66,19,1,1,109,0,19,128
8,9,8007,105,3,79,117,16,5,3,220,0,14,234
8,9,8007,106,3,77,294,32,8,8,419,2,58,479
8,9,8007,107,3,70,92,22,11,3,198,0,9,207
8,9,8007,108,3,62,81,71,18,0,232,0,8,240
8,9,8007,109,3,12,8,4,0,0,24,0,0,24
8,9,8007,110,3,44,106,11,5,4,170,0,98,268
8,9,8007,111,3,31,169,2,0,2,204,0,33,237
8,9,8007,112,3,71,24,8,1,0,104,0,7,111
8,9,8007,113,3,60,202,5,0,5,272,0,17,289
8,9,8007,114,3,396,342,32,18,9,797,0,47,844
8,9,8007,115,3,187,310,12,2,3,514,0,46,560
8,9,8008,116,3,185,223,59,10,2,479,1,30,510
8,9,8008,117,3,37,93,7,1,0,138,0,16,154
8,9,8008,118,3,8,56,9,4,0,77,0,5,82
8,9,8008,119,3,98,180,14,3,0,295,0,23,318
8,9,8008,120,3,31,55,3,3,0,92,0,8,100
8,9,8008,121,3,96,179,17,3,5,300,0,70,370
8,9,8008,122,3,28,42,3,4,0,77,0,7,84
8,9,8008,123,3,27,187,2,6,0,222,0,13,235
8,9,8008,124,3,22,59,1,0,0,82,0,8,90
8,9,8008,125,3,96,145,17,6,4,268,0,24,292
8,9,8008,126,3,5,65,8,0,2,80,0,2,82
8,9,8009,127,3,34,45,20,8,1,108,0,2,110
8,9,8009,128,3,108,114,50,42,1,315,0,13,328
8,9,8009,129,3,100,188,96,30,9,423,0,13,436
8,9,8009,130,3,142,219,92,56,7,516,0,30,546
8,9,8009,131,3,105,123,82,51,5,366,0,12,378
8,9,8009,132,3,159,209,129,51,5,553,2,23,578
8,9,8009,133,3,98,196,86,50,9,439,0,14,453
8,9,8009,134,3,85,163,73,59,7,387,1,21,409
8,9,8009,135,3,205,217,64,81,5,572,0,34,606
8,9,8009,136,3,259,255,129,136,14,793,1,26,820
8,9,8009,137,3,139,361,90,47,15,652,0,55,707
8,9,8009,138,3,39,110,28,7,0,184,0,11,195
8,9,8009,139,3,33,141,46,8,2,230,0,22,252
8,9,8009,140,3,130,177,105,8,13,433,0,43,476
8,9,8009,141,3,29,87,32,4,3,155,0,9,164
8,9,8009,142,3,11,112,8,11,2,144,1,16,161
8,9,8009,143,3,27,92,46,4,1,170,4,8,182
8,9,8009,144,3,198,221,126,95,7,647,0,29,676
8,9,8009,145,3,40,141,42,8,1,232,0,18,250
8,9,8009,146,3,88,177,39,5,7,316,2,59,377
8,9,8009,147,3,13,79,3,7,3,105,2,13,120
8,9,8009,148,3,30,70,11,3,2,116,0,25,141
8,9,8012,221,3,72,238,58,21,2,391,1,24,416
8,9,8012,222,3,48,90,28,4,0,170,0,8,178
8,9,8012,223,3,30,83,11,3,1,128,0,4,132
8,9,8012,224,3,11,53,18,5,2,89,0,1,90
8,9,8012,225,3,63,140,38,5,2,248,0,10,258
8,9,8012,226,3,18,36,15,0,0,69,0,0,69
8,9,8012,227,3,7,74,12,0,2,95,0,7,102
8,9,8012,228,3,3,44,9,1,0,57,0,5,62
8,9,8012,229,3,4,60,24,0,0,88,0,9,97
8,9,8012,230,3,7,35,5,2,0,49,0,5,54
8,9,8012,231,3,7,58,12,2,1,80,0,2,82
8,9,8012,232,3,7,61,5,2,1,76,0,4,80
8,9,8012,233,3,4,39,1,3,0,47,0,7,54
8,9,8012,234,3,41,198,30,4,5,278,0,62,340
8,9,8012,235,3,17,71,5,3,1,97,0,19,116
8,9,8012,236,3,12,60,19,7,0,98,1,29,128
8,9,8012,237,3,22,120,5,0,3,150,0,36,186
8,9,8018,388,3,25,42,46,6,1,120,0,5,125
8,9,8018,389,3,43,30,45,3,1,122,0,7,129
8,9,8018,390,3,9,31,13,1,1,55,0,3,58
8,9,8018,391,3,16,44,7,3,2,72,0,1,73
8,9,8018,393,3,56,48,16,2,1,123,0,7,130
8,9,8018,394,3,67,96,73,3,2,241,0,14,255
8,9,8018,395,3,13,62,85,6,5,171,0,12,183
8,9,8018,396,3,33,139,31,8,3,214,0,14,228
8,9,8018,397,3,30,63,18,2,0,113,0,2,115
8,9,8018,398,3,32,93,88,5,0,218,0,12,230
8,9,8018,399,3,36,29,11,2,0,78,0,3,81
8,9,8018,400,3,7,39,9,1,1,57,0,4,61
8,9,8018,401,3,17,65,14,4,0,100,0,5,105
8,9,8020,912,3,172,147,31,40,2,392,0,11,403
8,9,8020,913,3,69,69,22,11,2,173,0,6,179
8,9,8020,914,3,96,91,34,10,1,232,0,8,240
8,9,8020,915,3,27,48,2,2,0,79,0,0,79
8,9,8020,916,3,36,15,2,1,1,55,0,1,56
8,9,8020,917,3,19,59,7,1,2,88,0,4,92
8,9,8020,918,3,20,110,5,14,0,149,0,2,151
8,9,8020,919,3,104,103,18,36,1,262,0,20,282
8,9,8020,920,3,8,3,1,9,0,21,0,1,22
8,9,8022,1031,3,124,132,28,9,4,297,0,7,304
8,9,8022,1032,3,120,69,10,2,2,203,0,8,211
8,9,8022,1033,3,76,83,19,2,1,181,0,9,190
8,9,8022,1034,3,44,42,12,3,0,101,0,3,104
8,9,8022,1035,3,40,19,60,2,0,121,0,1,122
8,9,8022,1036,3,83,67,7,1,4,162,0,5,167
8,9,8022,1037,3,16,19,4,2,0,41,0,1,42
8,9,8022,1038,3,14,27,3,0,2,46,0,2,48
8,9,8022,1039,3,36,25,11,3,0,75,0,3,78
8,9,8022,1040,3,10,21,5,3,0,39,0,2,41
8,9,8022,1041,3,50,106,25,7,2,190,1,8,199
8,9,8024,1046,3,195,173,78,18,5,469,0,20,489
8,9,8024,1047,3,78,129,46,16,3,272,0,10,282
8,9,8024,1048,3,132,54,11,5,2,204,0,0,204
8,9,8024,1049,3,69,85,21,6,0,181,0,6,187
8,9,8024,1050,3,140,111,41,7,4,303,3,15,321
8,9,8024,1051,3,38,46,7,2,1,94,0,3,97
8,9,8024,1052,3,64,23,14,0,0,101,0,7,108
8,9,8026,1069,3,66,121,19,10,0,216,0,17,233
8,9,8026,1070,3,44,80,15,1,0,140,0,14,154
8,9,8026,1071,3,17,30,17,5,1,70,2,3,75
8,9,8026,1072,3,24,31,19,3,1,78,0,2,80
8,9,8026,1073,3,40,78,18,3,2,141,1,7,149
8,9,8026,1074,3,15,37,10,2,0,64,0,2,66
8,9,8026,1075,3,6,43,9,2,1,61,0,3,64
8,9,8026,1076,3,12,51,12,0,1,76,0,3,79
8,9,8026,1077,3,17,71,6,2,2,98,0,5,103
8,9,8026,1078,3,7,42,13,3,2,67,0,4,71
8,9,8026,1079,3,132,92,37,19,6,286,0,11,297
8,9,8026,1080,3,37,84,10,3,2,136,0,2,138
8,9,8026,1081,3,16,28,18,1,0,63,0,3,66
8,9,8027,1082,3,101,102,32,26,3,264,0,15,279
8,9,8027,1083,3,127,201,72,50,6,456,0,22,478
8,9,8027,1084,3,82,171,43,35,4,335,0,9,344
8,9,8027,1085,3,89,158,44,40,7,338,0,8,346
8,9,8027,1086,3,59,100,33,32,8,232,0,7,239
8,9,8027,1087,3,102,181,54,36,7,380,1,20,401
8,9,8027,1088,3,96,121,40,29,3,289,0,9,298
8,9,8027,1089,3,92,168,44,31,7,342,0,14,356
8,9,8027,1090,3,53,207,69,39,7,375,0,12,387
8,9,8027,1091,3,116,204,83,88,13,504,1,23,528
8,9,8027,1092,3,30,134,29,5,3,201,7,28,236
8,9,8027,1093,3,33,64,34,6,3,140,0,20,160
8,9,8027,1094,3,112,33,15,5,0,165,0,24,189
8,9,8027,1095,3,13,74,17,6,3,113,0,14,127
8,9,8027,1096,3,20,24,4,1,0,49,0,5,54
8,9,8027,1097,3,78,233,72,20,5,408,0,57,465
8,9,8027,1098,3,166,154,49,19,2,390,1,42,433
8,9,8027,1099,3,5,31,7,3,0,46,0,5,51
8,9,8027,1100,3,35,72,76,2,2,187,0,23,210
8,9,8027,1101,3,94,153,28,3,3,281,0,44,325
8,9,8027,1102,3,33,70,19,1,0,123,0,28,151
8,9,8027,1103,3,11,42,7,4,2,66,0,7,73
8,9,8027,1104,3,107,139,12,8,0,266,1,36,303
8,9,8027,1105,3,17,78,14,1,1,111,3,14,128
8,9,8027,1106,3,38,53,17,5,1,114,0,9,123
8,9,8027,1107,3,224,175,82,29,5,515,4,49,568
8,9,8027,1108,3,23,70,27,8,0,128,0,20,148
8,9,8027,1109,3,10,25,12,1,3,51,0,9,60
8,9,8027,1110,3,10,91,19,4,1,125,0,21,146
8,9,8027,1111,3,36,77,46,6,4,169,3,23,195
8,9,8027,1112,3,20,38,1,7,2,68,0,9,77
8,9,8027,1113,3,21,93,5,1,1,121,0,0,121
8,9,8027,1114,3,46,109,15,6,7,183,6,38,227
8,9,8027,1115,3,11,40,5,3,3,62,0,6,68
8,9,8027,1116,3,22,54,12,3,0,91,0,23,114
8,9,8027,1117,3,22,236,24,9,3,294,0,27,321
8,9,8027,1118,3,237,229,41,50,4,561,2,35,598
8,9,8027,1119,3,17,85,14,11,0,127,0,4,131
8,9,8027,1120,3,15,165,20,10,2,212,2,21,235
8,9,8027,1122,3,10,98,9,6,0,123,0,13,136
8,9,8027,1123,3,51,127,30,7,3,218,5,23,246
8,9,8027,1124,3,10,59,13,1,0,83,0,11,94
8,9,8027,1125,3,18,67,6,2,0,93,0,10,103
8,9,8029,1135,3,138,208,54,38,3,441,0,19,460
8,9,8029,1136,3,260,448,69,63,6,846,0,46,892
8,9,8029,1137,3,8,25,7,4,3,47,1,2,50
8,9,8029,1138,3,12,125,47,1,2,187,1,28,216
8,9,8029,1139,3,32,205,22,11,2,272,1,12,285
8,9,8029,1140,3,77,130,55,13,3,278,0,23,301
8,9,8029,1141,3,2,2,18,0,2,24,1,1,26
8,9,8029,1142,3,62,423,120,17,7,629,0,120,749
8,9,8029,1143,3,119,409,95,55,10,688,1,7,696
8,9,8029,1144,3,73,79,22,8,1,183,0,7,190
8,9,8029,1145,3,54,106,32,19,1,212,0,16,228
8,9,8029,1146,3,73,216,54,27,6,376,4,35,415
8,9,8029,1147,3,12,68,26,10,1,117,0,25,142
8,9,8029,1148,3,34,252,18,11,3,318,0,41,359
8,9,8029,1149,3,6,65,4,4,0,79,0,3,82
8,9,8029,1150,3,11,21,12,5,0,49,0,1,50
8,9,8029,1151,3,22,32,19,2,0,75,0,4,79
8,9,8029,1152,3,78,29,6,5,1,119,0,3,122
8,9,8029,1153,3,61,75,6,5,0,147,0,12,159
8,9,8029,1154,3,171,141,46,22,1,381,1,23,405
8,9,8029,1155,3,108,212,20,9,5,354,0,42,396
8,9,8029,1156,3,44,125,9,9,0,187,0,9,196
8,9,8029,1157,3,19,57,13,7,0,96,0,3,99
8,9,8029,1158,3,37,179,6,30,1,253,1,19,273
8,9,8029,1159,3,169,201,34,47,3,454,0,34,488
8,9,8029,1160,3,77,196,45,24,2,344,2,21,367
8,9,8029,1161,3,15,48,8,10,1,82,0,2,84
8,9,8029,1162,3,36,63,10,1,1,111,0,7,118
8,9,8029,1163,3,57,206,24,7,5,299,0,19,318
8,9,8029,1164,3,144,296,35,24,0,499,0,23,522
8,9,8029,1165,3,223,344,85,50,3,705,1,34,740
8,9,8029,1166,3,8,53,5,5,0,71,0,1,72
8,9,8030,1167,3,150,145,38,15,1,349,0,15,364
8,9,8030,1168,3,123,146,33,23,3,328,0,2,330
8,9,8030,1169,3,52,30,9,0,0,91,0,2,93
8,9,8030,1170,3,22,44,5,3,0,74,0,11,85
8,9,8030,1171,3,40,80,8,4,0,132,0,9,141
8,9,8030,1172,3,18,93,5,6,2,124,3,17,144
8,9,8030,1173,3,68,61,14,0,0,143,0,12,155
8,9,8030,1174,3,77,148,29,10,1,265,0,15,280
8,9,8030,1175,3,25,45,22,2,0,94,0,7,101
8,9,8030,1176,3,33,16,8,0,0,57,0,3,60
8,9,8030,1177,3,66,74,14,6,0,160,0,8,168
8,9,8030,1178,3,26,31,7,2,1,67,0,5,72
8,9,8030,1179,3,14,30,12,1,0,57,0,4,61
8,9,8030,1180,3,39,31,26,3,0,99,0,4,103
8,9,8030,1181,3,58,14,14,2,0,88,0,2,90
8,9,8032,1266,3,222,188,43,23,6,482,2,18,502
8,9,8032,1267,3,162,159,45,16,1,383,2,10,395
8,9,8032,1268,3,215,172,51,15,6,459,3,11,473
8,9,8032,1269,3,144,176,33,12,7,372,1,8,381
8,9,8032,1270,3,107,111,16,6,2,242,0,9,251
8,9,8032,1271,3,170,136,34,9,1,350,0,16,366
8,9,8032,1272,3,360,356,69,38,16,839,1,4,844
8,9,8032,1273,3,353,207,50,25,6,641,0,9,650
8,9,8032,1274,3,149,124,29,2,2,306,0,6,312
8,9,8032,1275,3,218,161,95,16,4,494,4,16,514
8,9,8032,1276,3,221,195,56,29,3,504,0,4,508
8,9,8032,1277,3,223,117,35,46,4,425,0,10,435
8,9,8032,1278,3,205,172,90,9,1,477,0,6,483
8,9,8032,1279,3,198,141,37,20,7,403,2,7,412
8,9,8032,1280,3,167,248,36,7,1,459,6,14,479
8,9,8032,1281,3,982,945,179,53,15,2174,4,65,2243
8,9,8032,1282,3,139,224,30,12,7,412,3,9,424
8,9,8032,1283,3,121,168,43,9,2,343,3,9,355
8,9,8032,1284,3,245,155,67,19,2,488,1,12,501
8,9,8032,1285,3,163,158,36,24,11,392,0,11,403
8,9,8032,1286,3,95,91,26,18,6,236,0,8,244
8,9,8032,1287,3,103,121,18,13,3,258,1,3,262
8,9,8032,1288,3,312,220,48,32,6,618,0,8,626
8,9,8032,1289,3,268,305,53,38,4,668,1,5,674
8,9,8032,1290,3,349,418,87,79,9,942,0,17,959
8,9,8032,1291,3,208,180,62,35,11,496,0,5,501
8,9,8032,1292,3,221,175,30,12,4,442,2,7,451
8,9,8032,1293,3,235,193,49,21,3,501,0,10,511
8,9,8032,1294,3,230,187,51,23,4,495,0,9,504
8,9,8032,1295,3,163,141,39,12,3,358,0,9,367
8,9,8032,1296,3,379,497,98,22,7,1003,5,34,1042
8,9,8032,1297,3,238,215,56,15,2,526,1,9,536
8,9,8032,1298,3,207,287,93,21,10,618,6,12,636
8,9,8032,1299,3,217,167,55,20,5,464,4,9,477
8,9,8032,1300,3,202,208,61,29,5,505,1,7,513
8,9,8032,1301,3,193,143,24,21,1,382,0,6,388
8,9,8032,1302,3,171,155,33,16,4,379,0,5,384
8,9,8032,1303,3,125,130,39,18,1,313,1,0,314
8,9,8032,1304,3,120,140,30,17,0,307,0,6,313
8,9,8032,1305,3,137,110,18,7,2,274,0,4,278
8,9,8032,1306,3,363,433,82,76,7,961,1,14,976
8,9,8032,1307,3,165,161,36,15,4,381,0,10,391
8,9,8032,1308,3,241,222,58,38,6,565,1,15,581
8,9,8032,1309,3,238,194,18,34,10,494,0,5,499
8,9,8032,1310,3,90,112,16,10,2,230,0,7,237
8,9,8032,1311,3,186,125,26,30,4,371,0,5,376
8,9,8032,1312,3,229,278,32,22,4,565,0,15,580
8,9,8032,1313,3,207,150,35,25,0,417,0,6,423
8,9,8032,1314,3,118,129,21,19,1,288,0,1,289
8,9,8032,1315,3,181,173,33,16,0,403,0,3,406
8,9,8032,1316,3,106,122,29,12,2,271,0,6,277
8,9,8032,1317,3,225,114,31,6,4,380,1,11,392
8,9,8032,1318,3,294,263,61,32,5,655,0,18,673
8,9,8032,1319,3,240,194,49,43,6,532,1,7,540
8,9,8032,1320,3,116,51,36,13,0,216,1,2,219
8,9,8032,1321,3,151,100,24,16,2,293,0,5,298
8,9,8032,1322,3,216,134,37,31,1,419,2,6,427
8,9,8032,1323,3,174,207,30,3,24,438,2,6,446
8,9,8032,1324,3,174,116,35,24,5,354,0,5,359
8,9,8032,1325,3,176,172,48,23,3,422,0,0,422
8,9,8032,1326,3,106,160,47,48,3,364,0,11,375
8,9,8032,1327,3,225,199,43,32,6,505,0,5,510
8,9,8032,1328,3,325,191,57,34,5,612,0,5,617
8,9,8032,1329,3,162,127,32,19,3,343,0,9,352
8,9,8032,1330,3,160,99,30,14,3,306,0,5,311
8,9,8032,1331,3,228,163,40,24,5,460,4,6,470
8,9,8032,1332,3,188,137,59,15,3,402,1,7,410
8,9,8032,1333,3,283,183,54,40,8,568,3,10,581
8,9,8032,1334,3,305,287,69,35,2,698,1,9,708
8,9,8032,1335,3,145,137,36,23,2,343,0,4,347
8,9,8032,1336,3,303,286,58,47,5,699,1,8,708
8,9,8032,1337,3,336,281,58,42,7,724,0,15,739
8,9,8032,1338,3,248,173,52,34,14,521,0,8,529
8,9,8032,1339,3,247,170,43,27,5,492,0,11,503
8,9,8032,1340,3,299,312,75,51,11,748,1,10,759
8,9,8032,1341,3,241,235,51,42,6,575,0,3,578
8,9,8032,1342,3,290,208,38,21,2,559,0,13,572
8,9,8032,1343,3,186,161,39,39,6,431,3,12,446
8,9,8032,1344,3,152,74,21,10,2,259,1,3,263
8,9,8032,1345,3,429,403,89,49,6,976,2,17,995
8,9,8032,1346,3,255,214,34,11,4,518,1,15,534
8,9,8032,1347,3,203,89,22,12,3,329,1,2,332
8,9,8032,1348,3,240,105,47,21,7,420,2,17,439
8,9,8032,1349,3,12,14,4,0,0,30,0,1,31
8,9,8032,1350,3,15,23,6,1,0,45,0,1,46
8,9,8032,1351,3,17,27,4,1,0,49,0,0,49
8,9,8032,1352,3,6,12,4,1,0,23,0,0,23
8,9,8032,1353,3,94,130,30,10,0,264,0,9,273
8,9,8032,1354,3,69,96,9,5,1,180,0,2,182
8,9,8033,1355,3,101,160,2,1,0,264,0,9,273
8,9,8033,1356,3,89,130,4,1,0,224,0,8,232
8,9,8041,2261,3,95,159,10,6,0,270,0,6,276
8,9,8041,2262,3,26,64,4,1,0,95,0,2,97
8,9,8041,2263,3,45,35,2,2,0,84,0,1,85
8,9,8041,2264,3,12,55,4,4,0,75,0,4,79
8,9,8041,2265,3,14,70,1,8,1,94,0,14,108
8,9,8044,2278,3,191,243,37,35,9,515,0,13,528
8,9,8044,2279,3,116,138,35,17,1,307,1,4,312
8,9,8044,2280,3,115,76,3,4,0,198,0,5,203
8,9,8044,2281,3,105,41,5,4,0,155,0,5,160
8,9,8044,2282,3,70,44,4,2,0,120,0,1,121
8,9,8044,2283,3,35,49,1,0,0,85,0,3,88
8,9,8044,2284,3,5,31,3,1,0,40,2,3,45
8,9,8044,2285,3,14,18,4,1,0,37,0,0,37
8,9,8044,2286,3,44,47,73,9,0,173,0,0,173
8,9,8044,2287,3,60,34,12,1,0,107,0,3,110
8,9,8046,2323,3,130,197,8,5,0,340,0,23,363
8,9,8046,2324,3,20,55,11,0,0,86,0,1,87
8,9,8046,2325,3,63,128,2,2,4,199,0,0,199
8,9,8046,2326,3,8,6,0,0,0,14,0,2,16
8,9,8046,2327,3,32,58,1,4,1,96,0,0,96
8,9,8046,2328,3,43,62,11,2,0,118,0,10,128
8,9,8046,2329,3,92,199,26,0,2,319,0,11,330
8,9,8046,2330,3,47,49,6,4,2,108,0,2,110
8,9,8049,2390,3,221,263,12,11,1,508,0,10,518
8,9,8049,2391,3,22,33,0,3,1,59,0,3,62
8,9,8049,2392,3,47,72,6,3,0,128,0,5,133
8,9,8049,2393,3,65,153,18,9,2,247,0,6,253
8,9,8049,2395,3,79,126,2,0,1,208,0,2,210
8,9,8056,2545,3,59,117,44,3,5,228,0,4,232
8,9,8056,2546,3,58,91,25,6,0,180,1,6,187
8,9,8056,2547,3,26,35,18,1,2,82,0,1,83
8,9,8056,2548,3,42,92,25,5,1,165,1,3,169
8,9,8057,2549,3,194,101,13,1,1,310,0,10,320
8,9,8057,2550,3,147,107,29,12,0,295,0,9,304
8,9,8057,2551,3,11,13,4,1,0,29,0,0,29
8,9,8057,2552,3,37,25,1,0,0,63,0,0,63
8,9,8057,2553,3,11,17,4,1,1,34,0,3,37
8,9,8057,2554,3,49,67,14,3,0,133,0,3,136
8,9,8057,2555,3,52,19,4,1,0,76,0,4,80
8,9,8057,2556,3,5,20,6,1,1,33,0,0,33
8,9,8057,2557,3,57,56,7,2,1,123,0,8,131
8,9,8057,2558,3,40,59,12,1,1,113,1,1,115
8,9,8059,2566,3,132,148,48,36,7,371,0,0,371
8,9,8059,2567,3,111,93,32,21,2,259,2,5,266
8,9,8059,2568,3,49,65,11,25,7,157,0,3,160
8,9,8059,2569,3,82,88,25,31,2,228,0,9,237
8,9,8059,2570,3,56,60,15,15,1,147,0,4,151
8,9,8059,2571,3,57,76,10,14,1,158,0,1,159
8,9,8059,2572,3,60,85,40,18,4,207,0,10,217
8,9,8059,2573,3,87,99,31,36,5,258,0,7,265
8,9,8059,2574,3,86,89,26,20,4,225,1,3,229
8,9,8059,2575,3,55,66,12,4,1,138,0,2,140
8,9,8059,2576,3,15,46,5,2,3,71,0,1,72
8,9,8059,2577,3,19,18,6,2,0,45,0,1,46
8,9,8060,2578,3,77,94,19,8,2,200,2,7,209
8,9,8060,2579,3,90,61,16,6,6,179,0,7,186
8,9,8060,2580,3,66,58,15,18,1,158,0,1,159
8,9,8060,2581,3,77,99,15,18,7,216,0,1,217
8,9,8060,2582,3,92,63,24,14,3,196,1,5,202
8,9,8060,2583,3,110,123,29,24,5,291,1,5,297
8,9,8060,2584,3,109,91,23,21,5,249,0,8,257
8,9,8060,2585,3,104,127,24,30,9,294,1,10,305
8,9,8060,2586,3,85,111,22,42,0,260,0,9,269
8,9,8060,2587,3,133,92,34,20,6,285,1,6,292
8,9,8060,2588,3,131,121,36,25,6,319,0,4,323
8,9,8060,2589,3,60,59,18,27,0,164,0,3,167
8,9,8060,2590,3,103,146,40,12,2,303,0,10,313
8,9,8060,2591,3,133,188,50,24,5,400,1,14,415
8,9,8060,2592,3,69,46,29,9,1,154,0,8,162
8,9,8060,2593,3,88,69,18,12,4,191,0,4,195
8,9,8060,2594,3,37,60,3,6,1,107,1,3,111
8,9,8060,2595,3,166,136,17,13,1,333,0,13,346
8,9,8060,2596,3,20,16,3,1,0,40,0,1,41
8,9,8060,2597,3,26,20,1,1,3,51,0,1,52
8,9,8060,2598,3,14,14,7,2,0,37,0,2,39
8,9,8060,2599,3,41,25,6,0,1,73,0,1,74
8,9,8061,2601,3,60,87,13,10,1,171,1,6,178
8,9,8061,2602,3,121,102,3,7,0,233,0,6,239
8,9,8061,2603,3,32,25,5,6,1,69,0,3,72
8,9,8061,2604,3,62,67,9,0,0,138,0,1,139
8,9,8061,2605,3,41,25,4,2,0,72,0,3,75
8,9,8061,2606,3,100,90,10,7,0,207,0,11,218
8,9,8061,2607,3,92,22,4,4,2,124,0,0,124
8,9,8061,2608,3,154,75,8,10,2,249,0,4,253
8,9,8061,2609,3,58,43,3,3,0,107,0,5,112
8,9,8061,2610,3,11,16,1,2,0,30,0,1,31
8,9,8061,2611,3,52,47,16,1,0,116,1,4,121
8,9,8061,2612,3,24,53,7,2,0,86,0,5,91
8,9,8061,2613,3,54,123,7,2,0,186,0,8,194
8,9,8061,2614,3,42,42,1,2,0,87,0,1,88
8,9,8064,2661,3,111,93,8,0,0,212,0,6,218
8,9,8064,2662,3,33,81,5,0,2,121,0,5,126
8,9,8064,2663,3,57,111,1,2,0,171,0,3,174
8,9,8064,2664,3,13,31,1,0,0,45,0,0,45
8,9,8064,2665,3,31,52,4,2,0,89,0,4,93
8,9,8064,2666,3,16,19,3,2,0,40,0,0,40
8,9,8064,2667,3,10,38,2,1,0,51,0,2,53
8,9,8065,2668,3,198,256,13,30,2,499,0,17,516
8,9,8065,2669,3,20,32,8,1,1,62,3,0,65
8,9,8065,2670,3,71,48,29,8,1,157,0,10,167
8,9,8065,2671,3,192,281,59,138,12,682,0,47,729
8,9,8065,2672,3,48,44,18,7,1,118,0,10,128
8,9,8065,2673,3,112,262,44,29,5,452,2,35,489
8,9,8065,2674,3,53,75,11,1,0,140,1,8,149
8,9,8065,2675,3,8,58,21,4,0,91,0,0,91
8,9,8065,2676,3,143,198,28,18,1,388,0,16,404
8,9,8065,2677,3,19,52,12,2,0,85,0,9,94
8,9,8065,2678,3,24,20,5,0,0,49,0,5,54
8,9,8065,2679,3,85,218,24,6,3,336,0,13,349
8,9,8065,2680,3,2,23,4,0,0,29,0,0,29
8,9,8065,2681,3,11,189,9,0,0,209,0,0,209
8,9,8065,2682,3,117,121,18,6,2,264,1,29,294
8,9,8065,2683,3,18,38,13,1,2,72,0,2,74
8,9,8066,2684,3,104,139,49,40,1,333,0,15,348
8,9,8066,2685,3,127,207,56,8,5,403,0,32,435
8,9,8066,2686,3,59,29,6,1,1,96,0,2,98
8,9,8066,2687,3,29,72,9,2,1,113,0,5,118
8,9,8066,2689,3,42,58,16,1,1,118,0,2,120
8,9,8066,2690,3,17,47,96,3,1,164,0,14,178
8,9,8066,2691,3,46,58,17,3,0,124,0,8,132
8,9,8066,2692,3,106,217,54,12,0,389,0,0,389
8,9,8066,2693,3,12,22,34,6,0,74,0,6,80
8,9,8066,2694,3,9,28,13,4,0,54,0,2,56
8,9,8066,2695,3,51,45,27,0,0,123,0,8,131
8,9,8066,2696,3,11,9,2,0,0,22,0,0,22
8,9,8067,2697,3,143,181,31,20,1,376,0,15,391
8,9,8067,2698,3,136,146,23,27,3,335,0,8,343
8,9,8067,2699,3,30,65,13,2,0,110,0,8,118
8,9,8067,2700,3,10,41,11,3,0,65,0,1,66
8,9,8067,2701,3,17,115,7,2,0,141,0,4,145
8,9,8067,2702,3,53,61,15,5,1,135,0,4,139
8,9,8067,2703,3,7,52,1,2,0,62,0,4,66
8,9,8067,2704,3,17,43,6,4,0,70,0,3,73
8,9,8067,2705,3,12,43,1,2,0,58,0,5,63
8,9,8067,2706,3,100,88,11,10,3,212,0,6,218
8,9,8067,2707,3,28,99,1,4,1,133,0,2,135
8,9,8067,2708,3,5,41,1,2,0,49,0,0,49
8,9,8067,2709,3,28,68,5,11,1,113,0,4,117
8,9,8067,2710,3,33,71,6,5,0,115,0,9,124
9,1,9005,821,3,98,105,794,32,41,1070,1,33,1104
9,1,9005,822,3,84,87,693,40,19,923,4,13,940
9,1,9005,823,3,103,65,782,41,24,1015,15,10,1040
9,1,9005,824,3,136,97,934,42,37,1246,1,36,1283
9,1,9005,825,3,95,57,567,15,18,752,1,16,769
9,1,9005,826,3,93,63,570,27,21,774,3,24,801
9,1,9005,827,3,153,103,1110,59,41,1466,5,38,1509
9,1,9005,828,3,95,85,607,42,38,867,4,11,882
9,1,9005,829,3,112,60,498,31,23,724,6,24,754
9,1,9005,830,3,106,68,654,33,34,895,1,18,914
9,1,9005,831,3,108,57,735,40,30,970,3,21,994
9,1,9005,832,3,111,38,545,30,33,757,0,17,774
9,1,9005,833,3,180,113,1018,53,30,1394,5,16,1415
9,1,9005,834,3,119,56,532,35,40,782,2,23,807
9,1,9005,835,3,156,72,635,51,41,955,4,27,986
9,1,9005,836,3,109,59,483,39,26,716,3,8,727
9,1,9005,837,3,126,60,585,37,19,827,3,17,847
9,1,9005,838,3,92,74,514,36,41,757,0,27,784
9,1,9005,839,3,140,72,637,30,24,903,1,21,925
9,1,9005,840,3,109,65,600,40,31,845,0,26,871
9,1,9005,841,3,128,108,814,41,27,1118,3,15,1136
9,1,9005,842,3,149,65,879,37,33,1163,0,43,1206
9,1,9005,843,3,174,66,625,30,25,920,0,16,936
9,1,9005,844,3,161,82,627,48,35,953,0,25,978
9,1,9005,845,3,141,67,436,41,22,707,1,17,725
9,1,9005,846,3,120,49,611,39,20,839,0,12,851
9,1,9005,847,3,37,34,382,18,20,491,2,12,505
9,1,9005,848,3,120,95,637,32,22,906,3,14,923
9,1,9005,849,3,117,66,700,51,17,951,2,22,975
9,1,9005,850,3,184,60,707,44,21,1016,3,16,1035
9,1,9005,851,3,131,60,539,35,31,796,1,13,810
9,1,9005,852,3,286,194,1661,106,65,2312,7,29,2348
9,1,9005,853,3,138,58,514,28,41,779,0,23,802
9,1,9005,854,3,206,126,660,41,43,1076,1,19,1096
9,1,9005,855,3,182,92,491,35,41,841,0,17,858
9,1,9005,856,3,179,95,637,52,29,992,1,12,1005
9,1,9005,857,3,178,96,643,37,25,979,1,10,990
9,1,9005,858,3,110,52,503,40,20,725,1,19,745
9,1,9005,859,3,125,124,848,57,43,1197,3,44,1244
9,1,9005,860,3,165,78,766,56,41,1106,0,30,1136
9,1,9005,861,3,143,74,580,50,25,872,4,3,879
9,1,9005,862,3,80,39,221,18,15,373,0,0,373
9,1,9005,863,3,108,65,593,39,32,837,3,10,850
9,1,9005,864,3,112,35,571,37,29,784,1,20,805
9,1,9005,865,3,270,360,1725,117,78,2550,4,57,2611
9,1,9005,866,3,157,62,567,40,34,860,3,13,876
9,1,9005,867,3,120,43,480,29,36,708,5,19,732
9,1,9005,868,3,115,84,435,25,21,680,2,21,703
9,1,9005,869,3,126,72,509,26,25,758,2,12,772
9,1,9005,870,3,112,61,564,32,27,796,0,12,808
9,1,9005,871,3,127,73,658,42,15,915,1,29,945
9,1,9005,872,3,139,74,587,65,29,894,2,23,919
9,1,9005,873,3,148,93,572,39,38,890,2,19,911
9,1,9005,874,3,163,69,492,52,30,806,3,17,826
9,1,9005,875,3,143,81,780,34,45,1083,1,36,1120
9,1,9005,876,3,97,204,884,66,41,1292,4,46,1342
9,1,9005,877,3,138,144,848,45,35,1210,3,26,1239
9,1,9005,878,3,102,103,592,24,27,848,1,13,862
9,1,9005,879,3,100,75,545,28,21,769,3,12,784
9,1,9005,880,3,69,42,514,30,21,676,0,17,693
9,1,9005,881,3,110,72,739,48,38,1007,14,15,1036
9,1,9005,882,3,110,93,664,23,22,912,3,5,920
9,1,9005,883,3,140,110,747,44,31,1072,1,15,1088
9,1,9005,884,3,182,64,601,45,24,916,0,16,932
9,1,9005,885,3,118,75,532,34,25,784,0,11,795
9,1,9005,886,3,109,49,508,26,18,710,0,28,738
9,1,9005,887,3,139,97,595,32,35,898,1,20,919
9,1,9005,888,3,159,83,726,60,29,1057,2,24,1083
9,1,9005,889,3,143,98,517,31,29,818,1,23,842
9,1,9005,890,3,177,79,621,52,40,969,0,16,985
9,1,9005,891,3,121,64,608,62,30,885,1,17,903
9,1,9005,892,3,156,77,501,32,29,795,5,19,819
9,1,9005,893,3,108,74,686,36,22,926,4,14,944
9,1,9005,894,3,103,81,652,34,26,896,1,31,928
9,1,9005,895,3,106,83,801,44,42,1076,5,36,1117
9,1,9005,896,3,110,67,794,43,34,1048,2,25,1075
9,1,9005,897,3,113,83,496,36,27,755,0,16,771
9,1,9005,898,3,133,60,545,31,28,797,2,20,819
9,1,9005,899,3,167,88,449,38,13,755,20,13,788
9,1,9005,900,3,169,59,593,29,31,881,0,28,909
9,1,9005,901,3,134,56,556,44,27,817,1,23,841
9,1,9005,902,3,118,69,507,42,34,770,2,17,789
9,1,9005,903,3,103,89,514,46,28,780,4,14,798
9,1,9005,904,3,152,78,579,42,27,878,0,19,897
9,1,9005,905,3,185,107,781,55,44,1172,5,23,1200
9,1,9005,906,3,143,101,642,30,34,950,0,9,959
9,1,9005,907,3,119,56,511,27,24,737,5,10,752
9,1,9005,908,3,102,70,636,36,30,874,1,11,886
9,1,9005,909,3,85,59,834,45,35,1058,0,24,1082
9,1,9005,910,3,161,139,810,55,34,1199,2,28,1229
9,1,9005,911,3,96,63,518,32,18,727,4,20,751
9,1,9005,912,3,71,71,591,38,22,793,1,15,809
9,1,9005,913,3,218,74,668,45,32,1037,1,21,1059
9,1,9005,914,3,137,61,622,53,29,902,0,15,917
9,1,9005,915,3,165,58,650,43,27,943,1,10,954
9,1,9005,916,3,156,68,596,62,27,909,0,28,937
9,1,9005,917,3,159,76,588,105,32,960,0,22,982
9,1,9005,918,3,234,135,722,56,39,1186,1,11,1198
9,1,9005,919,3,227,59,512,45,30,873,0,16,889
9,1,9005,920,3,206,34,527,140,38,945,3,8,956
9,1,9005,921,3,154,58,448,66,20,746,1,13,760
9,1,9005,922,3,137,56,543,58,26,820,1,5,826
9,1,9005,923,3,112,80,647,47,32,918,2,19,939
9,1,9005,924,3,91,71,548,23,20,753,2,16,771
9,1,9005,925,3,80,49,389,17,15,550,4,15,569
9,1,9005,926,3,140,48,482,12,20,702,6,5,713
9,1,9005,927,3,144,73,701,41,24,983,4,16,1003
9,1,9005,928,3,258,175,956,60,61,1510,3,18,1531
9,1,9005,929,3,189,69,500,38,47,843,0,21,864
9,1,9005,930,3,140,50,417,32,25,664,2,14,680
9,1,9005,931,3,164,81,263,297,47,852,19,0,871
9,1,9005,932,3,139,77,450,51,25,742,2,14,758
9,1,9005,933,3,217,105,753,92,46,1213,20,13,1246
9,1,9005,934,3,110,53,325,42,17,547,1,6,554
9,1,9005,935,3,151,85,459,46,24,765,0,12,777
9,1,9005,936,3,149,67,413,27,25,681,5,12,698
9,1,9005,937,3,160,90,557,34,33,874,3,22,899
9,1,9005,938,3,103,253,260,19,19,654,2,12,668
9,1,9005,939,3,113,73,598,19,27,830,1,31,862
9,1,9005,940,3,68,52,508,16,21,665,1,13,679
9,1,9005,941,3,96,57,534,30,26,743,0,21,764
9,1,9005,942,3,119,46,320,22,20,527,0,8,535
9,1,9005,943,3,139,91,563,42,24,859,2,14,875
9,1,9005,944,3,168,67,492,37,28,792,0,6,798
9,1,9005,945,3,199,79,386,33,35,732,0,5,737
9,1,9005,946,3,231,113,418,37,39,838,0,11,849
9,1,9005,947,3,261,79,483,59,35,917,0,13,930
9,1,9005,948,3,181,60,421,41,40,743,1,7,751
9,1,9005,949,3,247,87,462,40,45,881,0,21,902
9,1,9005,950,3,229,75,383,39,29,755,1,2,758
9,1,9005,951,3,190,80,414,49,44,777,8,11,796
9,1,9005,952,3,100,63,301,25,25,514,1,5,520
9,1,9005,953,3,251,81,673,40,41,1086,2,17,1105
9,1,9005,954,3,305,127,705,58,42,1237,1,11,1249
9,1,9005,955,3,197,84,591,47,31,950,2,13,965
9,1,9005,956,3,80,56,467,23,17,643,1,13,657
9,1,9005,957,3,56,29,363,22,8,478,0,12,490
9,1,9005,958,3,276,96,383,40,36,831,0,12,843
9,1,9005,959,3,265,107,327,38,38,775,1,9,785
9,1,9005,960,3,207,33,289,29,16,574,2,5,581
9,1,9005,961,3,229,91,268,36,31,655,0,10,665
9,1,9005,962,3,217,67,254,25,19,582,2,7,591
9,1,9005,963,3,188,57,215,27,24,511,3,6,520
9,1,9005,964,3,237,69,274,46,27,653,1,8,662
9,1,9005,965,3,191,52,240,26,16,525,0,6,531
9,1,9005,966,3,142,61,644,31,21,899,4,15,918
9,1,9005,967,3,123,59,580,24,23,809,2,25,836
9,1,9005,968,3,95,50,511,33,23,712,2,20,734
9,1,9005,969,3,89,78,478,28,26,699,2,15,716
9,1,9005,970,3,115,78,544,51,42,830,0,18,848
9,1,9005,971,3,121,59,595,52,37,864,3,12,879
9,1,9005,972,3,98,70,537,37,28,770,2,9,781
9,1,9005,973,3,55,60,322,17,23,477,0,9,486
9,1,9005,979,3,183,57,225,25,31,521,0,8,529
9,1,9005,983,3,202,69,218,29,26,544,1,9,554
9,1,9005,984,3,205,66,266,28,28,593,2,4,599
9,1,9005,1075,3,141,53,189,27,23,433,0,7,440
9,1,9005,1076,3,212,55,251,23,16,557,1,7,565
9,1,9005,1077,3,67,76,495,40,24,702,1,13,716
9,2,9005,974,3,183,66,402,33,26,710,2,10,722
9,2,9005,975,3,190,74,503,44,21,832,10,12,854
9,2,9005,976,3,167,91,399,36,28,721,3,11,735
9,2,9005,977,3,446,92,240,38,24,840,0,3,843
9,2,9005,978,3,239,61,173,27,23,523,0,7,530
9,2,9005,980,3,345,107,252,30,24,758,2,8,768
9,2,9005,981,3,259,78,234,32,27,630,2,1,633
9,2,9005,982,3,402,115,274,32,27,850,1,19,870
9,2,9005,985,3,247,66,180,28,23,544,0,5,549
9,2,9005,986,3,142,63,320,29,27,581,4,10,595
9,2,9005,987,3,209,70,405,58,25,767,5,15,787
9,2,9005,988,3,128,39,250,37,19,473,3,10,486
9,2,9005,989,3,130,62,307,28,24,551,3,10,564
9,2,9005,990,3,192,59,270,43,25,589,0,12,601
9,2,9005,991,3,224,87,350,34,41,736,2,7,745
9,2,9005,992,3,112,57,212,33,14,428,0,9,437
9,2,9005,993,3,169,58,229,18,18,492,2,8,502
9,2,9005,994,3,153,84,367,48,24,676,3,10,689
9,2,9005,995,3,127,76,410,33,29,675,1,7,683
9,2,9005,996,3,168,97,445,39,23,772,2,21,795
9,2,9005,997,3,72,23,187,23,15,320,1,2,323
9,2,9005,998,3,190,97,563,45,47,942,0,10,952
9,2,9005,999,3,212,92,457,61,33,855,1,17,873
9,2,9005,1000,3,143,76,431,39,18,707,0,18,725
9,2,9005,1001,3,194,95,454,49,28,820,2,13,835
9,2,9005,1002,3,349,168,908,95,73,1593,1,39,1633
9,2,9005,1003,3,156,74,399,42,30,701,0,11,712
9,2,9005,1004,3,195,74,422,43,28,762,0,7,769
9,2,9005,1005,3,116,71,304,24,14,529,0,11,540
9,2,9005,1006,3,183,72,456,47,19,777,0,10,787
9,2,9005,1007,3,143,44,186,27,12,412,0,5,417
9,2,9005,1008,3,130,89,362,49,38,668,1,10,679
9,2,9005,1009,3,184,85,433,45,26,773,2,9,784
9,2,9005,1010,3,129,72,326,37,24,588,1,3,592
9,2,9005,1011,3,125,58,262,26,11,482,2,8,492
9,2,9005,1012,3,115,37,185,30,7,374,1,3,378
9,2,9005,1013,3,170,54,376,39,29,668,0,10,678
9,2,9005,1014,3,263,121,441,74,41,940,0,12,952
9,2,9005,1015,3,238,90,395,55,38,816,1,19,836
9,2,9005,1016,3,246,106,472,63,33,920,2,2,924
9,2,9005,1017,3,185,118,308,35,14,660,3,7,670
9,2,9005,1018,3,118,43,200,27,22,410,0,11,421
9,2,9005,1019,3,132,81,342,46,23,624,1,9,634
9,2,9005,1020,3,138,71,331,40,27,607,1,8,616
9,2,9005,1021,3,131,48,327,34,22,562,0,7,569
9,2,9005,1022,3,160,55,409,27,21,672,1,12,685
9,2,9005,1023,3,175,57,316,42,29,619,9,16,644
9,2,9005,1024,3,151,53,331,33,21,589,0,10,599
9,2,9005,1025,3,214,59,297,41,27,638,1,11,650
9,2,9005,1026,3,206,79,487,48,20,840,0,20,860
9,2,9005,1027,3,201,70,488,47,33,839,0,9,848
9,2,9005,1028,3,335,297,832,115,68,1647,3,21,1671
9,2,9005,1029,3,252,169,478,62,32,993,0,7,1000
9,2,9005,1030,3,212,111,298,37,38,696,1,6,703
9,2,9005,1031,3,214,146,290,37,26,713,0,10,723
9,2,9005,1032,3,172,102,264,33,34,605,0,12,617
9,2,9005,1033,3,448,95,217,39,25,824,0,9,833
9,2,9005,1034,3,420,110,195,27,21,773,1,4,778
9,2,9005,1035,3,90,29,94,7,10,230,0,2,232
9,2,9005,1036,3,257,95,217,39,27,635,2,11,648
9,2,9005,1037,3,174,58,175,23,17,447,1,3,451
9,2,9005,1038,3,228,96,444,45,40,853,8,16,877
9,2,9005,1039,3,295,106,437,54,42,934,2,12,948
9,2,9005,1040,3,290,55,317,54,26,742,1,11,754
9,2,9005,1041,3,258,114,696,78,37,1183,2,23,1208
9,2,9005,1042,3,212,79,374,28,29,722,2,4,728
9,2,9005,1043,3,197,69,305,30,20,621,2,7,630
9,2,9005,1044,3,174,73,309,35,26,617,2,4,623
9,2,9005,1045,3,168,75,542,64,29,878,0,20,898
9,2,9005,1046,3,188,74,258,36,25,581,0,3,584
9,2,9005,1047,3,205,78,439,28,28,778,2,5,785
9,2,9005,1048,3,250,67,257,40,29,643,0,2,645
9,2,9005,1049,3,255,75,269,21,20,640,1,3,644
9,2,9005,1050,3,254,100,274,35,22,685,3,13,701
9,2,9005,1051,3,499,142,257,34,35,967,2,7,976
9,2,9005,1052,3,488,76,152,21,17,754,0,5,759
9,2,9005,1053,3,227,118,200,24,21,590,0,12,602
9,2,9005,1054,3,204,152,266,27,18,667,0,1,668
9,2,9005,1055,3,277,102,232,32,19,662,1,5,668
9,2,9005,1056,3,157,114,547,41,32,891,3,22,916
9,2,9005,1057,3,106,100,305,28,19,558,2,9,569
9,2,9005,1058,3,202,74,268,35,35,614,1,6,621
9,2,9005,1059,3,457,101,172,23,23,776,3,4,783
9,2,9005,1060,3,354,112,224,42,28,760,1,10,771
9,2,9005,1061,3,402,101,260,41,30,834,5,14,853
9,2,9005,1062,3,437,104,315,34,36,926,0,5,931
9,2,9005,1063,3,359,79,374,37,32,881,2,10,893
9,2,9005,1064,3,258,113,430,38,30,869,3,11,883
9,2,9005,1065,3,224,93,287,41,30,675,4,10,689
9,2,9005,1066,3,344,81,172,27,16,640,0,8,648
9,2,9005,1067,3,235,99,308,31,23,696,0,15,711
9,2,9005,1068,3,372,135,221,41,33,802,1,10,813
9,2,9005,1069,3,307,78,231,33,34,683,2,12,697
9,2,9005,1070,3,126,78,283,25,14,526,1,7,534
9,2,9005,1071,3,159,40,233,24,19,475,1,6,482
9,2,9005,1072,3,78,15,138,14,8,253,0,0,253
9,2,9005,1073,3,64,45,263,30,8,410,1,7,418
9,2,9005,1074,3,157,64,421,57,21,720,1,17,738
9,2,9005,1078,3,128,52,246,29,16,471,2,10,483
9,2,9005,1079,3,251,86,290,37,25,689,0,12,701
9,2,9005,1080,3,268,72,235,31,25,631,0,12,643
9,2,9005,1081,3,206,76,171,27,21,501,3,7,511
9,2,9005,1082,3,255,50,230,21,18,574,5,12,591
9,2,9005,1083,3,224,74,279,35,32,644,0,18,662
9,2,9005,1084,3,225,79,286,44,30,664,0,18,682
9,2,9005,1085,3,295,72,240,39,27,673,1,17,691
9,2,9005,1086,3,268,71,291,42,35,707,0,16,723
9,2,9005,1087,3,256,91,214,42,43,646,0,214,860
9,2,9005,1088,3,255,79,190,28,32,584,1,4,589
9,2,9005,1089,3,225,78,207,34,21,565,2,7,574
9,2,9005,1090,3,286,81,259,45,26,697,3,5,705
9,2,9005,1091,3,391,111,275,52,48,877,1,12,890
9,2,9005,1092,3,350,107,237,48,38,780,1,9,790
9,2,9005,1093,3,327,122,241,34,22,746,0,10,756
9,2,9005,1094,3,251,94,303,34,32,714,0,10,724
9,2,9005,1095,3,316,99,222,32,18,687,2,9,698
9,2,9005,1096,3,339,67,180,21,18,625,0,7,632
9,2,9005,1097,3,322,94,249,23,31,719,2,10,731
9,2,9005,1098,3,348,95,273,44,28,788,2,7,797
9,2,9005,1099,3,307,90,258,44,32,731,2,12,745
9,2,9005,1100,3,317,115,227,40,34,733,2,11,746
9,2,9005,1101,3,278,72,209,46,26,631,2,6,639
9,2,9005,1102,3,264,70,217,34,32,617,1,7,625
9,2,9005,1103,3,297,108,233,42,24,704,2,10,716
9,2,9005,1104,3,250,63,196,27,17,553,0,4,557
9,2,9005,1105,3,263,92,251,32,33,671,0,9,680
9,2,9005,1106,3,342,92,310,43,45,832,0,16,848
9,2,9005,1107,3,258,80,211,37,21,607,2,5,614
9,2,9005,1108,3,289,79,236,26,19,649,0,8,657
9,2,9005,1109,3,297,85,232,35,38,687,0,11,698
9,2,9005,1110,3,244,84,213,24,19,584,3,5,592
9,2,9005,1111,3,200,63,170,29,23,485,4,10,499
9,2,9005,1112,3,303,72,281,31,22,709,0,11,720
9,2,9005,1113,3,239,59,207,36,27,568,1,7,576
9,2,9005,1114,3,330,68,257,29,30,714,0,8,722
9,2,9005,1115,3,262,71,171,31,25,560,1,6,567
9,2,9005,1116,3,144,64,189,25,25,447,5,4,456
9,2,9005,1117,3,265,84,199,48,21,617,0,13,630
9,2,9005,1118,3,294,87,310,47,37,775,1,10,786
9,2,9005,1119,3,311,95,225,34,20,685,0,13,698
9,2,9005,1120,3,240,99,264,38,17,658,2,8,668
9,2,9005,1121,3,256,69,214,37,20,596,2,8,606
9,2,9005,1122,3,219,78,208,39,26,570,0,9,579
9,2,9005,1123,3,188,80,83,22,24,397,0,13,410
9,2,9005,1124,3,236,83,170,35,11,535,0,13,548
9,2,9005,1125,3,170,61,202,27,20,480,0,8,488
9,2,9005,1126,3,208,68,307,34,26,643,1,6,650
9,2,9005,1127,3,291,77,193,27,20,608,0,9,617
9,2,9005,1128,3,245,69,287,33,20,654,1,9,664
9,2,9005,1129,3,244,72,178,38,17,549,1,8,558
9,2,9005,1130,3,194,73,181,29,15,492,0,7,499
9,2,9005,1131,3,330,101,221,46,32,730,1,5,736
9,2,9005,1132,3,163,77,247,31,22,540,3,9,552
9,2,9005,1133,3,135,71,308,39,19,572,3,13,588
9,2,9005,1134,3,179,55,221,25,212,692,2,11,705
9,2,9005,1135,3,235,81,285,51,23,675,0,9,684
9,2,9005,1136,3,221,109,465,46,30,871,0,23,894
9,2,9005,1137,3,186,121,410,60,30,807,4,28,839
9,2,9005,1138,3,143,70,296,39,21,569,1,9,579
9,2,9005,1139,3,120,65,182,31,18,416,0,6,422
9,2,9005,1140,3,153,67,273,40,25,558,4,6,568
9,2,9005,1141,3,235,112,406,59,35,847,0,18,865
9,2,9005,1142,3,227,111,325,55,46,764,0,13,777
9,2,9005,1143,3,216,111,322,54,37,740,2,15,757
9,2,9005,1144,3,183,84,351,43,26,687,0,19,706
9,2,9005,1145,3,204,126,746,78,46,1200,10,7,1217
9,2,9005,1146,3,111,55,315,48,15,544,0,7,551
9,2,9005,1147,3,95,58,324,32,23,532,1,0,533
9,2,9005,1214,3,407,133,590,94,49,1273,2,27,1302
9,2,9005,1215,3,204,60,352,45,25,686,1,18,705
9,2,9005,1216,3,202,97,506,51,34,890,2,19,911
9,2,9005,1217,3,259,115,593,68,49,1084,4,20,1108
9,2,9005,1218,3,242,131,539,69,29,1010,4,13,1027
9,2,9005,1248,3,224,78,467,53,36,858,3,9,870
9,2,9005,1249,3,215,36,369,36,30,686,2,11,699
9,2,9005,1250,3,155,82,400,28,30,695,12,16,723
9,2,9005,1251,3,325,81,162,38,23,629,1,9,639
9,2,9005,1252,3,287,102,293,50,18,750,1,9,760
9,2,9005,1253,3,295,107,416,51,33,902,2,19,923
9,2,9005,1254,3,225,53,130,19,14,441,0,8,449
9,2,9005,1255,3,394,65,236,28,27,750,0,7,757
9,2,9005,1256,3,234,61,216,41,27,579,1,8,588
9,2,9005,1257,3,252,58,240,44,15,609,2,14,625
9,2,9005,1258,3,472,77,137,23,17,726,1,4,731
9,2,9005,1259,3,351,71,141,18,23,604,1,4,609
9,2,9005,1260,3,376,73,203,34,16,702,4,10,716
9,2,9005,1261,3,328,75,156,18,26,603,2,5,610
9,2,9005,1262,3,165,65,315,34,20,599,0,7,606
9,2,9005,1263,3,417,103,153,32,30,735,0,7,742
9,2,9005,1264,3,142,73,325,33,23,596,7,9,612
9,2,9005,1265,3,216,89,447,21,37,810,2,7,819
9,2,9005,1266,3,229,118,522,41,34,944,2,10,956
9,2,9005,1267,3,263,119,502,40,40,964,2,16,982
9,2,9005,1268,3,185,79,439,46,31,780,1,13,794
9,2,9005,1287,3,113,133,391,50,27,714,0,22,736
9,2,9005,1288,3,221,63,303,27,23,637,5,11,653
9,2,9005,1289,3,683,122,236,46,30,1117,1,15,1133
9,2,9005,1290,3,447,77,132,29,17,702,0,12,714
9,2,9005,1291,3,340,61,110,23,21,555,1,9,565
9,2,9005,1292,3,649,124,192,43,23,1031,0,15,1046
9,2,9005,1293,3,652,131,212,47,44,1086,1,16,1103
9,2,9005,1294,3,148,77,290,41,30,586,1,5,592
9,2,9005,1295,3,578,109,234,42,24,987,1,9,997
9,2,9005,1296,3,56,72,321,33,14,496,2,8,506
9,2,9005,1297,3,316,51,93,20,16,496,2,6,504
9,2,9005,1298,3,386,88,212,43,19,748,1,4,753
9,2,9005,1299,3,408,151,319,50,28,956,2,19,977
9,2,9005,1300,3,332,105,234,20,14,705,1,17,723
9,2,9005,1301,3,327,101,249,43,24,744,5,12,761
9,2,9005,1303,3,138,44,200,14,19,415,1,11,427
9,2,9005,1304,3,152,58,193,21,16,440,1,6,447
9,2,9005,1323,3,171,74,342,33,33,653,1,8,662
9,2,9005,1324,3,159,63,335,40,28,625,4,11,640
9,2,9005,1325,3,461,67,88,32,19,667,1,6,674
9,2,9005,1326,3,361,86,176,30,8,661,0,9,670
9,2,9005,1451,3,367,112,391,52,37,959,1,4,964
9,2,9005,1452,3,171,45,237,30,24,507,0,8,515
9,2,9005,1453,3,202,70,216,32,26,546,0,8,554
9,2,9005,1454,3,185,76,269,34,30,594,2,6,602
9,2,9005,1455,3,194,63,280,32,37,606,2,10,618
9,2,9005,1456,3,242,83,275,37,34,671,1,6,678
9,2,9005,1457,3,210,57,247,39,28,581,0,4,585
9,2,9005,1458,3,340,102,372,36,34,884,0,10,894
9,2,9005,1459,3,210,75,268,33,29,615,1,11,627
9,2,9005,1460,3,230,81,271,43,34,659,1,1,661
9,2,9005,1461,3,165,62,198,18,26,469,0,9,478
9,2,9005,1462,3,268,55,229,40,23,615,2,10,627
9,2,9005,1463,3,370,110,448,36,36,1000,2,15,1017
9,2,9005,1464,3,369,75,372,51,29,896,0,8,904
9,2,9005,1465,3,472,113,227,39,20,871,0,9,880
9,2,9005,1466,3,336,158,251,35,27,807,1,19,827
9,2,9005,1467,3,340,105,213,23,15,696,0,7,703
9,2,9005,1468,3,260,71,317,39,38,725,0,16,741
9,2,9005,1469,3,220,108,468,45,44,885,2,12,899
9,2,9005,1470,3,371,137,221,41,26,796,0,7,803
9,2,9005,1471,3,220,106,568,62,16,972,0,26,998
9,2,9005,1472,3,217,120,447,41,33,858,0,16,874
9,2,9005,1473,3,214,131,386,40,35,806,0,15,821
9,2,9005,1474,3,197,98,417,49,47,808,4,20,832
9,2,9005,1475,3,154,138,416,43,35,786,3,23,812
9,2,9005,1476,3,205,79,364,37,29,714,2,11,727
9,2,9005,1477,3,209,94,482,48,28,861,3,13,877
9,2,9005,1478,3,170,71,306,36,18,601,0,15,616
9,2,9005,1479,3,168,76,360,37,17,658,2,8,668
9,2,9005,1480,3,79,36,197,17,12,341,0,9,350
9,2,9005,1481,3,178,91,438,35,30,772,5,25,802
9,2,9005,1482,3,163,75,401,48,22,709,7,11,727
9,2,9005,1483,3,140,83,506,63,28,820,0,15,835
9,2,9005,1484,3,222,118,497,59,25,921,3,21,945
9,2,9005,1485,3,224,88,429,50,27,818,0,12,830
9,2,9005,1486,3,196,79,261,37,28,601,1,3,605
9,2,9005,1487,3,266,86,378,39,35,804,0,10,814
9,2,9005,1488,3,122,53,204,33,22,434,0,0,434
9,2,9005,1489,3,178,68,254,39,20,559,0,8,567
9,2,9005,1490,3,233,82,350,40,27,732,1,14,747
9,2,9005,1491,3,245,97,471,44,40,897,1,22,920
9,2,9005,1492,3,157,83,369,52,26,687,1,17,705
9,2,9005,1493,3,169,76,335,34,19,633,1,12,646
9,2,9005,1494,3,179,89,337,47,21,673,2,12,687
9,2,9005,1495,3,136,42,129,27,20,354,1,3,358
9,3,9002,56,3,329,183,862,74,70,1518,1,31,1550
9,3,9002,57,3,153,86,449,40,29,757,1,16,774
9,3,9002,58,3,227,104,575,63,38,1007,0,16,1023
9,3,9002,59,3,191,87,475,41,29,823,0,13,836
9,3,9002,60,3,202,94,446,31,20,793,5,19,817
9,3,9002,61,3,172,82,473,38,35,800,3,13,816
9,3,9002,62,3,258,91,439,25,34,847,4,16,867
9,3,9002,63,3,182,47,334,33,22,618,2,14,634
9,3,9002,64,3,215,92,543,59,34,943,3,15,961
9,3,9002,65,3,220,101,535,41,31,928,3,21,952
9,3,9002,66,3,181,88,484,42,33,828,4,14,846
9,3,9002,67,3,235,113,576,59,46,1029,5,15,1049
9,3,9002,68,3,203,88,544,47,25,907,2,13,922
9,3,9002,69,3,189,83,501,56,25,854,1,15,870
9,3,9002,70,3,399,175,609,69,47,1299,6,25,1330
9,3,9002,71,3,302,109,446,41,41,939,3,11,953
9,3,9002,72,3,302,105,535,47,35,1024,1,15,1040
9,3,9002,73,3,203,63,543,56,24,889,2,16,907
9,3,9002,74,3,208,86,435,42,33,804,0,19,823
9,3,9002,75,3,260,82,425,43,35,845,0,12,857
9,3,9002,76,3,194,161,562,62,41,1020,4,14,1038
9,3,9002,77,3,201,106,568,45,33,953,4,11,968
9,3,9002,78,3,212,84,349,43,22,710,0,9,719
9,3,9002,79,3,619,292,1036,134,86,2167,5,34,2206
9,3,9002,80,3,148,68,406,38,22,682,3,12,697
9,3,9002,81,3,173,79,300,33,22,607,4,9,620
9,3,9002,83,3,165,85,282,37,19,588,1,11,600
9,3,9002,84,3,306,124,474,120,39,1063,1,13,1077
9,3,9002,85,3,229,108,304,39,40,720,7,9,736
9,3,9002,86,3,279,140,406,51,42,918,0,19,937
9,3,9002,87,3,264,126,422,59,35,906,1,12,919
9,3,9002,88,3,266,94,513,36,40,949,0,11,960
9,3,9002,89,3,103,85,297,34,22,541,0,8,549
9,3,9002,90,3,368,132,409,44,41,994,6,18,1018
9,3,9002,91,3,299,90,379,31,43,842,6,10,858
9,3,9002,92,3,227,126,377,44,40,814,6,6,826
9,3,9002,93,3,159,100,324,30,32,645,1,7,653
9,3,9002,94,3,180,74,383,46,29,712,0,9,721
9,3,9002,95,3,282,123,438,44,33,920,1,15,936
9,3,9002,96,3,361,106,443,48,27,985,10,18,1013
9,3,9002,99,3,261,63,321,35,24,704,0,15,719
9,3,9002,100,3,429,122,368,45,27,991,4,11,1006
9,3,9002,101,3,347,113,468,42,31,1001,0,13,1014
9,3,9002,102,3,264,119,434,41,32,890,4,8,902
9,3,9002,103,3,215,119,438,54,49,875,2,16,893
9,3,9002,104,3,224,102,399,52,29,806,3,12,821
9,3,9002,105,3,291,140,334,38,24,827,3,9,839
9,3,9002,106,3,236,76,290,25,23,650,0,12,662
9,3,9002,107,3,360,145,335,50,28,918,1,7,926
9,3,9002,108,3,201,118,396,44,24,783,5,15,803
9,3,9002,109,3,280,164,703,52,66,1265,5,17,1287
9,3,9002,110,3,230,94,302,28,18,672,2,14,688
9,3,9002,122,3,200,83,374,36,29,722,2,8,732
9,3,9002,123,3,344,126,240,35,23,768,2,10,780
9,3,9002,124,3,392,86,254,33,35,800,0,14,814
9,3,9002,125,3,380,187,604,73,71,1315,1,30,1346
9,3,9002,126,3,381,128,314,41,37,901,0,17,918
9,3,9002,127,3,224,114,377,30,31,776,0,13,789
9,3,9002,128,3,334,127,362,63,34,920,2,11,933
9,3,9002,129,3,417,141,428,49,50,1085,0,20,1105
9,3,9002,130,3,31,57,152,15,10,265,0,5,270
9,3,9002,131,3,250,102,295,35,22,704,0,3,707
9,3,9002,132,3,333,130,275,34,28,800,0,19,819
9,3,9002,133,3,387,137,332,40,37,933,2,10,945
9,3,9002,134,3,283,76,209,38,17,623,0,9,632
9,3,9002,135,3,223,64,142,17,2,448,0,0,448
9,3,9002,136,3,278,90,242,37,40,687,1,10,698
9,3,9002,137,3,249,87,224,22,24,606,0,2,608
9,3,9002,138,3,290,72,189,20,16,587,1,4,592
9,3,9002,139,3,252,72,196,18,28,566,4,10,580
9,3,9002,140,3,180,78,171,33,11,473,1,2,476
9,3,9002,141,3,186,55,189,22,18,470,0,4,474
9,3,9002,142,3,208,93,313,37,27,678,4,2,684
9,3,9002,143,3,224,66,191,36,19,536,2,9,547
9,3,9002,144,3,271,86,244,27,21,649,3,8,660
9,3,9002,145,3,292,83,287,45,30,737,1,9,747
9,3,9002,146,3,207,101,272,31,23,634,0,14,648
9,3,9002,147,3,219,88,281,34,18,640,4,12,656
9,3,9002,148,3,173,118,384,41,31,747,1,17,765
9,3,9002,149,3,62,56,164,24,8,314,1,9,324
9,3,9002,150,3,141,46,161,17,14,379,0,5,384
9,3,9002,151,3,146,46,114,31,11,348,1,0,349
9,3,9002,152,3,169,60,216,25,20,490,1,2,493
9,3,9002,153,3,126,28,220,21,17,412,0,12,424
9,3,9002,154,3,232,92,368,44,34,770,0,16,786
9,3,9002,155,3,181,124,417,63,29,814,5,10,829
9,3,9002,156,3,251,79,455,35,43,863,1,7,871
9,3,9002,157,3,130,59,232,35,24,480,1,7,488
9,3,9002,158,3,112,81,198,23,17,431,0,7,438
9,3,9002,159,3,243,115,410,41,31,840,4,12,856
9,3,9002,160,3,221,114,368,45,27,775,4,7,786
9,3,9002,161,3,188,93,467,37,29,814,6,20,840
9,3,9002,162,3,230,134,433,47,37,881,3,15,899
9,3,9002,163,3,186,119,373,39,28,745,2,7,754
9,3,9002,164,3,222,75,526,39,26,888,3,12,903
9,3,9002,165,3,439,118,504,49,44,1154,0,15,1169
9,3,9002,166,3,355,132,599,38,51,1175,8,7,1190
9,3,9002,167,3,170,113,402,45,27,757,1,15,773
9,3,9002,168,3,337,118,557,55,53,1120,2,12,1134
9,3,9002,169,3,325,120,482,67,29,1023,3,9,1035
9,3,9002,170,3,312,129,471,54,40,1006,0,19,1025
9,3,9002,171,3,282,148,579,49,71,1129,0,11,1140
9,3,9002,172,3,214,96,370,51,54,785,1,19,805
9,3,9002,173,3,183,63,326,45,31,648,3,12,663
9,3,9002,174,3,165,73,348,59,31,676,1,10,687
9,3,9002,175,3,290,167,375,49,29,910,0,0,910
9,3,9002,176,3,302,118,445,49,47,961,1,15,977
9,3,9002,177,3,326,107,468,51,39,991,0,0,991
9,3,9002,178,3,139,52,171,23,23,408,0,11,419
9,3,9002,179,3,326,118,416,41,34,935,1,18,954
9,3,9002,180,3,181,126,359,28,18,712,1,12,725
9,3,9002,181,3,250,49,160,23,22,504,0,2,506
9,3,9002,182,3,253,58,195,23,12,541,0,6,547
9,3,9002,183,3,461,98,400,33,30,1022,0,18,1040
9,3,9002,184,3,195,98,287,27,24,631,0,8,639
9,3,9002,185,3,187,135,295,23,22,662,0,12,674
9,3,9002,186,3,177,98,499,35,27,836,1,15,852
9,3,9002,187,3,120,91,909,60,22,1202,2,16,1220
9,3,9002,188,3,225,73,476,41,39,854,2,13,869
9,3,9002,189,3,265,146,482,49,25,967,1,17,985
9,3,9002,190,3,199,92,361,48,29,729,0,15,744
9,3,9002,191,3,251,124,434,40,17,866,0,12,878
9,3,9002,192,3,148,59,153,15,14,389,0,5,394
9,3,9002,193,3,564,129,437,57,47,1234,5,11,1250
9,3,9002,194,3,397,174,520,64,51,1206,2,28,1236
9,3,9002,195,3,215,103,422,40,44,824,1,15,840
9,3,9002,196,3,229,108,368,49,36,790,3,8,801
9,3,9002,197,3,216,82,315,32,24,669,0,7,676
9,3,9002,198,3,411,123,434,44,39,1051,0,16,1067
9,3,9002,199,3,194,72,393,33,19,711,1,10,722
9,3,9002,200,3,229,123,519,60,28,959,2,15,976
9,3,9002,201,3,193,73,332,32,25,655,0,8,663
9,3,9002,202,3,238,86,476,41,29,870,1,16,887
9,3,9002,203,3,243,126,507,50,34,960,0,19,979
9,3,9002,204,3,260,147,461,58,38,964,0,14,978
9,3,9002,205,3,277,147,581,72,43,1120,0,26,1146
9,3,9002,206,3,301,136,430,42,35,944,0,15,959
9,3,9002,207,3,256,116,522,62,43,999,0,22,1021
9,3,9002,208,3,360,187,908,69,73,1597,2,27,1626
9,3,9002,209,3,196,104,334,46,25,705,0,19,724
9,3,9002,210,3,211,109,307,35,26,688,0,9,697
9,3,9002,211,3,181,104,358,46,23,712,0,17,729
9,3,9002,212,3,134,68,282,22,14,520,2,14,536
9,3,9002,213,3,326,104,397,33,23,883,0,26,909
9,3,9002,214,3,176,80,541,52,23,872,4,9,885
9,3,9002,215,3,223,75,415,34,23,770,0,12,782
9,3,9002,216,3,287,100,455,57,39,938,2,19,959
9,3,9002,217,3,181,89,478,38,55,841,0,20,861
9,3,9002,218,3,265,124,559,43,42,1033,0,22,1055
9,3,9002,219,3,331,201,861,67,37,1497,4,14,1515
9,3,9002,220,3,211,114,342,36,28,731,0,21,752
9,3,9002,221,3,168,68,337,46,32,651,0,11,662
9,3,9002,222,3,221,155,655,49,36,1116,3,13,1132
9,3,9002,223,3,141,80,194,21,13,449,0,7,456
9,3,9002,224,3,221,87,342,41,40,731,0,14,745
9,3,9002,225,3,282,157,550,69,37,1095,1,15,1111
9,3,9002,226,3,217,141,508,29,32,927,3,14,944
9,3,9002,227,3,237,95,380,45,32,789,0,5,794
9,3,9002,228,3,211,118,487,35,31,882,0,22,904
9,3,9002,229,3,196,142,563,59,33,993,4,28,1025
9,3,9002,230,3,225,153,541,44,33,996,2,23,1021
9,3,9002,231,3,192,111,477,55,32,867,0,21,888
9,3,9002,232,3,310,138,343,33,24,848,0,19,867
9,3,9002,233,3,190,81,375,34,23,703,1,6,710
9,3,9002,234,3,137,41,129,11,27,345,0,3,348
9,3,9002,235,3,150,66,210,22,12,460,0,7,467
9,3,9002,236,3,249,89,520,38,28,924,1,16,941
9,3,9002,237,3,362,147,706,68,41,1324,2,33,1359
9,3,9002,238,3,284,105,438,45,40,912,1,13,926
9,3,9002,239,3,250,138,460,31,31,910,0,14,924
9,3,9002,240,3,251,141,400,52,46,890,0,21,911
9,3,9002,241,3,282,136,562,36,39,1055,0,14,1069
9,3,9002,242,3,214,122,530,52,41,959,1,14,974
9,3,9002,243,3,64,35,168,21,12,300,0,3,303
9,3,9002,244,3,153,115,321,30,28,647,0,8,655
9,3,9002,245,3,345,106,500,25,19,995,0,16,1011
9,3,9002,246,3,432,153,566,55,40,1246,4,13,1263
9,3,9002,247,3,284,141,624,69,37,1155,0,21,1176
9,3,9002,248,3,279,79,485,43,27,913,1,15,929
9,3,9002,249,3,141,84,262,35,11,533,0,8,541
9,3,9002,250,3,173,68,408,36,20,705,1,17,723
9,3,9002,251,3,187,66,364,34,16,667,1,10,678
9,3,9002,252,3,175,87,439,45,24,770,1,10,781
9,3,9002,253,3,150,104,434,30,31,749,2,11,762
9,3,9002,254,3,364,129,501,56,38,1088,0,10,1098
9,3,9002,255,3,258,95,454,47,34,888,0,6,894
9,3,9002,256,3,177,95,641,37,24,974,1,13,988
9,3,9002,257,3,236,162,640,73,33,1144,0,33,1177
9,3,9002,258,3,177,138,620,51,43,1029,0,16,1045
9,3,9002,259,3,212,100,462,44,34,852,4,22,878
9,3,9002,260,3,162,74,438,55,29,758,2,22,782
9,3,9002,261,3,245,136,508,57,29,975,0,20,995
9,3,9002,262,3,180,68,432,44,29,753,1,9,763
9,3,9002,263,3,217,141,491,55,38,942,0,19,961
9,3,9002,264,3,193,135,519,65,39,951,1,10,962
9,3,9002,265,3,189,119,409,51,36,804,1,8,813
9,3,9002,266,3,248,131,496,61,24,960,1,14,975
9,3,9002,267,3,176,94,340,40,24,674,0,8,682
9,3,9002,268,3,166,87,385,50,17,705,5,11,721
9,3,9002,269,3,257,101,467,51,32,908,0,17,925
9,3,9002,270,3,174,79,466,40,19,778,2,14,794
9,3,9002,271,3,141,61,449,46,32,729,5,12,746
9,3,9002,272,3,192,75,454,38,23,782,2,24,808
9,3,9002,273,3,209,89,598,68,41,1005,1,11,1017
9,3,9002,274,3,164,75,445,26,31,741,0,17,758
9,3,9002,275,3,184,103,447,38,26,798,1,22,821
9,3,9002,276,3,118,65,400,38,17,638,1,11,650
9,3,9002,277,3,145,57,380,25,28,635,1,10,646
9,3,9002,278,3,104,60,353,25,14,556,0,20,576
9,3,9002,279,3,143,60,382,32,15,632,0,10,642
9,3,9002,280,3,125,63,255,24,19,486,3,7,496
9,3,9002,281,3,173,75,363,47,10,668,4,21,693
9,3,9002,282,3,202,93,584,54,24,957,5,14,976
9,3,9002,283,3,201,94,505,54,24,878,1,22,901
9,3,9002,284,3,155,74,511,53,27,820,3,18,841
9,3,9002,285,3,150,106,579,54,29,918,0,22,940
9,3,9002,286,3,120,74,322,33,22,571,1,14,586
9,3,9002,287,3,274,72,570,47,22,985,3,16,1004
9,3,9002,288,3,169,73,366,52,27,687,2,3,692
9,3,9002,289,3,143,60,152,19,17,391,0,6,397
9,3,9002,290,3,201,131,379,33,24,768,0,5,773
9,3,9002,291,3,79,31,215,15,6,346,0,7,353
9,3,9002,292,3,84,54,188,17,7,350,0,8,358
9,3,9002,293,3,197,137,316,43,18,711,2,15,728
9,3,9002,294,3,146,42,175,31,9,403,1,9,413
9,3,9002,295,3,102,44,194,19,17,376,1,5,382
9,3,9002,296,3,122,32,220,21,20,415,1,5,421
9,3,9002,297,3,153,67,249,17,21,507,1,6,514
9,3,9002,298,3,121,44,213,26,15,419,0,8,427
9,3,9002,299,3,153,84,269,32,12,550,1,6,557
9,3,9002,300,3,249,160,93,30,24,556,0,2,558
9,3,9002,301,3,119,57,280,10,15,481,2,13,496
9,3,9002,302,3,90,45,109,21,8,273,0,7,280
9,3,9002,303,3,109,45,178,19,19,370,0,8,378
9,3,9002,304,3,163,76,338,28,29,634,0,9,643
9,3,9002,305,3,186,74,250,31,30,571,0,5,576
9,3,9002,306,3,124,47,172,20,15,378,0,5,383
9,3,9002,307,3,108,20,164,0,13,305,2,4,311
9,3,9002,5512,3,176,59,200,31,17,483,0,3,486
9,3,9002,5513,3,123,61,156,28,24,392,1,9,402
9,3,9002,5514,3,135,41,207,20,23,426,0,9,435
9,4,9007,2341,3,280,106,446,49,37,918,4,10,932
9,4,9007,2342,3,174,64,232,21,22,513,0,7,520
9,4,9007,2343,3,238,72,343,39,29,721,4,8,733
9,4,9007,2344,3,223,67,383,40,29,742,1,15,758
9,4,9007,2345,3,265,64,335,35,40,739,0,9,748
9,4,9007,2346,3,314,83,348,50,34,829,1,5,835
9,4,9007,2347,3,250,94,350,32,38,764,0,12,776
9,4,9007,2348,3,216,111,478,61,28,894,0,24,918
9,4,9007,2349,3,173,71,412,35,29,720,1,11,732
9,4,9007,2350,3,209,96,804,68,39,1216,8,30,1254
9,4,9007,2351,3,274,100,657,75,46,1152,3,15,1170
9,4,9007,2352,3,136,100,539,53,41,869,1,14,884
9,4,9007,2353,3,279,87,398,33,30,827,2,12,841
9,4,9007,2354,3,289,101,402,43,27,862,1,14,877
9,4,9007,2355,3,232,87,480,53,32,884,1,15,900
9,4,9007,2356,3,273,77,410,36,24,820,0,17,837
9,4,9007,2357,3,204,74,435,32,22,767,0,14,781
9,4,9007,2358,3,165,97,467,42,30,801,1,21,823
9,4,9007,2359,3,180,77,451,33,21,762,0,21,783
9,4,9007,2360,3,181,96,508,35,16,836,0,14,850
9,4,9007,2361,3,159,73,434,45,23,734,3,10,747
9,4,9007,2362,3,145,74,478,36,32,765,4,18,787
9,4,9007,2363,3,251,130,668,59,40,1148,5,18,1171
9,4,9007,2364,3,92,58,573,36,25,784,2,10,796
9,4,9007,2365,3,143,75,705,43,23,989,2,15,1006
9,4,9007,2366,3,132,71,537,34,33,807,5,23,835
9,4,9007,2367,3,155,70,567,28,24,844,1,14,859
9,4,9007,2368,3,118,63,479,29,25,714,0,15,729
9,4,9007,2369,3,117,52,228,32,20,449,0,20,469
9,4,9007,2370,3,130,76,621,43,27,897,0,6,903
9,4,9007,2371,3,99,37,284,36,16,472,0,14,486
9,4,9007,2372,3,65,42,468,36,19,630,2,21,653
9,4,9007,2373,3,160,90,447,38,42,777,0,19,796
9,4,9007,2374,3,156,45,282,37,19,539,0,12,551
9,4,9007,2375,3,52,55,233,34,19,393,0,15,408
9,4,9007,2376,3,51,82,358,22,19,532,4,13,549
9,4,9007,2377,3,58,62,312,25,18,475,0,10,485
9,4,9007,2378,3,75,52,351,44,22,544,1,13,558
9,4,9007,2379,3,158,88,501,42,15,804,6,13,823
9,4,9007,2380,3,150,81,453,31,27,742,0,14,756
9,4,9007,2381,3,285,142,1089,101,57,1674,1,33,1708
9,4,9007,2382,3,152,88,374,57,32,703,0,22,725
9,4,9007,2383,3,22,18,119,28,7,194,3,0,197
9,4,9007,2384,3,151,83,398,24,26,682,3,13,698
9,4,9007,2385,3,169,123,863,65,59,1279,1,28,1308
9,4,9007,2510,3,110,99,395,150,44,798,3,14,815
9,4,9007,2511,3,369,114,549,64,48,1144,3,28,1175
9,4,9007,2512,3,212,105,541,35,38,931,2,24,957
9,4,9007,2513,3,259,99,464,60,42,924,3,14,941
9,4,9007,2514,3,284,141,806,74,59,1364,0,20,1384
9,4,9007,2515,3,203,61,342,44,29,679,2,11,692
9,4,9007,2516,3,220,123,508,67,41,959,3,33,995
9,4,9007,2517,3,109,62,197,19,23,410,0,9,419
9,4,9007,2518,3,153,86,445,34,39,757,1,13,771
9,4,9007,2519,3,257,94,519,64,46,980,4,10,994
9,4,9007,2520,3,172,48,338,20,22,600,3,4,607
9,4,9007,2521,3,176,63,438,38,32,747,0,11,758
9,4,9007,2522,3,161,75,346,26,33,641,1,15,657
9,4,9007,2523,3,239,97,358,44,43,781,1,17,799
9,4,9007,2524,3,120,50,532,48,27,777,4,25,806
9,4,9007,2525,3,95,57,321,33,19,525,1,7,533
9,4,9007,2526,3,141,92,493,46,28,800,2,16,818
9,4,9007,2527,3,81,44,282,26,29,462,2,3,467
9,4,9007,2528,3,106,63,492,36,24,721,3,8,732
9,4,9007,2529,3,145,73,418,46,32,714,2,11,727
9,4,9007,2530,3,198,122,558,45,20,943,2,22,967
9,4,9007,2531,3,199,94,495,36,32,856,1,24,881
9,4,9007,2532,3,104,47,395,33,24,603,2,14,619
9,4,9007,2533,3,198,64,519,34,32,847,1,17,865
9,4,9007,2534,3,113,61,474,28,28,704,2,14,720
9,4,9007,2535,3,181,101,474,47,41,844,4,15,863
9,4,9007,2536,3,363,161,863,86,68,1541,3,45,1589
9,4,9007,2537,3,157,72,493,37,36,795,1,26,822
9,4,9007,2538,3,149,67,433,51,35,735,0,11,746
9,4,9007,2539,3,238,153,684,66,41,1182,6,20,1208
9,4,9007,2540,3,238,135,817,88,54,1332,3,27,1362
9,4,9007,2541,3,185,50,562,55,33,885,5,19,909
9,4,9007,2542,3,84,41,314,25,22,486,0,12,498
9,4,9007,2543,3,101,60,381,33,27,602,1,8,611
9,4,9007,2544,3,155,119,599,70,53,996,6,41,1043
9,4,9007,2545,3,138,81,453,38,28,738,0,25,763
9,4,9007,2546,3,72,52,203,17,14,358,0,9,367
9,4,9007,2547,3,140,81,458,39,41,759,4,9,772
9,4,9007,2548,3,200,123,577,45,44,989,2,15,1006
9,4,9007,2549,3,186,93,494,48,34,855,4,19,878
9,4,9007,2550,3,123,41,353,36,28,581,2,11,594
9,4,9007,2551,3,105,51,449,29,23,657,1,19,677
9,4,9007,2552,3,156,75,485,34,22,772,0,15,787
9,4,9007,2553,3,136,93,441,35,17,722,0,19,741
9,4,9007,2627,3,109,72,480,37,22,720,3,19,742
9,4,9007,2628,3,151,80,470,40,38,779,0,19,798
9,4,9007,2629,3,201,95,732,68,49,1145,5,19,1169
9,4,9007,2630,3,181,63,612,29,27,912,7,19,938
9,4,9007,2631,3,149,64,532,41,25,811,5,8,824
9,4,9007,2632,3,159,82,547,47,36,871,2,21,894
9,4,9007,2633,3,147,80,557,42,38,864,0,22,886
9,4,9007,2634,3,78,69,332,35,19,533,0,12,545
9,4,9007,2635,3,115,59,489,29,27,719,5,7,731
9,4,9007,2636,3,142,89,476,39,33,779,6,24,809
9,4,9007,2637,3,129,94,570,54,28,875,0,14,889
9,4,9007,2638,3,114,74,434,56,31,709,0,21,730
9,4,9007,2639,3,125,107,312,43,28,615,0,19,634
9,4,9007,2640,3,199,112,513,66,50,940,8,18,966
9,4,9007,2641,3,223,99,587,64,51,1024,4,12,1040
9,4,9007,2642,3,88,33,234,22,21,398,0,12,410
9,4,9007,2643,3,281,102,652,52,58,1145,2,18,1165
9,4,9007,2644,3,115,68,385,32,22,622,2,9,633
9,4,9007,2645,3,260,99,731,71,52,1213,1,20,1234
9,4,9007,2646,3,188,83,523,47,53,894,3,19,916
9,4,9007,2647,3,242,121,694,83,52,1192,2,26,1220
9,4,9007,2648,3,334,178,1276,103,106,1997,3,26,2026
9,4,9007,2649,3,162,74,517,48,27,828,2,17,847
9,4,9007,2650,3,156,127,932,66,34,1315,2,17,1334
9,4,9007,2651,3,4,10,47,6,2,69,0,5,74
9,4,9007,2652,3,135,98,617,49,40,939,2,18,959
9,4,9007,2653,3,142,84,450,35,23,734,0,25,759
9,4,9007,2654,3,163,94,645,56,44,1002,1,12,1015
9,4,9007,2655,3,187,104,640,42,26,999,2,17,1018
9,4,9007,2656,3,141,72,511,23,17,764,0,18,782
9,4,9007,2657,3,202,101,735,56,42,1136,1,26,1163
9,4,9007,2658,3,114,72,446,44,15,691,0,18,709
9,4,9007,2659,3,156,66,612,56,37,927,0,24,951
9,4,9007,2660,3,170,68,564,56,35,893,0,17,910
9,4,9007,2661,3,115,72,566,39,28,820,1,21,842
9,4,9007,2662,3,773,402,2398,201,185,3959,11,60,4030
9,4,9007,2663,3,209,88,452,37,38,824,3,13,840
9,4,9007,2664,3,171,57,415,45,18,706,1,10,717
9,4,9007,2665,3,322,217,1242,125,82,1988,11,54,2053
9,4,9007,2666,3,248,143,1252,111,79,1833,13,35,1881
9,4,9007,2667,3,273,108,709,88,61,1239,2,30,1271
9,4,9007,2668,3,112,191,148,27,12,490,0,0,490
9,4,9007,2669,3,135,62,509,30,32,768,1,15,784
9,4,9007,2670,3,80,63,277,42,36,498,0,7,505
9,4,9007,2671,3,149,116,478,38,33,814,3,8,825
9,4,9007,2733,3,300,262,1421,104,61,2148,6,27,2181
9,4,9007,2734,3,71,95,396,30,22,614,4,13,631
9,4,9007,2735,3,218,113,468,52,39,890,1,10,901
9,4,9007,2736,3,144,124,447,37,29,781,3,15,799
9,4,9007,2737,3,192,101,314,41,30,678,0,7,685
9,4,9007,2738,3,245,139,1052,71,64,1571,4,26,1601
9,4,9007,2739,3,95,61,323,30,14,523,2,4,529
9,4,9007,2740,3,134,23,211,28,18,414,2,8,424
9,4,9007,2741,3,177,351,358,35,43,964,5,8,977
9,4,9007,2742,3,79,53,468,29,26,655,1,12,668
9,4,9007,2743,3,142,75,653,52,38,960,2,17,979
9,4,9007,2744,3,134,88,548,44,24,838,1,23,862
9,4,9007,2745,3,128,71,459,27,28,713,0,16,729
9,4,9007,2746,3,124,76,518,32,31,781,3,16,800
9,4,9007,2747,3,130,100,873,43,26,1172,2,30,1204
9,4,9007,2748,3,132,75,858,62,36,1163,2,25,1190
9,4,9007,2749,3,103,47,622,50,26,848,1,22,871
9,4,9007,2750,3,221,94,751,59,53,1178,4,22,1204
9,4,9007,2751,3,125,64,641,57,33,920,3,24,947
9,4,9007,2752,3,344,67,245,26,35,717,1,4,722
9,4,9007,2753,3,321,69,267,29,32,718,2,13,733
9,4,9007,2754,3,450,193,1388,115,71,2217,6,26,2249
9,4,9007,2755,3,167,90,538,28,41,864,1,21,886
9,4,9007,2756,3,147,76,370,27,18,638,2,12,652
9,4,9007,2757,3,267,116,729,35,37,1184,4,18,1206
9,4,9007,2835,3,140,87,409,30,31,697,0,15,712
9,4,9007,2836,3,150,66,383,34,27,660,1,16,677
9,4,9007,2837,3,189,92,413,46,34,774,1,1,776
9,4,9007,2838,3,205,96,522,47,27,897,2,6,905
9,4,9007,2839,3,148,53,219,27,10,457,1,10,468
9,4,9007,2840,3,179,117,333,47,32,708,0,11,719
9,4,9007,2841,3,105,72,476,40,22,715,3,19,737
9,4,9007,2842,3,365,93,316,28,39,841,1,7,849
9,4,9007,2843,3,258,83,174,24,28,567,0,5,572
9,4,9007,2844,3,179,70,209,19,18,495,0,10,505
9,4,9007,2845,3,204,54,219,21,23,521,3,4,528
9,4,9007,2846,3,238,56,181,24,29,528,0,6,534
9,4,9007,2847,3,131,66,252,29,27,505,0,7,512
9,4,9007,2848,3,112,62,174,22,13,383,2,4,389
9,4,9007,2849,3,184,70,432,52,39,777,2,5,784
9,4,9007,2878,3,138,76,520,55,31,820,1,13,834
9,4,9007,2879,3,425,272,744,93,76,1610,6,12,1628
9,4,9007,2880,3,125,59,331,16,16,547,0,6,553
9,4,9007,2881,3,234,48,283,33,24,622,0,3,625
9,4,9007,2882,3,448,171,482,59,52,1212,5,12,1229
9,4,9007,2883,3,172,72,222,21,21,508,0,7,515
9,4,9007,2884,3,444,102,312,33,37,928,2,6,936
9,4,9007,2885,3,716,229,813,88,99,1945,7,14,1966
9,4,9007,2886,3,302,165,317,21,22,827,0,17,844
9,4,9007,2887,3,140,62,350,58,16,626,1,1,628
9,4,9007,2888,3,121,65,323,28,23,560,0,6,566
9,4,9007,2889,3,98,51,136,30,27,342,2,7,351
9,4,9007,2923,3,87,82,201,21,11,402,1,6,409
9,4,9007,2946,3,198,120,516,74,48,956,2,17,975
9,4,9007,2963,3,49,46,226,18,14,353,0,4,357
9,5,9012,3742,3,149,86,482,43,32,792,2,22,816
9,5,9012,3743,3,131,71,456,43,38,739,5,7,751
9,5,9012,3744,3,165,80,584,40,45,914,2,13,929
9,5,9012,3745,3,154,92,495,60,31,832,1,14,847
9,5,9012,3746,3,210,106,749,64,42,1171,0,20,1191
9,5,9012,3747,3,131,61,490,38,33,753,2,15,770
9,5,9012,3748,3,211,73,550,41,37,912,3,26,941
9,5,9012,3749,3,171,68,595,38,30,902,1,16,919
9,5,9012,3750,3,134,63,594,44,31,866,3,15,884
9,5,9012,3751,3,137,115,550,36,36,874,0,15,889
9,5,9012,3752,3,232,132,607,53,51,1075,2,13,1090
9,5,9012,3753,3,147,87,513,43,38,828,1,24,853
9,5,9012,3754,3,254,70,457,29,41,851,1,21,873
9,5,9012,3755,3,325,67,163,17,24,596,3,4,603
9,5,9012,3756,3,303,77,166,24,18,588,0,7,595
9,5,9012,3757,3,286,96,375,23,34,814,4,14,832
9,5,9012,3758,3,184,114,744,48,24,1114,7,20,1141
9,5,9012,3759,3,164,48,265,28,21,526,0,18,544
9,5,9012,3760,3,49,36,190,11,13,299,0,7,306
9,5,9012,3761,3,97,45,254,23,17,436,0,14,450
9,5,9012,3762,3,284,120,634,43,38,1119,0,19,1138
9,5,9012,3763,3,349,101,527,41,42,1060,4,15,1079
9,5,9012,3764,3,302,62,175,27,22,588,1,7,596
9,5,9012,3765,3,405,95,200,19,57,776,0,19,795
9,5,9012,3766,3,602,84,190,27,30,933,0,18,951
9,5,9012,3767,3,356,127,379,38,36,936,0,19,955
9,5,9012,3769,3,604,145,97,25,31,902,0,7,909
9,5,9012,3770,3,470,93,122,20,22,727,1,4,732
9,5,9012,3771,3,547,136,129,17,29,858,0,13,871
9,5,9012,3772,3,118,66,126,18,19,347,1,4,352
9,5,9012,3773,3,247,82,335,22,21,707,2,10,719
9,5,9012,3774,3,291,130,736,53,47,1257,3,34,1294
9,5,9012,3775,3,713,175,92,19,21,1020,0,8,1028
9,5,9012,3776,3,610,98,78,18,27,831,0,5,836
9,5,9012,3777,3,380,103,195,16,50,744,0,6,750
9,5,9012,3778,3,224,40,199,14,32,509,1,7,517
9,5,9012,3779,3,220,43,239,12,32,546,1,7,554
9,5,9012,3780,3,472,104,286,41,32,935,0,11,946
9,5,9012,3781,3,804,185,126,21,27,1163,0,6,1169
9,5,9012,3782,3,146,58,244,22,18,488,2,4,494
9,5,9012,3783,3,223,92,317,37,24,693,0,6,699
9,5,9012,3784,3,97,27,96,10,15,245,0,0,245
9,5,9012,3785,3,126,75,685,53,57,996,0,26,1022
9,5,9012,3786,3,144,76,649,55,35,959,0,4,963
9,5,9012,3787,3,151,102,697,44,26,1020,2,12,1034
9,5,9012,3788,3,178,81,674,43,31,1007,0,23,1030
9,5,9012,3789,3,252,60,93,7,24,436,0,5,441
9,5,9012,3793,3,130,80,559,44,47,860,0,13,873
9,5,9012,3807,3,303,92,319,43,25,782,0,11,793
9,5,9012,3829,3,386,140,685,61,61,1333,2,21,1356
9,5,9012,3830,3,207,87,549,49,38,930,0,6,936
9,5,9012,3831,3,145,72,419,51,29,716,1,9,726
9,5,9012,3832,3,169,85,617,37,39,947,0,14,961
9,5,9012,3833,3,200,91,459,32,33,815,1,7,823
9,5,9012,3834,3,160,85,360,33,28,666,1,14,681
9,5,9012,3835,3,198,60,517,42,49,866,1,24,891
9,5,9012,3836,3,279,59,398,35,32,803,0,17,820
9,5,9012,3837,3,144,53,193,20,19,429,1,9,439
9,5,9012,3838,3,251,93,419,39,47,849,0,18,867
9,5,9012,3839,3,181,96,457,47,39,820,0,16,836
9,5,9012,3840,3,222,100,542,50,40,954,3,20,977
9,5,9012,3841,3,137,79,549,43,35,843,0,15,858
9,5,9012,3842,3,254,101,269,27,25,676,3,8,687
9,5,9012,3843,3,382,107,416,33,58,996,0,24,1020
9,5,9012,3844,3,292,71,374,30,40,807,1,8,816
9,5,9012,3845,3,273,82,314,29,34,732,3,12,747
9,5,9012,3846,3,224,63,199,14,31,531,0,3,534
9,5,9012,3847,3,215,83,279,22,29,628,1,8,637
9,5,9012,3848,3,282,109,346,35,29,801,0,16,817
9,5,9012,3849,3,260,90,271,11,31,663,0,6,669
9,5,9012,3850,3,157,152,275,48,45,677,1,9,687
9,5,9012,3851,3,104,112,250,33,22,521,1,7,529
9,5,9012,3852,3,133,97,235,27,28,520,0,10,530
9,5,9012,3853,3,125,104,215,31,20,495,2,10,507
9,5,9012,3892,3,297,68,297,41,36,739,1,10,750
9,5,9012,3893,3,212,79,300,28,38,657,0,10,667
9,5,9012,3894,3,189,46,162,14,21,432,0,11,443
9,5,9012,3895,3,38,10,55,6,2,111,1,0,112
9,5,9012,3896,3,58,24,52,5,6,145,1,3,149
9,5,9012,3897,3,96,22,87,8,12,225,0,1,226
9,5,9012,3898,3,90,32,257,12,11,402,0,8,410
9,5,9012,3899,3,263,82,518,37,22,922,3,7,932
9,5,9012,3900,3,39,20,94,10,4,167,2,2,171
9,5,9012,3901,3,217,51,125,15,19,427,1,4,432
9,5,9012,3902,3,62,19,197,11,21,310,0,3,313
9,5,9012,3903,3,148,58,476,44,32,758,2,20,780
9,5,9012,3904,3,173,86,664,42,40,1005,5,13,1023
9,5,9012,3905,3,289,74,272,20,34,689,0,6,695
9,5,9012,3909,3,184,56,450,31,30,751,3,21,775
9,5,9012,3910,3,193,72,627,33,35,960,3,22,985
9,5,9012,3911,3,265,99,570,49,35,1018,4,28,1050
9,5,9012,3912,3,192,84,468,42,33,819,2,7,828
9,5,9012,3913,3,169,64,494,40,41,808,2,10,820
9,5,9012,3914,3,126,83,546,36,30,821,2,24,847
9,5,9012,3915,3,229,89,592,61,52,1023,4,19,1046
9,5,9012,3939,3,215,77,510,41,37,880,1,13,894
9,5,9012,3940,3,101,42,291,34,21,489,4,9,502
9,5,9012,3941,3,86,49,249,21,16,421,0,11,432
9,5,9012,3942,3,124,97,385,34,31,671,2,12,685
9,5,9012,3943,3,295,99,487,42,44,967,2,13,982
9,5,9012,3944,3,226,173,1005,63,45,1512,5,35,1552
9,5,9012,3945,3,215,153,831,52,41,1292,2,26,1320
9,5,9012,3946,3,285,120,806,44,40,1295,6,20,1321
9,5,9012,3947,3,250,115,797,56,51,1269,2,12,1283
9,5,9012,3948,3,303,146,944,90,43,1526,2,35,1563
9,5,9012,3949,3,1217,268,454,71,107,2117,3,15,2135
9,5,9012,3950,3,254,94,375,32,33,788,0,7,795
9,5,9012,3951,3,746,214,994,97,114,2165,9,26,2200
9,5,9012,3952,3,324,165,1017,65,65,1636,3,34,1673
9,5,9012,3956,3,107,169,241,28,14,559,3,2,564
9,5,9012,3957,3,250,108,546,46,45,995,0,15,1010
9,5,9012,3995,3,100,32,251,19,14,416,3,4,423
9,5,9012,3996,3,56,47,324,27,31,485,1,9,495
9,5,9012,3997,3,89,45,268,22,15,439,3,9,451
9,5,9012,3998,3,188,103,541,53,34,919,3,8,930
9,5,9012,3999,3,95,81,319,26,14,535,1,17,553
9,5,9012,4000,3,96,44,245,17,13,415,0,8,423
9,5,9012,4001,3,102,53,280,15,22,472,0,4,476
9,5,9012,4002,3,283,394,294,34,24,1029,0,21,1050
9,5,9012,4003,3,392,117,256,35,44,844,1,11,856
9,5,9012,4004,3,324,169,270,41,51,855,1,13,869
9,5,9012,4005,3,530,194,258,47,42,1071,1,6,1078
9,5,9012,4006,3,580,166,325,46,46,1163,1,11,1175
9,5,9012,4007,3,537,155,339,26,47,1104,0,7,1111
9,5,9012,4008,3,479,150,321,38,36,1024,2,4,1030
9,5,9012,4009,3,706,171,323,41,60,1301,5,12,1318
9,5,9012,4010,3,215,61,106,13,10,405,0,6,411
9,5,9012,4011,3,267,81,246,31,31,656,0,9,665
9,5,9012,4012,3,324,82,172,17,12,607,9,4,620
9,5,9012,4013,3,494,102,224,33,52,905,0,9,914
9,5,9012,4014,3,527,136,349,44,38,1094,4,12,1110
9,5,9012,4015,3,205,42,139,15,23,424,0,3,427
9,5,9012,4016,3,263,94,340,32,36,765,2,11,778
9,5,9012,4017,3,587,146,357,52,41,1183,0,21,1204
9,5,9012,4018,3,183,48,269,31,30,561,3,14,578
9,5,9012,4019,3,196,52,297,37,22,604,1,8,613
9,5,9012,4020,3,199,61,270,29,22,581,0,4,585
9,5,9012,4021,3,226,71,257,26,36,616,2,7,625
9,5,9012,4022,3,186,62,262,37,23,570,3,5,578
9,5,9012,4023,3,198,68,204,24,18,512,0,13,525
9,5,9012,4024,3,517,99,311,29,49,1005,2,11,1018
9,5,9012,4025,3,320,92,214,30,30,686,0,8,694
9,5,9012,4026,3,291,78,155,29,18,571,0,7,578
9,5,9012,4027,3,323,144,458,56,33,1014,0,7,1021
9,5,9012,4028,3,257,86,289,28,35,695,3,4,702
9,5,9012,4029,3,242,103,325,40,30,740,1,10,751
9,5,9012,4030,3,353,65,230,37,46,731,0,11,742
9,5,9012,4031,3,399,138,231,36,38,842,1,8,851
9,5,9012,4032,3,781,176,271,39,50,1317,2,8,1327
9,5,9012,4033,3,521,148,548,54,53,1324,1,28,1353
9,5,9012,4034,3,411,127,469,50,42,1099,0,15,1114
9,5,9012,4035,3,234,64,149,23,26,496,2,5,503
9,5,9012,4036,3,644,162,326,55,50,1237,0,8,1245
9,5,9012,4037,3,364,96,238,35,27,760,0,12,772
9,5,9012,4038,3,419,104,202,25,28,778,0,11,789
9,5,9012,4039,3,316,84,306,22,42,770,0,14,784
9,5,9012,4040,3,325,90,360,36,42,853,0,7,860
9,5,9012,4041,3,235,85,270,26,25,641,1,9,651
9,5,9012,4042,3,307,95,365,40,25,832,1,12,845
9,5,9012,4043,3,314,79,317,52,27,789,0,14,803
9,5,9012,4044,3,248,80,274,26,29,657,0,7,664
9,5,9012,4045,3,241,82,288,38,41,690,0,12,702
9,5,9012,4046,3,379,92,205,38,43,757,0,13,770
9,5,9012,4047,3,373,81,163,24,25,666,0,7,673
9,5,9012,4048,3,273,86,209,25,17,610,0,8,618
9,5,9012,4049,3,252,121,559,54,37,1023,7,16,1046
9,5,9012,4050,3,242,81,524,44,33,924,3,13,940
9,5,9012,4051,3,319,156,514,48,36,1073,5,15,1093
9,5,9012,4052,3,199,124,378,36,31,768,1,24,793
9,5,9012,4053,3,270,92,260,29,30,681,0,13,694
9,5,9012,4054,3,309,104,448,41,34,936,1,7,944
9,5,9012,4055,3,333,117,379,50,40,919,2,9,930
9,5,9012,4056,3,466,137,134,23,38,798,1,10,809
9,5,9012,4057,3,246,120,572,40,41,1019,1,16,1036
9,5,9012,4058,3,290,95,499,35,31,950,0,13,963
9,5,9012,4059,3,253,85,275,24,33,670,2,8,680
9,5,9012,4060,3,275,75,290,47,28,715,2,5,722
9,5,9012,4061,3,247,72,274,22,27,642,1,8,651
9,5,9012,4062,3,227,79,272,31,24,633,0,8,641
9,5,9012,4063,3,218,75,259,23,33,608,0,8,616
9,5,9012,4064,3,291,77,270,33,33,704,0,9,713
9,5,9012,4065,3,442,141,283,32,25,923,0,5,928
9,5,9012,4066,3,300,88,328,38,29,783,1,12,796
9,5,9012,4067,3,308,99,340,43,39,829,1,3,833
9,5,9012,4068,3,360,135,391,33,29,948,2,13,963
9,5,9012,4069,3,278,83,275,37,31,704,2,15,721
9,5,9012,4070,3,314,121,331,44,27,837,0,17,854
9,5,9012,4071,3,284,118,652,64,51,1169,4,25,1198
9,5,9012,4072,3,109,65,388,31,21,614,0,19,633
9,5,9012,4073,3,247,122,485,46,29,929,0,22,951
9,5,9012,4074,3,192,78,382,34,38,724,4,10,738
9,5,9012,4075,3,446,149,301,36,37,969,1,22,992
9,5,9012,4076,3,565,140,234,30,34,1003,0,18,1021
9,5,9012,4077,3,327,138,500,30,46,1041,6,22,1069
9,5,9012,4078,3,219,64,535,49,28,895,3,24,922
9,5,9012,4079,3,174,80,378,40,30,702,2,14,718
9,5,9012,4080,3,200,148,399,25,24,796,1,13,810
9,5,9012,4081,3,398,119,390,37,50,994,1,13,1008
9,5,9012,4082,3,298,70,176,20,28,592,3,7,602
9,5,9012,4083,3,433,123,123,20,25,724,2,5,731
9,5,9012,4084,3,514,124,106,22,24,790,1,4,795
9,5,9012,4085,3,460,145,114,25,20,764,2,14,780
9,5,9012,4086,3,435,144,469,32,48,1128,1,10,1139
9,5,9012,4087,3,333,106,484,46,37,1006,2,12,1020
9,5,9012,4088,3,171,55,193,18,21,458,1,8,467
9,5,9012,4089,3,188,143,121,22,18,492,0,6,498
9,5,9012,4090,3,288,212,412,39,49,1000,5,11,1016
9,5,9012,4091,3,307,111,557,38,40,1053,2,11,1066
9,5,9012,4092,3,551,132,191,27,35,936,9,12,957
9,5,9012,4093,3,108,40,58,8,6,220,0,0,220
9,5,9012,4094,3,165,42,121,10,13,351,2,1,354
9,5,9012,5518,3,152,117,56,8,0,333,0,3,336
9,5,9012,5519,3,83,61,24,9,7,184,1,0,185
9,6,9005,1219,3,212,80,328,21,32,673,7,11,691
9,6,9005,1220,3,184,87,376,30,22,699,0,13,712
9,6,9005,1221,3,240,116,454,29,28,867,4,18,889
9,6,9005,1222,3,264,115,427,43,44,893,5,16,914
9,6,9005,1223,3,235,107,401,29,47,819,2,10,831
9,6,9005,1224,3,200,78,324,16,37,655,0,17,672
9,6,9005,1225,3,187,111,368,41,24,731,0,11,742
9,6,9005,1226,3,271,127,439,49,46,932,4,12,948
9,6,9005,1227,3,207,116,431,43,33,830,0,17,847
9,6,9005,1228,3,238,118,413,46,25,840,0,7,847
9,6,9005,1229,3,307,159,531,53,38,1088,2,12,1102
9,6,9005,1230,3,251,138,465,52,39,945,0,16,961
9,6,9005,1231,3,174,114,549,58,33,928,0,17,945
9,6,9005,1232,3,120,96,394,46,22,678,1,9,688
9,6,9005,1233,3,154,74,468,51,22,769,0,18,787
9,6,9005,1234,3,113,90,474,44,19,740,1,34,775
9,6,9005,1235,3,104,82,478,37,22,723,6,12,741
9,6,9005,1236,3,139,79,454,52,42,766,2,15,783
9,6,9005,1237,3,179,106,559,37,28,909,3,28,940
9,6,9005,1238,3,229,97,438,45,35,844,0,15,859
9,6,9005,1239,3,142,85,409,43,40,719,0,15,734
9,6,9005,1240,3,187,95,439,37,19,777,3,20,800
9,6,9005,1241,3,186,89,365,40,31,711,2,11,724
9,6,9005,1242,3,174,100,356,39,31,700,1,5,706
9,6,9005,1243,3,159,82,455,41,31,768,2,19,789
9,6,9005,1244,3,120,79,543,63,17,822,0,20,842
9,6,9005,1245,3,97,81,380,27,12,597,0,13,610
9,6,9005,1246,3,132,120,599,62,29,942,0,25,967
9,6,9005,1247,3,99,60,355,36,24,574,0,12,586
9,6,9005,1269,3,74,61,471,22,19,647,4,11,662
9,6,9005,1270,3,122,109,529,37,19,816,0,34,850
9,6,9005,1271,3,145,100,608,32,21,906,5,16,927
9,6,9005,1272,3,135,118,509,32,26,820,5,7,832
9,6,9005,1273,3,146,132,491,34,29,832,2,19,853
9,6,9005,1274,3,136,118,564,19,33,870,4,16,890
9,6,9005,1275,3,138,177,530,34,23,902,4,23,929
9,6,9005,1276,3,103,87,444,25,20,679,0,15,694
9,6,9005,1277,3,115,126,497,39,34,811,2,29,842
9,6,9005,1278,3,118,85,433,39,25,700,1,18,719
9,6,9005,1279,3,77,60,386,27,17,567,7,8,582
9,6,9005,1280,3,108,78,346,38,19,589,3,12,604
9,6,9005,1281,3,97,107,441,29,17,691,2,11,704
9,6,9005,1282,3,107,79,461,26,25,698,5,17,720
9,6,9005,1283,3,85,76,439,33,19,652,2,27,681
9,6,9005,1284,3,109,57,387,45,23,621,1,7,629
9,6,9005,1285,3,139,81,527,57,33,837,0,11,848
9,6,9005,1286,3,102,56,339,18,14,529,1,9,539
9,6,9005,1302,3,96,53,468,32,22,671,4,17,692
9,6,9005,1305,3,291,186,563,70,30,1140,3,14,1157
9,6,9005,1306,3,149,155,435,41,24,804,0,24,828
9,6,9005,1307,3,223,135,498,64,27,947,1,14,962
9,6,9005,1308,3,181,112,502,33,31,859,5,14,878
9,6,9005,1309,3,140,101,419,39,20,719,4,15,738
9,6,9005,1310,3,189,83,416,39,22,749,3,14,766
9,6,9005,1311,3,223,143,523,40,26,955,0,17,972
9,6,9005,1312,3,166,117,435,42,24,784,2,13,799
9,6,9005,1313,3,209,157,496,43,37,942,4,19,965
9,6,9005,1314,3,174,132,413,35,39,793,3,18,814
9,6,9005,1315,3,125,154,407,34,20,740,4,12,756
9,6,9005,1316,3,223,119,487,42,35,906,0,35,941
9,6,9005,1317,3,133,91,384,34,36,678,0,12,690
9,6,9005,1318,3,146,111,391,34,25,707,3,20,730
9,6,9005,1319,3,139,88,437,43,27,734,6,14,754
9,6,9005,1320,3,104,64,339,48,22,577,0,9,586
9,6,9005,1321,3,157,86,320,22,12,597,1,6,604
9,6,9005,1322,3,158,101,423,32,30,744,3,11,758
9,6,9005,1327,3,133,76,449,48,26,732,1,13,746
9,6,9005,1328,3,86,71,381,27,20,585,0,14,599
9,6,9005,1329,3,101,66,318,29,15,529,0,9,538
9,6,9005,1330,3,116,77,499,24,17,733,0,13,746
9,6,9005,1331,3,89,73,487,47,19,715,0,14,729
9,6,9005,1332,3,159,94,426,33,26,738,1,21,760
9,6,9005,1333,3,109,82,563,29,30,813,0,18,831
9,6,9005,1334,3,132,68,476,31,23,730,0,27,757
9,6,9005,1335,3,134,79,406,37,15,671,0,18,689
9,6,9005,1336,3,176,116,620,52,40,1004,0,16,1020
9,6,9005,1337,3,167,73,446,27,20,733,1,8,742
9,6,9005,1338,3,147,96,632,43,30,948,1,14,963
9,6,9005,1339,3,144,84,368,34,25,655,0,12,667
9,6,9005,1340,3,165,82,600,43,22,912,1,5,918
9,6,9005,1341,3,152,86,445,46,30,759,2,10,771
9,6,9005,1342,3,155,86,579,24,36,880,1,14,895
9,6,9005,1343,3,122,74,532,42,32,802,2,16,820
9,6,9005,1344,3,140,81,509,30,33,793,1,19,813
9,6,9005,1345,3,144,66,487,34,26,757,4,5,766
9,6,9005,1346,3,130,91,549,36,31,837,4,14,855
9,6,9005,1347,3,99,70,385,26,28,608,0,16,624
9,6,9005,1348,3,138,75,663,39,32,947,3,21,971
9,6,9005,1349,3,94,59,359,38,27,577,1,10,588
9,6,9005,1350,3,105,87,457,29,20,698,4,16,718
9,6,9005,1351,3,113,59,476,19,23,690,3,11,704
9,6,9005,1352,3,132,68,482,39,10,731,2,12,745
9,6,9005,1353,3,96,57,462,33,21,669,0,11,680
9,6,9005,1354,3,97,61,399,19,18,594,0,16,610
9,6,9005,1355,3,157,69,474,42,15,757,1,9,767
9,6,9005,1356,3,127,56,383,26,23,615,1,14,630
9,6,9005,1357,3,135,73,390,36,32,666,1,16,683
9,6,9005,1358,3,158,75,498,34,27,792,1,7,800
9,6,9005,1359,3,149,68,414,32,19,682,0,8,690
9,6,9005,1360,3,144,112,466,37,36,795,1,10,806
9,6,9005,1361,3,187,79,597,42,38,943,4,10,957
9,6,9005,1362,3,131,80,593,34,22,860,2,14,876
9,6,9005,1363,3,107,67,464,49,22,709,3,11,723
9,6,9005,1364,3,113,76,499,41,23,752,1,16,769
9,6,9005,1378,3,114,94,438,29,20,695,1,13,709
9,6,9005,1379,3,156,81,431,44,24,736,2,16,754
9,6,9005,1380,3,150,93,433,48,31,755,2,7,764
9,6,9005,1381,3,154,82,521,36,31,824,7,12,843
9,6,9005,1382,3,147,73,319,55,17,611,1,14,626
9,6,9005,1383,3,136,106,522,47,23,834,3,8,845
9,6,9005,1384,3,191,103,506,50,34,884,3,21,908
9,6,9005,1385,3,363,206,1075,108,72,1824,5,40,1869
9,6,9005,1386,3,147,74,460,31,27,739,0,14,753
9,6,9005,1387,3,151,82,453,36,47,769,4,6,779
9,6,9005,1388,3,154,96,357,58,27,692,2,3,697
9,6,9005,1389,3,170,79,354,23,26,652,2,27,681
9,6,9005,1390,3,143,75,483,42,28,771,0,6,777
9,6,9005,1391,3,180,93,460,45,37,815,4,5,824
9,6,9005,1392,3,212,67,396,36,25,736,2,16,754
9,6,9005,1393,3,151,75,386,42,26,680,7,12,699
9,6,9005,1394,3,192,104,451,65,24,836,1,24,861
9,6,9005,1395,3,220,103,545,53,48,969,5,13,987
9,6,9005,1409,3,165,88,526,37,33,849,2,13,864
9,6,9005,1410,3,165,108,556,60,47,936,1,22,959
9,6,9005,1411,3,202,105,461,34,29,831,0,12,843
9,6,9005,1412,3,141,82,414,34,18,689,0,12,701
9,6,9005,1413,3,144,92,531,44,29,840,0,9,849
9,6,9005,1414,3,153,87,465,29,104,838,0,10,848
9,6,9005,1415,3,149,86,426,26,31,718,2,11,731
9,6,9005,1416,3,162,95,473,40,28,798,2,9,809
9,6,9005,1417,3,183,86,444,35,27,775,2,7,784
9,6,9005,1418,3,183,95,526,46,29,879,0,10,889
9,6,9005,1419,3,205,115,455,48,28,851,0,21,872
9,6,9005,1420,3,157,87,505,47,34,830,1,17,848
9,6,9005,1421,3,174,118,523,63,28,906,0,13,919
9,6,9005,1422,3,188,89,520,47,34,878,0,15,893
9,6,9005,1423,3,201,135,583,51,34,1004,3,20,1027
9,6,9005,1424,3,121,67,438,21,9,656,0,8,664
9,6,9005,1425,3,224,122,598,63,42,1049,3,11,1063
9,6,9005,1426,3,168,130,508,41,33,880,2,23,905
9,6,9005,1427,3,192,80,511,50,26,859,2,5,866
9,6,9005,1428,3,155,100,437,45,23,760,3,19,782
9,6,9005,1447,3,163,79,404,35,35,716,1,15,732
9,6,9005,1448,3,141,105,451,42,14,753,2,14,769
9,6,9005,1496,3,177,79,619,44,31,950,0,24,974
9,6,9005,1497,3,133,73,513,31,21,771,1,26,798
9,6,9005,1498,3,96,63,436,39,20,654,1,19,674
9,6,9005,1499,3,148,87,626,40,22,923,0,16,939
9,6,9005,1500,3,152,99,700,45,28,1024,4,20,1048
9,6,9005,1501,3,66,41,265,23,10,405,2,9,416
9,6,9005,1502,3,138,104,568,33,34,877,3,8,888
9,6,9005,1503,3,119,66,443,31,20,679,1,17,697
9,6,9005,1504,3,127,87,518,55,25,812,0,26,838
9,6,9005,1505,3,81,72,469,43,22,687,1,26,714
9,6,9005,1506,3,75,68,384,32,19,578,0,15,593
9,6,9005,1507,3,157,91,452,55,31,786,4,20,810
9,6,9005,1508,3,166,112,674,50,30,1032,0,22,1054
9,6,9005,1509,3,122,90,398,40,20,670,0,15,685
9,6,9005,1510,3,148,72,368,33,20,641,3,20,664
9,6,9005,1511,3,186,112,479,49,37,863,0,17,880
9,6,9005,1512,3,174,94,576,56,30,930,3,10,943
9,6,9005,1513,3,161,88,436,36,21,742,3,24,769
9,6,9005,1514,3,57,52,172,19,19,319,1,7,327
9,6,9005,1515,3,149,108,448,48,18,771,1,18,790
9,6,9005,1516,3,197,101,516,44,37,895,1,15,911
9,6,9005,1517,3,121,82,439,43,30,715,1,6,722
9,6,9005,1518,3,192,116,570,43,34,955,3,16,974
9,6,9005,1519,3,184,77,507,48,34,850,1,9,860
9,6,9005,1520,3,135,92,463,44,16,750,0,21,771
9,6,9005,1521,3,150,104,530,51,49,884,0,21,905
9,6,9005,1522,3,135,105,498,34,27,799,1,12,812
9,6,9005,1523,3,145,102,541,40,26,854,3,20,877
9,6,9005,1524,3,125,64,363,38,20,610,1,15,626
9,6,9005,1525,3,134,65,467,38,22,726,15,3,744
9,6,9005,1526,3,99,55,404,28,21,607,5,3,615
9,6,9005,1527,3,113,64,480,41,30,728,1,8,737
9,6,9005,1528,3,135,67,443,41,28,714,1,17,732
9,6,9005,1529,3,178,98,485,36,24,821,1,16,838
9,6,9005,1530,3,188,105,512,31,35,871,1,8,880
9,6,9005,1531,3,167,73,458,33,20,751,0,12,763
9,6,9005,1532,3,140,95,443,49,29,756,1,18,775
9,6,9005,1533,3,143,72,347,47,19,628,0,8,636
9,6,9005,1534,3,156,126,451,43,35,811,0,16,827
9,6,9005,1535,3,192,93,499,33,25,842,0,14,856
9,6,9005,1536,3,314,122,378,38,30,882,2,17,901
9,6,9005,1537,3,148,92,506,54,45,845,3,14,862
9,6,9005,1538,3,152,64,322,52,34,624,1,10,635
9,6,9005,1539,3,156,97,346,93,38,730,0,8,738
9,6,9005,1540,3,270,104,523,54,53,1004,1,16,1021
9,6,9005,1541,3,146,104,475,64,25,814,2,12,828
9,6,9005,1542,3,150,92,433,40,39,754,2,13,769
9,6,9005,1543,3,172,73,357,45,25,672,1,15,688
9,6,9005,1544,3,358,132,468,49,32,1039,2,14,1055
9,6,9005,1545,3,281,147,379,44,34,885,1,13,899
9,6,9005,1546,3,361,164,495,68,39,1127,2,10,1139
9,6,9005,1547,3,171,92,311,50,38,662,0,10,672
9,6,9005,1548,3,122,112,316,35,30,615,1,74,690
9,6,9005,1549,3,148,64,373,31,21,637,1,14,652
9,6,9005,1550,3,127,79,364,33,17,620,0,13,633
9,6,9005,1551,3,125,63,314,32,18,552,0,16,568
9,6,9005,1552,3,221,123,875,57,39,1315,10,24,1349
9,6,9005,1553,3,151,58,243,27,19,498,1,8,507
9,6,9005,1554,3,125,58,346,30,18,577,1,15,593
9,6,9005,1555,3,154,83,445,57,23,762,1,15,778
9,6,9005,1556,3,151,150,478,44,28,851,0,19,870
9,6,9005,1557,3,120,109,272,29,15,545,2,7,554
9,6,9005,1558,3,109,101,242,29,25,506,0,7,513
9,6,9005,1585,3,113,63,409,33,27,645,4,10,659
9,6,9005,1586,3,112,80,380,32,13,617,0,11,628
9,6,9005,1587,3,94,90,242,21,10,457,1,3,461
9,6,9005,5537,3,145,84,474,40,26,769,0,14,783
9,6,9005,5538,3,118,79,467,40,26,730,1,15,746
9,6,9005,5539,3,146,86,504,41,17,794,1,13,808
9,6,9005,5540,3,113,79,482,56,27,757,7,12,776
9,6,9005,5541,3,103,102,535,40,26,806,1,19,826
9,6,9005,5542,3,123,92,588,31,23,857,0,20,877
9,6,9005,5543,3,185,134,533,45,36,933,0,19,952
9,7,9005,1148,3,249,103,397,49,43,841,1,12,854
9,7,9005,1149,3,310,80,390,40,27,847,3,9,859
9,7,9005,1150,3,213,103,399,29,30,774,0,6,780
9,7,9005,1151,3,195,97,449,56,38,835,3,17,855
9,7,9005,1152,3,269,118,423,58,34,902,2,15,919
9,7,9005,1153,3,172,69,438,50,24,753,2,15,770
9,7,9005,1154,3,190,93,468,38,35,824,0,5,829
9,7,9005,1155,3,206,104,403,54,35,802,0,12,814
9,7,9005,1156,3,190,90,460,49,29,818,2,12,832
9,7,9005,1157,3,123,82,384,36,25,650,4,11,665
9,7,9005,1158,3,190,110,439,61,26,826,1,13,840
9,7,9005,1159,3,205,90,407,51,27,780,3,15,798
9,7,9005,1160,3,173,109,473,52,37,844,4,14,862
9,7,9005,1161,3,215,95,382,57,35,784,0,11,795
9,7,9005,1162,3,290,112,425,58,50,935,0,10,945
9,7,9005,1163,3,274,99,338,36,29,776,2,11,789
9,7,9005,1164,3,166,102,297,29,22,616,3,15,634
9,7,9005,1165,3,276,105,447,52,34,914,1,5,920
9,7,9005,1166,3,187,120,443,46,18,814,3,22,839
9,7,9005,1167,3,203,87,336,32,27,685,4,13,702
9,7,9005,1168,3,178,129,540,42,29,918,4,19,941
9,7,9005,1169,3,162,96,454,40,27,779,3,13,795
9,7,9005,1170,3,216,125,541,56,45,983,2,13,998
9,7,9005,1171,3,207,97,455,27,37,823,4,15,842
9,7,9005,1172,3,167,75,367,29,27,665,0,4,669
9,7,9005,1173,3,170,78,365,30,25,668,1,12,681
9,7,9005,1174,3,188,101,407,47,28,771,1,14,786
9,7,9005,1175,3,149,87,326,34,31,627,2,16,645
9,7,9005,1176,3,220,99,405,42,36,802,3,10,815
9,7,9005,1177,3,198,109,464,59,38,868,4,13,885
9,7,9005,1178,3,219,110,411,47,40,827,3,8,838
9,7,9005,1179,3,228,109,506,56,30,929,4,8,941
9,7,9005,1180,3,174,110,477,49,27,837,1,6,844
9,7,9005,1181,3,271,111,505,57,34,978,1,11,990
9,7,9005,1182,3,211,112,399,17,35,774,3,9,786
9,7,9005,1183,3,235,137,420,45,52,889,1,10,900
9,7,9005,1184,3,285,141,469,58,44,997,1,22,1020
9,7,9005,1185,3,253,127,436,42,50,908,0,17,925
9,7,9005,1186,3,212,102,413,61,51,839,0,13,852
9,7,9005,1187,3,175,103,390,48,32,748,5,12,765
9,7,9005,1188,3,182,92,403,40,28,745,0,22,767
9,7,9005,1189,3,175,97,435,46,27,780,3,12,795
9,7,9005,1190,3,149,112,454,31,20,766,0,16,782
9,7,9005,1191,3,140,119,408,36,24,727,3,10,740
9,7,9005,1192,3,154,68,292,31,19,564,2,13,579
9,7,9005,1193,3,119,48,255,29,27,478,1,10,489
9,7,9005,1194,3,193,100,416,44,24,777,1,9,787
9,7,9005,1195,3,219,120,460,60,42,901,2,10,913
9,7,9005,1196,3,190,118,345,26,36,715,2,15,732
9,7,9005,1197,3,173,98,348,41,30,690,5,6,701
9,7,9005,1198,3,222,163,541,43,50,1019,0,9,1028
9,7,9005,1199,3,196,103,377,44,44,764,0,17,781
9,7,9005,1200,3,182,141,354,43,34,754,5,10,769
9,7,9005,1201,3,232,131,496,58,47,964,0,14,978
9,7,9005,1202,3,217,98,447,47,26,835,0,14,849
9,7,9005,1203,3,184,87,384,40,25,720,0,16,736
9,7,9005,1204,3,185,90,435,39,40,789,0,14,803
9,7,9005,1205,3,200,91,444,35,27,797,3,11,811
9,7,9005,1206,3,131,81,332,37,24,605,2,10,617
9,7,9005,1207,3,138,96,316,34,34,618,2,8,628
9,7,9005,1208,3,146,87,459,37,29,758,4,12,774
9,7,9005,1209,3,180,88,412,45,26,751,0,14,765
9,7,9005,1210,3,256,119,503,53,45,976,3,15,994
9,7,9005,1211,3,188,70,365,45,39,707,1,11,719
9,7,9005,1212,3,233,126,431,53,48,891,1,12,904
9,7,9005,1213,3,207,132,417,63,37,856,2,6,864
9,7,9005,1365,3,175,79,515,37,38,844,1,14,859
9,7,9005,1366,3,164,101,602,40,17,924,1,10,935
9,7,9005,1367,3,133,122,592,43,28,918,3,13,934
9,7,9005,1368,3,104,89,380,26,24,623,4,9,636
9,7,9005,1369,3,142,111,556,36,38,883,5,16,904
9,7,9005,1370,3,133,89,437,27,23,709,2,20,731
9,7,9005,1371,3,210,103,650,57,55,1075,1,54,1130
9,7,9005,1372,3,114,57,453,38,25,687,1,14,702
9,7,9005,1373,3,126,83,490,39,27,765,3,15,783
9,7,9005,1374,3,118,91,505,38,27,779,2,15,796
9,7,9005,1375,3,192,88,537,44,36,897,10,14,921
9,7,9005,1376,3,119,81,554,55,51,860,0,16,876
9,7,9005,1377,3,195,102,570,60,36,963,2,14,979
9,7,9005,1396,3,106,87,458,29,25,705,0,3,708
9,7,9005,1397,3,172,107,543,40,25,887,0,17,904
9,7,9005,1398,3,166,114,491,55,23,849,4,10,863
9,7,9005,1399,3,147,88,522,33,34,824,2,10,836
9,7,9005,1400,3,89,46,518,37,21,711,1,12,724
9,7,9005,1401,3,173,92,631,50,37,983,2,17,1002
9,7,9005,1402,3,154,65,453,45,39,756,5,18,779
9,7,9005,1403,3,167,113,617,54,34,985,0,10,995
9,7,9005,1404,3,173,122,515,40,30,880,3,15,898
9,7,9005,1405,3,127,86,451,32,29,725,2,10,737
9,7,9005,1406,3,189,103,566,65,50,973,1,23,997
9,7,9005,1407,3,201,90,500,33,34,858,3,15,876
9,7,9005,1408,3,166,79,347,33,27,652,0,1,653
9,7,9005,1429,3,151,106,543,31,27,858,0,15,873
9,7,9005,1430,3,184,149,663,51,48,1095,1,13,1109
9,7,9005,1431,3,218,157,709,61,41,1186,0,17,1203
9,7,9005,1432,3,178,114,528,52,46,918,3,17,938
9,7,9005,1433,3,190,103,564,49,45,951,5,10,966
9,7,9005,1434,3,184,130,669,51,35,1069,4,15,1088
9,7,9005,1435,3,168,110,670,48,45,1041,0,13,1054
9,7,9005,1436,3,74,82,410,35,18,619,0,6,625
9,7,9005,1437,3,243,79,540,56,30,948,3,17,968
9,7,9005,1438,3,153,77,461,36,28,755,0,13,768
9,7,9005,1439,3,147,100,445,33,18,743,6,11,760
9,7,9005,1440,3,267,125,608,57,57,1114,0,13,1127
9,7,9005,1441,3,251,127,497,36,58,969,3,17,989
9,7,9005,1442,3,308,102,583,58,58,1109,4,17,1130
9,7,9005,1443,3,288,105,614,50,35,1092,1,17,1110
9,7,9005,1444,3,383,116,388,38,38,963,3,19,985
9,7,9005,1445,3,312,86,376,28,43,845,4,14,863
9,7,9005,1446,3,356,92,328,42,19,837,1,9,847
9,7,9005,1449,3,126,87,471,38,35,757,0,22,779
9,7,9005,1450,3,54,72,193,18,8,345,0,6,351
9,7,9005,1559,3,118,56,204,20,18,416,2,3,421
9,7,9005,1560,3,189,114,398,32,41,774,1,13,788
9,7,9005,1561,3,212,118,321,56,58,765,1,9,775
9,7,9005,1562,3,253,95,229,42,41,660,0,12,672
9,7,9005,1563,3,253,90,333,41,27,744,1,13,758
9,7,9005,1564,3,260,85,445,43,40,873,3,13,889
9,7,9005,1565,3,364,132,424,49,44,1013,4,12,1029
9,7,9005,1566,3,354,116,326,27,35,858,1,8,867
9,7,9005,1567,3,273,101,301,43,34,752,1,7,760
9,7,9005,1568,3,353,115,306,51,28,853,1,22,876
9,7,9005,1569,3,208,205,902,71,41,1427,2,24,1453
9,7,9005,1570,3,231,110,454,41,39,875,1,15,891
9,7,9005,1571,3,110,87,373,34,18,622,1,16,639
9,7,9005,1572,3,134,58,414,31,29,666,4,10,680
9,7,9005,1573,3,175,157,385,62,40,819,0,16,835
9,7,9005,1574,3,140,111,447,55,33,786,6,15,807
9,7,9005,1575,3,134,64,394,32,28,652,1,16,669
9,7,9005,1576,3,127,112,469,46,24,778,0,17,795
9,7,9005,1577,3,103,107,680,54,37,981,7,25,1013
9,7,9005,1578,3,252,123,658,45,45,1123,3,22,1148
9,7,9005,1579,3,157,79,544,53,33,866,4,15,885
9,7,9005,1580,3,169,86,621,60,38,974,0,22,996
9,7,9005,1581,3,147,81,678,47,39,992,1,14,1007
9,7,9005,1582,3,136,109,400,36,31,712,1,8,721
9,7,9005,1583,3,153,139,590,54,28,964,1,18,983
9,7,9005,1584,3,390,284,1099,104,74,1951,8,32,1991
9,7,9005,1588,3,101,54,377,31,28,591,2,19,612
9,7,9005,1589,3,235,131,745,41,54,1206,2,23,1231
9,7,9005,1590,3,129,51,334,24,22,560,0,9,569
9,7,9005,1591,3,307,111,624,41,37,1120,3,20,1143
9,7,9005,1592,3,355,118,560,45,41,1119,2,12,1133
9,7,9005,1593,3,294,111,406,42,24,877,0,9,886
9,7,9005,1594,3,222,191,401,30,30,874,0,12,886
9,7,9005,1595,3,210,215,409,52,30,916,3,7,926
9,7,9005,1596,3,389,128,428,50,35,1030,0,16,1046
9,7,9005,1597,3,181,107,533,50,45,916,3,15,934
9,7,9005,1598,3,277,77,465,37,37,893,3,12,908
9,7,9005,1599,3,163,123,334,36,20,676,0,8,684
9,7,9005,1600,3,181,106,401,41,24,753,0,12,765
9,7,9005,1601,3,186,94,364,34,25,703,2,16,721
9,7,9005,1602,3,276,174,594,68,38,1150,0,23,1173
9,7,9005,1603,3,147,134,401,42,30,754,2,30,786
9,7,9005,1604,3,267,152,556,64,121,1160,3,23,1186
9,7,9005,1605,3,287,126,540,39,24,1016,2,14,1032
9,7,9005,1606,3,188,155,503,46,50,942,2,24,968
9,7,9005,1607,3,308,94,342,38,41,823,2,9,834
9,7,9005,1608,3,339,150,484,47,55,1075,1,16,1092
9,7,9005,1609,3,316,132,266,53,37,804,2,12,818
9,7,9005,1610,3,215,131,568,46,35,995,10,18,1023
9,7,9005,1611,3,269,138,610,51,33,1101,1,15,1117
9,7,9005,1612,3,204,169,471,55,40,939,0,16,955
9,7,9005,1613,3,218,106,570,48,41,983,6,13,1002
9,7,9005,1614,3,272,151,592,53,46,1114,2,20,1136
9,7,9005,1615,3,239,148,612,52,39,1090,0,20,1110
9,7,9005,1616,3,181,130,386,39,42,778,2,10,790
9,7,9005,1617,3,116,91,341,38,13,599,1,12,612
9,7,9005,1618,3,282,141,496,68,52,1039,3,18,1060
9,7,9005,1619,3,188,145,522,43,40,938,3,4,945
9,7,9005,1620,3,242,99,447,42,40,870,3,6,879
9,7,9005,1621,3,356,126,484,43,47,1056,0,12,1068
9,7,9005,1622,3,324,144,386,42,32,928,2,4,934
9,7,9005,1623,3,203,263,356,42,29,893,0,11,904
9,7,9005,1624,3,234,120,398,53,50,855,3,15,873
9,7,9005,1625,3,236,105,498,33,28,900,1,21,922
9,7,9005,1626,3,266,134,478,52,51,981,2,38,1021
9,7,9005,1627,3,227,123,517,42,47,956,6,12,974
9,7,9005,1628,3,237,95,410,33,40,815,1,6,822
9,7,9005,1629,3,266,111,413,42,46,878,3,21,902
9,7,9005,1630,3,226,88,379,38,34,765,0,7,772
9,7,9005,1631,3,384,143,538,57,39,1161,3,15,1179
9,7,9005,1632,3,399,191,443,68,50,1151,0,17,1168
9,7,9005,1633,3,339,147,453,47,44,1030,0,12,1042
9,7,9005,1634,3,237,99,394,47,40,817,2,10,829
9,7,9005,1635,3,199,89,665,39,34,1026,1,7,1034
9,7,9005,1636,3,197,129,560,33,37,956,2,16,974
9,7,9005,1637,3,331,138,479,58,30,1036,3,18,1057
9,7,9005,1638,3,251,141,440,47,36,915,1,14,930
9,7,9005,1639,3,169,127,414,19,32,761,6,14,781
9,7,9005,1640,3,210,124,348,31,36,749,2,18,769
9,7,9005,1641,3,202,119,487,48,47,903,2,14,919
9,7,9005,1642,3,151,98,372,20,30,671,0,25,696
9,7,9005,1643,3,292,137,371,46,31,877,2,9,888
9,7,9005,1644,3,234,156,480,41,35,946,5,11,962
9,7,9005,1645,3,143,80,381,40,32,676,2,11,689
9,7,9005,1646,3,194,71,309,33,45,652,1,13,666
9,7,9005,1647,3,276,113,435,40,35,899,2,12,913
9,7,9005,1648,3,268,114,386,36,40,844,1,18,863
9,7,9005,1649,3,167,73,393,32,14,679,11,12,702
9,7,9005,1650,3,130,58,374,38,23,623,5,11,639
9,7,9005,1651,3,186,94,474,38,41,833,6,7,846
9,7,9005,1652,3,179,112,522,46,33,892,0,12,904
9,7,9005,1653,3,132,70,364,42,39,647,0,11,658
9,7,9005,1654,3,196,117,556,50,43,962,0,17,979
9,7,9005,1655,3,186,82,536,35,31,870,1,15,886
9,7,9005,1656,3,207,121,447,54,29,858,2,13,873
9,7,9005,1657,3,206,113,496,46,37,898,0,19,917
9,7,9005,1658,3,138,75,320,24,26,583,2,11,596
9,7,9005,1659,3,182,89,494,32,40,837,1,15,853
9,7,9005,1660,3,158,84,426,24,29,721,3,12,736
9,7,9005,1661,3,165,98,409,38,29,739,0,14,753
9,7,9005,1662,3,127,58,355,32,16,588,2,17,607
9,7,9005,1663,3,98,79,332,22,12,543,3,10,556
9,7,9005,1664,3,174,67,305,21,24,591,1,12,604
9,7,9005,1665,3,135,67,335,20,14,571,0,14,585
9,7,9005,1666,3,240,125,419,38,38,860,6,13,879
9,7,9005,1667,3,207,111,496,55,38,907,2,9,918
9,7,9005,1668,3,104,92,300,41,25,562,1,12,575
9,7,9005,1669,3,149,84,420,35,31,719,0,6,725
9,7,9005,1670,3,168,104,228,26,17,543,4,5,552
9,7,9005,1671,3,149,75,375,27,37,663,0,7,670
9,8,9002,1,3,149,82,330,28,16,605,4,9,618
9,8,9002,2,3,257,90,432,30,27,836,0,14,850
9,8,9002,3,3,210,91,393,52,19,765,0,9,774
9,8,9002,4,3,103,98,400,37,21,659,4,14,677
9,8,9002,5,3,180,94,310,21,23,628,0,10,638
9,8,9002,6,3,155,82,411,44,31,723,2,14,739
9,8,9002,7,3,176,81,312,32,16,617,1,13,631
9,8,9002,8,3,279,84,388,35,24,810,0,16,826
9,8,9002,9,3,125,85,340,25,21,596,3,8,607
9,8,9002,10,3,317,96,435,44,24,916,2,12,930
9,8,9002,11,3,160,54,264,24,18,520,2,10,532
9,8,9002,12,3,240,61,191,20,19,531,0,10,541
9,8,9002,13,3,464,125,253,40,26,908,2,4,914
9,8,9002,14,3,297,98,200,35,20,650,5,13,668
9,8,9002,15,3,357,110,247,25,19,758,0,6,764
9,8,9002,16,3,278,97,436,57,34,902,1,14,917
9,8,9002,17,3,166,71,298,27,24,586,5,19,610
9,8,9002,18,3,233,78,283,57,22,673,1,19,693
9,8,9002,19,3,148,108,307,27,25,615,1,17,633
9,8,9002,20,3,144,71,290,29,17,551,0,8,559
9,8,9002,21,3,129,80,358,26,19,612,0,20,632
9,8,9002,22,3,198,80,409,35,15,737,0,12,749
9,8,9002,23,3,169,68,315,17,12,581,0,7,588
9,8,9002,24,3,194,106,358,23,17,698,0,10,708
9,8,9002,25,3,131,98,267,22,17,535,0,5,540
9,8,9002,26,3,214,78,316,33,22,663,1,4,668
9,8,9002,27,3,182,89,377,26,30,704,0,9,713
9,8,9002,28,3,245,114,424,36,23,842,0,21,863
9,8,9002,29,3,208,96,383,25,11,723,0,11,734
9,8,9002,30,3,234,81,386,50,23,774,0,14,788
9,8,9002,31,3,214,108,361,43,23,749,3,16,768
9,8,9002,32,3,289,94,246,27,30,686,0,11,697
9,8,9002,33,3,170,83,314,24,14,605,0,14,619
9,8,9002,34,3,272,67,186,24,23,572,0,5,577
9,8,9002,35,3,298,96,240,17,18,669,0,4,673
9,8,9002,36,3,310,82,251,31,25,699,1,7,707
9,8,9002,37,3,376,97,201,43,28,745,0,10,755
9,8,9002,38,3,195,64,321,27,18,625,2,16,643
9,8,9002,39,3,275,93,321,49,29,767,3,9,779
9,8,9002,40,3,207,85,262,36,19,609,3,8,620
9,8,9002,41,3,227,98,296,43,31,695,0,8,703
9,8,9002,42,3,205,80,318,46,15,664,1,10,675
9,8,9002,43,3,145,66,283,33,25,552,0,6,558
9,8,9002,44,3,286,74,219,31,22,632,0,1,633
9,8,9002,45,3,357,99,251,27,28,762,0,12,774
9,8,9002,46,3,258,85,141,23,19,526,0,8,534
9,8,9002,47,3,213,79,445,48,28,813,1,8,822
9,8,9002,48,3,271,122,443,45,23,904,4,10,918
9,8,9002,49,3,189,66,300,36,9,600,1,8,609
9,8,9002,50,3,224,87,395,39,22,767,0,7,774
9,8,9002,51,3,215,94,511,57,27,904,0,18,922
9,8,9002,52,3,300,94,238,19,24,675,1,10,686
9,8,9002,53,3,254,103,217,30,18,622,0,10,632
9,8,9002,54,3,275,109,492,48,22,946,3,15,964
9,8,9002,55,3,302,76,280,37,30,725,3,21,749
9,8,9002,82,3,154,70,368,32,28,652,2,15,669
9,8,9002,97,3,171,196,599,32,19,1017,2,12,1031
9,8,9002,98,3,231,67,222,25,20,565,2,12,579
9,8,9002,111,3,340,128,516,72,35,1091,2,5,1098
9,8,9002,112,3,180,41,264,30,18,533,1,10,544
9,8,9002,113,3,200,58,242,36,26,562,0,4,566
9,8,9002,114,3,154,48,203,22,17,444,3,3,450
9,8,9002,115,3,216,71,257,30,26,600,2,11,613
9,8,9002,116,3,212,68,221,39,24,564,0,4,568
9,8,9002,117,3,195,69,247,15,14,540,0,7,547
9,8,9002,118,3,201,80,234,36,17,568,0,6,574
9,8,9002,119,3,285,123,558,46,34,1046,0,8,1054
9,8,9002,120,3,202,60,274,17,22,575,3,6,584
9,8,9002,121,3,297,80,260,28,30,695,0,12,707
9,8,9002,308,3,267,115,528,52,30,992,2,18,1012
9,8,9002,309,3,83,59,172,17,13,344,0,10,354
9,8,9002,310,3,95,85,336,25,10,551,2,10,563
9,8,9002,311,3,106,62,238,29,18,453,0,6,459
9,8,9002,312,3,138,92,374,29,11,644,1,13,658
9,8,9002,313,3,205,90,468,55,26,844,0,13,857
9,8,9002,314,3,260,123,400,51,22,856,3,17,876
9,8,9002,315,3,239,84,495,47,17,882,14,8,904
9,8,9002,316,3,151,81,346,34,24,636,0,8,644
9,8,9002,317,3,181,88,334,34,16,653,0,17,670
9,8,9002,318,3,236,112,456,41,27,872,0,15,887
9,8,9002,319,3,204,88,473,35,15,815,4,15,834
9,8,9002,320,3,231,91,501,34,18,875,0,9,884
9,8,9002,321,3,282,113,342,38,21,796,3,16,815
9,8,9002,322,3,238,90,355,34,33,750,1,9,760
9,8,9002,323,3,212,47,364,41,24,688,1,9,698
9,8,9002,324,3,180,78,326,29,21,634,1,14,649
9,8,9002,325,3,192,62,357,39,17,667,0,13,680
9,8,9002,326,3,266,109,490,50,22,937,4,15,956
9,8,9002,327,3,160,95,310,33,16,614,2,6,622
9,8,9002,328,3,150,64,351,21,25,611,1,3,615
9,8,9002,329,3,222,107,312,47,27,715,0,11,726
9,8,9002,330,3,176,80,233,30,26,545,2,18,565
9,8,9002,331,3,182,103,351,48,36,720,1,10,731
9,8,9002,332,3,185,83,369,36,24,697,2,11,710
9,8,9002,333,3,230,85,355,30,24,724,1,9,734
9,8,9002,334,3,248,107,351,32,23,761,1,9,771
9,8,9002,335,3,180,71,264,37,21,573,0,12,585
9,8,9002,336,3,233,78,327,31,31,700,0,6,706
9,8,9002,337,3,190,69,297,26,18,600,0,13,613
9,8,9002,338,3,178,79,257,28,19,561,1,11,573
9,8,9002,339,3,189,91,324,32,21,657,1,13,671
9,8,9002,340,3,175,110,376,31,20,712,1,13,726
9,8,9002,341,3,192,108,474,38,24,836,1,9,846
9,8,9002,342,3,205,62,331,37,26,661,1,6,668
9,8,9002,343,3,218,87,334,25,30,694,0,9,703
9,8,9002,344,3,238,107,488,51,25,909,0,17,926
9,8,9015,4586,3,208,105,613,60,40,1026,5,15,1046
9,8,9015,4587,3,56,42,317,18,18,451,2,7,460
9,8,9015,4588,3,333,130,386,42,40,931,1,14,946
9,8,9015,4589,3,284,127,498,47,34,990,3,10,1003
9,8,9015,4590,3,175,98,556,33,21,883,1,15,899
9,8,9015,4591,3,172,131,526,42,23,894,2,19,915
9,8,9015,4592,3,111,66,202,24,15,418,1,5,424
9,8,9015,4593,3,244,144,575,59,46,1068,4,16,1088
9,8,9015,4594,3,225,102,389,37,50,803,1,15,819
9,8,9015,4595,3,274,179,505,44,51,1053,0,17,1070
9,8,9015,4596,3,229,108,424,33,56,850,1,12,863
9,8,9015,4597,3,287,135,543,52,46,1063,1,5,1069
9,8,9015,4598,3,168,123,405,31,32,759,0,17,776
9,8,9015,4599,3,207,111,416,38,24,796,0,9,805
9,8,9015,4600,3,186,124,389,33,23,755,1,16,772
9,8,9015,4601,3,198,101,384,28,28,739,4,8,751
9,8,9015,4602,3,258,129,415,27,33,862,0,12,874
9,8,9015,4603,3,178,128,282,31,24,643,0,12,655
9,8,9015,4604,3,250,149,448,43,30,920,0,8,928
9,8,9015,4605,3,612,299,1172,143,78,2304,4,28,2336
9,8,9015,4606,3,268,158,823,74,46,1369,2,19,1390
9,8,9015,4607,3,161,115,668,56,25,1025,3,12,1040
9,8,9015,4608,3,210,115,439,34,38,836,1,8,845
9,8,9015,4609,3,313,119,791,51,53,1327,3,19,1349
9,8,9015,4610,3,279,112,385,36,33,845,0,22,867
9,8,9015,4611,3,329,161,399,41,41,971,2,16,989
9,8,9015,4612,3,273,140,469,63,35,980,5,20,1005
9,8,9015,4613,3,278,149,456,56,35,974,6,23,1003
9,8,9015,4614,3,205,119,544,46,35,949,0,13,962
9,8,9015,4615,3,204,127,433,46,16,826,2,18,846
9,8,9015,4616,3,189,141,521,41,33,925,3,16,944
9,8,9015,4617,3,198,140,581,75,33,1027,1,19,1047
9,8,9015,4618,3,175,147,593,41,31,987,3,6,996
9,8,9015,4619,3,218,129,419,41,28,835,0,14,849
9,8,9015,4620,3,187,125,518,51,40,921,2,13,936
9,8,9015,4621,3,272,166,702,69,36,1245,2,21,1268
9,8,9015,4622,3,218,133,576,66,38,1031,0,25,1056
9,8,9015,4623,3,260,145,435,49,33,922,6,12,940
9,8,9015,4624,3,230,97,334,35,35,731,0,12,743
9,8,9015,4625,3,462,171,575,54,47,1309,2,16,1327
9,8,9015,4626,3,218,129,444,40,35,866,5,14,885
9,8,9015,4627,3,311,124,445,63,47,990,1,13,1004
9,8,9015,4628,3,237,139,380,58,40,854,3,20,877
9,8,9015,4629,3,311,111,340,31,43,836,3,11,850
9,8,9015,4630,3,161,72,188,27,19,467,1,5,473
9,8,9015,4631,3,362,143,419,41,59,1024,1,20,1045
9,8,9015,4632,3,329,141,431,37,43,981,5,18,1004
9,8,9015,4633,3,147,143,346,32,28,696,5,11,712
9,8,9015,4634,3,233,138,557,64,30,1022,3,20,1045
9,8,9015,4635,3,242,156,513,53,39,1003,3,20,1026
9,8,9015,4636,3,218,151,495,41,36,941,1,14,956
9,8,9015,4637,3,240,147,503,56,24,970,4,15,989
9,8,9015,4638,3,98,102,282,29,21,532,0,10,542
9,8,9015,4639,3,192,94,388,39,24,737,1,10,748
9,8,9015,4640,3,264,147,435,48,30,924,1,16,941
9,8,9015,4641,3,286,122,447,37,53,945,3,11,959
9,8,9015,4642,3,343,140,410,46,38,977,2,15,994
9,8,9015,4643,3,310,160,595,45,41,1151,0,18,1169
9,8,9015,4644,3,408,153,561,55,43,1220,2,14,1236
9,8,9015,4645,3,283,111,358,44,48,844,4,9,857
9,8,9015,4646,3,73,101,449,38,23,684,2,17,703
9,8,9015,4647,3,154,93,392,34,33,706,0,11,717
9,8,9015,4648,3,204,98,274,26,23,625,2,12,639
9,8,9015,4649,3,138,79,303,37,15,572,0,12,584
9,8,9015,4650,3,107,45,223,18,18,411,0,0,411
9,8,9015,4651,3,80,56,270,16,16,438,0,7,445
9,8,9015,4652,3,128,71,156,17,26,398,3,4,405
9,8,9015,4653,3,61,88,161,12,10,332,1,1,334
9,8,9015,4654,3,284,111,500,59,41,995,0,19,1014
9,8,9015,4655,3,254,136,541,59,34,1024,3,28,1055
9,8,9015,4656,3,268,139,538,38,39,1022,2,14,1038
9,8,9015,4657,3,252,141,476,54,47,970,1,20,991
9,8,9015,4658,3,298,111,617,52,45,1123,0,20,1143
9,8,9015,4659,3,310,141,571,59,43,1124,1,21,1146
9,8,9015,4660,3,243,129,437,33,27,869,0,23,892
9,8,9015,4661,3,235,123,480,43,38,919,3,20,942
9,8,9015,4662,3,268,155,824,80,50,1377,14,30,1421
9,8,9015,4663,3,265,129,563,63,44,1064,0,6,1070
9,8,9015,4664,3,275,155,531,49,37,1047,0,18,1065
9,8,9015,4665,3,190,94,393,29,26,732,1,15,748
9,8,9015,4670,3,98,80,229,32,23,462,0,9,471
9,8,9015,4671,3,197,124,383,45,38,787,0,19,806
9,8,9015,4672,3,278,152,461,50,56,997,3,12,1012
9,8,9015,4673,3,225,104,407,39,35,810,0,10,820
9,8,9015,4674,3,141,70,241,22,20,494,1,7,502
9,8,9015,4675,3,141,70,226,24,19,480,0,4,484
9,8,9015,4676,3,184,101,308,39,18,650,0,16,666
9,8,9015,4677,3,262,131,449,58,46,946,0,19,965
9,8,9015,4678,3,92,48,135,11,22,308,2,11,321
9,8,9015,4684,3,127,101,367,33,13,641,0,13,654
9,8,9015,4685,3,192,99,406,42,30,769,0,12,781
9,8,9015,4686,3,145,100,576,39,45,905,2,20,927
9,8,9015,4687,3,247,143,648,53,36,1127,1,28,1156
9,8,9015,4688,3,133,78,432,38,25,706,0,8,714
9,8,9015,4689,3,157,87,457,64,31,796,5,14,815
9,8,9015,4696,3,207,164,490,56,43,960,4,18,982
9,8,9015,4697,3,128,111,410,35,17,701,5,16,722
9,8,9015,4698,3,190,111,407,50,38,796,5,17,818
9,8,9015,4699,3,202,143,482,62,34,923,4,20,947
9,8,9015,4700,3,217,178,670,72,46,1183,0,20,1203
9,8,9015,4701,3,137,83,309,37,21,587,1,12,600
9,8,9015,4702,3,278,184,628,61,53,1204,1,38,1243
9,8,9015,4708,3,176,165,625,87,40,1093,2,27,1122
9,8,9015,4709,3,187,200,526,54,39,1006,4,23,1033
9,8,9015,4710,3,196,139,476,58,37,906,1,22,929
9,8,9015,4712,3,141,172,319,36,29,697,0,8,705
9,8,9015,4714,3,168,98,369,44,27,706,2,9,717
9,8,9015,4717,3,158,113,549,38,29,887,1,15,903
9,8,9015,4720,3,93,47,355,10,21,526,1,6,533
9,8,9015,4722,3,148,86,275,16,18,543,3,15,561
9,8,9015,4823,3,271,121,512,35,33,972,2,17,991
9,8,9015,4824,3,187,76,327,26,19,635,2,7,644
9,8,9015,4825,3,137,97,363,30,28,655,0,2,657
9,8,9015,4826,3,310,128,612,63,41,1154,0,25,1179
9,8,9015,4827,3,309,151,691,57,30,1238,0,13,1251
9,8,9015,4828,3,241,126,453,34,34,888,2,14,904
9,8,9015,4829,3,161,71,333,30,23,618,1,15,634
9,8,9015,4831,3,306,100,324,41,45,816,1,12,829
9,8,9015,4832,3,320,171,417,63,47,1018,4,11,1033
9,8,9015,4833,3,318,107,374,54,32,885,0,10,895
9,8,9015,4834,3,289,118,345,28,40,820,1,10,831
9,8,9015,4835,3,194,156,387,38,40,815,2,15,832
9,8,9015,4836,3,184,111,302,32,31,660,0,15,675
9,8,9015,4853,3,186,117,310,35,28,676,2,14,692
9,8,9015,4854,3,172,118,412,30,36,768,1,12,781
9,8,9015,4855,3,244,103,349,38,48,782,2,13,797
9,8,9015,4856,3,287,122,396,45,33,883,1,23,907
9,8,9015,4857,3,361,151,413,38,44,1007,2,12,1021
9,8,9015,4858,3,292,107,379,42,52,872,2,15,889
9,8,9015,4859,3,269,130,385,60,25,869,9,10,888
9,8,9015,4860,3,209,84,314,34,45,686,2,6,694
9,8,9015,4861,3,285,83,173,28,28,597,2,10,609
9,8,9015,4862,3,279,115,323,46,30,793,1,13,807
9,8,9015,4863,3,198,94,345,31,28,696,2,15,713
9,8,9015,4864,3,209,83,222,20,28,562,1,4,567
9,8,9015,4874,3,266,93,151,18,25,553,1,4,558
9,8,9015,4875,3,260,80,202,22,32,596,1,6,603
9,8,9015,4876,3,304,91,171,27,23,616,1,6,623
9,8,9015,4877,3,231,92,168,21,20,532,1,9,542
9,8,9015,4878,3,228,58,121,14,17,438,0,7,445
9,8,9015,4879,3,272,74,186,24,32,588,1,7,596
9,8,9015,4880,3,241,63,109,20,20,453,1,1,455
9,8,9015,4881,3,242,68,151,22,16,499,2,12,513
9,8,9015,4885,3,269,90,205,29,21,614,1,6,621
9,8,9015,4889,3,161,67,156,27,24,435,2,5,442
9,9,9017,5183,3,149,129,464,44,51,837,2,23,862
9,9,9017,5184,3,137,111,485,48,41,822,0,18,840
9,9,9017,5185,3,139,100,378,56,29,702,4,9,715
9,9,9017,5186,3,210,132,494,41,31,908,0,7,915
9,9,9017,5187,3,231,106,422,53,41,853,2,18,873
9,9,9017,5188,3,44,14,95,6,11,170,1,3,174
9,9,9017,5189,3,156,131,508,62,51,908,3,15,926
9,9,9017,5190,3,211,89,401,45,41,787,5,17,809
9,9,9017,5191,3,143,124,377,50,25,719,2,23,744
9,9,9017,5192,3,231,93,457,43,37,861,2,8,871
9,9,9017,5193,3,231,114,355,40,39,779,6,11,796
9,9,9017,5194,3,165,84,249,35,25,558,0,8,566
9,9,9017,5195,3,198,115,423,45,34,815,0,16,831
9,9,9017,5196,3,215,108,534,49,35,941,9,22,972
9,9,9017,5197,3,212,115,519,56,36,938,6,22,966
9,9,9017,5198,3,198,95,362,33,40,728,1,12,741
9,9,9017,5199,3,259,120,535,40,42,996,0,22,1018
9,9,9017,5200,3,228,109,462,56,42,897,1,24,922
9,9,9017,5201,3,252,122,484,60,42,960,4,17,981
9,9,9017,5202,3,292,129,505,65,49,1040,5,20,1065
9,9,9017,5203,3,132,57,216,29,22,456,1,8,465
9,9,9017,5204,3,283,100,412,46,31,872,1,11,884
9,9,9017,5205,3,267,134,416,46,36,899,0,22,921
9,9,9017,5206,3,153,74,291,22,23,563,0,19,582
9,9,9017,5207,3,177,92,304,38,20,631,4,7,642
9,9,9017,5208,3,177,110,331,37,25,680,0,15,695
9,9,9017,5209,3,183,134,653,76,43,1089,6,19,1114
9,9,9017,5210,3,133,153,546,51,28,911,2,17,930
9,9,9017,5211,3,130,100,381,48,32,691,4,12,707
9,9,9017,5212,3,118,96,285,22,12,533,2,4,539
9,9,9017,5213,3,270,162,458,30,57,977,1,17,995
9,9,9017,5214,3,147,42,179,24,18,410,2,3,415
9,9,9017,5215,3,226,119,441,37,43,866,1,12,879
9,9,9017,5216,3,197,128,441,46,35,847,3,11,861
9,9,9017,5217,3,224,107,388,42,35,796,0,22,818
9,9,9017,5218,3,227,99,607,31,36,1000,3,17,1020
9,9,9017,5219,3,215,133,591,61,44,1044,4,20,1068
9,9,9017,5220,3,203,86,458,50,29,826,2,13,841
9,9,9017,5221,3,258,126,518,43,52,997,2,21,1020
9,9,9017,5222,3,134,98,280,39,34,585,3,8,596
9,9,9017,5223,3,169,116,434,38,19,776,3,14,793
9,9,9017,5224,3,240,117,656,71,42,1126,4,31,1161
9,9,9017,5225,3,105,137,453,35,38,768,1,13,782
9,9,9017,5226,3,183,160,620,71,40,1074,3,23,1100
9,9,9017,5227,3,137,80,391,38,28,674,5,9,688
9,9,9017,5228,3,149,125,500,51,40,865,3,13,881
9,9,9017,5229,3,206,142,713,76,56,1193,7,23,1223
9,9,9017,5230,3,163,85,562,49,50,909,2,13,924
9,9,9017,5231,3,144,106,417,54,30,751,2,15,768
9,9,9017,5232,3,206,137,520,67,39,969,3,10,982
9,9,9017,5233,3,194,80,366,34,31,705,4,15,724
9,9,9017,5234,3,149,112,470,58,28,817,2,16,835
9,9,9017,5235,3,183,121,389,36,40,769,2,10,781
9,9,9017,5236,3,223,116,461,52,35,887,2,19,908
9,9,9017,5237,3,209,96,516,44,27,892,3,16,911
9,9,9017,5238,3,176,82,356,28,16,658,2,8,668
9,9,9017,5239,3,130,101,349,38,17,635,0,12,647
9,9,9017,5240,3,108,58,268,18,24,476,0,5,481
9,9,9017,5241,3,148,85,283,41,21,578,0,13,591
9,9,9017,5242,3,73,70,254,25,23,445,1,5,451
9,9,9017,5243,3,164,118,495,63,42,882,5,20,907
9,9,9017,5244,3,158,63,265,36,26,548,1,5,554
9,9,9017,5245,3,133,95,265,29,31,553,0,14,567
9,9,9017,5246,3,154,107,401,41,22,725,0,9,734
9,9,9017,5247,3,80,71,309,36,26,522,2,10,534
9,9,9017,5248,3,125,75,313,44,24,581,1,6,588
9,9,9017,5249,3,107,99,449,46,16,717,3,18,738
9,9,9017,5250,3,129,141,438,50,28,786,3,20,809
9,9,9017,5251,3,128,113,407,45,18,711,4,11,726
9,9,9017,5252,3,90,85,341,36,31,583,10,14,607
9,9,9017,5253,3,165,143,469,72,39,888,7,14,909
9,9,9017,5254,3,140,112,396,52,35,735,0,11,746
9,9,9017,5255,3,130,91,333,67,23,644,1,19,664
9,9,9017,5256,3,126,95,451,42,28,742,2,13,757
9,9,9017,5257,3,218,110,411,36,34,809,1,17,827
9,9,9017,5258,3,141,123,416,53,25,758,0,19,777
9,9,9017,5259,3,162,136,463,48,43,852,4,15,871
9,9,9017,5260,3,99,112,530,39,34,814,3,15,832
9,9,9017,5261,3,83,68,354,30,20,555,2,18,575
9,9,9017,5262,3,157,117,392,34,35,735,0,15,750
9,9,9017,5263,3,160,146,379,41,33,759,3,17,779
9,9,9017,5264,3,144,88,346,36,34,648,0,1,649
9,9,9017,5265,3,112,102,331,23,25,593,0,22,615
9,9,9017,5266,3,186,86,282,36,32,622,1,8,631
9,9,9017,5267,3,194,86,350,43,33,706,3,23,732
9,9,9017,5268,3,170,144,507,90,33,944,8,17,969
9,9,9017,5269,3,327,147,386,50,36,946,4,20,970
9,9,9017,5270,3,133,110,388,61,34,726,6,16,748
9,9,9017,5271,3,118,82,235,31,21,487,1,11,499
9,9,9017,5272,3,100,60,411,32,29,632,2,14,648
9,9,9017,5273,3,162,89,301,33,17,602,5,14,621
9,9,9017,5274,3,178,88,448,44,33,791,1,9,801
9,9,9017,5275,3,209,124,564,57,32,986,4,17,1007
9,9,9017,5276,3,314,127,536,72,46,1095,8,18,1121
9,9,9017,5277,3,244,89,547,57,23,960,0,17,977
9,9,9017,5278,3,236,104,491,46,37,914,2,23,939
9,9,9017,5279,3,156,85,382,29,33,685,1,14,700
9,9,9017,5280,3,168,89,414,33,25,729,0,22,751
9,9,9017,5281,3,153,68,434,41,23,719,3,16,738
9,9,9017,5282,3,97,53,204,32,19,405,0,0,405
9,9,9017,5283,3,155,75,378,35,36,679,7,11,697
9,9,9017,5284,3,213,78,419,56,26,792,1,23,816
9,9,9017,5285,3,209,92,364,38,37,740,1,25,766
9,9,9017,5286,3,235,67,404,36,36,778,2,11,791
9,9,9017,5287,3,181,109,487,47,27,851,0,15,866
9,9,9017,5288,3,162,70,428,43,30,733,0,10,743
9,9,9017,5289,3,257,133,543,55,43,1031,6,27,1064
9,9,9017,5290,3,165,74,364,41,42,686,1,16,703
9,9,9017,5291,3,170,107,408,65,31,781,2,18,801
9,9,9017,5292,3,223,143,694,51,63,1174,3,17,1194
9,9,9017,5293,3,187,127,576,76,39,1005,1,18,1024
9,9,9017,5294,3,254,104,413,47,42,860,3,19,882
9,9,9017,5295,3,203,90,379,39,29,740,2,20,762
9,9,9017,5296,3,233,107,459,38,49,886,2,14,902
9,9,9017,5297,3,277,129,489,64,60,1019,0,20,1039
9,9,9017,5298,3,190,100,411,57,45,803,1,19,823
9,9,9017,5299,3,265,108,503,48,49,973,2,22,997
9,9,9017,5300,3,242,105,528,45,42,962,0,31,993
9,9,9017,5301,3,230,120,330,37,33,750,5,16,771
9,9,9017,5302,3,253,147,496,68,54,1018,4,18,1040
9,9,9017,5303,3,297,118,490,72,46,1023,0,23,1046
9,9,9017,5304,3,90,33,141,18,15,297,0,6,303
9,9,9017,5305,3,259,119,419,36,37,870,4,15,889
9,9,9017,5306,3,302,108,429,66,42,947,4,20,971
9,9,9017,5307,3,190,102,299,50,27,668,4,11,683
9,9,9017,5308,3,258,123,514,44,36,975,0,14,989
9,9,9017,5309,3,207,134,418,55,47,861,0,22,883
9,9,9017,5310,3,201,144,440,51,41,877,3,22,902
9,9,9017,5311,3,197,94,325,34,30,680,0,13,693
9,9,9017,5312,3,208,102,415,37,45,807,0,12,819
9,9,9017,5313,3,203,104,343,38,29,717,0,12,729
9,9,9017,5314,3,130,72,276,20,18,516,3,9,528
9,9,9017,5315,3,163,97,310,35,34,639,0,12,651
9,9,9017,5316,3,167,123,362,39,33,724,3,14,741
9,9,9017,5317,3,202,108,307,27,28,672,0,11,683
9,9,9017,5318,3,247,105,330,51,36,769,3,3,775
9,9,9017,5319,3,214,96,429,54,40,833,2,22,857
9,9,9017,5320,3,192,98,425,48,48,811,1,12,824
9,9,9017,5321,3,160,102,484,54,40,840,4,10,854
9,9,9017,5322,3,202,74,443,55,43,817,3,24,844
9,9,9017,5323,3,252,85,375,53,36,801,1,6,808
9,9,9017,5324,3,191,109,639,57,54,1050,0,13,1063
9,9,9017,5325,3,170,76,312,40,37,635,0,7,642
9,9,9017,5326,3,147,89,319,26,28,609,1,11,621
9,9,9017,5327,3,216,79,315,29,29,668,4,13,685
9,9,9017,5328,3,310,129,571,63,54,1127,1,29,1157
9,9,9017,5329,3,286,113,489,53,35,976,2,12,990
9,9,9017,5330,3,170,91,291,27,27,606,1,10,617
9,9,9017,5331,3,101,48,220,30,19,418,6,0,424
9,9,9017,5332,3,138,112,364,40,26,680,1,9,690
9,9,9017,5333,3,76,29,169,29,9,312,0,6,318
9,9,9017,5334,3,134,52,218,25,36,465,2,4,471
9,9,9017,5335,3,183,80,397,48,31,739,0,19,758
9,9,9017,5336,3,126,78,269,42,23,538,1,4,543
9,9,9017,5337,3,112,74,215,20,25,446,2,9,457
9,9,9017,5338,3,61,50,210,24,13,358,0,19,377
9,9,9017,5340,3,178,143,292,46,29,688,4,8,700
9,9,9017,5341,3,173,102,284,33,30,622,2,6,630
9,9,9017,5342,3,225,105,291,60,25,706,2,9,717
9,9,9017,5343,3,359,143,477,53,48,1080,3,12,1095
9,9,9017,5344,3,361,101,334,35,34,865,3,7,875
9,9,9017,5345,3,354,125,322,44,32,877,3,22,902
9,9,9017,5346,3,210,74,266,43,47,640,2,9,651
9,9,9017,5347,3,432,134,339,42,37,984,2,8,994
9,9,9017,5348,3,296,103,361,40,48,848,0,14,862
9,9,9017,5349,3,229,112,340,42,27,750,1,5,756
9,9,9017,5350,3,332,118,319,38,31,838,9,24,871
9,9,9017,5351,3,331,100,262,27,25,745,2,9,756
9,9,9017,5352,3,381,135,291,30,29,866,0,9,875
9,9,9017,5353,3,408,123,235,41,32,839,0,14,853
9,9,9017,5354,3,217,114,351,35,38,755,0,7,762
9,9,9017,5355,3,170,74,231,25,16,516,1,7,524
9,9,9017,5356,3,252,94,235,34,45,660,0,15,675
9,9,9017,5357,3,260,127,277,31,29,724,4,14,742
9,9,9017,5358,3,279,112,304,41,33,769,0,13,782
9,9,9017,5359,3,376,121,296,31,41,865,1,14,880
9,9,9017,5370,3,247,60,258,26,23,614,2,9,625
9,9,9017,5372,3,320,175,448,82,47,1072,2,26,1100
9,9,9017,5373,3,376,153,416,70,61,1076,1,15,1092
9,9,9017,5374,3,245,114,378,49,25,811,3,17,831
9,9,9017,5375,3,270,132,546,44,41,1033,2,11,1046
9,9,9017,5376,3,303,140,606,53,41,1143,6,14,1163
9,9,9017,5377,3,337,76,346,37,44,840,2,8,850
9,9,9017,5382,3,168,95,508,53,37,861,0,13,874
9,9,9017,5383,3,185,158,665,58,48,1114,2,30,1146
9,9,9017,5384,3,187,102,515,39,19,862,4,15,881
9,9,9017,5385,3,257,152,636,66,47,1158,8,20,1186
9,9,9017,5386,3,132,75,462,47,32,748,1,7,756
9,9,9017,5387,3,242,118,698,55,53,1166,1,17,1184
9,9,9017,5395,3,82,35,234,27,12,390,0,7,397
9,9,9017,5396,3,97,62,206,19,16,400,1,9,410
9,9,9017,5400,3,188,151,499,56,44,938,3,9,950
9,9,9017,5401,3,191,119,520,58,43,931,4,21,956
9,9,9017,5402,3,185,110,558,47,38,938,2,20,960
9,9,9017,5408,3,164,102,511,70,37,884,4,15,903
9,9,9017,5409,3,219,121,553,29,36,958,1,17,976
9,9,9017,5410,3,216,111,495,55,39,916,0,21,937
9,9,9017,5411,3,226,129,638,37,41,1071,5,19,1095
9,9,9017,5412,3,202,141,503,56,47,949,1,12,962
9,9,9017,5413,3,146,113,455,36,31,781,1,6,788
9,9,9017,5414,3,221,148,471,46,34,920,2,23,945
9,9,9017,5415,3,212,97,612,67,46,1034,0,26,1060
9,9,9017,5416,3,211,128,569,60,28,996,3,13,1012
9,9,9017,5417,3,194,103,477,48,33,855,3,23,881
9,9,9017,5418,3,254,110,504,53,25,946,0,21,967
9,9,9017,5421,3,158,83,309,32,28,610,3,10,623
9,9,9017,5422,3,195,75,421,53,22,766,2,14,782
9,9,9017,5493,3,116,39,129,12,11,307,0,1,308
9,9,9017,5503,3,247,137,406,44,32,866,2,8,876
9,9,9017,5504,3,209,81,282,28,21,621,1,16,638
9,9,9017,5505,3,153,66,300,33,24,576,0,17,593
9,9,9017,5506,3,265,135,571,75,39,1085,5,15,1105
9,9,9017,5507,3,258,124,585,55,42,1064,10,22,1096
9,9,9017,5508,3,213,157,615,76,37,1098,1,12,1111
9,9,9017,5509,3,240,100,409,39,42,830,6,15,851
9,9,9017,5510,3,163,118,362,40,37,720,1,11,732
9,9,9017,5511,3,137,88,315,35,29,604,0,11,615
9,10,9016,4912,3,126,100,36,20,4,286,2,4,292
9,10,9016,4913,3,410,78,64,14,20,586,1,2,589
9,10,9016,4914,3,399,94,59,15,12,579,1,13,593
9,10,9016,4915,3,453,151,66,9,9,688,0,4,692
9,10,9016,4916,3,335,115,37,12,5,504,0,6,510
9,10,9016,4917,3,276,72,46,4,7,405,0,5,410
9,10,9016,4918,3,476,102,83,13,12,686,0,7,693
9,10,9016,4919,3,335,73,50,10,17,485,1,4,490
9,10,9016,4920,3,199,68,394,40,17,718,2,8,728
9,10,9016,4921,3,308,99,621,50,26,1104,0,5,1109
9,10,9016,4922,3,473,173,400,50,33,1129,2,19,1150
9,10,9016,4923,3,480,109,127,15,20,751,0,9,760
9,10,9016,4924,3,311,90,53,15,11,480,0,5,485
9,10,9016,4925,3,295,86,61,14,12,468,0,1,469
9,10,9016,4926,3,259,99,75,17,20,470,0,5,475
9,10,9016,4927,3,307,65,81,16,24,493,0,12,505
9,10,9016,4928,3,224,46,49,12,15,346,0,3,349
9,10,9016,4929,3,208,63,53,7,16,347,0,4,351
9,10,9016,4930,3,252,72,71,16,17,428,0,5,433
9,10,9016,4931,3,382,50,41,11,22,506,0,5,511
9,10,9016,4932,3,439,107,64,19,24,653,0,5,658
9,10,9016,4933,3,411,132,84,21,21,669,0,7,676
9,10,9016,4934,3,545,166,63,16,23,813,0,6,819
9,10,9016,4935,3,643,126,66,15,22,872,0,9,881
9,10,9016,4936,3,339,56,32,8,8,443,0,4,447
9,10,9016,4937,3,431,137,204,28,19,819,0,6,825
9,10,9016,4938,3,472,83,75,15,16,661,0,6,667
9,10,9016,4939,3,581,123,78,18,30,830,1,6,837
9,10,9016,4940,3,416,82,88,16,16,618,0,8,626
9,10,9016,4941,3,347,65,40,4,11,467,0,5,472
9,10,9016,4942,3,389,91,45,8,19,552,1,1,554
9,10,9016,4943,3,249,74,168,35,24,550,2,3,555
9,10,9016,4944,3,482,79,272,26,38,897,3,13,913
9,10,9016,4945,3,434,84,240,42,40,840,3,1,844
9,10,9016,4946,3,379,77,277,36,34,803,3,2,808
9,10,9016,4947,3,397,111,223,35,29,795,3,10,808
9,10,9016,4948,3,162,44,120,13,19,358,0,3,361
9,10,9016,4949,3,295,106,343,24,23,791,1,10,802
9,10,9016,4950,3,292,79,203,22,19,615,1,9,625
9,10,9016,4951,3,331,128,410,45,36,950,3,10,963
9,10,9016,4952,3,338,144,460,38,34,1014,1,6,1021
9,10,9016,4953,3,289,134,307,40,20,790,2,11,803
9,10,9016,4954,3,446,142,503,64,49,1204,1,22,1227
9,10,9016,4955,3,285,98,249,29,20,681,1,4,686
9,10,9016,4956,3,402,108,344,56,41,951,0,18,969
9,10,9016,4957,3,321,157,401,27,15,921,1,1,923
9,10,9016,4958,3,422,118,432,60,35,1067,1,17,1085
9,10,9016,4959,3,362,164,606,52,35,1219,2,21,1242
9,10,9016,4960,3,314,120,561,55,31,1081,3,15,1099
9,10,9016,4961,3,227,87,448,30,20,812,4,9,825
9,10,9016,4962,3,753,177,118,22,22,1092,2,1,1095
9,10,9016,4963,3,612,139,74,21,13,859,1,7,867
9,10,9016,4964,3,501,132,61,12,22,728,1,1,730
9,10,9016,4965,3,689,156,45,18,12,920,3,3,926
9,10,9016,4966,3,526,157,46,14,12,755,0,1,756
9,10,9016,4967,3,259,66,22,2,9,358,1,1,360
9,10,9016,4968,3,667,175,29,17,12,900,1,7,908
9,10,9016,4969,3,792,190,60,18,21,1081,0,3,1084
9,10,9016,4970,3,1134,175,137,26,52,1524,2,4,1530
9,10,9016,4971,3,745,153,72,18,34,1022,0,12,1034
9,10,9016,4972,3,232,156,544,29,26,987,1,25,1013
9,10,9016,4973,3,226,122,408,39,25,820,3,17,840
9,10,9016,4974,3,336,96,393,60,35,920,1,14,935
9,10,9016,4975,3,228,104,494,41,18,885,2,12,899
9,10,9016,4976,3,251,124,507,42,32,956,3,19,978
9,10,9016,4977,3,282,99,454,47,16,898,5,10,913
9,10,9016,4978,3,217,90,361,33,16,717,0,13,730
9,10,9016,4979,3,302,116,352,55,26,851,0,9,860
9,10,9016,4980,3,144,46,17,9,8,224,1,1,226
9,10,9016,4981,3,237,81,74,24,12,428,0,6,434
9,10,9016,4982,3,338,93,36,13,12,492,1,4,497
9,10,9016,4983,3,230,74,14,10,9,337,0,0,337
9,10,9016,4984,3,256,54,32,9,5,356,0,5,361
9,10,9016,4985,3,198,66,447,51,10,772,1,13,786
9,10,9016,4986,3,149,38,102,10,22,321,0,8,329
9,10,9016,4987,3,332,51,33,7,9,432,0,2,434
9,10,9016,4988,3,14,38,12,3,4,71,0,0,71
9,10,9016,4989,3,213,318,164,29,26,750,0,13,763
9,10,9016,4990,3,77,65,19,2,6,169,2,4,175
9,10,9016,4991,3,43,80,17,2,6,148,0,2,150
9,10,9016,4992,3,477,283,131,50,31,972,0,4,976
9,10,9016,4993,3,276,144,75,23,13,531,2,3,536
9,10,9016,4994,3,133,73,307,27,14,554,0,10,564
9,10,9016,4995,3,247,107,286,47,35,722,0,8,730
9,10,9016,4996,3,202,88,190,19,17,516,0,5,521
9,10,9016,4997,3,461,120,432,43,42,1098,0,18,1116
9,10,9016,4998,3,330,101,328,30,36,825,0,6,831
9,10,9016,4999,3,385,136,423,52,36,1032,0,23,1055
9,10,9016,5000,3,215,97,321,44,27,704,0,7,711
9,10,9016,5001,3,360,145,367,44,34,950,0,13,963
9,10,9016,5002,3,294,92,360,40,29,815,0,9,824
9,10,9016,5003,3,358,104,479,37,37,1015,0,13,1028
9,10,9016,5004,3,208,80,277,38,34,637,2,12,651
9,10,9016,5005,3,330,116,602,54,30,1132,3,22,1157
9,10,9016,5006,3,226,106,430,48,25,835,0,18,853
9,10,9016,5007,3,327,204,592,69,22,1214,1,17,1232
9,10,9016,5008,3,258,85,550,48,35,976,2,22,1000
9,10,9016,5009,3,200,134,412,28,23,797,0,17,814
9,10,9016,5010,3,190,55,180,29,19,473,2,8,483
9,10,9016,5011,3,181,76,84,23,11,375,2,8,385
9,10,9016,5012,3,169,56,168,21,12,426,0,6,432
9,10,9016,5013,3,309,72,278,19,31,709,0,5,714
9,10,9016,5014,3,354,131,320,28,36,869,1,18,888
9,10,9016,5015,3,323,75,282,37,30,747,2,7,756
9,10,9016,5016,3,284,215,234,34,30,797,1,10,808
9,10,9016,5017,3,439,148,342,39,35,1003,2,18,1023
9,10,9016,5018,3,429,113,350,51,38,981,2,11,994
9,10,9016,5019,3,293,107,346,39,26,811,0,14,825
9,10,9016,5020,3,373,113,316,30,39,871,0,15,886
9,10,9016,5021,3,562,129,426,54,28,1199,0,8,1207
9,10,9016,5022,3,470,136,508,60,45,1219,2,24,1245
9,10,9016,5023,3,416,112,448,48,60,1084,0,20,1104
9,10,9016,5024,3,395,105,368,38,37,943,2,16,961
9,10,9016,5025,3,365,82,332,29,26,834,1,14,849
9,10,9016,5026,3,365,143,366,51,27,952,4,17,973
9,10,9016,5027,3,224,52,260,30,33,599,1,8,608
9,10,9016,5028,3,378,112,412,63,44,1009,5,13,1027
9,10,9016,5029,3,253,99,436,38,31,857,0,8,865
9,10,9016,5030,3,270,92,452,36,34,884,7,5,896
9,10,9016,5031,3,254,69,322,36,26,707,2,8,717
9,10,9016,5032,3,289,57,197,32,15,590,1,7,598
9,10,9016,5033,3,333,98,265,44,34,774,2,11,787
9,10,9016,5034,3,276,77,299,36,31,719,1,9,729
9,10,9016,5035,3,345,122,431,45,25,968,0,12,980
9,10,9016,5036,3,266,119,449,51,29,914,1,13,928
9,10,9016,5037,3,361,155,485,63,20,1084,0,10,1094
9,10,9016,5038,3,253,93,374,30,29,779,2,14,795
9,10,9016,5039,3,341,119,502,33,35,1030,0,19,1049
9,10,9016,5040,3,256,65,377,31,26,755,1,14,770
9,10,9016,5041,3,336,99,429,54,35,953,0,21,974
9,10,9016,5042,3,354,126,426,39,38,983,1,17,1001
9,10,9016,5043,3,342,120,482,53,36,1033,0,6,1039
9,10,9016,5044,3,392,140,382,42,26,982,1,18,1001
9,10,9016,5045,3,340,131,458,62,26,1017,0,15,1032
9,10,9016,5046,3,232,114,390,47,32,815,3,10,828
9,10,9016,5047,3,229,111,285,32,16,673,5,17,695
9,10,9016,5048,3,340,104,382,58,22,906,5,6,917
9,10,9016,5049,3,413,118,501,55,32,1119,1,17,1137
9,10,9016,5050,3,305,86,444,49,18,902,0,29,931
9,10,9016,5051,3,457,87,570,65,32,1211,4,23,1238
9,10,9016,5052,3,244,117,455,41,21,878,2,18,898
9,10,9016,5053,3,146,55,289,23,20,533,1,12,546
9,10,9016,5054,3,171,55,417,34,19,696,1,14,711
9,10,9016,5055,3,388,117,614,64,32,1215,0,16,1231
9,10,9016,5056,3,368,132,546,52,27,1125,2,13,1140
9,10,9016,5057,3,161,86,394,34,20,695,0,4,699
9,10,9016,5058,3,247,105,532,49,32,965,3,19,987
9,10,9016,5059,3,237,105,372,45,25,784,0,18,802
9,10,9016,5060,3,336,124,586,61,20,1127,3,19,1149
9,10,9016,5061,3,278,108,492,38,19,935,1,12,948
9,10,9016,5062,3,317,94,488,35,17,951,2,30,983
9,10,9016,5063,3,297,131,546,33,27,1034,7,15,1056
9,10,9016,5064,3,235,126,591,47,27,1026,1,20,1047
9,10,9016,5065,3,232,97,462,54,16,861,3,7,871
9,10,9016,5066,3,558,120,219,39,39,975,5,7,987
9,10,9016,5067,3,333,71,215,21,22,662,0,10,672
9,10,9016,5068,3,413,124,411,37,30,1015,2,13,1030
9,10,9016,5069,3,240,109,659,38,33,1079,2,3,1084
9,10,9016,5070,3,247,107,537,38,22,951,2,16,969
9,10,9016,5071,3,274,88,490,38,18,908,0,21,929
9,10,9016,5072,3,303,129,486,53,25,996,2,14,1012
9,10,9016,5073,3,200,77,315,25,25,642,1,7,650
9,10,9016,5074,3,258,99,421,43,11,832,6,9,847
9,10,9016,5075,3,264,72,427,25,25,813,3,6,822
9,10,9016,5076,3,229,66,308,37,13,653,0,8,661
9,10,9016,5077,3,304,85,411,34,27,861,3,15,879
9,10,9016,5078,3,259,88,387,39,20,793,2,16,811
9,10,9016,5079,3,353,62,127,16,25,583,1,10,594
9,10,9016,5080,3,449,62,97,22,17,647,0,10,657
9,10,9016,5081,3,281,63,248,18,14,624,0,8,632
9,10,9016,5082,3,360,87,96,25,13,581,1,3,585
9,10,9016,5083,3,417,87,139,15,32,690,1,9,700
9,10,9016,5084,3,206,65,202,17,18,508,0,11,519
9,10,9016,5085,3,293,67,211,24,20,615,0,9,624
9,10,9016,5086,3,278,71,211,15,18,593,0,10,603
9,10,9016,5087,3,267,58,185,25,16,551,1,9,561
9,10,9016,5088,3,320,70,234,27,9,660,1,4,665
9,10,9016,5089,3,267,61,259,26,18,631,1,6,638
9,10,9016,5090,3,284,74,214,15,16,603,0,6,609
9,10,9016,5091,3,29,72,30,4,5,140,0,3,143
9,10,9016,5092,3,5,8,5,1,0,19,0,0,19
9,10,9016,5093,3,16,5,15,3,1,40,0,0,40
9,10,9016,5094,3,31,28,25,0,5,89,0,3,92
9,10,9016,5095,3,39,36,35,3,3,116,0,0,116
9,10,9016,5096,3,36,57,23,14,5,135,0,3,138
9,10,9016,5097,3,56,93,51,10,2,212,0,0,212
9,10,9016,5098,3,126,57,293,31,9,516,2,9,527
9,10,9016,5099,3,211,57,278,35,22,603,4,8,615
9,10,9016,5100,3,103,45,206,16,11,381,0,3,384
9,10,9016,5101,3,162,76,299,16,20,573,0,7,580
9,10,9016,5102,3,223,31,61,13,15,343,2,0,345
9,10,9016,5103,3,148,49,244,16,7,464,0,7,471
9,10,9016,5104,3,693,104,669,66,53,1585,4,18,1607
9,10,9016,5105,3,332,123,443,52,30,980,0,11,991
9,10,9016,5106,3,395,142,487,54,46,1124,0,9,1133
9,10,9016,5107,3,519,198,749,59,52,1577,1,15,1593
9,10,9016,5108,3,258,86,499,34,16,893,2,16,911
9,10,9016,5109,3,249,136,489,47,21,942,3,7,952
9,10,9016,5110,3,232,109,241,39,32,653,1,9,663
9,10,9016,5111,3,217,55,276,29,26,603,0,9,612
9,10,9016,5112,3,335,165,509,48,25,1082,2,11,1095
9,10,9016,5113,3,242,102,463,35,30,872,2,14,888
9,10,9016,5114,3,288,102,551,40,23,1004,5,20,1029
9,10,9016,5115,3,87,22,177,16,9,311,3,10,324
9,10,9016,5116,3,62,34,151,14,4,265,0,5,270
9,10,9016,5117,3,274,151,781,69,33,1308,3,23,1334
9,10,9016,5118,3,297,127,538,68,29,1059,0,22,1081
9,10,9016,5119,3,277,124,474,57,17,949,1,22,972
9,10,9016,5120,3,345,113,508,47,39,1052,1,10,1063
9,10,9016,5121,3,505,142,569,82,39,1337,1,17,1355
9,10,9016,5122,3,225,86,311,27,18,667,0,13,680
9,10,9016,5123,3,272,109,457,59,27,924,5,19,948
9,10,9016,5124,3,358,108,522,60,30,1078,0,14,1092
9,10,9016,5125,3,164,47,242,33,19,505,0,10,515
9,10,9016,5126,3,176,70,298,36,13,593,2,12,607
9,10,9016,5127,3,267,81,361,40,27,776,0,22,798
9,10,9016,5128,3,301,130,462,58,36,987,3,12,1002
9,10,9016,5129,3,337,128,572,49,31,1117,4,22,1143
9,10,9016,5130,3,258,98,523,65,30,974,3,11,988
9,10,9016,5131,3,208,97,476,38,15,834,6,19,859
9,10,9016,5132,3,304,113,506,44,18,985,4,16,1005
9,10,9016,5133,3,266,95,434,58,19,872,4,15,891
9,10,9016,5134,3,424,101,403,42,26,996,1,16,1013
9,10,9016,5135,3,144,83,504,46,23,800,0,17,817
9,10,9016,5136,3,242,91,333,34,26,726,1,10,737
9,10,9016,5137,3,228,111,288,46,27,700,0,8,708
9,10,9016,5138,3,346,140,570,58,35,1149,1,20,1170
9,10,9016,5139,3,302,99,415,47,36,899,1,10,910
9,10,9016,5140,3,281,141,576,42,20,1060,3,23,1086
9,10,9016,5141,3,316,131,665,76,29,1217,5,27,1249
9,10,9016,5142,3,300,80,466,47,43,936,0,23,959
9,10,9016,5143,3,337,138,572,63,38,1148,3,19,1170
9,10,9016,5144,3,214,75,517,45,30,881,4,12,897
9,10,9016,5145,3,313,117,555,65,39,1089,2,21,1112
9,10,9016,5146,3,271,112,467,45,30,925,2,9,936
9,10,9016,5147,3,235,58,451,28,14,786,2,17,805
9,10,9016,5148,3,290,40,354,34,23,741,0,11,752
9,10,9016,5149,3,248,77,232,38,13,608,0,25,633
9,10,9016,5150,3,226,83,444,46,18,817,3,15,835
9,10,9016,5151,3,287,118,527,45,36,1013,1,16,1030
9,10,9016,5152,3,271,95,452,52,20,890,0,33,923
9,10,9016,5153,3,267,123,352,45,12,799,0,29,828
9,10,9016,5154,3,223,120,429,75,22,869,1,18,888
9,10,9016,5155,3,336,111,312,44,38,841,3,10,854
9,10,9016,5156,3,236,74,331,30,20,691,5,8,704
9,10,9016,5157,3,359,114,585,45,23,1126,7,13,1146
9,10,9016,5158,3,256,96,340,55,25,772,2,14,788
9,10,9016,5159,3,410,71,95,12,15,603,1,5,609
9,10,9016,5160,3,434,76,68,22,16,616,1,6,623
9,10,9016,5161,3,288,49,93,14,15,459,0,4,463
9,10,9016,5162,3,536,163,149,23,23,894,2,14,910
9,10,9016,5163,3,263,55,71,15,22,426,5,5,436
9,10,9016,5164,3,347,91,110,12,16,576,0,9,585
9,10,9016,5165,3,378,96,173,24,25,696,0,4,700
9,10,9016,5166,3,330,73,201,25,28,657,1,14,672
9,10,9016,5167,3,415,86,125,22,21,669,2,8,679
9,10,9016,5168,3,350,82,56,15,19,522,2,9,533
9,10,9016,5169,3,385,80,82,23,22,592,0,8,600
9,10,9016,5170,3,372,71,91,11,14,559,0,9,568
9,10,9016,5171,3,367,99,57,10,20,553,1,8,562
9,10,9016,5172,3,327,90,89,14,15,535,0,7,542
9,10,9016,5173,3,301,78,66,22,14,481,1,8,490
9,10,9016,5174,3,339,63,79,15,15,511,1,5,517
9,10,9016,5175,3,375,70,107,19,17,588,4,4,596
9,10,9016,5176,3,292,71,98,22,14,497,0,4,501
9,10,9016,5177,3,409,82,133,20,29,673,4,3,680
9,10,9016,5178,3,377,111,128,29,17,662,0,8,670
9,10,9016,5179,3,247,84,57,7,9,404,0,3,407
9,10,9016,5180,3,370,87,71,22,15,565,0,9,574
9,10,9016,5181,3,299,104,65,8,18,494,0,10,504
9,10,9016,5182,3,175,102,311,41,37,666,0,10,676
9,11,9006,1833,3,251,87,532,61,31,962,0,17,979
9,11,9006,1834,3,155,63,412,49,10,689,0,12,701
9,11,9006,1835,3,158,72,395,46,19,690,1,11,702
9,11,9006,1836,3,181,92,471,66,32,842,3,17,862
9,11,9006,1837,3,224,164,671,78,50,1187,4,21,1212
9,11,9006,1838,3,159,108,486,36,23,812,1,16,829
9,11,9006,1839,3,219,127,595,71,38,1050,3,16,1069
9,11,9006,1840,3,138,70,429,34,28,699,2,17,718
9,11,9006,1841,3,144,76,450,65,38,773,0,22,795
9,11,9006,1842,3,189,60,507,26,33,815,0,10,825
9,11,9006,1843,3,117,50,344,39,21,571,0,16,587
9,11,9006,1844,3,148,65,319,51,23,606,1,8,615
9,11,9006,1854,3,162,62,378,39,13,654,0,13,667
9,11,9006,1855,3,168,84,469,51,24,796,3,14,813
9,11,9006,1856,3,170,69,342,30,30,641,1,16,658
9,11,9006,1857,3,189,86,391,52,30,748,0,15,763
9,11,9006,1858,3,190,86,519,53,30,878,0,21,899
9,11,9006,1859,3,184,76,557,68,43,928,0,3,931
9,11,9006,1860,3,185,101,443,52,27,808,0,19,827
9,11,9006,1861,3,246,105,517,53,23,944,4,15,963
9,11,9006,1862,3,184,75,611,61,39,970,0,32,1002
9,11,9006,1863,3,114,62,360,42,28,606,1,9,616
9,11,9006,1864,3,128,70,387,36,24,645,0,15,660
9,11,9006,1865,3,122,75,333,37,29,596,0,18,614
9,11,9006,1866,3,159,96,329,40,21,645,7,3,655
9,11,9006,1867,3,185,81,442,51,26,785,1,17,803
9,11,9006,1868,3,181,78,461,49,41,810,0,14,824
9,11,9006,1882,3,150,88,295,35,20,588,1,5,594
9,11,9006,1883,3,216,116,539,61,42,974,0,11,985
9,11,9006,1884,3,144,96,401,55,25,721,1,3,725
9,11,9006,1885,3,197,72,492,58,31,850,1,4,855
9,11,9006,1886,3,46,30,220,30,11,337,1,8,346
9,11,9006,1887,3,145,96,373,38,22,674,3,16,693
9,11,9006,1888,3,170,78,470,44,20,782,0,9,791
9,11,9006,1889,3,270,78,531,54,39,972,0,20,992
9,11,9006,1890,3,182,90,507,45,26,850,4,4,858
9,11,9006,1891,3,249,117,603,58,29,1056,1,13,1070
9,11,9006,1892,3,148,93,548,52,40,881,0,30,911
9,11,9006,1893,3,247,125,474,62,47,955,3,20,978
9,11,9006,1894,3,165,56,371,27,12,631,4,13,648
9,11,9006,1895,3,183,80,506,39,22,830,4,3,837
9,11,9006,1896,3,209,100,513,44,32,898,0,18,916
9,11,9006,1897,3,158,80,409,43,17,707,2,13,722
9,11,9006,1898,3,174,94,521,61,34,884,5,11,900
9,11,9006,1899,3,115,77,376,44,22,634,5,8,647
9,11,9006,1900,3,218,56,412,42,26,754,2,3,759
9,11,9006,1901,3,94,56,293,31,16,490,1,8,499
9,11,9006,1902,3,226,116,495,54,39,930,4,13,947
9,11,9006,1904,3,153,93,522,64,29,861,3,12,876
9,11,9006,1905,3,206,84,374,48,23,735,3,11,749
9,11,9006,1906,3,168,113,451,49,34,815,0,15,830
9,11,9006,1907,3,166,92,510,55,31,854,2,15,871
9,11,9006,1908,3,92,49,355,43,24,563,0,18,581
9,11,9006,1909,3,181,108,543,50,33,915,3,19,937
9,11,9006,1910,3,112,64,359,35,13,583,2,5,590
9,11,9006,1911,3,123,77,373,28,22,623,6,8,637
9,11,9006,1912,3,110,80,274,33,34,531,0,16,547
9,11,9006,1913,3,167,72,634,64,32,969,2,25,996
9,11,9006,1914,3,125,64,359,41,30,619,1,11,631
9,11,9006,1915,3,98,57,282,38,20,495,2,12,509
9,11,9006,1916,3,211,117,539,67,37,971,2,25,998
9,11,9006,1917,3,102,70,389,44,18,623,3,4,630
9,11,9006,1918,3,156,79,502,65,34,836,0,18,854
9,11,9006,1919,3,168,64,286,41,27,586,5,12,603
9,11,9006,1920,3,97,59,319,22,17,514,1,9,524
9,11,9006,1921,3,271,224,553,70,50,1168,8,10,1186
9,11,9006,1922,3,181,47,456,57,20,761,1,17,779
9,11,9006,1923,3,153,77,337,42,14,623,0,1,624
9,11,9006,1924,3,299,125,532,60,32,1048,2,18,1068
9,11,9006,1925,3,168,65,288,38,35,594,2,12,608
9,11,9006,1926,3,202,58,496,45,26,827,0,9,836
9,11,9006,1927,3,187,97,379,53,28,744,4,11,759
9,11,9006,1928,3,183,73,380,63,29,728,4,13,745
9,11,9006,1929,3,201,62,418,46,30,757,6,19,782
9,11,9006,1930,3,168,65,345,35,33,646,1,9,656
9,11,9006,1931,3,379,171,783,100,65,1498,0,7,1505
9,11,9006,1932,3,169,99,346,39,25,678,6,8,692
9,11,9006,1933,3,134,108,292,37,17,588,0,5,593
9,11,9006,1934,3,211,89,336,74,34,744,4,11,759
9,11,9006,1935,3,140,44,230,32,17,463,3,12,478
9,11,9006,1936,3,245,113,400,49,39,846,5,12,863
9,11,9006,1937,3,266,127,520,81,45,1039,2,10,1051
9,11,9006,1938,3,181,129,462,69,37,878,2,9,889
9,11,9006,1939,3,231,92,451,67,37,878,1,11,890
9,11,9006,1940,3,187,54,357,47,11,656,1,8,665
9,11,9006,1941,3,145,57,360,40,29,631,0,5,636
9,11,9006,1942,3,178,105,411,62,29,785,2,9,796
9,11,9006,1943,3,346,160,818,92,78,1494,1,27,1522
9,11,9006,1944,3,197,89,399,37,37,759,1,12,772
9,11,9017,5339,3,267,97,484,64,31,943,3,22,968
9,11,9017,5360,3,305,81,262,32,39,719,1,9,729
9,11,9017,5361,3,380,129,426,64,48,1047,5,21,1073
9,11,9017,5362,3,436,120,280,36,31,903,4,16,923
9,11,9017,5363,3,482,137,358,60,36,1073,2,17,1092
9,11,9017,5364,3,380,164,397,63,39,1043,3,14,1060
9,11,9017,5365,3,264,158,376,70,42,910,0,21,931
9,11,9017,5366,3,410,184,394,59,57,1104,4,18,1126
9,11,9017,5367,3,365,117,256,50,33,821,5,15,841
9,11,9017,5368,3,385,127,375,52,32,971,0,7,978
9,11,9017,5369,3,498,163,379,58,39,1137,1,9,1147
9,11,9017,5371,3,367,94,352,78,33,924,4,8,936
9,11,9017,5378,3,389,119,217,40,28,793,0,6,799
9,11,9017,5379,3,323,181,333,50,39,926,2,14,942
9,11,9017,5380,3,262,112,380,59,37,850,1,7,858
9,11,9017,5381,3,317,124,453,64,44,1002,0,15,1017
9,11,9017,5388,3,249,94,592,68,30,1033,8,8,1049
9,11,9017,5389,3,223,83,318,35,29,688,1,7,696
9,11,9017,5390,3,309,92,271,39,45,756,4,5,765
9,11,9017,5391,3,171,62,248,28,18,527,3,12,542
9,11,9017,5392,3,261,169,506,83,33,1052,0,14,1066
9,11,9017,5393,3,189,59,312,34,18,612,2,10,624
9,11,9017,5394,3,228,116,616,53,46,1059,1,26,1086
9,11,9017,5397,3,115,50,199,27,22,413,0,10,423
9,11,9017,5398,3,98,44,251,31,15,439,0,9,448
9,11,9017,5399,3,174,61,134,36,18,423,1,5,429
9,11,9017,5403,3,249,111,535,52,42,989,3,8,1000
9,11,9017,5404,3,137,68,307,37,17,566,2,7,575
9,11,9017,5405,3,147,87,363,48,21,666,1,21,688
9,11,9017,5406,3,155,52,366,38,24,635,0,14,649
9,11,9017,5407,3,188,111,491,66,33,889,3,14,906
9,11,9017,5419,3,185,87,531,50,32,885,5,17,907
9,11,9017,5420,3,175,94,513,66,25,873,1,25,899
9,11,9017,5423,3,112,51,342,35,24,564,1,7,572
9,11,9017,5424,3,181,87,393,46,21,728,2,10,740
9,11,9017,5425,3,146,68,404,42,20,680,3,21,704
9,11,9017,5426,3,137,72,281,28,19,537,0,12,549
9,11,9017,5427,3,91,67,267,24,22,471,2,12,485
9,11,9017,5428,3,205,129,519,82,46,981,10,8,999
9,11,9017,5429,3,192,112,538,67,32,941,2,33,976
9,11,9017,5430,3,94,53,287,36,12,482,3,9,494
9,11,9017,5431,3,231,144,627,86,38,1126,2,23,1151
9,11,9017,5432,3,78,66,304,57,10,515,1,11,527
9,11,9017,5433,3,70,70,413,51,20,624,4,8,636
9,11,9017,5434,3,74,104,388,51,25,642,1,10,653
9,11,9017,5435,3,82,65,249,42,18,456,0,12,468
9,11,9017,5436,3,168,114,553,78,38,951,2,15,968
9,11,9017,5437,3,118,91,410,70,37,726,0,22,748
9,11,9017,5438,3,97,53,293,66,15,524,2,17,543
9,11,9017,5439,3,228,152,683,73,51,1187,7,18,1212
9,11,9017,5440,3,217,133,571,57,27,1005,5,32,1042
9,11,9017,5441,3,196,108,612,51,38,1005,1,18,1024
9,11,9017,5442,3,118,97,368,46,23,652,1,12,665
9,11,9017,5443,3,152,113,548,49,22,884,1,15,900
9,11,9017,5444,3,184,111,574,66,33,968,1,18,987
9,11,9017,5445,3,212,60,442,36,37,787,2,8,797
9,11,9017,5446,3,200,106,557,56,39,958,4,21,983
9,11,9017,5447,3,226,160,623,79,29,1117,6,17,1140
9,11,9017,5448,3,198,108,457,48,24,835,1,12,848
9,11,9017,5449,3,117,71,413,39,32,672,0,15,687
9,11,9017,5450,3,135,81,443,40,36,735,5,20,760
9,11,9017,5451,3,243,129,590,95,50,1107,3,23,1133
9,11,9017,5452,3,204,114,596,104,46,1064,7,16,1087
9,11,9017,5453,3,178,116,525,64,21,904,6,23,933
9,11,9017,5454,3,182,84,484,52,40,842,4,20,866
9,11,9017,5455,3,140,82,393,47,25,687,3,11,701
9,11,9017,5456,3,237,123,591,81,43,1075,1,21,1097
9,11,9017,5457,3,193,125,499,71,33,921,3,10,934
9,11,9017,5458,3,104,48,221,13,5,391,2,9,402
9,11,9017,5459,3,151,46,285,54,29,565,0,16,581
9,11,9017,5460,3,185,133,405,64,34,821,0,19,840
9,11,9017,5461,3,214,95,403,56,23,791,2,8,801
9,11,9017,5462,3,310,135,360,56,34,895,1,10,906
9,11,9017,5463,3,344,111,363,62,61,941,2,10,953
9,11,9017,5464,3,278,130,518,61,56,1043,4,18,1065
9,11,9017,5465,3,328,146,500,71,46,1091,1,13,1105
9,11,9017,5466,3,196,75,376,34,21,702,2,10,714
9,11,9017,5467,3,146,69,230,37,9,491,2,6,499
9,11,9017,5468,3,210,110,357,46,31,754,0,12,766
9,11,9017,5469,3,258,136,392,56,41,883,4,7,894
9,11,9017,5470,3,272,107,505,48,49,981,0,17,998
9,11,9017,5471,3,217,102,359,48,35,761,0,13,774
9,11,9017,5472,3,214,103,360,46,26,749,4,8,761
9,11,9017,5473,3,211,115,387,49,31,793,4,19,816
9,11,9017,5474,3,193,131,452,85,41,902,3,23,928
9,11,9017,5475,3,199,115,450,88,30,882,7,8,897
9,11,9017,5476,3,156,70,346,39,18,629,1,2,632
9,11,9017,5477,3,226,131,434,62,31,884,5,11,900
9,11,9017,5478,3,277,135,563,75,43,1093,4,15,1112
9,11,9017,5479,3,144,109,286,43,20,602,0,10,612
9,11,9017,5480,3,241,114,352,62,23,792,3,7,802
9,11,9017,5481,3,227,107,507,72,39,952,0,11,963
9,11,9017,5482,3,181,102,334,62,34,713,0,17,730
9,11,9017,5483,3,167,70,270,49,19,575,3,10,588
9,11,9017,5484,3,261,136,423,88,39,947,1,14,962
9,11,9017,5485,3,236,107,406,59,41,849,0,24,873
9,11,9017,5486,3,230,105,387,42,27,791,1,9,801
9,11,9017,5487,3,195,93,431,57,22,798,0,13,811
9,11,9017,5488,3,239,107,408,71,33,858,2,17,877
9,11,9017,5489,3,266,128,511,75,36,1016,0,19,1035
9,11,9017,5490,3,229,57,340,56,32,714,0,13,727
9,11,9017,5491,3,287,110,468,113,27,1005,3,25,1033
9,11,9017,5492,3,304,127,443,65,34,973,6,15,994
9,11,9017,5494,3,92,50,178,25,13,358,1,10,369
9,11,9017,5495,3,196,90,297,50,14,647,5,17,669
9,11,9017,5496,3,119,26,187,26,18,376,0,4,380
9,11,9017,5497,3,139,91,387,55,23,695,1,15,711
9,11,9017,5498,3,118,57,323,68,13,579,0,11,590
9,11,9017,5499,3,85,55,334,29,11,514,0,17,531
9,11,9017,5500,3,119,87,281,32,16,535,3,10,548
9,11,9017,5501,3,44,123,45,21,6,239,0,6,245
9,11,9017,5502,3,135,81,381,32,21,650,1,12,663
9,11,9017,5520,3,44,57,137,17,8,263,0,5,268
9,11,9017,5521,3,46,32,164,18,7,267,0,0,267
9,11,9017,5522,3,60,45,146,12,14,277,0,5,282
9,11,9017,5523,3,43,49,161,22,7,282,0,5,287
9,11,9017,5524,3,67,33,278,18,12,408,0,4,412
9,11,9017,5525,3,54,21,132,23,5,235,0,4,239
9,11,9017,5526,3,48,48,194,16,4,310,2,1,313
9,11,9017,5527,3,73,98,110,28,20,329,0,3,332
9,12,9015,4523,3,289,153,464,43,34,983,0,19,1002
9,12,9015,4524,3,266,102,291,25,34,718,0,19,737
9,12,9015,4525,3,394,116,290,26,58,884,0,18,902
9,12,9015,4526,3,223,85,222,20,34,584,0,12,596
9,12,9015,4527,3,365,108,333,33,54,893,1,16,910
9,12,9015,4528,3,273,89,317,25,52,756,1,11,768
9,12,9015,4529,3,245,92,255,24,34,650,0,13,663
9,12,9015,4530,3,244,65,211,20,47,587,0,8,595
9,12,9015,4531,3,234,96,277,27,30,664,0,7,671
9,12,9015,4532,3,409,130,321,42,60,962,0,15,977
9,12,9015,4533,3,234,63,220,15,43,575,0,6,581
9,12,9015,4534,3,228,68,151,15,31,493,0,9,502
9,12,9015,4535,3,328,93,221,30,52,724,0,12,736
9,12,9015,4536,3,260,86,152,19,44,561,2,6,569
9,12,9015,4537,3,150,48,144,26,32,400,0,0,400
9,12,9015,4538,3,326,109,309,31,34,809,1,12,822
9,12,9015,4539,3,238,106,341,39,52,776,0,23,799
9,12,9015,4540,3,256,88,334,32,44,754,0,10,764
9,12,9015,4541,3,366,116,394,35,57,968,1,22,991
9,12,9015,4542,3,244,84,290,18,33,669,0,16,685
9,12,9015,4543,3,349,166,448,50,90,1103,2,7,1112
9,12,9015,4544,3,236,74,330,38,40,718,2,18,738
9,12,9015,4545,3,318,122,385,42,49,916,0,17,933
9,12,9015,4546,3,216,66,163,17,48,510,1,7,518
9,12,9015,4547,3,243,76,160,25,46,550,1,5,556
9,12,9015,4548,3,223,60,141,14,34,472,0,4,476
9,12,9015,4549,3,266,72,147,28,36,549,0,6,555
9,12,9015,4550,3,427,116,235,22,30,830,0,8,838
9,12,9015,4551,3,380,125,358,39,52,954,0,20,974
9,12,9015,4552,3,322,85,239,26,48,720,0,8,728
9,12,9015,4553,3,306,85,199,17,38,645,2,10,657
9,12,9015,4554,3,303,111,319,42,50,825,0,19,844
9,12,9015,4555,3,265,110,330,35,39,779,2,13,794
9,12,9015,4556,3,296,108,386,47,41,878,0,12,890
9,12,9015,4557,3,270,126,348,30,38,812,0,15,827
9,12,9015,4558,3,314,138,361,53,53,919,0,16,935
9,12,9015,4559,3,301,113,346,28,51,839,0,11,850
9,12,9015,4560,3,365,135,410,41,47,998,2,19,1019
9,12,9015,4561,3,193,57,121,23,26,420,0,4,424
9,12,9015,4562,3,196,59,128,14,47,444,1,0,445
9,12,9015,4563,3,294,79,231,25,46,675,0,16,691
9,12,9015,4564,3,280,96,230,43,50,699,2,10,711
9,12,9015,4565,3,283,74,176,21,52,606,3,7,616
9,12,9015,4566,3,189,47,124,21,28,409,0,7,416
9,12,9015,4567,3,214,51,115,8,20,408,0,5,413
9,12,9015,4568,3,330,95,151,21,32,629,0,14,643
9,12,9015,4569,3,212,66,132,16,30,456,0,7,463
9,12,9015,4570,3,368,89,244,25,57,783,1,9,793
9,12,9015,4571,3,165,46,117,13,24,365,0,13,378
9,12,9015,4572,3,280,120,173,28,51,652,1,10,663
9,12,9015,4573,3,406,127,314,31,29,907,1,18,926
9,12,9015,4574,3,311,113,320,32,35,811,0,19,830
9,12,9015,4575,3,342,122,451,32,43,990,0,16,1006
9,12,9015,4576,3,288,110,423,49,31,901,0,18,919
9,12,9015,4577,3,255,80,251,31,33,650,1,20,671
9,12,9015,4578,3,335,102,362,29,49,877,0,21,898
9,12,9015,4579,3,284,106,276,34,51,751,1,8,760
9,12,9015,4580,3,347,114,303,31,53,848,2,13,863
9,12,9015,4581,3,346,113,217,26,45,747,0,20,767
9,12,9015,4582,3,329,84,251,34,37,735,2,10,747
9,12,9015,4583,3,385,117,261,26,36,825,0,12,837
9,12,9015,4584,3,224,79,209,25,32,569,2,7,578
9,12,9015,4585,3,261,95,246,33,37,672,0,16,688
9,12,9015,4666,3,170,128,523,41,20,882,0,11,893
9,12,9015,4667,3,220,110,559,40,22,951,0,19,970
9,12,9015,4668,3,214,160,616,66,50,1106,0,28,1134
9,12,9015,4669,3,228,141,511,52,41,973,2,20,995
9,12,9015,4679,3,141,75,374,36,30,656,2,10,668
9,12,9015,4680,3,165,97,526,47,34,869,2,11,882
9,12,9015,4681,3,27,24,148,14,8,221,0,4,225
9,12,9015,4682,3,123,241,344,15,20,743,1,18,762
9,12,9015,4683,3,128,97,411,42,31,709,7,7,723
9,12,9015,4690,3,178,121,498,71,37,905,1,29,935
9,12,9015,4691,3,160,110,524,39,36,869,1,19,889
9,12,9015,4692,3,103,110,371,48,21,653,1,15,669
9,12,9015,4693,3,125,128,379,51,34,717,2,12,731
9,12,9015,4694,3,186,114,477,62,38,877,4,15,896
9,12,9015,4695,3,151,105,408,41,32,737,0,24,761
9,12,9015,4703,3,121,93,371,42,28,655,2,18,675
9,12,9015,4704,3,143,99,462,46,29,779,1,17,797
9,12,9015,4705,3,86,90,307,31,22,536,1,14,551
9,12,9015,4706,3,88,62,194,18,21,383,0,3,386
9,12,9015,4707,3,76,84,429,31,18,638,1,22,661
9,12,9015,4711,3,118,120,555,41,25,859,0,12,871
9,12,9015,4713,3,97,71,204,16,15,403,0,19,422
9,12,9015,4715,3,84,46,198,12,13,353,0,6,359
9,12,9015,4716,3,148,58,283,28,30,547,2,8,557
9,12,9015,4718,3,64,45,225,18,40,392,3,7,402
9,12,9015,4719,3,57,72,283,29,13,454,1,10,465
9,12,9015,4721,3,59,51,216,22,14,362,2,3,367
9,12,9015,4723,3,93,75,274,30,17,489,0,10,499
9,12,9015,4724,3,165,113,590,47,29,944,0,22,966
9,12,9015,4725,3,122,85,346,38,21,612,0,19,631
9,12,9015,4726,3,59,75,213,26,15,388,0,8,396
9,12,9015,4727,3,133,128,423,53,26,763,0,17,780
9,12,9015,4728,3,90,117,326,38,14,585,1,16,602
9,12,9015,4729,3,97,83,281,34,14,509,3,16,528
9,12,9015,4730,3,101,72,305,37,15,530,2,7,539
9,12,9015,4731,3,167,109,455,38,34,803,2,26,831
9,12,9015,4732,3,132,108,473,56,25,794,3,25,822
9,12,9015,4733,3,120,66,344,32,22,584,2,15,601
9,12,9015,4734,3,202,134,464,70,36,906,2,16,924
9,12,9015,4735,3,157,120,418,51,34,780,8,19,807
9,12,9015,4736,3,113,107,441,27,22,710,0,13,723
9,12,9015,4737,3,122,128,446,56,35,787,1,20,808
9,12,9015,4738,3,134,177,462,51,26,850,4,23,877
9,12,9015,4739,3,126,117,421,29,13,706,1,21,728
9,12,9015,4740,3,123,97,258,21,27,526,2,12,540
9,12,9015,4741,3,79,76,349,18,19,541,1,12,554
9,12,9015,4742,3,92,84,297,29,16,518,1,12,531
9,12,9015,4743,3,115,83,377,39,28,642,0,11,653
9,12,9015,4744,3,111,64,399,27,13,614,0,20,634
9,12,9015,4745,3,91,86,363,23,17,580,3,13,596
9,12,9015,4746,3,143,89,279,38,29,578,0,16,594
9,12,9015,4747,3,77,69,177,21,18,362,0,1,363
9,12,9015,4748,3,132,91,291,35,23,572,2,18,592
9,12,9015,4749,3,76,64,221,15,14,390,1,4,395
9,12,9015,4750,3,102,88,348,45,24,607,0,12,619
9,12,9015,4751,3,137,124,507,39,18,825,2,12,839
9,12,9015,4752,3,111,107,330,29,23,600,3,12,615
9,12,9015,4753,3,162,98,538,43,38,879,10,17,906
9,12,9015,4754,3,137,108,554,44,30,873,3,15,891
9,12,9015,4755,3,125,117,289,37,25,593,3,14,610
9,12,9015,4756,3,130,82,310,22,29,573,4,13,590
9,12,9015,4757,3,157,116,400,44,32,749,4,25,778
9,12,9015,4758,3,105,76,343,30,18,572,7,10,589
9,12,9015,4759,3,78,63,271,36,9,457,1,15,473
9,12,9015,4760,3,67,64,366,31,31,559,2,9,570
9,12,9015,4761,3,298,211,624,78,48,1259,1,36,1296
9,12,9015,4762,3,299,138,496,50,53,1036,0,13,1049
9,12,9015,4763,3,264,98,335,32,37,766,0,29,795
9,12,9015,4764,3,177,97,317,38,25,654,4,11,669
9,12,9015,4765,3,166,106,401,49,27,749,0,17,766
9,12,9015,4766,3,192,73,362,31,41,699,0,11,710
9,12,9015,4767,3,247,82,447,55,50,881,0,21,902
9,12,9015,4768,3,214,138,460,55,36,903,5,14,922
9,12,9015,4769,3,225,130,441,50,38,884,0,14,898
9,12,9015,4770,3,334,149,606,61,58,1208,1,23,1232
9,12,9015,4771,3,289,143,652,55,67,1206,0,18,1224
9,12,9015,4772,3,325,121,361,45,40,892,0,18,910
9,12,9015,4773,3,160,64,275,36,33,568,0,12,580
9,12,9015,4774,3,229,131,488,56,42,946,1,15,962
9,12,9015,4775,3,232,133,463,57,53,938,0,20,958
9,12,9015,4776,3,224,125,581,44,47,1021,0,32,1053
9,12,9015,4777,3,172,65,398,39,48,722,0,15,737
9,12,9015,4778,3,179,81,481,47,34,822,3,14,839
9,12,9015,4779,3,203,137,408,53,42,843,0,19,862
9,12,9015,4780,3,181,100,475,36,34,826,0,16,842
9,12,9015,4781,3,237,141,604,58,62,1102,3,15,1120
9,12,9015,4782,3,156,106,448,43,33,786,0,17,803
9,12,9015,4783,3,114,71,366,35,29,615,1,15,631
9,12,9015,4784,3,257,127,509,62,59,1014,0,23,1037
9,12,9015,4785,3,196,86,391,43,36,752,0,15,767
9,12,9015,4786,3,244,109,378,54,36,821,2,22,845
9,12,9015,4787,3,303,119,700,70,56,1248,3,29,1280
9,12,9015,4788,3,145,59,334,33,32,603,1,12,616
9,12,9015,4789,3,287,119,562,52,60,1080,0,25,1105
9,12,9015,4790,3,139,104,496,45,35,819,4,13,836
9,12,9015,4791,3,170,86,412,42,34,744,1,30,775
9,12,9015,4792,3,210,72,386,44,52,764,2,10,776
9,12,9015,4793,3,220,107,334,51,33,745,0,17,762
9,12,9015,4794,3,182,84,367,34,24,691,1,17,709
9,12,9015,4795,3,250,156,591,48,53,1098,1,13,1112
9,12,9015,4796,3,303,176,720,85,62,1346,1,33,1380
9,12,9015,4797,3,296,125,727,64,54,1266,3,30,1299
9,12,9015,4798,3,190,156,656,70,49,1121,3,20,1144
9,12,9015,4799,3,168,78,337,31,19,633,0,12,645
9,12,9015,4800,3,272,111,501,59,33,976,3,13,992
9,12,9015,4801,3,255,126,577,57,39,1054,3,16,1073
9,12,9015,4802,3,243,100,433,48,38,862,0,15,877
9,12,9015,4803,3,191,98,434,37,33,793,2,21,816
9,12,9015,4804,3,212,58,195,39,175,679,0,9,688
9,12,9015,4805,3,131,66,348,25,32,602,3,8,613
9,12,9015,4806,3,94,73,373,33,19,592,0,9,601
9,12,9015,4807,3,368,168,558,65,53,1212,3,18,1233
9,12,9015,4808,3,230,90,307,33,33,693,0,7,700
9,12,9015,4809,3,288,128,404,57,34,911,0,20,931
9,12,9015,4810,3,211,110,368,41,39,769,1,13,783
9,12,9015,4811,3,266,104,350,39,30,789,0,25,814
9,12,9015,4812,3,159,87,371,15,35,667,2,7,676
9,12,9015,4813,3,126,39,303,25,25,518,1,10,529
9,12,9015,4814,3,131,51,266,28,17,493,2,5,500
9,12,9015,4815,3,104,39,223,27,11,404,0,11,415
9,12,9015,4816,3,107,53,235,25,24,444,2,11,457
9,12,9015,4817,3,130,44,266,29,33,502,0,15,517
9,12,9015,4818,3,205,149,531,81,31,997,0,14,1011
9,12,9015,4819,3,176,117,800,52,32,1177,0,24,1201
9,12,9015,4820,3,165,127,470,32,17,811,0,26,837
9,12,9015,4821,3,166,86,427,38,27,744,0,9,753
9,12,9015,4822,3,301,169,669,74,44,1257,2,22,1281
9,12,9015,4830,3,93,46,333,17,15,504,1,13,518
9,12,9015,4837,3,123,60,302,21,17,523,1,9,533
9,12,9015,4838,3,106,74,192,15,18,405,0,8,413
9,12,9015,4839,3,106,94,252,26,15,493,4,18,515
9,12,9015,4840,3,151,104,447,37,27,766,2,12,780
9,12,9015,4841,3,149,122,401,42,27,741,0,23,764
9,12,9015,4842,3,126,110,363,17,27,643,3,21,667
9,12,9015,4843,3,151,80,310,40,17,598,3,23,624
9,12,9015,4844,3,163,99,436,26,33,757,0,16,773
9,12,9015,4845,3,172,92,401,46,38,749,0,20,769
9,12,9015,4846,3,137,99,468,30,31,765,2,12,779
9,12,9015,4847,3,104,54,245,19,19,441,1,5,447
9,12,9015,4848,3,190,111,402,43,36,782,1,21,804
9,12,9015,4849,3,124,77,310,21,26,558,1,9,568
9,12,9015,4850,3,187,113,458,44,39,841,0,3,844
9,12,9015,4851,3,202,149,460,45,32,888,0,23,911
9,12,9015,4852,3,235,117,404,31,51,838,0,21,859
9,12,9015,4865,3,204,86,254,31,27,602,1,19,622
9,12,9015,4866,3,230,130,407,43,49,859,0,20,879
9,12,9015,4867,3,119,100,376,32,26,653,4,12,669
9,12,9015,4868,3,84,64,317,23,17,505,0,15,520
9,12,9015,4869,3,156,117,416,39,39,767,0,22,789
9,12,9015,4870,3,269,173,374,23,47,886,2,17,905
9,12,9015,4871,3,290,102,259,36,53,740,1,10,751
9,12,9015,4872,3,303,135,386,36,40,900,2,13,915
9,12,9015,4873,3,99,42,90,10,6,247,0,6,253
9,12,9015,4882,3,136,63,149,28,28,404,0,5,409
9,12,9015,4883,3,135,43,115,13,15,321,0,4,325
9,12,9015,4884,3,205,63,138,16,24,446,0,5,451
9,12,9015,4886,3,176,84,188,20,32,500,0,14,514
9,12,9015,4887,3,74,45,169,15,14,317,0,0,317
9,12,9015,4888,3,144,79,288,28,18,557,1,10,568
9,12,9015,4890,3,69,51,251,17,31,419,3,6,428
9,12,9015,4891,3,211,127,573,60,45,1016,8,26,1050
9,12,9015,4892,3,267,186,614,71,49,1187,4,59,1250
9,12,9015,4893,3,241,202,643,69,57,1212,2,24,1238
9,12,9015,4894,3,202,139,552,59,49,1001,11,23,1035
9,12,9015,4895,3,243,146,451,48,38,926,1,12,939
9,12,9015,4896,3,236,134,287,45,38,740,1,8,749
9,12,9015,4897,3,182,144,527,55,55,963,0,6,969
9,12,9015,4898,3,252,122,332,42,33,781,0,13,794
9,12,9015,4899,3,319,103,389,37,43,891,0,10,901
9,12,9015,4900,3,165,110,416,49,27,767,1,18,786
9,12,9015,4901,3,163,108,355,40,35,701,0,16,717
9,12,9015,4902,3,204,72,356,43,27,702,0,11,713
9,12,9015,4903,3,244,112,330,33,29,748,0,14,762
9,12,9015,4904,3,312,96,334,46,47,835,0,12,847
9,12,9015,4905,3,324,155,291,44,41,855,0,14,869
9,12,9015,4906,3,223,84,436,47,50,840,0,20,860
9,12,9015,4907,3,314,95,450,47,40,946,0,27,973
9,12,9015,4908,3,251,123,466,34,45,919,0,18,937
9,12,9015,4909,3,104,58,351,34,28,575,0,16,591
9,12,9015,4910,3,129,81,360,41,30,641,1,10,652
9,12,9015,4911,3,152,54,334,27,14,581,0,15,596
9,13,9006,1672,3,148,74,423,37,26,708,1,11,720
9,13,9006,1673,3,208,97,339,34,17,695,2,7,704
9,13,9006,1674,3,120,104,315,29,29,597,1,12,610
9,13,9006,1675,3,282,135,574,74,38,1103,0,21,1124
9,13,9006,1676,3,156,88,442,43,25,754,2,13,769
9,13,9006,1677,3,106,49,277,32,22,486,3,8,497
9,13,9006,1678,3,234,76,611,57,33,1011,2,9,1022
9,13,9006,1679,3,176,120,376,35,27,734,2,7,743
9,13,9006,1680,3,137,76,497,36,27,773,0,12,785
9,13,9006,1681,3,184,75,449,33,14,755,1,14,770
9,13,9006,1682,3,155,54,301,17,26,553,0,8,561
9,13,9006,1683,3,175,87,477,51,34,824,4,20,848
9,13,9006,1684,3,179,85,363,30,16,673,0,14,687
9,13,9006,1685,3,167,81,240,29,18,535,1,6,542
9,13,9006,1686,3,134,71,343,42,31,621,2,13,636
9,13,9006,1687,3,169,87,429,38,20,743,4,11,758
9,13,9006,1688,3,112,80,472,58,20,742,1,15,758
9,13,9006,1689,3,71,54,279,34,16,454,1,9,464
9,13,9006,1690,3,136,68,375,42,28,649,7,16,672
9,13,9006,1691,3,207,83,447,46,30,813,0,15,828
9,13,9006,1692,3,99,82,422,47,34,684,3,8,695
9,13,9006,1693,3,159,49,206,29,28,471,1,12,484
9,13,9006,1694,3,356,137,292,52,43,880,0,16,896
9,13,9006,1695,3,132,35,211,20,14,412,3,8,423
9,13,9006,1696,3,310,127,706,79,41,1263,15,13,1291
9,13,9006,1697,3,283,133,563,51,44,1074,3,24,1101
9,13,9006,1698,3,221,102,598,56,24,1001,2,18,1021
9,13,9006,1699,3,148,83,540,48,28,847,1,13,861
9,13,9006,1700,3,62,45,199,16,9,331,0,3,334
9,13,9006,1701,3,162,110,564,49,23,908,3,13,924
9,13,9006,1702,3,191,129,537,58,26,941,2,19,962
9,13,9006,1703,3,184,129,539,45,37,934,0,21,955
9,13,9006,1704,3,142,110,504,46,26,828,1,18,847
9,13,9006,1705,3,165,95,493,53,26,832,4,17,853
9,13,9006,1706,3,131,97,384,54,31,697,3,10,710
9,13,9006,1707,3,124,111,493,47,30,805,2,22,829
9,13,9006,1708,3,148,115,551,32,18,864,1,9,874
9,13,9006,1709,3,147,94,469,54,36,800,1,9,810
9,13,9006,1710,3,145,102,396,33,29,705,0,10,715
9,13,9006,1711,3,115,81,435,46,25,702,0,9,711
9,13,9006,1712,3,115,82,413,37,36,683,2,15,700
9,13,9006,1713,3,143,70,448,30,20,711,1,15,727
9,13,9006,1714,3,80,91,419,47,16,653,0,13,666
9,13,9006,1715,3,118,80,372,42,19,631,0,8,639
9,13,9006,1716,3,142,70,472,21,46,751,0,8,759
9,13,9006,1717,3,149,94,478,53,27,801,3,14,818
9,13,9006,1718,3,185,99,508,39,22,853,4,15,872
9,13,9006,1719,3,146,94,440,35,26,741,3,7,751
9,13,9006,1720,3,138,109,569,48,24,888,2,12,902
9,13,9006,1721,3,151,126,429,42,21,769,3,13,785
9,13,9006,1722,3,116,80,378,37,23,634,0,14,648
9,13,9006,1723,3,140,108,497,46,36,827,0,10,837
9,13,9006,1724,3,187,99,444,34,27,791,1,15,807
9,13,9006,1725,3,185,114,454,43,31,827,0,13,840
9,13,9006,1726,3,111,96,484,40,29,760,1,5,766
9,13,9006,1727,3,159,96,432,46,25,758,1,26,785
9,13,9006,1728,3,126,111,427,35,24,723,1,29,753
9,13,9006,1729,3,137,70,507,33,28,775,2,14,791
9,13,9006,1730,3,194,103,587,56,33,973,1,14,988
9,13,9006,1731,3,207,91,642,58,31,1029,0,30,1059
9,13,9006,1732,3,202,83,471,46,28,830,0,13,843
9,13,9006,1733,3,152,66,415,46,23,702,1,12,715
9,13,9006,1734,3,191,103,620,48,21,983,0,25,1008
9,13,9006,1735,3,161,85,390,39,31,706,2,12,720
9,13,9006,1736,3,189,93,609,40,27,958,3,18,979
9,13,9006,1737,3,158,99,520,43,32,852,2,13,867
9,13,9006,1738,3,119,71,457,38,20,705,1,10,716
9,13,9006,1739,3,75,47,254,32,11,419,0,8,427
9,13,9006,1740,3,218,105,478,44,39,884,3,25,912
9,13,9006,1741,3,191,92,419,38,29,769,0,6,775
9,13,9006,1742,3,197,97,542,43,38,917,5,14,936
9,13,9006,1743,3,138,111,619,37,32,937,6,22,965
9,13,9006,1744,3,153,125,562,36,32,908,5,16,929
9,13,9006,1745,3,137,94,424,40,18,713,1,20,734
9,13,9006,1746,3,145,101,447,51,38,782,3,9,794
9,13,9006,1747,3,120,97,390,39,21,667,3,4,674
9,13,9006,1748,3,157,91,444,41,31,764,1,17,782
9,13,9006,1749,3,132,100,491,48,30,801,3,18,822
9,13,9006,1750,3,127,102,448,36,25,738,0,13,751
9,13,9006,1751,3,157,85,430,45,37,754,1,20,775
9,13,9006,1752,3,160,124,509,43,22,858,1,18,877
9,13,9006,1753,3,156,97,544,48,26,871,0,27,898
9,13,9006,1754,3,177,113,782,47,32,1151,4,21,1176
9,13,9006,1755,3,166,101,556,46,22,891,4,9,904
9,13,9006,1756,3,110,88,361,50,28,637,0,19,656
9,13,9006,1757,3,103,68,421,40,14,646,1,14,661
9,13,9006,1758,3,135,79,489,41,33,777,2,18,797
9,13,9006,1759,3,110,63,344,27,20,564,5,12,581
9,13,9006,1760,3,34,15,104,13,6,172,0,1,173
9,13,9006,1761,3,97,82,439,28,24,670,14,15,699
9,13,9006,1762,3,153,119,577,52,27,928,4,14,946
9,13,9006,1763,3,159,90,467,41,27,784,9,15,808
9,13,9006,1764,3,265,122,447,60,38,932,6,17,955
9,13,9006,1765,3,233,118,428,49,47,875,4,13,892
9,13,9006,1766,3,142,103,450,56,25,776,0,18,794
9,13,9006,1767,3,116,123,498,41,33,811,3,11,825
9,13,9006,1768,3,238,129,722,62,45,1196,1,16,1213
9,13,9006,1769,3,168,101,498,53,25,845,2,18,865
9,13,9006,1770,3,187,140,697,63,43,1130,0,19,1149
9,13,9006,1771,3,199,166,593,44,36,1038,3,12,1053
9,13,9006,1772,3,286,152,603,56,50,1147,0,25,1172
9,13,9006,1773,3,286,92,300,36,21,735,0,3,738
9,13,9006,1774,3,334,89,347,47,35,852,1,6,859
9,13,9006,1775,3,209,67,190,24,24,514,0,7,521
9,13,9006,1776,3,269,169,533,82,35,1088,4,9,1101
9,13,9006,1777,3,232,146,287,39,22,726,0,14,740
9,13,9006,1778,3,233,109,285,45,24,696,0,7,703
9,13,9006,1779,3,167,113,435,63,23,801,3,23,827
9,13,9006,1780,3,211,121,681,45,38,1096,7,15,1118
9,13,9006,1781,3,228,107,564,54,24,977,3,7,987
9,13,9006,1782,3,181,88,527,70,29,895,0,15,910
9,13,9006,1783,3,203,107,626,46,28,1010,1,15,1026
9,13,9006,1784,3,204,120,664,57,33,1078,0,27,1105
9,13,9006,1785,3,263,79,468,65,41,916,3,15,934
9,13,9006,1786,3,245,126,504,54,36,965,1,23,989
9,13,9006,1787,3,292,104,545,58,35,1034,0,15,1049
9,13,9006,1788,3,234,106,355,41,26,762,0,9,771
9,13,9006,1789,3,193,106,521,48,31,899,1,18,918
9,13,9006,1790,3,285,86,380,40,22,813,1,10,824
9,13,9006,1791,3,281,139,554,66,42,1082,0,11,1093
9,13,9006,1792,3,244,107,464,46,31,892,2,12,906
9,13,9006,1793,3,154,70,483,51,36,794,1,15,810
9,13,9006,1794,3,143,75,539,50,29,836,1,23,860
9,13,9006,1795,3,97,94,406,30,16,643,1,7,651
9,13,9006,1796,3,146,114,519,49,25,853,0,16,869
9,13,9006,1797,3,198,88,441,49,29,805,4,10,819
9,13,9006,1798,3,139,120,456,47,32,794,3,13,810
9,13,9006,1799,3,231,119,418,44,32,844,3,10,857
9,13,9006,1800,3,238,104,376,69,24,811,3,9,823
9,13,9006,1801,3,233,96,408,69,18,824,1,13,838
9,13,9006,1802,3,176,139,500,65,38,918,7,31,956
9,13,9006,1803,3,222,140,509,64,47,982,5,11,998
9,13,9006,1804,3,256,120,485,52,39,952,1,13,966
9,13,9006,1805,3,176,73,437,45,29,760,2,23,785
9,13,9006,1806,3,174,92,519,57,23,865,1,14,880
9,13,9006,1807,3,191,93,523,61,35,903,1,22,926
9,13,9006,1808,3,163,112,627,41,29,972,1,24,997
9,13,9006,1809,3,131,101,627,68,28,955,6,20,981
9,13,9006,1810,3,149,90,733,58,32,1062,3,27,1092
9,13,9006,1811,3,218,132,771,65,34,1220,4,14,1238
9,13,9006,1812,3,189,133,855,35,48,1260,2,37,1299
9,13,9006,1813,3,284,205,446,20,14,969,0,26,995
9,13,9006,1814,3,301,102,247,29,24,703,0,9,712
9,13,9006,1815,3,447,131,309,36,42,965,0,18,983
9,13,9006,1816,3,227,74,107,18,10,436,2,3,441
9,13,9006,1817,3,300,74,203,24,28,629,2,8,639
9,13,9006,1818,3,131,13,56,8,6,214,0,10,224
9,13,9006,1819,3,482,115,256,25,26,904,1,13,918
9,13,9006,1820,3,369,123,294,31,32,849,0,14,863
9,13,9006,1821,3,341,103,202,32,33,711,1,12,724
9,13,9006,1822,3,318,133,291,29,30,801,0,10,811
9,13,9006,1823,3,313,123,264,31,26,757,1,11,769
9,13,9006,1824,3,330,112,233,33,31,739,1,17,757
9,13,9006,1825,3,277,89,226,27,15,634,0,13,647
9,13,9006,1826,3,397,130,268,39,30,864,0,14,878
9,13,9006,1827,3,71,65,323,33,19,511,1,6,518
9,13,9006,1828,3,66,34,175,12,19,306,1,5,312
9,13,9006,1829,3,152,53,167,13,10,395,0,2,397
9,13,9006,1830,3,497,136,341,41,32,1047,0,13,1060
9,13,9006,1831,3,188,105,459,43,36,831,1,9,841
9,13,9006,1832,3,201,150,551,55,45,1002,1,16,1019
9,13,9006,1845,3,230,103,597,75,34,1039,0,24,1063
9,13,9006,1846,3,139,82,431,37,31,720,3,12,735
9,13,9006,1847,3,80,59,410,55,26,630,1,9,640
9,13,9006,1848,3,151,63,362,33,29,638,1,8,647
9,13,9006,1849,3,119,79,395,49,30,672,1,10,683
9,13,9006,1850,3,166,62,432,21,16,697,1,9,707
9,13,9006,1851,3,189,107,571,43,32,942,0,5,947
9,13,9006,1852,3,126,64,433,28,29,680,3,13,696
9,13,9006,1853,3,163,90,464,75,18,810,1,9,820
9,13,9006,1869,3,233,123,586,61,37,1040,0,24,1064
9,13,9006,1870,3,206,107,547,63,33,956,3,13,972
9,13,9006,1871,3,89,71,363,28,14,565,1,13,579
9,13,9006,1872,3,112,46,223,22,12,415,0,5,420
9,13,9006,1873,3,106,84,393,33,30,646,2,8,656
9,13,9006,1874,3,138,89,498,54,35,814,2,17,833
9,13,9006,1875,3,186,104,514,65,17,886,4,16,906
9,13,9006,1876,3,168,127,536,54,27,912,4,20,936
9,13,9006,1877,3,121,68,424,39,21,673,0,10,683
9,13,9006,1878,3,190,83,452,37,37,799,1,8,808
9,13,9006,1879,3,209,103,572,57,42,983,0,21,1004
9,13,9006,1880,3,180,68,457,40,33,778,0,14,792
9,13,9006,1881,3,175,86,480,36,28,805,0,13,818
9,13,9006,1903,3,162,66,332,36,26,622,4,11,637
9,13,9006,1945,3,158,113,412,43,31,757,1,24,782
9,13,9006,1946,3,102,96,287,34,19,538,2,8,548
9,13,9006,1947,3,117,120,331,26,11,605,2,15,622
9,13,9006,1948,3,340,124,352,42,25,883,0,13,896
9,13,9006,1949,3,183,42,154,25,16,420,1,11,432
9,13,9006,1950,3,369,102,273,41,23,808,3,6,817
9,13,9006,1951,3,223,82,205,22,25,557,4,16,577
9,13,9006,1952,3,213,85,205,15,13,531,1,6,538
9,13,9006,1953,3,207,58,185,28,24,502,0,8,510
9,13,9006,1954,3,104,43,132,26,16,321,1,4,326
9,13,9006,1955,3,185,63,199,20,16,483,0,2,485
9,13,9006,1956,3,178,79,178,21,17,473,4,3,480
9,13,9006,1957,3,307,97,355,36,43,838,3,13,854
9,13,9006,1958,3,230,107,208,32,14,591,0,5,596
9,13,9006,1959,3,196,71,376,36,36,715,0,10,725
9,13,9006,1960,3,190,224,586,65,31,1096,14,28,1138
9,13,9006,1961,3,138,100,376,34,15,663,3,16,682
9,13,9006,1962,3,203,94,420,38,27,782,0,15,797
9,13,9006,1963,3,114,58,183,19,12,386,0,2,388
9,13,9006,1964,3,281,93,441,49,31,895,1,17,913
9,13,9006,1965,3,124,38,236,26,16,440,0,14,454
9,13,9006,1966,3,105,39,240,24,21,429,0,11,440
9,13,9006,1967,3,236,110,363,52,24,785,13,9,807
9,13,9006,1968,3,158,75,335,37,23,628,1,6,635
9,13,9006,1969,3,209,121,553,50,36,969,1,20,990
9,13,9006,1970,3,123,113,356,43,15,650,0,19,669
9,14,9012,3790,3,143,135,609,41,27,955,1,21,977
9,14,9012,3791,3,202,110,659,69,39,1079,0,15,1094
9,14,9012,3792,3,139,69,611,48,42,909,0,25,934
9,14,9012,3794,3,151,83,678,41,38,991,2,25,1018
9,14,9012,3795,3,161,58,664,33,32,948,0,18,966
9,14,9012,3796,3,182,102,675,39,31,1029,0,17,1046
9,14,9012,3797,3,218,136,564,50,44,1012,0,21,1033
9,14,9012,3798,3,177,101,631,46,38,993,0,27,1020
9,14,9012,3799,3,262,114,998,71,53,1498,0,36,1534
9,14,9012,3800,3,197,81,795,64,33,1170,2,28,1200
9,14,9012,3801,3,202,92,576,52,42,964,0,9,973
9,14,9012,3802,3,175,91,648,48,42,1004,0,20,1024
9,14,9012,3803,3,186,89,575,46,48,944,2,23,969
9,14,9012,3804,3,202,81,599,39,45,966,0,17,983
9,14,9012,3805,3,234,78,541,32,36,921,0,19,940
9,14,9012,3806,3,283,102,512,33,47,977,2,23,1002
9,14,9012,3808,3,432,83,216,26,29,786,0,10,796
9,14,9012,3809,3,322,112,701,42,45,1222,1,24,1247
9,14,9012,3810,3,220,80,531,37,30,898,0,21,919
9,14,9012,3811,3,198,68,478,41,28,813,0,17,830
9,14,9012,3812,3,270,87,690,42,37,1126,2,25,1153
9,14,9012,3813,3,204,113,698,40,46,1101,2,29,1132
9,14,9012,3814,3,198,71,731,44,45,1089,0,22,1111
9,14,9012,3815,3,146,62,536,42,23,809,0,14,823
9,14,9012,3816,3,178,99,874,62,48,1261,0,20,1281
9,14,9012,3817,3,208,92,791,53,38,1182,0,24,1206
9,14,9012,3818,3,182,86,769,46,41,1124,0,23,1147
9,14,9012,3819,3,145,61,481,33,27,747,0,7,754
9,14,9012,3820,3,202,78,647,54,33,1014,0,22,1036
9,14,9012,3821,3,158,98,534,21,24,835,1,2,838
9,14,9012,3822,3,165,70,525,42,23,825,1,19,845
9,14,9012,3823,3,286,102,592,46,42,1068,9,17,1094
9,14,9012,3824,3,312,117,493,48,52,1022,2,18,1042
9,14,9012,3825,3,458,88,264,28,33,871,2,10,883
9,14,9012,3826,3,202,82,667,62,50,1063,0,17,1080
9,14,9012,3827,3,294,87,659,63,56,1159,2,19,1180
9,14,9012,3828,3,226,85,673,44,45,1073,3,18,1094
9,14,9012,3854,3,173,54,215,37,23,502,0,4,506
9,14,9012,3855,3,179,74,593,70,29,945,0,23,968
9,14,9012,3856,3,330,117,759,65,46,1317,0,28,1345
9,14,9012,3857,3,266,125,800,70,39,1300,0,20,1320
9,14,9012,3858,3,259,122,720,43,76,1220,1,20,1241
9,14,9012,3859,3,211,99,585,63,36,994,1,17,1012
9,14,9012,3860,3,170,73,772,50,45,1110,1,17,1128
9,14,9012,3861,3,297,108,743,66,67,1281,4,28,1313
9,14,9012,3862,3,175,78,603,39,32,927,2,22,951
9,14,9012,3863,3,171,86,640,30,42,969,4,20,993
9,14,9012,3864,3,217,76,526,46,44,909,0,15,924
9,14,9012,3865,3,180,77,614,31,32,934,2,8,944
9,14,9012,3866,3,171,86,680,52,46,1035,0,19,1054
9,14,9012,3867,3,201,101,787,47,41,1177,4,30,1211
9,14,9012,3868,3,149,85,585,34,30,883,7,15,905
9,14,9012,3869,3,165,67,612,42,32,918,0,18,936
9,14,9012,3870,3,239,121,656,56,58,1130,4,25,1159
9,14,9012,3871,3,234,84,646,41,41,1046,0,16,1062
9,14,9012,3872,3,243,61,763,57,34,1158,0,18,1176
9,14,9012,3873,3,171,95,717,38,41,1062,1,27,1090
9,14,9012,3874,3,184,89,872,55,30,1230,0,23,1253
9,14,9012,3875,3,153,105,915,47,39,1259,1,37,1297
9,14,9012,3876,3,174,98,782,56,56,1166,1,29,1196
9,14,9012,3877,3,153,94,692,34,41,1014,0,17,1031
9,14,9012,3878,3,225,148,695,47,38,1153,3,30,1186
9,14,9012,3879,3,133,72,650,45,39,939,0,32,971
9,14,9012,3880,3,183,97,650,71,48,1049,2,27,1078
9,14,9012,3881,3,191,67,727,42,35,1062,1,21,1084
9,14,9012,3882,3,138,60,589,38,22,847,0,15,862
9,14,9012,3883,3,202,61,579,55,39,936,4,14,954
9,14,9012,3884,3,170,105,621,49,35,980,1,19,1000
9,14,9012,3885,3,208,120,767,44,69,1208,9,26,1243
9,14,9012,3886,3,10,9,65,5,2,91,0,0,91
9,14,9012,3887,3,30,20,131,4,11,196,1,3,200
9,14,9012,3888,3,90,69,425,34,34,652,0,7,659
9,14,9012,3889,3,325,154,1371,118,73,2041,1,40,2082
9,14,9012,3890,3,146,87,243,24,26,526,0,16,542
9,14,9012,3891,3,259,107,458,53,43,920,0,23,943
9,14,9012,3906,3,239,203,1118,103,67,1730,3,47,1780
9,14,9012,3907,3,79,104,215,51,31,480,0,10,490
9,14,9012,3908,3,295,164,924,91,89,1563,4,31,1598
9,14,9012,3916,3,237,108,587,54,58,1044,3,26,1073
9,14,9012,3917,3,86,63,428,36,29,642,0,14,656
9,14,9012,3918,3,238,86,658,50,56,1088,1,21,1110
9,14,9012,3919,3,233,52,628,51,40,1004,0,23,1027
9,14,9012,3920,3,72,43,266,36,18,435,1,9,445
9,14,9012,3921,3,309,190,1109,73,61,1742,3,32,1777
9,14,9012,3922,3,144,50,590,42,43,869,3,17,889
9,14,9012,3923,3,132,61,638,53,41,925,0,21,946
9,14,9012,3924,3,151,115,732,51,37,1086,1,28,1115
9,14,9012,3925,3,107,106,622,56,43,934,0,24,958
9,14,9012,3926,3,151,80,713,45,39,1028,0,19,1047
9,14,9012,3927,3,133,106,820,75,47,1181,3,33,1217
9,14,9012,3928,3,117,55,710,36,34,952,0,21,973
9,14,9012,3929,3,213,189,1241,113,58,1814,6,33,1853
9,14,9012,3930,3,227,122,1087,75,82,1593,4,23,1620
9,14,9012,3931,3,114,68,640,53,27,902,1,21,924
9,14,9012,3932,3,99,50,636,63,47,895,0,11,906
9,14,9012,3933,3,77,51,451,33,33,645,0,14,659
9,14,9012,3934,3,116,82,608,26,22,854,0,11,865
9,14,9012,3935,3,280,150,1223,90,63,1806,3,39,1848
9,14,9012,3936,3,99,105,527,34,28,793,1,29,823
9,14,9012,3937,3,107,84,434,46,38,709,1,19,729
9,14,9012,3938,3,300,102,658,48,67,1175,2,16,1193
9,14,9012,3953,3,255,128,674,50,44,1151,3,18,1172
9,14,9012,3954,3,207,101,559,51,47,965,2,14,981
9,14,9012,3955,3,255,81,958,76,51,1421,0,16,1437
9,14,9012,3958,3,365,216,1394,99,83,2157,1,48,2206
9,14,9012,3959,3,336,165,1003,67,88,1659,1,41,1701
9,14,9012,3960,3,205,85,602,40,50,982,0,27,1009
9,14,9012,3961,3,325,124,1038,62,69,1618,0,33,1651
9,14,9012,3962,3,376,191,1215,115,113,2010,1,46,2057
9,14,9012,3963,3,163,118,710,53,37,1081,0,9,1090
9,14,9012,3964,3,116,46,376,26,15,579,0,4,583
9,14,9012,3965,3,222,98,403,30,31,784,0,16,800
9,14,9012,3966,3,158,67,573,39,42,879,0,17,896
9,14,9012,3967,3,94,79,376,36,20,605,4,19,628
9,14,9012,3968,3,272,81,381,20,33,787,0,18,805
9,14,9012,3969,3,201,158,812,39,47,1257,1,40,1298
9,14,9012,3970,3,211,135,789,63,38,1236,0,21,1257
9,14,9012,3971,3,312,128,507,37,43,1027,3,15,1045
9,14,9012,3972,3,188,119,791,56,30,1184,1,39,1224
9,14,9012,3973,3,307,171,947,66,53,1544,2,39,1585
9,14,9012,3974,3,183,106,622,78,28,1017,1,23,1041
9,14,9012,3975,3,265,192,1060,66,54,1637,1,28,1666
9,14,9012,3976,3,154,88,613,36,39,930,0,29,959
9,14,9012,3977,3,130,87,645,46,24,932,1,23,956
9,14,9012,3978,3,166,140,774,64,37,1181,0,20,1201
9,14,9012,3979,3,110,114,652,44,29,949,1,26,976
9,14,9012,3980,3,141,164,705,120,39,1169,1,21,1191
9,14,9012,3981,3,362,251,1943,129,88,2773,20,67,2860
9,14,9012,3982,3,222,139,884,52,42,1339,0,27,1366
9,14,9012,3983,3,140,76,609,40,32,897,1,20,918
9,14,9012,3984,3,264,221,1617,96,66,2264,5,45,2314
9,14,9012,3985,3,170,111,872,55,36,1244,4,30,1278
9,14,9012,3986,3,330,179,1592,96,74,2271,6,48,2325
9,14,9012,3987,3,311,146,1346,72,62,1937,6,37,1980
9,14,9012,3988,3,197,167,832,69,42,1307,2,24,1333
9,14,9012,3989,3,201,109,707,31,35,1083,0,28,1111
9,14,9012,3990,3,226,142,953,55,40,1416,0,52,1468
9,14,9012,3991,3,336,247,1227,48,58,1916,6,47,1969
9,14,9012,3992,3,165,115,847,52,32,1211,2,35,1248
9,14,9012,3993,3,115,207,874,32,17,1245,1,40,1286
9,14,9012,3994,3,47,14,174,10,5,250,0,2,252
9,15,9014,4269,3,411,110,318,39,68,946,4,12,962
9,15,9014,4270,3,317,111,314,42,42,826,1,19,846
9,15,9014,4271,3,355,116,340,43,43,897,2,13,912
9,15,9014,4272,3,294,87,253,45,35,714,2,11,727
9,15,9014,4273,3,357,138,337,47,46,925,1,12,938
9,15,9014,4274,3,310,76,243,25,35,689,2,7,698
9,15,9014,4275,3,335,98,240,40,41,754,1,11,766
9,15,9014,4276,3,472,109,247,32,37,897,1,8,906
9,15,9014,4277,3,449,126,292,43,45,955,1,19,975
9,15,9014,4278,3,303,102,395,17,48,865,1,17,883
9,15,9014,4279,3,357,85,307,25,49,823,0,15,838
9,15,9014,4280,3,394,113,303,36,54,900,4,3,907
9,15,9014,4281,3,366,157,370,41,54,988,0,14,1002
9,15,9014,4282,3,375,111,283,44,54,867,0,7,874
9,15,9014,4283,3,386,127,365,43,57,978,1,4,983
9,15,9014,4284,3,458,133,415,46,67,1119,0,10,1129
9,15,9014,4285,3,407,133,328,56,66,990,1,15,1006
9,15,9014,4286,3,313,82,277,34,44,750,1,11,762
9,15,9014,4287,3,353,117,304,54,48,876,2,13,891
9,15,9014,4288,3,419,128,276,49,50,922,1,6,929
9,15,9014,4289,3,323,114,284,32,34,787,0,5,792
9,15,9014,4290,3,380,156,324,36,49,945,0,17,962
9,15,9014,4291,3,562,144,368,56,47,1177,1,17,1195
9,15,9014,4292,3,294,96,245,24,32,691,0,9,700
9,15,9014,4293,3,334,74,165,18,25,616,0,5,621
9,15,9014,4294,3,250,55,170,16,27,518,4,2,524
9,15,9014,4295,3,301,98,198,15,33,645,1,3,649
9,15,9014,4296,3,472,132,318,43,61,1026,0,21,1047
9,15,9014,4297,3,415,132,314,37,53,951,0,15,966
9,15,9014,4298,3,228,99,346,24,40,737,1,18,756
9,15,9014,4299,3,342,114,328,35,58,877,0,19,896
9,15,9014,4300,3,407,126,315,37,47,932,0,18,950
9,15,9014,4301,3,431,144,465,47,62,1149,0,15,1164
9,15,9014,4302,3,525,173,403,60,60,1221,4,12,1237
9,15,9014,4303,3,414,151,547,59,44,1215,3,24,1242
9,15,9014,4304,3,374,137,341,50,58,960,0,15,975
9,15,9014,4305,3,374,132,307,39,39,891,2,20,913
9,15,9014,4306,3,405,122,262,40,47,876,0,16,892
9,15,9014,4307,3,409,119,261,33,47,869,3,13,885
9,15,9014,4308,3,485,175,373,35,56,1124,1,12,1137
9,15,9014,4309,3,460,144,348,42,51,1045,2,10,1057
9,15,9014,4310,3,362,104,260,33,46,805,2,7,814
9,15,9014,4311,3,603,155,378,42,72,1250,0,23,1273
9,15,9014,4312,3,421,103,201,27,32,784,0,5,789
9,15,9014,4313,3,337,94,218,27,39,715,1,11,727
9,15,9014,4314,3,396,99,248,32,36,811,1,10,822
9,15,9014,4315,3,393,152,310,44,66,965,2,5,972
9,15,9014,4316,3,356,133,489,49,47,1074,2,10,1086
9,15,9014,4317,3,220,78,256,33,30,617,1,11,629
9,15,9014,4318,3,224,105,380,32,40,781,1,16,798
9,15,9014,4319,3,159,68,277,23,34,561,3,12,576
9,15,9014,4320,3,435,130,241,29,41,876,1,10,887
9,15,9014,4321,3,597,170,376,50,61,1254,2,12,1268
9,15,9014,4322,3,340,116,195,18,36,705,2,6,713
9,15,9014,4323,3,583,136,212,29,33,993,1,14,1008
9,15,9014,4324,3,448,103,162,18,25,756,0,12,768
9,15,9014,4325,3,444,101,229,38,39,851,1,16,868
9,15,9014,4326,3,205,66,114,12,14,411,0,8,419
9,15,9014,4327,3,291,117,536,51,58,1053,1,19,1073
9,15,9014,4328,3,148,52,224,20,22,466,1,10,477
9,15,9014,4329,3,226,87,259,46,36,654,1,10,665
9,15,9014,4330,3,209,36,138,17,16,416,0,4,420
9,15,9014,4331,3,413,123,358,51,46,991,0,13,1004
9,15,9014,4332,3,256,89,161,16,24,546,4,6,556
9,15,9014,4333,3,301,89,223,30,38,681,0,13,694
9,15,9014,4334,3,571,90,237,29,56,983,1,12,996
9,15,9014,4335,3,458,127,211,32,65,893,1,17,911
9,15,9014,4336,3,468,134,264,28,47,941,4,9,954
9,15,9014,4337,3,362,101,186,34,45,728,0,11,739
9,15,9014,4338,3,512,124,227,27,38,928,0,17,945
9,15,9014,4339,3,524,128,296,37,46,1031,3,17,1051
9,15,9014,4340,3,429,117,239,24,42,851,1,10,862
9,15,9014,4341,3,386,99,211,34,34,764,1,4,769
9,15,9014,4342,3,419,101,212,23,34,789,3,8,800
9,15,9014,4343,3,438,88,173,17,46,762,1,6,769
9,15,9014,4344,3,541,143,170,35,41,930,0,9,939
9,15,9014,4345,3,700,124,265,46,47,1182,1,11,1194
9,15,9014,4346,3,385,117,210,26,43,781,1,9,791
9,15,9014,4347,3,531,102,300,32,40,1005,4,12,1021
9,15,9014,4348,3,574,143,256,19,31,1023,0,13,1036
9,15,9014,4349,3,434,88,159,23,36,740,1,8,749
9,15,9014,4350,3,522,98,171,35,35,861,0,12,873
9,15,9014,4351,3,463,79,134,18,38,732,1,11,744
9,15,9014,4352,3,620,123,182,35,37,997,0,10,1007
9,15,9014,4353,3,487,105,186,26,36,840,0,3,843
9,15,9014,4354,3,527,119,191,35,50,922,0,13,935
9,15,9014,4355,3,535,149,289,42,47,1062,2,6,1070
9,15,9014,4356,3,455,150,346,33,60,1044,3,10,1057
9,15,9014,4357,3,481,158,416,49,70,1174,0,13,1187
9,15,9014,4358,3,368,152,515,47,71,1153,3,16,1172
9,15,9014,4359,3,409,135,460,58,54,1116,4,16,1136
9,15,9014,4360,3,451,170,486,50,65,1222,2,18,1242
9,15,9014,4361,3,448,151,481,62,55,1197,1,25,1223
9,15,9014,4362,3,448,148,465,57,64,1182,1,15,1198
9,15,9014,4363,3,518,115,232,41,38,944,3,11,958
9,15,9014,4364,3,467,89,167,17,29,769,1,16,786
9,15,9014,4365,3,730,155,276,48,68,1277,1,13,1291
9,15,9014,4366,3,597,121,212,24,51,1005,1,8,1014
9,15,9014,4367,3,633,94,187,24,44,982,0,9,991
9,15,9014,4368,3,601,140,207,29,40,1017,3,23,1043
9,15,9014,4369,3,480,104,224,23,39,870,1,9,880
9,15,9014,4370,3,782,169,262,44,51,1308,3,9,1320
9,15,9014,4371,3,505,135,192,27,41,900,1,13,914
9,15,9014,4372,3,515,121,169,30,39,874,0,8,882
9,15,9014,4373,3,617,147,213,40,56,1073,3,16,1092
9,15,9014,4374,3,602,192,296,50,70,1210,1,21,1232
9,15,9014,4375,3,364,133,389,50,35,971,0,12,983
9,15,9014,4376,3,371,130,421,54,49,1025,5,18,1048
9,15,9014,4377,3,386,124,477,53,68,1108,1,21,1130
9,15,9014,4378,3,307,140,604,49,68,1168,0,14,1182
9,15,9014,4379,3,451,126,484,47,73,1181,0,25,1206
9,15,9014,4380,3,318,107,351,49,59,884,5,18,907
9,15,9014,4381,3,385,137,536,51,49,1158,0,19,1177
9,15,9014,4382,3,382,97,351,56,42,928,1,13,942
9,15,9014,4383,3,483,101,264,44,37,929,0,11,940
9,15,9014,4384,3,532,202,283,40,41,1098,0,11,1109
9,15,9014,4385,3,466,136,299,47,62,1010,1,14,1025
9,15,9014,4386,3,650,161,283,44,57,1195,2,19,1216
9,15,9014,4387,3,728,145,291,48,42,1254,1,19,1274
9,15,9014,4388,3,438,94,195,23,32,782,2,6,790
9,15,9014,4389,3,615,154,363,30,61,1223,3,13,1239
9,15,9014,4390,3,568,141,160,37,43,949,1,19,969
9,15,9014,4391,3,627,139,241,34,70,1111,1,13,1125
9,15,9014,4392,3,550,115,180,27,39,911,0,9,920
9,15,9014,4393,3,416,105,166,14,38,739,0,14,753
9,15,9014,4394,3,549,111,257,41,49,1007,3,13,1023
9,15,9014,4395,3,397,92,205,36,42,772,2,8,782
9,15,9014,4396,3,559,101,232,35,45,972,3,12,987
9,15,9014,4397,3,588,123,223,35,42,1011,2,7,1020
9,15,9014,4398,3,514,134,215,30,44,937,0,13,950
9,15,9014,4399,3,663,127,325,50,68,1233,1,17,1251
9,15,9014,4400,3,125,53,109,18,13,318,2,9,329
9,15,9014,4401,3,308,102,531,54,45,1040,1,9,1050
9,15,9014,4402,3,206,78,278,29,40,631,1,11,643
9,15,9014,4403,3,163,41,177,22,26,429,0,4,433
9,15,9014,4404,3,449,145,407,42,63,1106,0,10,1116
9,15,9014,4405,3,400,130,598,53,64,1245,3,19,1267
9,15,9014,4406,3,255,120,525,49,57,1006,1,16,1023
9,15,9014,4407,3,127,54,271,16,17,485,0,13,498
9,15,9014,4408,3,444,113,188,26,43,814,1,6,821
9,15,9014,4409,3,492,111,175,17,41,836,0,9,845
9,15,9014,4410,3,454,104,253,18,36,865,1,12,878
9,15,9014,4411,3,519,180,354,49,53,1155,3,11,1169
9,15,9014,4412,3,660,141,331,48,56,1236,8,7,1251
9,15,9014,4413,3,227,119,406,52,33,837,2,12,851
9,15,9014,4414,3,544,113,363,41,56,1117,4,12,1133
9,15,9014,4415,3,347,69,172,13,36,637,1,10,648
9,15,9014,4416,3,323,71,111,18,22,545,0,5,550
9,15,9014,4417,3,429,86,223,25,45,808,0,12,820
9,15,9014,4418,3,393,82,184,30,43,732,2,7,741
9,15,9014,4419,3,592,112,347,52,60,1163,3,11,1177
9,15,9014,4420,3,593,130,445,71,91,1330,1,10,1341
9,15,9014,4421,3,397,108,269,43,51,868,0,16,884
9,15,9014,4422,3,622,111,399,46,66,1244,1,20,1265
9,15,9014,4423,3,370,78,145,20,26,639,0,7,646
9,15,9014,4424,3,444,98,179,27,29,777,0,6,783
9,15,9014,4425,3,340,69,123,22,23,577,3,9,589
9,15,9014,4426,3,260,64,167,23,12,526,0,7,533
9,15,9014,4427,3,478,119,261,44,46,948,5,15,968
9,15,9014,4428,3,542,123,241,29,51,986,2,8,996
9,15,9014,4429,3,295,69,284,36,41,725,3,6,734
9,15,9014,4430,3,334,145,555,67,48,1149,0,22,1171
9,15,9014,4431,3,335,149,466,49,49,1048,1,22,1071
9,15,9014,4432,3,450,153,440,39,48,1130,0,18,1148
9,15,9014,4433,3,355,134,428,51,56,1024,2,23,1049
9,15,9014,4434,3,418,129,560,59,63,1229,1,16,1246
9,15,9014,4435,3,418,122,405,55,49,1049,1,15,1065
9,15,9014,4436,3,451,149,325,53,53,1031,1,16,1048
9,15,9014,4437,3,539,159,403,52,60,1213,1,11,1225
9,15,9014,4438,3,250,78,239,23,30,620,0,10,630
9,15,9014,4439,3,384,113,386,38,47,968,3,15,986
9,15,9014,4440,3,385,143,482,49,48,1107,3,21,1131
9,15,9014,4441,3,338,128,475,43,43,1027,1,14,1042
9,15,9014,4442,3,282,120,458,38,56,954,3,25,982
9,15,9014,4443,3,336,93,479,59,71,1038,2,7,1047
9,15,9014,4444,3,416,119,607,64,66,1272,1,16,1289
9,15,9014,4445,3,229,90,249,24,35,627,1,8,636
9,15,9014,4446,3,521,156,567,54,80,1378,4,24,1406
9,15,9014,4447,3,397,59,174,22,27,679,0,4,683
9,15,9014,4448,3,483,123,417,32,63,1118,5,12,1135
9,15,9014,4449,3,580,128,364,43,69,1184,5,9,1198
9,15,9014,4450,3,439,91,157,25,39,751,1,5,757
9,15,9014,4451,3,327,89,185,24,41,666,3,10,679
9,15,9014,4452,3,611,135,332,33,45,1156,2,11,1169
9,15,9014,4453,3,599,130,376,58,76,1239,1,19,1259
9,15,9014,4454,3,455,110,418,56,43,1082,1,15,1098
9,15,9014,4455,3,280,63,179,18,28,568,0,6,574
9,15,9014,4456,3,358,90,336,40,34,858,0,13,871
9,15,9014,4457,3,511,98,218,23,40,890,0,8,898
9,15,9014,4458,3,484,102,217,27,39,869,0,17,886
9,15,9014,4459,3,347,67,106,14,32,566,1,4,571
9,15,9014,4460,3,504,138,248,35,62,987,1,7,995
9,15,9014,4461,3,359,142,472,43,40,1056,1,17,1074
9,15,9014,4462,3,469,125,176,46,47,863,1,19,883
9,15,9014,4463,3,597,126,238,24,61,1046,2,10,1058
9,15,9014,4464,3,605,145,269,40,45,1104,6,17,1127
9,15,9014,4465,3,459,88,139,23,22,731,1,4,736
9,15,9014,4466,3,776,148,297,49,59,1329,0,12,1341
9,15,9014,4467,3,304,77,144,7,14,546,1,2,549
9,15,9014,4468,3,533,144,250,31,56,1014,2,6,1022
9,15,9014,4469,3,321,34,90,13,15,473,0,7,480
9,15,9014,4470,3,463,122,262,29,46,922,0,15,937
9,15,9014,4471,3,503,120,442,51,61,1177,4,11,1192
9,15,9014,4472,3,533,125,344,36,49,1087,2,20,1109
9,15,9014,4473,3,492,109,202,17,38,858,1,9,868
9,15,9014,4474,3,279,76,98,13,31,497,1,3,501
9,15,9014,4475,3,744,125,235,36,59,1199,0,15,1214
9,15,9014,4476,3,454,83,246,27,28,838,1,9,848
9,15,9014,4477,3,593,134,252,38,37,1054,1,11,1066
9,15,9014,4478,3,415,83,142,25,34,699,2,8,709
9,15,9014,4479,3,363,53,175,19,39,649,0,2,651
9,15,9014,4480,3,359,58,122,14,33,586,0,7,593
9,15,9014,4481,3,386,54,102,13,22,577,1,5,583
9,15,9014,4482,3,406,133,375,53,63,1030,0,16,1046
9,15,9014,4483,3,386,108,270,21,45,830,2,10,842
9,15,9014,4484,3,536,160,446,63,84,1289,3,16,1308
9,15,9014,4485,3,379,120,394,47,40,980,0,15,995
9,15,9014,4486,3,329,128,474,63,49,1043,1,9,1053
9,15,9014,4487,3,319,121,490,58,52,1040,2,7,1049
9,15,9014,4488,3,360,81,477,40,46,1004,2,10,1016
9,15,9014,4489,3,361,124,456,54,36,1031,1,12,1044
9,15,9014,4490,3,363,136,362,43,38,942,1,17,960
9,15,9014,4491,3,365,110,400,34,41,950,0,14,964
9,15,9014,4492,3,379,150,396,38,61,1024,0,18,1042
9,15,9014,4493,3,517,153,429,61,52,1212,1,12,1225
9,15,9014,4494,3,236,80,263,38,34,651,1,15,667
9,15,9014,4495,3,477,106,268,35,57,943,1,19,963
9,15,9014,4496,3,310,127,258,36,31,762,0,6,768
9,15,9014,4497,3,218,70,138,26,26,478,3,3,484
9,15,9014,4498,3,358,106,405,40,45,954,1,13,968
9,15,9014,4499,3,330,109,332,39,38,848,1,16,865
9,15,9014,4500,3,399,133,393,43,38,1006,7,20,1033
9,15,9014,4501,3,407,112,351,57,51,978,3,10,991
9,15,9014,4502,3,394,136,510,47,60,1147,4,20,1171
9,15,9014,4503,3,428,126,405,63,64,1086,2,14,1102
9,15,9014,4504,3,320,160,343,53,62,938,0,21,959
9,15,9014,4505,3,366,127,423,47,45,1008,2,7,1017
9,15,9014,4506,3,286,82,369,43,33,813,0,19,832
9,15,9014,4507,3,777,157,446,54,67,1501,2,8,1511
9,15,9014,4508,3,677,155,292,50,73,1247,0,10,1257
9,15,9014,4509,3,234,65,176,36,19,530,0,9,539
9,15,9014,4510,3,377,109,349,39,51,925,8,15,948
9,15,9014,4511,3,486,150,397,43,87,1163,1,18,1182
9,15,9014,4512,3,459,165,392,61,58,1135,1,13,1149
9,15,9014,4513,3,363,108,247,29,45,792,1,7,800
9,15,9014,4514,3,510,112,398,56,79,1155,0,18,1173
9,15,9014,4515,3,277,94,269,20,33,693,0,14,707
9,15,9014,4516,3,304,105,251,43,46,749,1,14,764
9,15,9014,4517,3,270,60,98,16,10,454,2,6,462
9,15,9014,4518,3,192,81,210,36,38,557,0,8,565
9,15,9014,4519,3,652,115,395,59,65,1286,3,21,1310
9,15,9014,4520,3,211,88,245,24,31,599,1,13,613
9,15,9014,4521,3,274,89,314,27,43,747,1,17,765
9,15,9014,4522,3,381,113,207,41,38,780,2,8,790
9,16,9010,3163,3,157,104,484,46,22,813,3,18,834
9,16,9010,3164,3,232,83,429,39,30,813,0,15,828
9,16,9010,3165,3,203,79,487,47,37,853,3,17,873
9,16,9010,3166,3,214,68,318,44,34,678,0,10,688
9,16,9010,3167,3,150,90,341,36,25,642,3,15,660
9,16,9010,3168,3,200,110,512,31,31,884,0,18,902
9,16,9010,3169,3,144,95,478,40,32,789,0,16,805
9,16,9010,3170,3,59,34,200,14,3,310,1,15,326
9,16,9010,3171,3,176,88,497,48,26,835,12,11,858
9,16,9010,3172,3,196,89,388,37,18,728,2,14,744
9,16,9010,3173,3,197,114,536,47,47,941,0,23,964
9,16,9010,3174,3,259,163,404,52,31,909,0,21,930
9,16,9010,3175,3,282,184,594,54,37,1151,0,12,1163
9,16,9010,3176,3,500,163,793,61,64,1581,0,27,1608
9,16,9010,3177,3,191,85,452,46,41,815,3,19,837
9,16,9010,3178,3,133,101,117,27,8,386,0,15,401
9,16,9010,3179,3,303,140,799,64,59,1365,12,23,1400
9,16,9010,3180,3,205,52,252,23,17,549,0,3,552
9,16,9010,3181,3,256,71,278,35,20,660,0,10,670
9,16,9010,3182,3,351,103,411,43,37,945,1,14,960
9,16,9010,3183,3,254,108,406,53,35,856,3,13,872
9,16,9010,3184,3,154,69,483,41,27,774,2,16,792
9,16,9010,3185,3,144,82,541,60,30,857,3,28,888
9,16,9010,3186,3,191,111,493,40,46,881,2,17,900
9,16,9010,3187,3,171,101,500,38,36,846,1,14,861
9,16,9010,3188,3,212,95,524,37,36,904,2,11,917
9,16,9010,3189,3,265,152,727,74,53,1271,3,24,1298
9,16,9010,3190,3,232,74,444,45,18,813,2,15,830
9,16,9010,3191,3,224,109,504,40,36,913,3,14,930
9,16,9010,3192,3,164,90,510,40,26,830,3,18,851
9,16,9010,3193,3,300,98,526,58,33,1015,2,10,1027
9,16,9010,3194,3,266,87,563,46,49,1011,3,12,1026
9,16,9010,3195,3,264,101,635,62,57,1119,2,27,1148
9,16,9010,3196,3,205,64,498,56,31,854,1,24,879
9,16,9010,3197,3,173,106,465,53,23,820,2,15,837
9,16,9010,3198,3,147,65,321,36,24,593,0,11,604
9,16,9010,3199,3,146,81,333,40,29,629,3,9,641
9,16,9010,3200,3,115,50,344,43,20,572,4,16,592
9,16,9010,3201,3,97,68,344,33,20,562,5,13,580
9,16,9010,3202,3,217,103,399,61,30,810,3,19,832
9,16,9010,3203,3,351,61,241,17,24,694,3,6,703
9,16,9010,3204,3,155,95,389,30,28,697,1,18,716
9,16,9010,3205,3,145,47,341,44,17,594,0,3,597
9,16,9010,3206,3,152,80,304,25,29,590,2,10,602
9,16,9010,3207,3,81,73,407,29,21,611,2,9,622
9,16,9010,3208,3,135,64,309,22,22,552,0,7,559
9,16,9010,3209,3,130,73,394,42,39,678,0,15,693
9,16,9010,3210,3,261,126,635,62,42,1126,0,21,1147
9,16,9010,3211,3,161,68,332,27,36,624,0,15,639
9,16,9010,3212,3,276,148,639,57,49,1169,1,32,1202
9,16,9010,3213,3,194,97,660,57,25,1033,0,29,1062
9,16,9010,3214,3,799,208,1016,102,83,2208,3,18,2229
9,16,9010,3215,3,149,80,361,38,26,654,2,11,667
9,16,9010,3216,3,184,99,453,43,38,817,2,12,831
9,16,9010,3235,3,389,54,186,14,28,671,0,10,681
9,16,9010,3236,3,294,108,634,70,31,1137,1,15,1153
9,16,9010,3237,3,121,90,460,42,30,743,1,22,766
9,16,9010,3238,3,176,86,472,49,31,814,1,20,835
9,16,9010,3239,3,245,111,476,39,33,904,0,24,928
9,16,9010,3240,3,101,62,387,41,23,614,0,28,642
9,16,9010,3241,3,171,61,600,48,29,909,4,11,924
9,16,9010,3242,3,231,100,587,55,28,1001,1,20,1022
9,16,9010,3243,3,115,64,245,15,15,454,0,6,460
9,16,9010,3244,3,177,68,450,33,25,753,1,17,771
9,16,9010,3245,3,304,135,585,55,58,1137,0,24,1161
9,16,9010,3246,3,198,58,287,46,30,619,0,8,627
9,16,9010,3247,3,155,55,228,27,22,487,0,5,492
9,16,9010,3248,3,277,100,419,44,29,869,0,9,878
9,16,9010,3249,3,129,79,643,55,28,934,2,27,963
9,16,9010,3250,3,148,81,543,50,37,859,0,31,890
9,16,9010,3251,3,135,112,370,48,30,695,1,17,713
9,16,9010,3252,3,152,74,338,31,26,621,1,11,633
9,16,9010,3253,3,275,143,582,55,47,1102,2,20,1124
9,16,9010,3254,3,204,131,566,57,35,993,2,15,1010
9,16,9010,3255,3,192,74,386,34,31,717,3,18,738
9,16,9010,3256,3,298,108,432,30,39,907,1,10,918
9,16,9010,3257,3,208,58,295,31,33,625,0,7,632
9,16,9010,3258,3,194,77,323,39,25,658,0,13,671
9,16,9010,3259,3,182,64,329,21,29,625,2,7,634
9,16,9010,3260,3,187,84,456,20,38,785,2,25,812
9,16,9010,3261,3,205,76,382,36,21,720,1,2,723
9,16,9010,3262,3,131,84,358,35,14,622,1,12,635
9,16,9010,3263,3,244,113,618,61,45,1081,1,25,1107
9,16,9010,3264,3,120,98,606,67,41,932,2,24,958
9,16,9010,3265,3,109,86,560,40,31,826,2,10,838
9,16,9010,3266,3,122,77,561,48,23,831,2,25,858
9,16,9010,3267,3,146,100,583,54,42,925,0,38,963
9,16,9010,3268,3,114,63,533,60,33,803,0,22,825
9,16,9010,3269,3,147,86,592,53,20,898,2,13,913
9,16,9010,3270,3,126,82,586,43,28,865,0,13,878
9,16,9010,3271,3,141,101,595,41,27,905,1,15,921
9,16,9010,3272,3,142,77,503,47,36,805,0,16,821
9,16,9010,3273,3,100,42,379,36,25,582,2,2,586
9,16,9010,3274,3,174,120,557,60,34,945,3,21,969
9,16,9010,3275,3,154,70,431,35,23,713,7,9,729
9,16,9010,3276,3,189,92,581,48,34,944,1,20,965
9,16,9010,3277,3,142,109,682,59,26,1018,1,27,1046
9,16,9010,3278,3,195,128,1067,54,58,1502,0,35,1537
9,16,9010,3279,3,111,66,603,42,30,852,1,18,871
9,16,9010,3280,3,75,52,422,69,37,655,3,17,675
9,16,9010,3281,3,134,66,480,31,36,747,0,28,775
9,16,9010,3282,3,71,78,362,30,20,561,2,17,580
9,16,9010,3283,3,129,47,516,45,30,767,1,20,788
9,16,9010,3284,3,119,66,484,47,23,739,0,25,764
9,16,9010,3285,3,104,77,435,50,20,686,0,29,715
9,16,9010,3286,3,155,107,847,77,40,1226,1,24,1251
9,16,9010,3287,3,117,102,454,42,25,740,5,16,761
9,16,9010,3288,3,147,49,613,51,18,878,5,15,898
9,16,9010,3289,3,173,72,664,64,34,1007,5,24,1036
9,16,9010,3290,3,99,61,386,36,25,607,2,11,620
9,16,9010,3291,3,104,103,626,79,36,948,5,27,980
9,16,9010,3292,3,84,53,342,16,9,504,1,28,533
9,16,9010,3293,3,209,110,394,45,42,800,0,14,814
9,16,9010,3294,3,231,118,284,31,24,688,1,7,696
9,16,9010,3295,3,735,206,798,107,77,1923,3,19,1945
9,16,9010,3296,3,298,114,849,87,54,1402,6,26,1434
9,16,9010,3297,3,157,75,615,50,29,926,1,15,942
9,16,9010,3298,3,226,123,914,71,47,1381,2,29,1412
9,16,9010,3299,3,142,59,433,44,33,711,1,16,728
9,16,9010,3300,3,174,89,535,85,37,920,2,32,954
9,16,9010,3301,3,156,89,708,50,39,1042,2,35,1079
9,16,9010,3302,3,241,111,739,58,35,1184,2,25,1211
9,16,9010,3303,3,276,80,472,53,34,915,0,16,931
9,16,9010,3304,3,130,47,408,36,21,642,0,19,661
9,16,9010,3305,3,156,75,675,58,37,1001,1,19,1021
9,16,9010,3306,3,140,65,680,65,38,988,1,17,1006
9,16,9010,3307,3,120,52,592,45,29,838,2,16,856
9,16,9010,3308,3,143,106,474,42,36,801,0,25,826
9,16,9010,3309,3,147,102,595,32,46,922,3,12,937
9,16,9010,3310,3,112,80,677,60,35,964,3,21,988
9,16,9010,3311,3,228,60,602,32,40,962,1,14,977
9,16,9010,3312,3,230,70,435,43,26,804,0,15,819
9,16,9010,3313,3,169,57,486,46,24,782,1,8,791
9,16,9010,3314,3,297,59,544,46,31,977,1,25,1003
9,16,9010,3315,3,330,122,929,79,44,1504,1,23,1528
9,16,9010,3316,3,221,73,586,45,42,967,0,27,994
9,16,9010,3317,3,124,48,483,37,27,719,0,9,728
9,16,9010,3318,3,123,80,709,60,34,1006,0,24,1030
9,16,9010,3319,3,82,74,484,36,29,705,0,29,734
9,16,9010,3320,3,176,69,463,42,27,777,0,16,793
9,16,9010,3321,3,225,119,744,64,44,1196,0,15,1211
9,16,9010,3322,3,264,100,686,56,43,1149,1,20,1170
9,16,9010,3323,3,303,119,906,72,50,1450,0,37,1487
9,16,9010,3324,3,82,66,590,40,28,806,0,34,840
9,16,9010,3325,3,136,79,471,38,35,759,0,18,777
9,16,9010,3326,3,172,57,470,38,26,763,0,18,781
9,16,9010,3327,3,126,40,470,37,25,698,4,16,718
9,16,9010,3328,3,114,71,633,67,35,920,0,21,941
9,16,9010,3329,3,179,52,600,44,25,900,1,17,918
9,16,9010,3330,3,162,98,661,43,32,996,1,24,1021
9,16,9010,3331,3,109,50,413,25,21,618,1,20,639
9,16,9010,3332,3,145,81,557,51,26,860,4,28,892
9,16,9010,3333,3,168,91,517,41,30,847,1,22,870
9,16,9010,3334,3,192,96,447,44,28,807,1,12,820
9,16,9010,3335,3,138,79,437,32,20,706,1,14,721
9,16,9010,3336,3,190,76,446,35,26,773,0,19,792
9,16,9010,3337,3,178,98,591,62,24,953,1,21,975
9,16,9010,3338,3,167,60,540,50,61,878,3,11,892
9,16,9010,3339,3,138,49,329,39,31,586,1,19,606
9,16,9010,3340,3,184,65,488,37,23,797,0,12,809
9,16,9010,3341,3,223,108,598,59,34,1022,0,22,1044
9,16,9010,3342,3,198,74,295,37,23,627,1,5,633
9,16,9010,3343,3,197,55,460,39,29,780,0,14,794
9,16,9010,3344,3,197,87,526,38,25,873,0,15,888
9,16,9010,3345,3,183,87,397,47,27,741,1,16,758
9,16,9010,3346,3,161,51,425,24,17,678,0,11,689
9,16,9010,3347,3,230,88,467,26,42,853,2,22,877
9,16,9010,3348,3,178,72,617,51,29,947,0,6,953
9,16,9010,3349,3,229,76,515,82,48,950,2,24,976
9,16,9010,3350,3,222,90,571,56,33,972,4,27,1003
9,16,9010,3351,3,226,82,703,34,34,1079,1,15,1095
9,16,9010,3352,3,327,96,683,66,47,1219,2,31,1252
9,16,9010,3353,3,273,82,202,11,14,582,0,5,587
9,16,9010,3354,3,321,108,554,50,41,1074,0,10,1084
9,16,9010,3355,3,119,28,171,13,10,341,0,5,346
9,16,9010,3356,3,162,67,578,66,26,899,0,12,911
9,16,9010,3357,3,224,61,472,22,27,806,0,15,821
9,16,9010,3358,3,257,105,588,56,39,1045,0,17,1062
9,16,9010,3359,3,107,72,483,58,24,744,0,26,770
9,16,9010,3360,3,561,124,384,62,33,1164,0,21,1185
9,16,9010,3361,3,211,92,464,46,22,835,4,15,854
9,16,9010,3362,3,109,60,657,61,26,913,3,29,945
9,16,9010,3363,3,72,61,482,42,31,688,3,7,698
9,16,9010,3364,3,139,110,676,62,33,1020,0,28,1048
9,16,9010,3372,3,149,54,252,30,15,500,0,3,503
9,16,9010,3373,3,90,36,232,18,13,389,2,9,400
9,16,9010,3374,3,123,130,593,36,39,921,2,23,946
9,16,9010,3375,3,169,79,514,51,43,856,2,24,882
9,16,9010,3399,3,100,40,280,25,18,463,0,16,479
9,16,9010,3400,3,44,31,163,13,9,260,0,10,270
9,16,9010,3401,3,73,31,221,22,17,364,0,12,376
9,16,9010,3402,3,77,15,234,25,15,366,0,8,374
9,16,9010,3403,3,154,58,311,33,17,573,1,9,583
9,16,9010,3404,3,136,64,449,36,23,708,5,15,728
9,16,9010,3405,3,132,80,383,28,31,654,1,14,669
9,16,9010,3406,3,135,47,293,28,14,517,0,5,522
9,16,9010,3407,3,255,111,421,52,36,875,2,14,891
9,16,9010,3408,3,208,67,266,24,23,588,1,16,605
9,16,9010,3409,3,317,98,396,35,43,889,3,21,913
9,16,9010,3410,3,253,110,348,48,33,792,2,13,807
9,16,9010,3411,3,280,105,446,51,39,921,3,18,942
9,16,9010,3412,3,171,70,415,37,22,715,0,7,722
9,16,9010,3413,3,210,83,438,46,31,808,2,3,813
9,16,9010,3414,3,207,70,321,43,30,671,1,9,681
9,16,9010,3415,3,262,62,359,32,34,749,0,7,756
9,16,9010,3416,3,294,108,513,49,38,1002,1,11,1014
9,16,9010,3417,3,314,105,407,49,25,900,0,9,909
9,16,9010,3418,3,361,125,557,45,47,1135,5,15,1155
9,16,9010,3419,3,290,121,397,40,23,871,0,12,883
9,16,9010,3421,3,287,101,563,49,55,1055,0,27,1082
9,16,9010,3423,3,287,121,650,31,33,1122,1,11,1134
9,16,9010,3425,3,134,55,492,45,47,773,2,4,779
9,16,9010,3473,3,212,57,437,29,32,767,0,22,789
9,16,9010,3477,3,181,38,285,37,37,578,1,8,587
9,16,9010,3478,3,208,97,383,42,25,755,1,12,768
9,16,9010,3479,3,188,77,461,47,33,806,1,14,821
9,16,9010,3480,3,186,95,648,50,44,1023,4,28,1055
9,16,9010,3481,3,308,111,944,60,55,1478,1,22,1501
9,16,9010,3482,3,288,74,333,34,36,765,3,6,774
9,17,9004,747,3,269,216,426,91,60,1062,4,29,1095
9,17,9004,748,3,909,264,403,66,39,1681,0,24,1705
9,17,9004,749,3,812,169,43,21,13,1058,1,2,1061
9,17,9004,750,3,353,87,350,30,15,835,0,26,861
9,17,9004,751,3,381,112,358,47,36,934,2,18,954
9,17,9004,752,3,892,129,197,37,27,1282,2,10,1294
9,17,9004,753,3,223,80,369,54,25,751,0,15,766
9,17,9004,754,3,328,189,736,129,55,1437,12,26,1475
9,17,9004,755,3,241,141,494,80,42,998,1,20,1019
9,17,9004,756,3,182,64,280,47,14,587,0,18,605
9,17,9004,757,3,285,135,542,90,40,1092,2,42,1136
9,17,9004,758,3,362,128,571,125,28,1214,2,14,1230
9,17,9004,759,3,924,131,82,37,38,1212,0,8,1220
9,17,9004,760,3,826,177,81,28,33,1145,0,4,1149
9,17,9004,761,3,231,115,635,77,25,1083,5,21,1109
9,17,9004,762,3,228,77,443,83,32,863,1,28,892
9,17,9004,763,3,286,122,617,104,42,1171,1,27,1199
9,17,9004,764,3,311,123,505,108,33,1080,2,31,1113
9,17,9004,765,3,556,219,712,133,73,1693,3,28,1724
9,17,9004,766,3,392,186,465,99,47,1189,0,32,1221
9,17,9004,767,3,516,189,626,125,47,1503,2,44,1549
9,17,9004,768,3,259,57,190,40,20,566,0,8,574
9,17,9004,769,3,241,108,452,97,45,943,0,35,978
9,17,9004,770,3,266,137,589,94,35,1121,0,36,1157
9,17,9004,771,3,325,95,396,78,38,932,2,18,952
9,17,9004,772,3,533,98,318,69,37,1055,2,19,1076
9,17,9004,773,3,676,122,292,65,39,1194,1,13,1208
9,17,9004,774,3,497,70,110,25,28,730,0,178,908
9,17,9004,775,3,397,165,504,84,36,1186,5,22,1213
9,17,9004,776,3,301,131,447,59,38,976,7,26,1009
9,17,9004,777,3,332,74,250,55,16,727,1,212,940
9,17,9004,778,3,303,119,556,98,42,1118,0,25,1143
9,17,9004,779,3,188,102,440,73,26,829,1,22,852
9,17,9004,780,3,271,193,532,122,37,1155,1,49,1205
9,17,9004,781,3,363,178,470,125,64,1200,2,26,1228
9,17,9004,782,3,340,165,355,119,38,1017,1,31,1049
9,17,9004,783,3,204,127,415,103,38,887,0,36,923
9,17,9004,784,3,388,98,286,80,44,896,2,23,921
9,17,9004,785,3,345,93,325,51,30,844,1,18,863
9,17,9004,786,3,244,100,413,53,184,994,4,16,1014
9,17,9004,787,3,271,108,398,72,21,870,3,25,898
9,17,9004,788,3,288,151,552,88,40,1119,1,25,1145
9,17,9004,789,3,287,122,324,77,34,844,3,20,867
9,17,9004,790,3,424,168,413,155,43,1203,1,37,1241
9,17,9004,791,3,328,186,582,113,41,1250,5,19,1274
9,17,9004,792,3,241,201,410,109,44,1005,1,32,1038
9,17,9004,793,3,249,228,629,154,44,1304,5,48,1357
9,17,9004,794,3,170,206,556,142,50,1124,11,43,1178
9,17,9004,795,3,209,292,686,123,55,1365,3,49,1417
9,17,9004,796,3,193,335,589,86,46,1249,3,41,1293
9,17,9004,797,3,237,290,862,142,48,1579,3,44,1626
9,17,9004,798,3,303,182,657,121,47,1310,6,54,1370
9,17,9004,799,3,335,261,657,143,57,1453,5,40,1498
9,17,9004,800,3,189,146,406,84,33,858,3,27,888
9,17,9004,801,3,359,190,495,81,49,1174,0,26,1200
9,17,9004,802,3,338,97,213,58,23,729,0,13,742
9,17,9004,803,3,264,83,265,47,25,684,3,19,706
9,17,9004,804,3,357,82,239,61,28,767,0,12,779
9,17,9004,805,3,293,385,736,138,54,1606,7,54,1667
9,17,9004,806,3,293,169,960,113,184,1719,12,41,1772
9,17,9004,807,3,188,74,561,65,156,1044,1,24,1069
9,17,9004,808,3,193,117,380,49,90,829,0,5,834
9,17,9004,809,3,221,124,481,79,196,1101,0,25,1126
9,17,9004,810,3,169,89,418,83,259,1018,2,51,1071
9,17,9004,811,3,450,208,378,84,65,1185,1,28,1214
9,17,9004,812,3,216,131,533,72,30,982,2,26,1010
9,17,9004,813,3,95,76,278,43,18,510,2,13,525
9,17,9004,814,3,310,265,809,121,59,1564,12,34,1610
9,17,9004,815,3,290,120,498,78,41,1027,4,18,1049
9,17,9004,816,3,262,166,498,52,37,1015,6,13,1034
9,17,9004,817,3,148,42,243,53,25,511,3,10,524
9,17,9004,818,3,145,43,299,43,16,546,0,12,558
9,17,9004,819,3,209,105,386,53,32,785,1,20,806
9,17,9004,820,3,158,94,259,46,21,578,2,6,586
9,17,9010,3365,3,407,97,222,35,32,793,0,9,802
9,17,9010,3366,3,280,67,181,18,21,567,0,4,571
9,17,9010,3367,3,357,77,208,20,29,691,0,5,696
9,17,9010,3368,3,330,83,226,30,34,703,1,9,713
9,17,9010,3369,3,492,106,270,20,23,911,1,9,921
9,17,9010,3370,3,134,86,485,55,22,782,4,17,803
9,17,9010,3371,3,263,97,626,54,30,1070,2,28,1100
9,17,9010,3377,3,262,112,645,74,77,1170,2,32,1204
9,17,9010,3378,3,202,100,618,35,46,1001,2,18,1021
9,17,9010,3379,3,158,76,489,40,29,792,1,17,810
9,17,9010,3380,3,219,106,725,74,49,1173,1,16,1190
9,17,9010,3381,3,219,81,679,68,46,1093,2,25,1120
9,17,9010,3382,3,140,67,582,43,34,866,0,24,890
9,17,9010,3383,3,142,89,487,59,33,810,1,15,826
9,17,9010,3384,3,452,125,294,51,48,970,2,5,977
9,17,9010,3385,3,600,242,982,128,82,2034,10,33,2077
9,17,9010,3386,3,183,104,581,51,30,949,4,11,964
9,17,9010,3387,3,231,116,537,55,39,978,2,20,1000
9,17,9010,3388,3,198,104,534,59,48,943,0,13,956
9,17,9010,3389,3,238,83,765,64,39,1189,3,26,1218
9,17,9010,3390,3,152,94,667,52,30,995,0,27,1022
9,17,9010,3391,3,319,166,1285,116,71,1957,11,32,2000
9,17,9010,3392,3,137,77,476,27,38,755,5,15,775
9,17,9010,3393,3,218,85,841,66,73,1283,3,37,1323
9,17,9010,3394,3,175,114,856,45,105,1295,4,37,1336
9,17,9010,3395,3,132,73,571,46,79,901,22,31,954
9,17,9010,3396,3,264,84,846,77,38,1309,0,40,1349
9,17,9010,3397,3,229,140,1034,99,74,1576,0,50,1626
9,17,9010,3398,3,414,96,382,38,41,971,2,22,995
9,17,9010,3484,3,731,169,417,42,63,1422,1,5,1428
9,17,9010,3490,3,317,109,502,61,43,1032,3,26,1061
9,17,9010,3491,3,1026,273,1637,145,117,3198,2,54,3254
9,17,9010,3492,3,141,63,569,56,35,864,4,17,885
9,17,9010,3493,3,125,79,350,35,32,621,2,1,624
9,17,9010,3494,3,257,82,510,68,40,957,3,22,982
9,17,9010,3495,3,205,119,406,48,39,817,1,20,838
9,17,9010,3496,3,103,38,399,52,15,607,1,14,622
9,17,9010,3497,3,109,90,473,43,17,732,4,17,753
9,17,9010,3498,3,225,124,502,46,43,940,1,33,974
9,17,9010,3499,3,220,79,497,48,29,873,0,16,889
9,17,9010,3507,3,216,120,636,59,41,1072,4,8,1084
9,17,9010,3508,3,215,76,649,49,20,1009,5,18,1032
9,17,9010,3509,3,114,37,424,35,29,639,1,8,648
9,17,9010,3510,3,188,75,448,37,26,774,1,18,793
9,17,9010,3511,3,292,61,354,35,15,757,3,11,771
9,17,9010,3512,3,162,70,333,35,22,622,1,10,633
9,17,9010,3513,3,206,133,1071,56,68,1534,5,23,1562
9,17,9010,3514,3,238,76,595,43,40,992,3,18,1013
9,17,9010,3515,3,70,30,325,28,19,472,1,16,489
9,17,9010,3516,3,497,93,386,34,38,1048,0,17,1065
9,17,9010,3517,3,525,66,163,26,28,808,0,6,814
9,17,9010,3518,3,206,58,401,15,16,696,1,20,717
9,17,9010,3519,3,190,81,632,62,27,992,0,22,1014
9,17,9010,3520,3,134,63,578,49,25,849,1,23,873
9,17,9010,3521,3,160,58,460,35,26,739,0,22,761
9,17,9010,3522,3,179,66,452,46,28,771,2,12,785
9,17,9010,3523,3,348,53,221,24,31,677,3,6,686
9,17,9010,3524,3,196,66,297,27,11,597,0,13,610
9,17,9010,3525,3,177,67,561,50,31,886,2,14,902
9,17,9010,3532,3,288,107,598,85,52,1130,2,31,1163
9,17,9010,3533,3,199,84,515,75,41,914,3,29,946
9,17,9010,3534,3,476,116,108,17,21,738,0,8,746
9,17,9010,3535,3,580,76,126,17,30,829,1,4,834
9,17,9010,3536,3,687,105,161,17,28,998,0,7,1005
9,17,9010,3537,3,631,97,129,23,23,903,1,10,914
9,17,9010,3538,3,547,83,114,15,28,787,0,6,793
9,17,9010,3539,3,430,73,167,24,31,725,1,12,738
9,17,9010,3540,3,438,86,564,59,43,1190,1,35,1226
9,17,9010,3558,3,186,82,748,59,42,1117,0,27,1144
9,17,9010,3559,3,142,80,526,55,49,852,0,20,872
9,17,9010,3560,3,214,108,578,57,34,991,0,22,1013
9,17,9010,3561,3,315,138,977,81,77,1588,5,38,1631
9,17,9010,3562,3,469,97,214,32,25,837,1,13,851
9,17,9010,3563,3,192,48,474,47,36,797,3,15,815
9,17,9010,3564,3,204,66,567,48,29,914,1,21,936
9,17,9010,3565,3,110,46,333,44,18,551,0,13,564
9,17,9010,3566,3,167,69,573,66,42,917,3,18,938
9,17,9010,3567,3,119,51,373,43,18,604,0,9,613
9,17,9010,3568,3,291,97,734,59,50,1231,2,25,1258
9,17,9010,3569,3,64,30,299,16,23,432,0,9,441
9,17,9010,3570,3,125,56,330,28,16,555,1,11,567
9,17,9010,3571,3,146,54,363,29,33,625,0,17,642
9,17,9010,3572,3,74,31,154,19,6,284,1,8,293
9,17,9010,3573,3,502,88,184,22,46,842,1,10,853
9,17,9010,3579,3,105,41,448,34,21,649,2,23,674
9,17,9010,3580,3,127,55,533,24,36,775,5,18,798
9,17,9010,3581,3,225,88,638,44,45,1040,2,29,1071
9,17,9010,3582,3,315,138,663,56,46,1218,1,14,1233
9,17,9010,3583,3,244,114,744,66,55,1223,3,20,1246
9,17,9010,3584,3,344,144,756,132,64,1440,4,52,1496
9,17,9010,3585,3,198,97,495,143,49,982,4,26,1012
9,17,9010,3586,3,295,117,631,109,71,1223,1,28,1252
9,17,9010,3587,3,219,100,694,132,40,1185,6,27,1218
9,17,9010,3588,3,193,72,434,93,45,837,0,11,848
9,17,9010,3589,3,237,103,790,64,48,1242,3,29,1274
9,17,9010,3590,3,200,54,554,41,37,886,0,24,910
9,17,9010,3591,3,112,66,634,52,39,903,7,19,929
9,17,9010,3592,3,144,71,708,46,39,1008,5,21,1034
9,17,9010,3593,3,284,104,835,64,39,1326,3,28,1357
9,17,9010,3594,3,217,82,526,102,60,987,5,30,1022
9,17,9010,3595,3,297,132,1233,105,59,1826,4,51,1881
9,17,9010,3596,3,220,83,797,73,45,1218,5,28,1251
9,17,9010,3597,3,151,65,622,54,39,931,0,16,947
9,17,9010,3598,3,146,59,680,58,41,984,1,8,993
9,17,9010,3599,3,154,44,547,40,21,806,1,21,828
9,17,9010,3600,3,243,104,1061,105,60,1573,9,48,1630
9,17,9010,3601,3,124,58,672,55,20,929,6,30,965
9,17,9010,3602,3,195,75,593,72,37,972,0,18,990
9,17,9010,3603,3,113,24,74,13,9,233,0,3,236
9,17,9010,3604,3,124,73,392,44,21,654,6,21,681
9,17,9010,3605,3,184,91,789,55,23,1142,5,35,1182
9,17,9010,3606,3,140,50,461,43,25,719,5,22,746
9,17,9010,3607,3,77,43,360,29,18,527,2,3,532
9,17,9004,5536,3,144,99,349,50,22,664,0,20,684
9,18,9007,1972,3,274,66,332,40,43,755,1,12,768
9,18,9007,1973,3,202,105,269,51,27,654,0,11,665
9,18,9007,1974,3,365,114,435,60,49,1023,0,16,1039
9,18,9007,1975,3,204,113,422,47,47,833,0,9,842
9,18,9007,1976,3,310,126,456,60,58,1010,0,26,1036
9,18,9007,1977,3,99,24,146,20,11,300,0,0,300
9,18,9007,1978,3,256,60,265,31,18,630,0,8,638
9,18,9007,1979,3,327,113,321,42,41,844,0,13,857
9,18,9007,1980,3,329,129,314,40,44,856,1,18,875
9,18,9007,1981,3,373,129,217,47,25,791,0,10,801
9,18,9007,1982,3,422,112,333,40,42,949,0,12,961
9,18,9007,1983,3,386,87,247,26,41,787,1,9,797
9,18,9007,1984,3,398,107,180,48,34,767,0,8,775
9,18,9007,1985,3,194,113,208,28,18,561,0,5,566
9,18,9007,1986,3,278,116,264,38,35,731,1,6,738
9,18,9007,1987,3,286,99,259,30,30,704,0,22,726
9,18,9007,1988,3,108,57,338,44,26,573,0,12,585
9,18,9007,1989,3,276,168,729,73,66,1312,1,22,1335
9,18,9007,1990,3,123,96,418,63,45,745,1,16,762
9,18,9007,1991,3,152,79,465,48,28,772,5,16,793
9,18,9007,1992,3,153,84,443,41,29,750,0,15,765
9,18,9007,1993,3,137,101,441,66,16,761,0,26,787
9,18,9007,1994,3,115,73,438,67,40,733,1,8,742
9,18,9007,1995,3,146,70,436,37,38,727,8,14,749
9,18,9007,1996,3,128,69,337,35,29,598,0,14,612
9,18,9007,1997,3,150,86,496,32,37,801,1,18,820
9,18,9007,1998,3,152,89,478,37,27,783,1,15,799
9,18,9007,1999,3,124,106,476,55,31,792,4,10,806
9,18,9007,2000,3,130,93,473,52,41,789,1,24,814
9,18,9007,2001,3,185,105,413,77,40,820,1,27,848
9,18,9007,2002,3,193,111,613,79,46,1042,1,18,1061
9,18,9007,2003,3,143,74,436,57,40,750,2,29,781
9,18,9007,2004,3,125,101,484,50,36,796,2,19,817
9,18,9007,2005,3,210,100,578,84,42,1014,2,10,1026
9,18,9007,2006,3,150,88,456,52,32,778,1,17,796
9,18,9007,2008,3,118,44,298,33,16,509,0,8,517
9,18,9007,2009,3,63,36,287,30,15,431,1,13,445
9,18,9007,2010,3,196,84,595,50,42,967,3,17,987
9,18,9007,2011,3,216,91,444,48,34,833,1,14,848
9,18,9007,2012,3,138,107,299,49,26,619,1,15,635
9,18,9007,2013,3,194,109,600,48,50,1001,0,21,1022
9,18,9007,2014,3,137,134,510,44,29,854,0,19,873
9,18,9007,2015,3,138,89,527,60,29,843,5,14,862
9,18,9007,2016,3,178,89,475,59,41,842,0,18,860
9,18,9007,2017,3,168,148,407,44,37,804,2,5,811
9,18,9007,2018,3,207,124,524,49,33,937,0,16,953
9,18,9007,2059,3,78,42,198,19,12,349,1,4,354
9,18,9007,2060,3,82,27,270,11,22,412,0,1,413
9,18,9007,2065,3,132,118,561,52,40,903,2,15,920
9,18,9007,2066,3,38,40,366,31,21,496,0,12,508
9,18,9007,2067,3,319,139,806,84,67,1415,0,24,1439
9,18,9007,2068,3,173,123,474,44,29,843,0,22,865
9,18,9007,2069,3,137,118,450,48,28,781,0,17,798
9,18,9007,2070,3,139,68,372,28,29,636,0,9,645
9,18,9007,2071,3,178,95,435,40,37,785,3,14,802
9,18,9007,2072,3,269,107,571,51,59,1057,1,20,1078
9,18,9007,2073,3,260,80,443,50,49,882,1,21,904
9,18,9007,2074,3,139,54,240,31,28,492,0,6,498
9,18,9007,2075,3,147,63,317,31,23,581,0,10,591
9,18,9007,2076,3,116,82,420,33,34,685,1,15,701
9,18,9007,2077,3,148,75,387,29,22,661,7,10,678
9,18,9007,2078,3,147,90,337,31,29,634,4,18,656
9,18,9007,2079,3,141,221,311,56,49,778,0,13,791
9,18,9007,2080,3,222,199,842,63,57,1383,1,42,1426
9,18,9007,2081,3,133,113,370,39,34,689,0,16,705
9,18,9007,2082,3,196,99,505,64,49,913,0,24,937
9,18,9007,2083,3,102,78,213,28,18,439,0,13,452
9,18,9007,2084,3,293,126,816,87,84,1406,0,16,1422
9,18,9007,2085,3,52,18,145,12,10,237,0,4,241
9,18,9007,2086,3,128,89,423,35,42,717,2,10,729
9,18,9007,2087,3,82,58,318,28,33,519,0,12,531
9,18,9007,2088,3,146,84,386,40,27,683,0,11,694
9,18,9007,2089,3,169,86,455,48,30,788,0,7,795
9,18,9007,2090,3,170,92,384,38,35,719,6,18,743
9,18,9007,2091,3,221,180,479,60,42,982,0,20,1002
9,18,9007,2092,3,127,109,383,55,25,699,2,20,721
9,18,9007,2093,3,128,130,611,51,52,972,3,13,988
9,18,9007,2094,3,197,259,828,89,76,1449,2,39,1490
9,18,9007,2095,3,90,127,198,39,25,479,0,18,497
9,18,9007,2096,3,116,79,285,31,34,545,1,4,550
9,18,9007,2097,3,78,63,389,43,31,604,0,10,614
9,18,9007,2098,3,94,60,251,41,26,472,0,13,485
9,18,9007,2099,3,285,228,828,103,74,1518,0,33,1551
9,18,9007,2100,3,118,109,367,41,33,668,2,13,683
9,18,9007,2101,3,113,111,499,45,34,802,1,11,814
9,18,9007,2102,3,119,120,513,54,46,852,2,26,880
9,18,9007,2103,3,119,69,263,26,23,500,1,10,511
9,18,9007,2104,3,102,66,383,37,23,611,1,14,626
9,18,9007,2105,3,155,68,371,45,27,666,1,13,680
9,18,9007,2106,3,200,75,390,34,44,743,0,15,758
9,18,9007,2107,3,202,96,450,57,36,841,1,9,851
9,18,9007,2108,3,190,121,475,55,43,884,1,12,897
9,18,9007,2109,3,158,98,320,33,17,626,1,4,631
9,18,9007,2110,3,199,65,372,30,18,684,1,7,692
9,18,9007,2111,3,134,69,488,41,34,766,0,14,780
9,18,9007,2112,3,127,74,485,37,33,756,3,24,783
9,18,9007,2113,3,160,89,506,50,39,844,0,3,847
9,18,9007,2114,3,121,90,477,46,23,757,0,29,786
9,18,9007,2115,3,140,115,455,50,28,788,2,14,804
9,18,9007,2116,3,166,115,557,62,42,942,1,20,963
9,18,9007,2117,3,198,90,522,82,32,924,0,12,936
9,18,9007,2118,3,110,65,490,43,30,738,1,19,758
9,18,9007,2119,3,51,42,366,18,16,493,0,6,499
9,18,9007,2120,3,113,79,441,32,31,696,1,21,718
9,18,9007,2121,3,121,101,495,43,32,792,2,19,813
9,18,9007,2122,3,100,55,413,36,36,640,0,7,647
9,18,9007,2123,3,162,107,492,49,54,864,2,3,869
9,18,9007,2124,3,100,67,353,86,24,630,0,12,642
9,18,9007,2125,3,544,249,1582,174,128,2677,0,30,2707
9,18,9007,2148,3,184,81,469,46,36,816,1,16,833
9,18,9007,2149,3,169,77,518,44,42,850,1,16,867
9,18,9007,2150,3,171,106,376,46,36,735,3,16,754
9,18,9007,2151,3,149,91,599,53,29,921,3,17,941
9,18,9007,2152,3,97,69,344,27,15,552,3,15,570
9,18,9007,2153,3,256,298,1403,131,113,2201,1,53,2255
9,18,9007,2154,3,128,92,533,44,38,835,0,28,863
9,18,9007,2155,3,164,107,443,50,36,800,0,18,818
9,18,9007,2156,3,160,119,463,36,37,815,1,31,847
9,18,9007,2157,3,217,147,524,54,27,969,5,19,993
9,18,9007,2158,3,167,126,459,54,47,853,0,15,868
9,18,9007,2159,3,176,117,498,21,34,846,7,14,867
9,18,9007,2160,3,79,87,349,38,31,584,1,8,593
9,18,9007,2161,3,163,154,407,51,33,808,0,12,820
9,18,9007,2162,3,133,135,504,51,33,856,2,17,875
9,18,9007,2163,3,121,115,383,41,38,698,0,36,734
9,18,9007,2164,3,141,118,554,45,63,921,0,29,950
9,18,9007,2165,3,172,163,552,86,42,1015,8,13,1036
9,18,9007,2166,3,97,63,307,37,24,528,2,12,542
9,18,9007,2167,3,139,119,478,50,37,823,1,18,842
9,18,9007,2168,3,97,92,600,49,38,876,18,30,924
9,18,9007,2169,3,46,40,268,38,24,416,0,18,434
9,18,9007,2170,3,95,50,330,44,19,538,2,8,548
9,18,9007,2171,3,98,126,310,29,24,587,3,10,600
9,18,9007,2172,3,106,104,415,39,33,697,2,13,712
9,18,9007,2173,3,158,89,506,42,40,835,2,20,857
9,18,9007,2174,3,153,129,463,64,36,845,1,26,872
9,18,9007,2175,3,123,72,448,54,49,746,3,20,769
9,18,9007,2176,3,130,111,476,46,44,807,1,21,829
9,18,9007,2177,3,127,78,377,54,25,661,0,18,679
9,18,9007,2178,3,116,132,613,50,60,971,2,27,1000
9,18,9007,2179,3,106,88,554,37,22,807,1,21,829
9,18,9007,2180,3,168,133,447,51,28,827,0,16,843
9,18,9007,2181,3,114,115,585,56,40,910,0,18,928
9,18,9007,2182,3,158,97,566,62,41,924,2,17,943
9,18,9007,2183,3,159,86,393,41,33,712,5,12,729
9,18,9007,2184,3,119,65,389,37,24,634,0,23,657
9,18,9007,2198,3,125,248,496,47,39,955,6,12,973
9,18,9007,2199,3,150,153,852,70,59,1284,7,31,1322
9,18,9007,2200,3,88,77,325,36,20,546,0,13,559
9,18,9007,2201,3,160,123,428,59,35,805,0,23,828
9,18,9007,2202,3,234,122,614,47,52,1069,0,17,1086
9,18,9007,2203,3,211,98,529,37,34,909,0,12,921
9,18,9007,2204,3,121,52,333,34,20,560,1,5,566
9,18,9007,2205,3,143,66,476,40,26,751,7,10,768
9,18,9007,2206,3,203,100,795,52,54,1204,3,22,1229
9,18,9007,2207,3,310,326,1518,160,128,2442,18,67,2527
9,18,9007,2208,3,113,120,496,43,31,803,0,9,812
9,18,9007,2209,3,92,73,383,27,30,605,4,9,618
9,18,9007,2210,3,152,103,408,63,40,766,1,18,785
9,18,9007,2211,3,202,117,469,48,33,869,2,13,884
9,18,9007,2212,3,145,120,417,49,29,760,1,13,774
9,18,9007,2213,3,65,79,341,35,24,544,1,13,558
9,18,9007,2214,3,413,188,1188,108,80,1977,4,21,2002
9,18,9007,2215,3,42,76,270,29,11,428,1,13,442
9,18,9007,2216,3,46,51,268,15,23,403,0,10,413
9,18,9007,2217,3,63,59,268,27,30,447,2,6,455
9,18,9007,2218,3,207,338,1459,108,93,2205,5,52,2262
9,18,9007,2219,3,99,75,368,44,23,609,1,15,625
9,18,9007,2220,3,246,276,1102,92,67,1783,1,49,1833
9,18,9007,2221,3,106,151,482,39,26,804,2,27,833
9,18,9007,2222,3,68,187,426,32,22,735,3,17,755
9,18,9007,2223,3,132,91,412,51,34,720,1,7,728
9,18,9007,2224,3,142,89,569,45,29,874,2,21,897
9,18,9007,2312,3,87,92,316,40,32,567,0,13,580
9,18,9007,2322,3,101,46,432,25,29,633,0,6,639
9,18,9007,2323,3,103,77,402,59,43,684,1,9,694
9,18,9007,2324,3,128,83,452,62,45,770,0,12,782
9,18,9007,2325,3,127,214,235,46,32,654,0,12,666
9,18,9007,2327,3,18,21,185,14,7,245,4,5,254
9,18,9007,2328,3,54,57,179,15,15,320,3,11,334
9,18,9007,2329,3,78,79,344,28,22,551,0,17,568
9,18,9007,2330,3,63,65,477,40,25,670,3,9,682
9,18,9007,2336,3,121,76,711,48,40,996,3,14,1013
9,18,9007,2337,3,15,29,231,22,11,308,3,9,320
9,18,9007,2338,3,328,254,1357,128,74,2141,13,52,2206
9,18,9007,2339,3,39,47,199,18,13,316,0,4,320
9,18,9007,5517,3,379,410,1627,144,127,2687,5,48,2740
9,19,9007,2126,3,122,96,286,31,28,563,1,11,575
9,19,9007,2127,3,131,74,481,50,31,767,2,17,786
9,19,9007,2128,3,123,97,509,52,28,809,4,10,823
9,19,9007,2129,3,120,112,450,59,21,762,2,8,772
9,19,9007,2130,3,130,89,416,48,24,707,0,16,723
9,19,9007,2131,3,115,86,423,64,21,709,7,23,739
9,19,9007,2132,3,135,127,601,52,34,949,4,18,971
9,19,9007,2133,3,156,120,544,48,39,907,1,11,919
9,19,9007,2134,3,144,124,548,69,34,919,6,7,932
9,19,9007,2135,3,166,98,457,37,22,780,0,18,798
9,19,9007,2136,3,104,86,521,30,21,762,3,17,782
9,19,9007,2137,3,89,73,515,34,14,725,0,13,738
9,19,9007,2138,3,132,86,625,50,30,923,3,23,949
9,19,9007,2139,3,150,92,520,56,31,849,1,17,867
9,19,9007,2140,3,122,118,530,64,31,865,0,23,888
9,19,9007,2141,3,158,101,530,49,32,870,1,23,894
9,19,9007,2142,3,124,80,339,36,28,607,0,17,624
9,19,9007,2143,3,146,99,502,46,22,815,2,17,834
9,19,9007,2144,3,139,114,473,47,36,809,2,18,829
9,19,9007,2145,3,111,81,556,37,28,813,2,8,823
9,19,9007,2146,3,216,75,458,39,37,825,3,19,847
9,19,9007,2147,3,119,48,401,34,25,627,1,14,642
9,19,9007,2185,3,150,74,546,52,28,850,1,26,877
9,19,9007,2186,3,127,80,521,39,39,806,0,22,828
9,19,9007,2187,3,197,106,582,49,32,966,3,13,982
9,19,9007,2188,3,138,84,620,48,32,922,0,36,958
9,19,9007,2189,3,199,104,673,48,37,1061,6,22,1089
9,19,9007,2190,3,158,86,554,41,36,875,0,23,898
9,19,9007,2191,3,164,64,473,51,25,777,2,9,788
9,19,9007,2192,3,140,71,475,49,30,765,1,20,786
9,19,9007,2193,3,137,109,770,54,36,1106,2,21,1129
9,19,9007,2194,3,158,111,678,51,32,1030,2,23,1055
9,19,9007,2195,3,91,61,531,39,23,745,2,20,767
9,19,9007,2196,3,125,60,428,41,34,688,4,7,699
9,19,9007,2197,3,132,110,651,53,35,981,0,18,999
9,19,9007,2225,3,160,58,523,52,41,834,0,17,851
9,19,9007,2226,3,129,100,607,30,21,887,2,14,903
9,19,9007,2227,3,152,67,441,31,26,717,0,19,736
9,19,9007,2228,3,141,87,481,40,25,774,4,20,798
9,19,9007,2229,3,146,86,595,62,30,919,6,15,940
9,19,9007,2230,3,100,77,534,44,17,772,0,7,779
9,19,9007,2231,3,106,95,450,42,23,716,2,21,739
9,19,9007,2232,3,156,117,644,73,32,1022,2,25,1049
9,19,9007,2233,3,109,73,391,22,17,612,4,12,628
9,19,9007,2234,3,119,94,647,37,21,918,7,10,935
9,19,9007,2235,3,113,71,601,36,26,847,0,17,864
9,19,9007,2236,3,93,63,498,44,16,714,4,4,722
9,19,9007,2237,3,151,84,579,47,28,889,0,16,905
9,19,9007,2238,3,116,90,539,35,20,800,0,25,825
9,19,9007,2278,3,246,133,863,94,42,1378,7,18,1403
9,19,9007,2279,3,144,121,446,41,22,774,3,20,797
9,19,9007,2280,3,159,136,486,60,34,875,4,18,897
9,19,9007,2281,3,142,85,696,46,36,1005,3,22,1030
9,19,9007,2282,3,140,71,618,36,20,885,2,12,899
9,19,9007,2283,3,192,90,510,28,36,856,1,14,871
9,19,9007,2284,3,104,64,386,27,17,598,0,8,606
9,19,9007,2285,3,20,14,126,8,5,173,0,4,177
9,19,9007,2286,3,129,70,427,35,18,679,0,16,695
9,19,9007,2287,3,143,93,551,44,36,867,2,27,896
9,19,9007,2288,3,183,96,561,50,31,921,6,18,945
9,19,9007,2289,3,123,127,651,39,34,974,2,32,1008
9,19,9007,2290,3,144,119,573,26,26,888,1,20,909
9,19,9007,2291,3,114,47,473,27,21,682,3,9,694
9,19,9007,2292,3,146,90,616,31,33,916,2,22,940
9,19,9007,2293,3,196,105,489,46,32,868,5,17,890
9,19,9007,2294,3,137,111,534,36,26,844,2,14,860
9,19,9007,2295,3,146,72,465,37,25,745,1,13,759
9,19,9007,2296,3,128,106,482,36,19,771,1,19,791
9,19,9007,2297,3,128,98,503,42,16,787,0,18,805
9,19,9007,2298,3,177,152,588,64,23,1004,1,33,1038
9,19,9007,2315,3,212,106,472,57,33,880,0,11,891
9,19,9007,2316,3,190,141,615,48,35,1029,0,17,1046
9,19,9007,2317,3,196,138,493,46,42,915,0,15,930
9,19,9007,2318,3,122,78,430,41,24,695,0,10,705
9,19,9007,2319,3,143,68,433,32,29,705,1,17,723
9,19,9007,2320,3,206,124,649,44,32,1055,1,26,1082
9,19,9007,2321,3,175,149,558,67,29,978,5,21,1004
9,19,9007,2333,3,122,77,388,40,13,640,0,18,658
9,19,9007,2335,3,107,65,302,30,22,526,1,9,536
9,19,9007,2554,3,173,54,531,44,23,825,5,15,845
9,19,9007,2555,3,107,55,439,32,37,670,1,14,685
9,19,9007,2556,3,126,91,481,36,33,767,3,15,785
9,19,9007,2557,3,128,83,436,29,31,707,6,14,727
9,19,9007,2558,3,133,81,375,36,18,643,0,13,656
9,19,9007,2559,3,106,77,446,47,24,700,1,14,715
9,19,9007,2621,3,138,80,607,54,30,909,3,18,930
9,19,9007,2622,3,138,81,474,43,17,753,5,10,768
9,19,9007,2623,3,168,80,514,38,27,827,5,15,847
9,19,9007,2624,3,126,59,470,39,34,728,4,12,744
9,19,9007,2625,3,188,102,518,57,42,907,1,19,927
9,19,9007,2626,3,162,112,612,52,36,974,19,5,998
9,19,9007,2672,3,165,91,578,43,18,895,2,0,897
9,19,9007,2673,3,145,73,499,37,29,783,0,6,789
9,19,9007,2674,3,156,99,547,41,46,889,1,9,899
9,19,9007,2675,3,132,71,528,36,33,800,9,14,823
9,19,9007,2676,3,215,91,699,68,38,1111,0,18,1129
9,19,9007,2677,3,93,62,336,27,36,554,1,13,568
9,19,9007,2678,3,193,85,524,39,53,894,2,25,921
9,19,9007,2679,3,222,107,655,75,53,1112,6,25,1143
9,19,9007,2680,3,155,102,611,53,45,966,3,23,992
9,19,9007,2681,3,103,91,498,47,23,762,2,8,772
9,19,9007,2723,3,117,107,515,43,34,816,3,24,843
9,19,9007,2724,3,168,97,660,56,30,1011,3,18,1032
9,19,9007,2725,3,190,79,600,43,52,964,7,11,982
9,19,9007,2726,3,142,72,523,43,33,813,1,14,828
9,19,9007,2727,3,176,77,528,68,47,896,1,21,918
9,19,9007,2728,3,166,90,713,53,43,1065,4,19,1088
9,19,9007,2729,3,156,51,625,31,37,900,3,18,921
9,19,9007,2730,3,173,139,583,68,38,1001,2,11,1014
9,19,9007,2731,3,133,73,563,49,38,856,0,22,878
9,19,9007,2732,3,606,299,1588,182,139,2814,8,39,2861
9,19,9007,2759,3,232,100,587,56,50,1025,2,15,1042
9,19,9007,2760,3,173,81,636,43,36,969,3,19,991
9,19,9007,2761,3,159,97,539,43,35,873,3,15,891
9,19,9007,2762,3,156,88,533,44,37,858,1,19,878
9,19,9007,2763,3,47,72,265,22,14,420,0,11,431
9,19,9007,2764,3,168,78,563,60,63,932,3,21,956
9,19,9007,2765,3,151,90,575,45,45,906,2,13,921
9,19,9007,2766,3,155,83,524,43,35,840,2,12,854
9,19,9007,2767,3,204,100,452,59,45,860,2,5,867
9,19,9007,2768,3,170,81,611,57,30,949,2,20,971
9,19,9007,2769,3,267,103,696,64,49,1179,2,18,1199
9,19,9007,2770,3,141,72,485,56,29,783,6,15,804
9,19,9007,2771,3,155,100,619,57,24,955,2,12,969
9,19,9007,2772,3,100,79,552,54,22,807,4,15,826
9,19,9007,2773,3,77,66,525,52,20,740,0,21,761
9,19,9007,2774,3,120,93,518,48,31,810,4,12,826
9,19,9007,2775,3,119,58,515,41,17,750,5,13,768
9,19,9007,2776,3,103,86,507,38,23,757,13,10,780
9,19,9007,2824,3,83,66,602,42,39,832,3,12,847
9,19,9007,2825,3,123,81,545,58,17,824,1,21,846
9,19,9007,2826,3,95,59,514,36,23,727,1,28,756
9,19,9007,2827,3,118,74,538,41,24,795,0,38,833
9,19,9007,2828,3,125,58,403,38,28,652,4,11,667
9,19,9007,2829,3,175,87,583,53,35,933,2,21,956
9,19,9007,2830,3,154,78,613,55,28,928,3,11,942
9,19,9007,2831,3,150,69,539,36,33,827,3,16,846
9,19,9007,2832,3,147,72,601,56,40,916,2,27,945
9,19,9007,2833,3,130,78,504,54,28,794,4,10,808
9,19,9007,2834,3,200,93,697,62,46,1098,0,14,1112
9,19,9007,2852,3,188,100,633,61,39,1021,4,22,1047
9,19,9007,2853,3,283,129,1108,85,60,1665,2,26,1693
9,19,9007,2854,3,98,95,525,44,31,793,1,28,822
9,19,9007,2855,3,122,70,596,53,30,871,0,16,887
9,19,9007,2856,3,95,61,491,38,25,710,1,13,724
9,19,9007,2857,3,108,67,444,43,27,689,5,14,708
9,19,9007,2858,3,183,98,592,60,49,982,1,26,1009
9,19,9007,2859,3,97,70,604,52,24,847,6,17,870
9,19,9007,2860,3,85,57,485,30,26,683,3,13,699
9,19,9007,2861,3,131,98,552,36,24,841,1,28,870
9,19,9007,2862,3,113,64,432,26,22,657,5,17,679
9,19,9007,2863,3,154,107,550,70,39,920,15,34,969
9,19,9007,2865,3,175,104,1172,84,50,1585,12,36,1633
9,19,9007,2866,3,418,370,3082,238,166,4274,20,89,4383
9,19,9007,2867,3,171,112,934,84,44,1345,6,24,1375
9,19,9007,2868,3,118,133,489,44,26,810,0,22,832
9,19,9007,2869,3,211,98,814,68,44,1235,7,16,1258
9,19,9007,2870,3,207,152,850,82,36,1327,4,17,1348
9,19,9007,2871,3,112,57,651,59,36,915,3,16,934
9,19,9007,2872,3,178,87,631,47,37,980,2,21,1003
9,19,9007,2896,3,116,132,727,53,39,1067,0,24,1091
9,19,9007,2897,3,90,55,507,37,24,713,3,13,729
9,19,9007,2898,3,133,76,626,32,33,900,3,19,922
9,19,9007,2899,3,296,252,2106,164,119,2937,14,53,3004
9,20,9007,1971,3,140,78,369,83,37,707,0,13,720
9,20,9007,2007,3,191,80,433,90,31,825,3,19,847
9,20,9007,2019,3,174,97,421,45,25,762,0,13,775
9,20,9007,2020,3,152,68,439,49,21,729,5,9,743
9,20,9007,2021,3,171,57,400,35,33,696,0,11,707
9,20,9007,2022,3,262,78,253,25,29,647,2,9,658
9,20,9007,2023,3,261,99,366,44,34,804,1,17,822
9,20,9007,2024,3,146,97,536,68,45,892,2,40,934
9,20,9007,2025,3,132,74,538,124,22,890,6,29,925
9,20,9007,2026,3,175,126,525,99,18,943,2,18,963
9,20,9007,2027,3,182,182,664,76,29,1133,0,17,1150
9,20,9007,2028,3,194,115,602,86,43,1040,7,20,1067
9,20,9007,2029,3,124,122,531,85,29,891,6,12,909
9,20,9007,2030,3,230,167,704,104,50,1255,2,24,1281
9,20,9007,2031,3,160,96,414,70,20,760,0,27,787
9,20,9007,2032,3,164,115,481,66,16,842,2,19,863
9,20,9007,2033,3,121,65,455,40,31,712,2,14,728
9,20,9007,2034,3,109,58,437,61,22,687,0,13,700
9,20,9007,2035,3,231,126,594,75,40,1066,4,15,1085
9,20,9007,2036,3,81,84,222,37,16,440,3,4,447
9,20,9007,2037,3,107,98,390,49,30,674,1,6,681
9,20,9007,2038,3,151,83,438,52,22,746,3,16,765
9,20,9007,2039,3,176,63,619,66,54,978,0,23,1001
9,20,9007,2040,3,179,96,425,29,26,755,0,14,769
9,20,9007,2041,3,131,61,389,35,25,641,3,11,655
9,20,9007,2042,3,148,134,626,57,27,992,1,30,1023
9,20,9007,2043,3,134,84,491,61,36,806,3,12,821
9,20,9007,2044,3,243,135,621,85,39,1123,0,30,1153
9,20,9007,2045,3,166,70,419,49,39,743,3,14,760
9,20,9007,2046,3,219,117,328,52,35,751,0,24,775
9,20,9007,2047,3,257,107,490,41,54,949,1,21,971
9,20,9007,2048,3,242,147,501,64,50,1004,0,24,1028
9,20,9007,2049,3,195,118,433,78,36,860,1,25,886
9,20,9007,2050,3,236,152,672,99,52,1211,8,45,1264
9,20,9007,2051,3,156,91,555,104,34,940,2,12,954
9,20,9007,2052,3,175,105,520,122,36,958,5,24,987
9,20,9007,2053,3,174,110,601,184,33,1102,1,26,1129
9,20,9007,2054,3,54,35,237,37,12,375,1,15,391
9,20,9007,2055,3,375,131,353,47,39,945,4,12,961
9,20,9007,2056,3,180,107,764,224,53,1328,5,27,1360
9,20,9007,2057,3,233,133,568,148,42,1124,7,20,1151
9,20,9007,2058,3,263,111,504,67,48,993,7,20,1020
9,20,9007,2061,3,47,21,144,14,13,239,0,8,247
9,20,9007,2062,3,132,75,437,66,40,750,1,12,763
9,20,9007,2063,3,97,86,367,51,24,625,4,8,637
9,20,9007,2064,3,171,55,292,44,26,588,0,7,595
9,20,9007,2239,3,132,114,460,57,32,795,0,17,812
9,20,9007,2240,3,145,91,562,33,45,876,3,24,903
9,20,9007,2241,3,146,107,437,47,19,756,0,13,769
9,20,9007,2242,3,130,89,351,28,26,624,2,11,637
9,20,9007,2243,3,122,68,358,33,34,615,1,10,626
9,20,9007,2244,3,190,124,534,45,26,919,1,19,939
9,20,9007,2245,3,205,143,691,55,43,1137,4,22,1163
9,20,9007,2246,3,194,129,553,55,32,963,0,14,977
9,20,9007,2247,3,104,66,353,19,26,568,3,14,585
9,20,9007,2248,3,116,68,319,34,21,558,1,13,572
9,20,9007,2249,3,702,263,1416,156,156,2693,8,38,2739
9,20,9007,2250,3,114,69,308,35,22,548,1,11,560
9,20,9007,2251,3,137,92,352,38,29,648,1,19,668
9,20,9007,2252,3,265,132,658,64,64,1183,2,21,1206
9,20,9007,2253,3,168,135,473,43,33,852,4,22,878
9,20,9007,2254,3,188,89,507,49,36,869,2,18,889
9,20,9007,2255,3,182,98,501,40,32,853,5,13,871
9,20,9007,2256,3,188,78,412,44,39,761,3,16,780
9,20,9007,2257,3,138,67,502,37,32,776,4,12,792
9,20,9007,2258,3,148,100,525,45,21,839,1,14,854
9,20,9007,2259,3,164,77,435,34,60,770,1,15,786
9,20,9007,2260,3,222,137,533,54,47,993,3,24,1020
9,20,9007,2261,3,183,115,410,35,29,772,3,17,792
9,20,9007,2262,3,220,88,400,30,31,769,1,14,784
9,20,9007,2263,3,130,76,519,42,30,797,0,22,819
9,20,9007,2264,3,126,59,306,30,31,552,5,5,562
9,20,9007,2265,3,134,58,301,42,24,559,1,6,566
9,20,9007,2266,3,133,48,349,35,21,586,1,10,597
9,20,9007,2267,3,113,90,394,35,31,663,0,13,676
9,20,9007,2268,3,196,78,548,66,27,915,0,22,937
9,20,9007,2269,3,188,77,434,38,25,762,0,16,778
9,20,9007,2270,3,274,126,521,59,39,1019,0,23,1042
9,20,9007,2271,3,153,74,336,36,22,621,0,8,629
9,20,9007,2272,3,149,84,410,29,18,690,1,6,697
9,20,9007,2273,3,206,100,381,49,26,762,3,8,773
9,20,9007,2274,3,264,133,477,46,58,978,0,12,990
9,20,9007,2275,3,201,146,460,53,34,894,0,18,912
9,20,9007,2276,3,171,94,503,46,29,843,8,3,854
9,20,9007,2277,3,155,136,482,45,40,858,3,14,875
9,20,9007,2299,3,213,71,404,34,29,751,3,11,765
9,20,9007,2300,3,310,96,277,37,30,750,1,5,756
9,20,9007,2301,3,263,131,493,42,39,968,0,27,995
9,20,9007,2302,3,276,148,569,50,43,1086,1,11,1098
9,20,9007,2303,3,247,132,488,41,39,947,4,13,964
9,20,9007,2304,3,262,132,430,47,40,911,3,17,931
9,20,9007,2305,3,215,107,439,44,36,841,2,12,855
9,20,9007,2306,3,315,123,574,45,49,1106,1,19,1126
9,20,9007,2307,3,136,56,287,21,17,517,0,5,522
9,20,9007,2308,3,176,76,293,30,25,600,0,11,611
9,20,9007,2309,3,589,200,553,62,76,1480,3,20,1503
9,20,9007,2310,3,418,125,398,56,48,1045,1,12,1058
9,20,9007,2311,3,173,62,388,46,33,702,0,8,710
9,20,9007,2313,3,246,99,524,49,42,960,0,11,971
9,20,9007,2314,3,176,59,304,31,36,606,2,8,616
9,20,9007,2326,3,266,139,564,46,53,1068,1,23,1092
9,20,9007,2331,3,165,102,461,71,33,832,5,14,851
9,20,9007,2332,3,88,31,325,32,42,518,4,9,531
9,20,9007,2334,3,107,64,315,24,20,530,2,13,545
9,20,9007,2340,3,186,92,306,30,20,634,6,15,655
9,20,9007,2386,3,232,128,495,66,44,965,2,25,992
9,20,9007,2387,3,245,106,556,45,43,995,5,15,1015
9,20,9007,2388,3,209,107,331,32,22,701,1,11,713
9,20,9007,2389,3,136,96,508,38,26,804,2,15,821
9,20,9007,2390,3,143,72,371,34,22,642,1,14,657
9,20,9007,2391,3,219,116,513,62,39,949,2,24,975
9,20,9007,2392,3,181,124,486,47,26,864,0,12,876
9,20,9007,2393,3,190,132,652,54,46,1074,3,14,1091
9,20,9007,2394,3,106,102,448,24,33,713,1,9,723
9,20,9007,2395,3,104,56,351,40,14,565,0,10,575
9,20,9007,2396,3,171,119,537,45,35,907,1,21,929
9,20,9007,2397,3,245,119,605,48,40,1057,6,20,1083
9,20,9007,2398,3,213,96,580,59,30,978,3,13,994
9,20,9007,2399,3,210,128,642,52,40,1072,5,14,1091
9,20,9007,2400,3,256,126,663,60,32,1137,2,18,1157
9,20,9007,2401,3,182,84,470,54,25,815,2,19,836
9,20,9007,2402,3,185,96,453,41,31,806,2,18,826
9,20,9007,2403,3,262,118,600,59,41,1080,1,13,1094
9,20,9007,2404,3,240,108,478,46,36,908,0,13,921
9,20,9007,2405,3,140,67,509,51,46,813,1,12,826
9,20,9007,2406,3,235,116,761,54,34,1200,2,28,1230
9,20,9007,2407,3,329,167,574,56,44,1170,4,11,1185
9,20,9007,2408,3,321,148,696,51,37,1253,0,16,1269
9,20,9007,2409,3,311,139,669,75,43,1237,3,35,1275
9,20,9007,2410,3,183,112,574,63,24,956,1,24,981
9,20,9007,2411,3,214,82,249,37,24,606,3,9,618
9,20,9007,2412,3,151,34,160,30,19,394,1,2,397
9,20,9007,2413,3,163,87,502,44,40,836,3,20,859
9,20,9007,2414,3,106,55,246,22,27,456,0,6,462
9,20,9007,2415,3,226,94,326,49,24,719,0,18,737
9,20,9007,2416,3,147,61,352,41,28,629,0,7,636
9,20,9007,2417,3,120,39,218,24,21,422,1,12,435
9,20,9007,2418,3,140,82,297,27,26,572,3,7,582
9,20,9007,2419,3,141,71,319,28,43,602,2,9,613
9,20,9007,2420,3,203,80,429,52,29,793,3,15,811
9,20,9007,2421,3,189,99,570,35,40,933,1,21,955
9,20,9007,2422,3,186,75,293,33,22,609,2,7,618
9,20,9007,2423,3,154,95,305,44,31,629,0,8,637
9,20,9007,2424,3,194,119,444,48,40,845,5,14,864
9,20,9007,2425,3,188,101,632,55,44,1020,3,21,1044
9,20,9007,2426,3,256,105,313,31,22,727,0,13,740
9,20,9007,2427,3,102,62,342,29,25,560,2,10,572
9,20,9007,2428,3,74,58,255,19,14,420,0,12,432
9,20,9007,2429,3,246,100,384,32,40,802,4,18,824
9,20,9007,2430,3,268,93,430,45,40,876,2,12,890
9,20,9007,2431,3,188,69,358,27,29,671,2,14,687
9,20,9007,2432,3,250,87,517,46,36,936,2,20,958
9,20,9007,2433,3,305,96,532,45,23,1001,0,21,1022
9,20,9007,2434,3,272,102,374,36,39,823,1,11,835
9,20,9007,2435,3,199,73,290,27,25,614,0,10,624
9,20,9007,2436,3,330,131,528,56,53,1098,9,14,1121
9,20,9007,2437,3,204,126,407,60,41,838,4,15,857
9,20,9007,2438,3,219,80,444,57,35,835,0,16,851
9,20,9007,2439,3,285,110,431,63,37,926,1,26,953
9,20,9007,2440,3,262,98,391,59,25,835,4,10,849
9,20,9007,2441,3,168,109,326,44,20,667,2,14,683
9,20,9007,2442,3,242,102,300,48,28,720,6,9,735
9,20,9007,2443,3,206,61,306,28,27,628,0,13,641
9,20,9007,2444,3,191,96,364,37,30,718,2,11,731
9,20,9007,2445,3,446,156,374,41,43,1060,3,17,1080
9,20,9007,2446,3,155,58,357,41,25,636,2,8,646
9,20,9007,2447,3,219,84,411,63,30,807,0,21,828
9,20,9007,2448,3,289,103,302,49,47,790,1,13,804
9,20,9007,2449,3,183,109,548,54,64,958,5,26,989
9,20,9007,2450,3,257,130,424,62,48,921,2,17,940
9,20,9007,2451,3,297,99,487,47,49,979,3,17,999
9,20,9007,2452,3,208,64,228,23,28,551,0,10,561
9,20,9007,2453,3,287,88,252,19,30,676,0,12,688
9,20,9007,2454,3,712,184,374,39,49,1358,0,10,1368
9,20,9007,2455,3,265,58,142,13,16,494,0,7,501
9,20,9007,2456,3,205,76,277,38,22,618,3,7,628
9,20,9007,2457,3,187,79,243,50,39,598,2,0,600
9,20,9007,2458,3,209,102,431,45,25,812,0,10,822
9,20,9007,2459,3,208,108,399,58,38,811,1,15,827
9,20,9007,2460,3,161,93,344,46,31,675,2,5,682
9,20,9007,2461,3,213,87,413,43,37,793,6,15,814
9,20,9007,2462,3,200,86,415,67,32,800,1,16,817
9,20,9007,2463,3,178,87,395,44,28,732,0,13,745
9,20,9007,2464,3,182,113,407,45,40,787,7,12,806
9,20,9007,2465,3,175,88,378,47,38,726,1,9,736
9,20,9007,2466,3,218,100,456,70,50,894,4,17,915
9,20,9007,2467,3,202,85,348,46,35,716,6,11,733
9,20,9007,2468,3,367,109,275,26,37,814,1,7,822
9,20,9007,2469,3,342,121,231,26,56,776,0,16,792
9,20,9007,2470,3,469,112,258,59,26,924,7,18,949
9,20,9007,2471,3,200,60,141,12,24,437,0,6,443
9,20,9007,2472,3,344,82,205,27,27,685,1,10,696
9,20,9007,2473,3,367,116,252,27,37,799,0,9,808
9,20,9007,2474,3,243,60,250,21,26,600,1,10,611
9,20,9007,2475,3,335,88,232,27,30,712,2,9,723
9,20,9007,2476,3,333,115,359,49,55,911,3,10,924
9,20,9007,2477,3,214,114,299,39,22,688,0,10,698
9,20,9007,2478,3,87,46,200,26,15,374,2,6,382
9,20,9007,2479,3,132,58,280,32,20,522,3,4,529
9,20,9007,2480,3,238,63,270,31,35,637,1,6,644
9,20,9007,2481,3,268,93,192,33,23,609,2,11,622
9,20,9007,2482,3,353,121,405,51,43,973,0,19,992
9,20,9007,2483,3,311,113,427,32,35,918,3,16,937
9,20,9007,2484,3,232,90,387,40,39,788,11,10,809
9,20,9007,2485,3,246,111,419,56,35,867,10,14,891
9,20,9007,2486,3,226,116,450,68,33,893,4,20,917
9,20,9007,2487,3,264,115,321,33,43,776,0,12,788
9,20,9007,2488,3,331,125,310,40,31,837,2,9,848
9,20,9007,2489,3,484,129,290,39,43,985,2,9,996
9,20,9007,2490,3,266,84,196,28,27,601,2,5,608
9,20,9007,2491,3,243,81,229,63,25,641,1,18,660
9,20,9007,2492,3,247,114,478,66,37,942,0,14,956
9,20,9007,2493,3,193,87,445,48,28,801,2,20,823
9,20,9007,2494,3,66,57,249,16,16,404,0,8,412
9,20,9007,2495,3,50,41,245,17,10,363,1,6,370
9,20,9007,2496,3,63,44,157,17,10,291,2,4,297
9,20,9007,2497,3,80,34,120,12,17,263,0,3,266
9,20,9007,2498,3,166,41,131,13,15,366,0,5,371
9,20,9007,2499,3,205,60,323,26,29,643,1,13,657
9,20,9007,2500,3,87,41,171,11,11,321,4,9,334
9,20,9007,2501,3,154,137,544,72,33,940,2,4,946
9,20,9007,2502,3,175,89,562,41,29,896,5,10,911
9,20,9007,2503,3,72,44,207,18,16,357,0,6,363
9,20,9007,2504,3,169,93,479,49,31,821,1,16,838
9,20,9007,2505,3,209,100,700,69,34,1112,1,26,1139
9,20,9007,2506,3,176,76,378,55,33,718,3,16,737
9,20,9007,2507,3,182,100,443,35,14,774,1,19,794
9,20,9007,2508,3,92,74,169,30,22,387,0,3,390
9,20,9007,2509,3,139,84,419,50,33,725,2,17,744
9,20,9007,2968,3,41,36,324,30,15,446,1,6,453
9,20,9007,2969,3,96,46,215,15,13,385,3,9,397
9,20,9007,2970,3,221,62,454,64,31,832,3,13,848
9,20,9007,2971,3,48,8,74,14,13,157,1,4,162
9,20,9007,5516,3,103,69,243,34,22,471,0,6,477
9,21,9009,3119,3,143,175,584,67,38,1007,6,17,1030
9,21,9009,3120,3,188,318,984,85,35,1610,4,35,1649
9,21,9009,3121,3,202,253,706,106,60,1327,6,39,1372
9,21,9009,3122,3,226,239,692,109,71,1337,4,44,1385
9,21,9009,3123,3,295,319,1120,128,81,1943,3,52,1998
9,21,9009,3124,3,146,219,663,68,44,1140,4,28,1172
9,21,9009,3125,3,239,286,919,128,58,1630,9,35,1674
9,21,9009,3126,3,132,328,643,81,29,1213,3,46,1262
9,21,9009,3127,3,155,226,425,84,26,916,0,43,959
9,21,9009,3128,3,192,183,351,89,35,850,0,51,901
9,21,9009,3129,3,121,255,418,94,30,918,3,35,956
9,21,9009,3130,3,143,184,365,108,38,838,0,33,871
9,21,9009,3131,3,193,284,407,96,34,1014,1,36,1051
9,21,9009,3132,3,132,314,658,85,23,1212,6,26,1244
9,21,9009,3133,3,154,370,723,110,44,1401,1,45,1447
9,21,9009,3134,3,177,241,436,150,31,1035,8,45,1088
9,21,9009,3135,3,154,167,313,68,23,725,3,38,766
9,21,9009,3136,3,186,166,279,78,19,728,0,34,762
9,21,9009,3137,3,180,221,400,105,19,925,1,42,968
9,21,9009,3138,3,139,163,625,100,26,1053,4,35,1092
9,21,9009,3139,3,100,187,526,75,23,911,6,24,941
9,21,9009,3140,3,108,168,693,88,36,1093,0,37,1130
9,21,9009,3141,3,72,130,517,72,40,831,7,19,857
9,21,9009,3142,3,76,153,482,58,27,796,2,30,828
9,21,9009,3143,3,138,170,569,78,17,972,0,30,1002
9,21,9009,3144,3,165,118,556,63,16,918,2,49,969
9,21,9009,3145,3,162,123,487,50,16,838,3,19,860
9,21,9009,3146,3,131,134,489,52,29,835,0,19,854
9,21,9009,3147,3,166,123,487,76,36,888,5,20,913
9,21,9009,3148,3,121,125,471,69,30,816,1,17,834
9,21,9009,3149,3,166,124,483,50,36,859,4,24,887
9,21,9009,3150,3,114,109,474,74,25,796,2,29,827
9,21,9009,3151,3,124,187,681,86,22,1100,1,24,1125
9,21,9009,3152,3,134,191,639,55,32,1051,3,21,1075
9,21,9009,3153,3,148,220,913,94,40,1415,7,28,1450
9,21,9009,3154,3,109,213,539,55,46,962,2,26,990
9,21,9009,3155,3,164,199,712,69,33,1177,5,31,1213
9,21,9009,3156,3,115,143,570,63,43,934,0,24,958
9,21,9009,3157,3,154,210,753,87,47,1251,4,25,1280
9,21,9009,3158,3,114,184,481,51,33,863,4,27,894
9,21,9009,3159,3,189,521,1219,113,69,2111,10,57,2178
9,21,9009,3160,3,235,480,1171,101,42,2029,11,68,2108
9,21,9009,3161,3,109,273,614,49,29,1074,4,14,1092
9,21,9009,3162,3,130,192,448,52,33,855,0,14,869
9,21,9013,4126,3,293,78,439,22,52,884,0,15,899
9,21,9013,4127,3,370,111,540,53,60,1134,4,37,1175
9,21,9013,4128,3,373,120,550,63,62,1168,4,15,1187
9,21,9013,4129,3,254,100,445,63,46,908,1,32,941
9,21,9013,4173,3,112,98,799,136,21,1166,1,28,1195
9,21,9013,4174,3,115,71,489,120,21,816,1,21,838
9,21,9013,4175,3,118,104,650,99,25,996,1,31,1028
9,21,9013,4176,3,100,77,558,111,19,865,0,16,881
9,21,9013,4177,3,123,124,875,108,47,1277,6,27,1310
9,21,9013,4178,3,130,109,942,98,48,1327,5,29,1361
9,21,9013,4179,3,141,134,667,69,39,1050,3,18,1071
9,21,9013,4180,3,98,121,543,71,31,864,1,24,889
9,21,9013,4181,3,173,106,531,76,38,924,10,11,945
9,21,9013,4182,3,206,173,1039,91,66,1575,3,18,1596
9,21,9013,4183,3,217,235,1142,103,79,1776,12,45,1833
9,21,9013,4192,3,366,100,278,28,45,817,2,10,829
9,21,9013,4193,3,336,76,225,24,29,690,0,10,700
9,21,9013,4194,3,191,88,288,36,44,647,2,15,664
9,21,9013,4195,3,193,50,366,34,29,672,0,15,687
9,21,9013,4196,3,222,132,580,59,45,1038,4,14,1056
9,21,9013,4197,3,193,106,506,58,44,907,3,26,936
9,21,9013,4198,3,174,75,559,72,43,923,2,14,939
9,21,9013,4199,3,159,106,847,74,55,1241,0,32,1273
9,21,9013,4200,3,180,96,813,65,45,1199,3,32,1234
9,21,9013,4201,3,403,221,1318,168,92,2202,2,41,2245
9,21,9013,4202,3,235,101,271,26,37,670,12,12,694
9,21,9013,4203,3,186,120,296,37,40,679,0,5,684
9,21,9013,4204,3,341,90,262,21,29,743,6,12,761
9,21,9013,4205,3,254,117,409,47,28,855,1,17,873
9,21,9013,4206,3,416,118,253,23,39,849,1,9,859
9,21,9013,4207,3,389,103,247,30,41,810,4,10,824
9,21,9013,4213,3,231,162,590,79,52,1114,0,28,1142
9,21,9013,4216,3,231,101,532,76,51,991,5,17,1013
9,21,9013,4217,3,214,108,540,61,38,961,3,26,990
9,21,9013,4218,3,208,136,671,79,48,1142,2,31,1175
9,21,9013,4219,3,180,142,721,66,38,1147,2,19,1168
9,21,9013,4220,3,179,100,624,60,37,1000,1,14,1015
9,21,9013,4221,3,125,78,522,53,27,805,0,14,819
9,21,9013,4222,3,199,115,678,87,47,1126,1,22,1149
9,21,9013,4223,3,176,150,1107,93,53,1579,4,39,1622
9,21,9013,4224,3,174,141,1154,126,48,1643,6,46,1695
9,21,9013,4225,3,183,213,1133,101,85,1715,2,50,1767
9,21,9013,4226,3,155,124,820,82,49,1230,6,29,1265
9,21,9013,4227,3,133,157,674,99,40,1103,1,24,1128
9,21,9013,4228,3,218,191,869,78,49,1405,6,28,1439
9,21,9013,4229,3,284,147,752,92,61,1336,0,23,1359
9,21,9013,4230,3,329,105,478,58,40,1010,10,7,1027
9,21,9013,4231,3,191,84,443,59,36,813,0,35,848
9,21,9013,4232,3,367,84,223,22,37,733,0,12,745
9,21,9013,4233,3,420,126,259,39,38,882,0,3,885
9,21,9013,4234,3,292,135,777,74,53,1331,4,23,1358
9,21,9013,4235,3,343,129,988,72,58,1590,6,23,1619
9,21,9013,4236,3,159,149,854,64,46,1272,3,28,1303
9,21,9013,4237,3,295,223,1467,117,111,2213,8,34,2255
9,21,9013,4238,3,224,152,1166,117,78,1737,7,45,1789
9,21,9013,4239,3,191,135,845,64,34,1269,2,24,1295
9,21,9013,4240,3,126,63,314,27,30,560,0,8,568
9,21,9013,4241,3,185,99,671,66,31,1052,2,19,1073
9,21,9013,4242,3,195,93,458,57,32,835,2,13,850
9,21,9013,4243,3,151,93,392,52,38,726,1,26,753
9,21,9013,4244,3,213,132,715,81,45,1186,4,38,1228
9,21,9013,4245,3,236,165,854,94,69,1418,1,34,1453
9,21,9013,4246,3,397,302,2302,216,107,3324,17,74,3415
9,21,9013,4247,3,102,79,583,50,40,854,5,19,878
9,21,9013,4248,3,315,171,777,54,49,1366,2,28,1396
9,21,9013,4249,3,141,104,672,81,36,1034,2,20,1056
9,21,9013,4250,3,147,99,858,79,52,1235,3,23,1261
9,21,9013,4251,3,182,124,751,100,47,1204,7,30,1241
9,21,9013,4252,3,165,122,791,61,43,1182,7,20,1209
9,21,9013,4253,3,181,100,803,71,44,1199,1,15,1215
9,21,9013,4254,3,187,107,836,72,39,1241,4,12,1257
9,21,9013,4255,3,225,118,798,88,39,1268,2,31,1301
9,21,9013,4256,3,204,88,640,62,46,1040,3,15,1058
9,21,9013,4257,3,196,107,626,68,53,1050,1,31,1082
9,21,9013,4258,3,182,119,664,52,33,1050,8,24,1082
9,21,9013,4259,3,198,120,967,89,47,1421,4,29,1454
9,21,9013,4260,3,370,217,1603,158,108,2456,7,41,2504
9,21,9013,4261,3,253,169,929,85,54,1490,4,29,1523
9,21,9013,4262,3,169,158,927,81,38,1373,5,23,1401
9,21,9013,4263,3,186,108,754,87,44,1179,0,40,1219
9,21,9013,4264,3,165,115,853,65,51,1249,3,31,1283
9,21,9013,4265,3,141,124,775,74,29,1143,4,23,1170
9,21,9013,4266,3,100,120,674,73,30,997,2,17,1016
9,21,9013,4267,3,207,55,297,39,29,627,0,3,630
9,21,9013,4268,3,110,34,207,28,19,398,2,11,411
9,22,9007,2560,3,147,79,532,47,43,848,2,26,876
9,22,9007,2561,3,143,71,445,36,35,730,3,11,744
9,22,9007,2562,3,342,170,1123,98,77,1810,2,39,1851
9,22,9007,2563,3,228,109,631,62,54,1084,5,19,1108
9,22,9007,2564,3,120,76,365,43,30,634,4,15,653
9,22,9007,2565,3,167,100,533,53,35,888,3,12,903
9,22,9007,2566,3,147,78,584,48,45,902,7,14,923
9,22,9007,2567,3,180,121,572,38,44,955,7,20,982
9,22,9007,2568,3,156,67,498,49,25,795,5,15,815
9,22,9007,2569,3,122,53,458,39,25,697,3,6,706
9,22,9007,2570,3,146,87,685,50,39,1007,3,27,1037
9,22,9007,2571,3,165,124,734,62,50,1135,1,21,1157
9,22,9007,2572,3,134,93,489,54,32,802,0,25,827
9,22,9007,2573,3,113,63,524,24,23,747,3,18,768
9,22,9007,2574,3,103,78,581,35,29,826,0,21,847
9,22,9007,2575,3,131,77,602,60,35,905,3,23,931
9,22,9007,2576,3,65,64,469,31,26,655,3,19,677
9,22,9007,2577,3,84,51,553,52,26,766,2,26,794
9,22,9007,2578,3,96,74,527,42,18,757,3,14,774
9,22,9007,2579,3,107,73,425,35,24,664,4,21,689
9,22,9007,2580,3,123,78,765,44,29,1039,5,15,1059
9,22,9007,2581,3,140,101,746,36,35,1058,2,24,1084
9,22,9007,2582,3,69,84,510,41,24,728,2,7,737
9,22,9007,2583,3,111,86,568,51,30,846,4,31,881
9,22,9007,2584,3,97,84,519,34,33,767,2,5,774
9,22,9007,2585,3,112,79,466,35,26,718,1,12,731
9,22,9007,2586,3,290,168,1005,96,50,1609,5,24,1638
9,22,9007,2587,3,182,102,684,41,26,1035,11,15,1061
9,22,9007,2588,3,133,71,605,61,26,896,3,13,912
9,22,9007,2589,3,143,55,511,50,28,787,4,23,814
9,22,9007,2590,3,152,112,746,72,30,1112,6,30,1148
9,22,9007,2591,3,167,128,776,45,36,1152,1,49,1202
9,22,9007,2592,3,70,65,441,29,22,627,1,12,640
9,22,9007,2593,3,76,75,495,28,24,698,4,11,713
9,22,9007,2594,3,106,78,629,35,32,880,5,17,902
9,22,9007,2595,3,99,55,541,35,21,751,1,21,773
9,22,9007,2596,3,77,77,536,40,26,756,1,0,757
9,22,9007,2597,3,102,66,613,30,23,834,3,21,858
9,22,9007,2598,3,109,73,509,43,29,763,4,16,783
9,22,9007,2599,3,84,67,599,37,41,828,3,29,860
9,22,9007,2600,3,87,62,556,42,19,766,1,20,787
9,22,9007,2601,3,83,67,628,35,17,830,2,16,848
9,22,9007,2602,3,73,42,512,41,20,688,0,14,702
9,22,9007,2603,3,72,58,442,31,15,618,0,8,626
9,22,9007,2604,3,88,62,576,23,22,771,1,12,784
9,22,9007,2605,3,103,57,624,28,23,835,3,0,838
9,22,9007,2606,3,92,64,547,42,30,775,0,16,791
9,22,9007,2607,3,101,66,535,38,27,767,2,18,787
9,22,9007,2608,3,181,104,549,52,26,912,3,18,933
9,22,9007,2609,3,137,79,536,26,29,807,0,15,822
9,22,9007,2610,3,106,78,524,58,39,805,2,22,829
9,22,9007,2611,3,143,115,568,38,34,898,2,18,918
9,22,9007,2612,3,146,93,773,52,44,1108,1,20,1129
9,22,9007,2613,3,183,92,608,32,37,952,3,24,979
9,22,9007,2614,3,122,77,449,40,28,716,4,20,740
9,22,9007,2615,3,158,70,501,38,28,795,6,8,809
9,22,9007,2616,3,294,173,1017,104,60,1648,5,23,1676
9,22,9007,2617,3,175,93,669,45,55,1037,6,21,1064
9,22,9007,2618,3,129,67,416,42,28,682,0,21,703
9,22,9007,2619,3,160,65,642,41,41,949,4,9,962
9,22,9007,2620,3,168,93,727,60,52,1100,7,24,1131
9,22,9007,2682,3,190,74,550,58,46,918,5,18,941
9,22,9007,2683,3,140,78,572,55,48,893,1,4,898
9,22,9007,2684,3,165,112,653,55,31,1016,6,16,1038
9,22,9007,2685,3,148,127,716,49,37,1077,2,18,1097
9,22,9007,2686,3,128,63,451,44,32,718,0,23,741
9,22,9007,2687,3,127,80,541,53,40,841,2,24,867
9,22,9007,2688,3,124,82,619,45,37,907,1,13,921
9,22,9007,2689,3,111,56,474,39,43,723,6,15,744
9,22,9007,2690,3,196,120,638,53,50,1057,3,29,1089
9,22,9007,2691,3,79,75,672,39,38,903,1,27,931
9,22,9007,2692,3,147,85,680,56,42,1010,1,30,1041
9,22,9007,2693,3,98,64,603,51,24,840,4,4,848
9,22,9007,2694,3,91,60,587,31,32,801,4,18,823
9,22,9007,2695,3,65,46,395,19,19,544,6,8,558
9,22,9007,2696,3,48,60,543,37,29,717,0,19,736
9,22,9007,2697,3,105,69,418,48,22,662,9,14,685
9,22,9007,2698,3,58,70,385,40,23,576,6,18,600
9,22,9007,2699,3,105,80,619,42,17,863,2,19,884
9,22,9007,2700,3,80,80,625,50,20,855,4,34,893
9,22,9007,2701,3,81,66,560,39,15,761,0,19,780
9,22,9007,2702,3,105,66,669,44,24,908,2,25,935
9,22,9007,2703,3,80,83,545,37,27,772,1,9,782
9,22,9007,2704,3,66,74,545,26,21,732,3,13,748
9,22,9007,2705,3,93,85,552,36,17,783,0,29,812
9,22,9007,2706,3,86,65,448,62,19,680,4,18,702
9,22,9007,2707,3,99,73,661,42,23,898,2,25,925
9,22,9007,2708,3,81,70,524,40,18,733,1,6,740
9,22,9007,2709,3,78,67,578,56,27,806,1,27,834
9,22,9007,2710,3,63,60,707,49,35,914,2,23,939
9,22,9007,2711,3,91,57,528,34,33,743,2,12,757
9,22,9007,2712,3,84,88,556,41,24,793,4,11,808
9,22,9007,2713,3,91,79,673,39,42,924,2,33,959
9,22,9007,2714,3,126,83,609,38,35,891,6,25,922
9,22,9007,2715,3,111,73,546,44,30,804,2,20,826
9,22,9007,2716,3,96,87,497,41,48,769,1,16,786
9,22,9007,2717,3,111,97,621,48,37,914,2,20,936
9,22,9007,2718,3,140,58,487,51,32,768,5,17,790
9,22,9007,2719,3,170,129,906,64,69,1338,5,17,1360
9,22,9007,2720,3,156,98,845,70,39,1208,5,22,1235
9,22,9007,2721,3,154,69,634,45,44,946,1,18,965
9,22,9007,2722,3,105,68,520,44,28,765,5,21,791
9,22,9007,2777,3,116,54,533,46,36,785,8,13,806
9,22,9007,2778,3,119,71,536,46,31,803,6,17,826
9,22,9007,2779,3,140,113,904,66,41,1264,5,28,1297
9,22,9007,2780,3,124,117,629,53,42,965,5,22,992
9,22,9007,2781,3,79,89,660,48,29,905,4,25,934
9,22,9007,2782,3,137,97,658,41,27,960,4,19,983
9,22,9007,2783,3,117,83,547,35,37,819,4,24,847
9,22,9007,2784,3,124,93,498,50,27,792,3,18,813
9,22,9007,2785,3,91,75,777,42,33,1018,5,25,1048
9,22,9007,2786,3,193,193,1439,85,51,1961,6,32,1999
9,22,9007,2787,3,66,74,577,36,26,779,5,13,797
9,22,9007,2788,3,103,61,689,29,23,905,5,33,943
9,22,9007,2789,3,85,94,764,49,34,1026,10,30,1066
9,22,9007,2790,3,93,94,831,55,37,1110,3,28,1141
9,22,9007,2791,3,91,82,693,38,35,939,9,20,968
9,22,9007,2792,3,73,56,554,43,28,754,3,27,784
9,22,9007,2793,3,88,50,660,29,23,850,1,24,875
9,22,9007,2794,3,83,78,556,45,32,794,15,23,832
9,22,9007,2795,3,96,93,486,48,21,744,1,12,757
9,22,9007,2796,3,94,59,573,40,26,792,2,16,810
9,22,9007,2797,3,133,122,892,62,52,1261,3,25,1289
9,22,9007,2798,3,113,115,681,34,24,967,12,13,992
9,22,9007,2799,3,85,100,697,37,31,950,1,22,973
9,22,9007,2800,3,225,150,1565,92,88,2120,7,38,2165
9,22,9007,2801,3,86,123,832,48,44,1133,6,16,1155
9,22,9007,2802,3,148,178,1228,90,49,1693,10,46,1749
9,22,9007,2803,3,100,96,905,58,40,1199,4,38,1241
9,22,9007,2804,3,72,100,466,31,16,685,2,12,699
9,22,9007,2805,3,77,76,722,30,26,931,3,27,961
9,22,9007,2806,3,84,90,671,40,21,906,1,29,936
9,22,9007,2807,3,86,83,650,40,37,896,3,17,916
9,22,9007,2808,3,65,64,582,37,28,776,5,17,798
9,22,9007,2809,3,88,194,713,64,44,1103,15,9,1127
9,22,9007,2810,3,61,45,403,29,8,546,1,11,558
9,22,9007,2811,3,184,129,1177,76,52,1618,3,33,1654
9,22,9007,2812,3,103,103,774,46,41,1067,5,26,1098
9,22,9007,2813,3,107,79,373,26,41,626,1,16,643
9,22,9007,2814,3,102,83,532,41,39,797,3,25,825
9,22,9007,2815,3,93,61,521,54,46,775,6,21,802
9,22,9007,2816,3,91,55,399,40,32,617,2,21,640
9,22,9007,2817,3,125,99,650,40,28,942,3,27,972
9,22,9007,2818,3,170,102,622,54,41,989,0,30,1019
9,22,9007,2819,3,156,153,1069,76,62,1516,5,53,1574
9,22,9007,2820,3,128,103,783,53,43,1110,1,33,1144
9,22,9007,2821,3,204,114,928,87,58,1391,5,32,1428
9,22,9007,2822,3,155,97,654,54,52,1012,3,13,1028
9,22,9007,2823,3,111,63,462,39,28,703,2,15,720
9,22,9007,2864,3,306,310,2344,166,109,3235,16,93,3344
9,22,9007,2964,3,83,40,330,11,15,479,5,9,493
9,22,9007,2965,3,77,54,422,26,21,600,3,13,616
9,23,9003,345,3,342,123,490,61,33,1049,1,24,1074
9,23,9003,346,3,126,52,124,14,18,334,2,1,337
9,23,9003,347,3,577,166,415,46,60,1264,4,18,1286
9,23,9003,348,3,518,175,607,58,86,1444,0,13,1457
9,23,9003,349,3,411,139,262,38,36,886,0,11,897
9,23,9003,350,3,433,137,344,22,36,972,0,9,981
9,23,9003,351,3,455,156,736,60,48,1455,8,19,1482
9,23,9003,352,3,316,119,464,33,33,965,4,18,987
9,23,9003,353,3,362,153,743,56,36,1350,1,28,1379
9,23,9003,354,3,678,260,1278,119,126,2461,7,25,2493
9,23,9003,355,3,339,190,875,73,65,1542,2,29,1573
9,23,9003,356,3,219,118,634,58,42,1071,9,23,1103
9,23,9003,357,3,217,138,769,58,45,1227,1,19,1247
9,23,9003,358,3,98,58,539,24,30,749,13,17,779
9,23,9003,359,3,371,134,427,31,54,1017,1,18,1036
9,23,9003,360,3,190,90,711,31,49,1071,5,16,1092
9,23,9003,361,3,163,71,698,63,35,1030,0,23,1053
9,23,9003,362,3,162,76,651,56,33,978,1,15,994
9,23,9003,363,3,196,96,862,71,53,1278,1,19,1298
9,23,9003,364,3,248,124,956,78,58,1464,6,46,1516
9,23,9003,365,3,218,113,732,59,53,1175,3,24,1202
9,23,9003,366,3,228,100,864,53,54,1299,5,25,1329
9,23,9003,367,3,409,146,753,57,44,1409,1,37,1447
9,23,9003,368,3,391,128,488,40,51,1098,1,29,1128
9,23,9003,369,3,394,161,222,24,30,831,2,21,854
9,23,9003,370,3,150,64,132,12,26,384,1,6,391
9,23,9003,371,3,243,56,384,32,27,742,2,6,750
9,23,9003,372,3,312,96,456,41,39,944,0,13,957
9,23,9003,373,3,287,70,689,43,53,1142,4,29,1175
9,23,9003,374,3,215,106,778,54,43,1196,4,20,1220
9,23,9003,375,3,116,59,254,21,25,475,2,8,485
9,23,9003,376,3,224,107,759,54,52,1196,0,18,1214
9,23,9003,377,3,268,110,704,56,31,1169,14,21,1204
9,23,9003,378,3,244,132,878,60,42,1356,3,17,1376
9,23,9003,379,3,211,101,731,48,41,1132,2,14,1148
9,23,9003,380,3,104,75,437,32,14,662,4,10,676
9,23,9003,381,3,214,114,849,75,54,1306,6,24,1336
9,23,9003,382,3,236,92,834,79,78,1319,4,34,1357
9,23,9003,383,3,231,112,756,58,43,1200,0,30,1230
9,23,9003,384,3,209,97,948,59,49,1362,8,30,1400
9,23,9003,385,3,245,68,870,58,39,1280,9,22,1311
9,23,9003,386,3,166,86,729,33,35,1049,0,19,1068
9,23,9003,387,3,73,53,371,28,22,547,0,14,561
9,23,9003,388,3,187,111,724,64,51,1137,1,19,1157
9,23,9003,389,3,140,68,601,31,35,875,2,16,893
9,23,9003,390,3,187,102,1004,50,39,1382,3,22,1407
9,23,9003,391,3,135,61,568,35,30,829,5,12,846
9,23,9003,392,3,113,67,851,38,28,1097,8,21,1126
9,23,9003,393,3,172,95,923,49,45,1284,1,16,1301
9,23,9003,394,3,150,76,646,43,31,946,1,8,955
9,23,9003,395,3,241,108,825,60,49,1283,2,28,1313
9,23,9003,396,3,53,42,366,29,15,505,1,12,518
9,23,9003,397,3,326,143,633,46,50,1198,2,23,1223
9,23,9003,398,3,322,93,367,28,35,845,0,20,865
9,23,9003,399,3,356,130,612,76,60,1234,2,33,1269
9,23,9003,400,3,263,103,484,69,47,966,2,22,990
9,23,9003,401,3,214,98,606,49,34,1001,2,12,1015
9,23,9003,402,3,277,110,645,81,48,1161,1,12,1174
9,23,9003,403,3,164,114,669,42,32,1021,2,13,1036
9,23,9003,404,3,195,109,995,57,54,1410,4,16,1430
9,23,9003,405,3,108,61,516,34,21,740,0,22,762
9,23,9003,406,3,220,89,769,55,45,1178,1,22,1201
9,23,9003,407,3,192,119,686,56,39,1092,4,19,1115
9,23,9003,408,3,77,36,477,32,21,643,0,12,655
9,23,9003,409,3,142,94,699,43,32,1010,4,19,1033
9,23,9003,410,3,111,54,541,35,41,782,6,17,805
9,23,9003,411,3,128,71,741,37,33,1010,0,16,1026
9,23,9003,412,3,590,163,71,27,18,869,1,2,872
9,23,9003,413,3,543,146,89,17,30,825,0,3,828
9,23,9003,414,3,252,74,114,16,20,476,0,7,483
9,23,9003,415,3,154,59,586,35,33,867,2,19,888
9,23,9003,416,3,260,127,1036,52,54,1529,4,36,1569
9,23,9003,417,3,182,121,815,62,37,1217,4,23,1244
9,23,9003,418,3,275,136,745,61,70,1287,2,12,1301
9,23,9003,419,3,202,116,591,58,40,1007,0,17,1024
9,23,9003,420,3,143,89,509,58,32,831,1,21,853
9,23,9003,421,3,192,121,655,57,53,1078,1,14,1093
9,23,9003,422,3,137,101,615,43,35,931,2,13,946
9,23,9003,423,3,154,76,433,41,24,728,0,9,737
9,23,9003,424,3,134,61,324,39,23,581,2,13,596
9,23,9003,425,3,240,108,716,50,48,1162,4,13,1179
9,23,9003,426,3,192,77,439,43,22,773,0,10,783
9,23,9003,427,3,368,229,579,66,73,1315,0,27,1342
9,23,9003,428,3,298,130,412,29,44,913,1,12,926
9,23,9003,429,3,219,60,352,40,32,703,0,18,721
9,23,9003,430,3,210,111,808,54,47,1230,5,23,1258
9,23,9003,431,3,154,70,657,46,19,946,0,13,959
9,23,9003,432,3,179,73,648,56,33,989,0,19,1008
9,23,9003,433,3,256,103,637,61,44,1101,0,13,1114
9,23,9003,434,3,257,122,732,61,48,1220,0,17,1237
9,23,9003,435,3,226,119,695,54,41,1135,0,29,1164
9,23,9003,436,3,226,128,854,38,41,1287,0,25,1312
9,23,9003,437,3,220,98,765,37,39,1159,1,23,1183
9,23,9003,438,3,244,130,668,74,56,1172,10,17,1199
9,23,9003,439,3,187,84,836,56,34,1197,1,28,1226
9,23,9003,440,3,117,61,483,34,28,723,1,16,740
9,23,9003,441,3,220,116,895,46,35,1312,5,36,1353
9,23,9003,442,3,119,56,517,44,23,759,0,20,779
9,23,9003,443,3,164,103,680,58,39,1044,3,25,1072
9,23,9003,444,3,209,129,863,48,66,1315,4,31,1350
9,23,9003,445,3,223,121,667,63,32,1106,3,13,1122
9,23,9003,446,3,143,75,495,44,39,796,2,12,810
9,23,9003,447,3,245,114,735,64,46,1204,0,33,1237
9,23,9003,448,3,184,92,599,49,44,968,6,20,994
9,23,9003,449,3,165,80,719,61,28,1053,4,28,1085
9,23,9003,450,3,139,79,540,30,20,808,1,15,824
9,23,9003,451,3,189,123,505,34,41,892,1,15,908
9,23,9003,452,3,255,144,946,82,41,1468,5,23,1496
9,23,9003,453,3,231,108,788,53,45,1225,5,24,1254
9,23,9003,454,3,138,95,626,38,31,928,3,11,942
9,23,9003,455,3,137,78,438,44,41,738,2,18,758
9,23,9003,456,3,288,106,637,48,42,1121,2,15,1138
9,23,9003,457,3,114,79,491,29,33,746,1,17,764
9,23,9003,458,3,271,79,332,53,38,773,0,11,784
9,23,9003,459,3,278,91,332,51,34,786,0,8,794
9,23,9003,460,3,229,72,290,50,44,685,4,7,696
9,23,9003,461,3,166,66,160,25,32,449,3,6,458
9,23,9003,462,3,222,49,220,20,26,537,1,5,543
9,23,9003,463,3,214,79,340,24,37,694,4,15,713
9,23,9003,464,3,205,86,455,47,37,830,1,12,843
9,23,9003,465,3,291,114,382,51,54,892,1,14,907
9,23,9003,466,3,316,98,479,47,60,1000,5,16,1021
9,23,9003,467,3,257,102,353,41,55,808,2,9,819
9,23,9003,468,3,291,97,415,34,34,871,1,11,883
9,23,9003,469,3,320,92,362,52,56,882,0,8,890
9,23,9003,470,3,272,139,414,50,54,929,0,16,945
9,23,9003,471,3,644,259,1009,96,87,2095,5,21,2121
9,23,9003,472,3,556,160,149,21,44,930,1,5,936
9,23,9003,473,3,684,165,290,32,56,1227,1,10,1238
9,23,9003,474,3,314,114,402,42,49,921,0,13,934
9,23,9003,475,3,367,121,371,42,51,952,4,11,967
9,23,9003,476,3,459,131,413,45,53,1101,0,13,1114
9,23,9003,477,3,224,176,321,40,35,796,3,13,812
9,23,9003,478,3,254,123,340,39,37,793,4,7,804
9,23,9003,479,3,165,38,92,13,15,323,2,6,331
9,23,9003,480,3,287,80,177,21,33,598,0,5,603
9,23,9003,481,3,121,52,247,25,24,469,0,5,474
9,23,9003,482,3,188,110,705,59,31,1093,4,21,1118
9,23,9003,483,3,137,46,240,20,16,459,2,3,464
9,23,9003,484,3,107,83,620,42,27,879,5,16,900
9,23,9003,485,3,316,138,846,75,72,1447,4,25,1476
9,23,9003,486,3,140,64,475,33,29,741,1,9,751
9,23,9003,487,3,117,43,688,39,26,913,2,18,933
9,23,9003,488,3,100,66,587,31,35,819,1,23,843
9,23,9003,489,3,133,62,470,33,42,740,1,19,760
9,23,9003,490,3,227,90,566,50,31,964,3,24,991
9,23,9003,491,3,283,51,182,16,21,553,0,7,560
9,23,9003,492,3,83,46,346,26,13,514,2,3,519
9,23,9003,493,3,157,46,672,41,36,952,1,23,976
9,23,9003,494,3,136,64,406,35,38,679,2,14,695
9,23,9003,495,3,533,115,177,27,53,905,2,6,913
9,23,9003,496,3,99,42,462,27,19,649,1,14,664
9,23,9003,497,3,121,61,395,27,10,614,1,17,632
9,23,9003,498,3,110,66,350,20,20,566,3,12,581
9,23,9003,499,3,176,81,523,50,34,864,0,6,870
9,23,9003,500,3,132,72,447,40,39,730,3,19,752
9,23,9003,501,3,188,86,569,46,26,915,2,18,935
9,23,9003,502,3,169,56,471,31,39,766,4,17,787
9,23,9003,503,3,127,77,663,38,32,937,3,13,953
9,23,9003,504,3,82,40,526,22,22,692,1,19,712
9,23,9003,505,3,127,55,310,26,17,535,0,7,542
9,23,9003,506,3,84,60,255,21,26,446,0,12,458
9,23,9003,507,3,86,72,394,31,24,607,0,12,619
9,23,9003,508,3,101,43,359,23,15,541,2,10,553
9,23,9003,509,3,76,53,331,23,10,493,3,4,500
9,23,9003,510,3,224,105,472,70,37,908,2,9,919
9,23,9003,511,3,70,40,297,22,12,441,0,6,447
9,23,9003,512,3,157,58,262,28,19,524,1,8,533
9,23,9003,513,3,112,60,315,19,22,528,2,9,539
9,23,9003,514,3,92,49,463,18,30,652,0,14,666
9,23,9003,515,3,94,36,463,21,25,639,4,13,656
9,23,9003,693,3,59,18,91,8,13,189,0,1,190
9,23,9003,715,3,225,85,272,18,36,636,0,11,647
9,23,9003,716,3,213,75,173,18,22,501,0,6,507
9,23,9003,719,3,341,118,305,38,45,847,2,13,862
9,23,9003,720,3,201,51,261,30,19,562,0,13,575
9,23,9003,721,3,359,141,627,71,65,1263,4,19,1286
9,23,9003,722,3,236,88,225,23,27,599,0,19,618
9,23,9003,723,3,570,140,326,33,62,1131,1,9,1141
9,23,9003,724,3,435,145,447,39,54,1120,1,8,1129
9,23,9003,725,3,335,85,325,18,44,807,3,13,823
9,23,9003,726,3,709,195,221,37,58,1220,2,19,1241
9,23,9003,727,3,471,139,540,43,63,1256,5,20,1281
9,23,9003,728,3,224,69,124,28,23,468,0,2,470
9,23,9003,729,3,226,53,210,19,26,534,0,8,542
9,23,9003,730,3,167,48,165,13,24,417,1,14,432
9,23,9003,731,3,505,143,168,25,38,879,2,5,886
9,23,9003,732,3,617,113,82,21,16,849,1,15,865
9,23,9003,733,3,258,171,318,38,42,827,1,13,841
9,23,9003,734,3,264,147,436,53,39,939,1,11,951
9,23,9003,735,3,277,153,482,44,47,1003,0,16,1019
9,23,9003,736,3,223,26,226,18,31,524,2,11,537
9,23,9003,737,3,376,165,581,42,47,1211,4,17,1232
9,23,9003,738,3,264,127,387,37,40,855,2,15,872
9,23,9003,739,3,231,79,187,21,35,553,2,3,558
9,23,9003,740,3,170,65,211,22,33,501,2,9,512
9,23,9003,741,3,264,99,277,24,38,702,0,11,713
9,23,9003,743,3,206,87,133,21,30,477,0,12,489
9,23,9003,745,3,303,100,405,33,34,875,0,12,887
9,23,9003,746,3,427,172,473,45,69,1186,1,20,1207
9,23,9003,5515,3,467,77,162,27,32,765,0,3,768
9,24,9003,516,3,284,136,374,51,37,882,0,13,895
9,24,9003,517,3,180,63,200,14,28,485,0,5,490
9,24,9003,518,3,173,72,185,23,22,475,0,5,480
9,24,9003,519,3,482,145,442,65,57,1191,0,15,1206
9,24,9003,520,3,391,115,266,27,26,825,0,16,841
9,24,9003,521,3,400,127,285,33,42,887,0,15,902
9,24,9003,522,3,298,86,200,17,37,638,0,12,650
9,24,9003,523,3,451,143,271,23,54,942,0,8,950
9,24,9003,524,3,226,69,106,10,22,433,0,8,441
9,24,9003,525,3,294,100,194,24,26,638,1,8,647
9,24,9003,526,3,529,171,355,39,56,1150,3,16,1169
9,24,9003,527,3,430,116,176,23,32,777,0,9,786
9,24,9003,528,3,534,145,256,41,47,1023,1,11,1035
9,24,9003,529,3,466,102,162,20,22,772,0,10,782
9,24,9003,530,3,402,188,543,49,55,1237,0,20,1257
9,24,9003,531,3,473,132,222,25,38,890,1,13,904
9,24,9003,532,3,445,114,176,28,31,794,1,6,801
9,24,9003,533,3,421,89,151,17,24,702,0,7,709
9,24,9003,534,3,565,130,191,27,27,940,0,7,947
9,24,9003,535,3,534,142,196,25,39,936,0,16,952
9,24,9003,536,3,558,120,219,37,41,975,0,10,985
9,24,9003,537,3,417,106,157,26,39,745,1,6,752
9,24,9003,538,3,188,90,543,36,33,890,0,32,922
9,24,9003,539,3,199,92,634,62,40,1027,6,25,1058
9,24,9003,540,3,213,69,481,48,36,847,0,24,871
9,24,9003,541,3,202,59,360,38,38,697,1,13,711
9,24,9003,542,3,370,77,104,21,21,593,0,8,601
9,24,9003,543,3,535,169,217,30,48,999,1,5,1005
9,24,9003,544,3,392,102,156,31,21,702,0,2,704
9,24,9003,545,3,537,175,201,40,37,990,6,10,1006
9,24,9003,546,3,381,111,666,54,36,1248,0,26,1274
9,24,9003,547,3,479,120,220,26,44,889,0,10,899
9,24,9003,548,3,348,73,151,19,18,609,0,2,611
9,24,9003,549,3,450,76,177,25,11,739,0,7,746
9,24,9003,550,3,233,78,208,23,27,569,0,9,578
9,24,9003,551,3,422,130,327,24,33,936,1,12,949
9,24,9003,552,3,439,133,258,29,41,900,0,16,916
9,24,9003,553,3,529,169,412,47,52,1209,2,9,1220
9,24,9003,554,3,330,98,261,27,37,753,0,11,764
9,24,9003,555,3,283,68,221,28,31,631,1,4,636
9,24,9003,556,3,269,132,746,89,52,1288,0,35,1323
9,24,9003,557,3,143,91,664,36,20,954,2,15,971
9,24,9003,558,3,116,111,675,51,29,982,3,21,1006
9,24,9003,559,3,127,70,572,30,26,825,0,18,843
9,24,9003,560,3,170,130,702,45,38,1085,0,31,1116
9,24,9003,561,3,195,96,417,40,27,775,0,19,794
9,24,9003,562,3,452,126,538,46,38,1200,0,19,1219
9,24,9003,563,3,347,127,318,40,45,877,0,4,881
9,24,9003,564,3,395,127,385,32,49,988,1,7,996
9,24,9003,565,3,222,105,344,30,44,745,2,0,747
9,24,9003,566,3,315,108,351,24,47,845,0,13,858
9,24,9003,567,3,448,120,422,40,57,1087,0,20,1107
9,24,9003,568,3,423,106,389,47,54,1019,0,13,1032
9,24,9003,569,3,413,128,398,33,54,1026,2,19,1047
9,24,9003,570,3,324,121,544,47,49,1085,1,23,1109
9,24,9003,571,3,243,115,642,60,43,1103,5,26,1134
9,24,9003,572,3,301,127,588,40,56,1112,0,17,1129
9,24,9003,573,3,168,86,651,33,28,966,0,31,997
9,24,9003,574,3,146,64,237,25,22,494,0,0,494
9,24,9003,575,3,283,116,342,41,50,832,4,9,845
9,24,9003,576,3,804,265,1220,109,97,2495,2,48,2545
9,24,9003,577,3,276,90,481,51,53,951,1,8,960
9,24,9003,578,3,171,73,284,32,31,591,0,5,596
9,24,9003,579,3,239,73,385,56,31,784,0,16,800
9,24,9003,580,3,247,91,499,47,36,920,3,16,939
9,24,9003,581,3,342,121,502,53,36,1054,10,11,1075
9,24,9003,582,3,468,119,484,62,55,1188,0,29,1217
9,24,9003,583,3,468,158,438,51,49,1164,1,18,1183
9,24,9003,584,3,281,91,283,37,30,722,0,12,734
9,24,9003,585,3,402,119,331,36,38,926,0,9,935
9,24,9003,586,3,503,144,403,34,39,1123,0,18,1141
9,24,9003,587,3,413,184,486,59,58,1200,1,17,1218
9,24,9003,588,3,285,58,279,25,26,673,1,10,684
9,24,9003,589,3,374,100,339,26,46,885,1,9,895
9,24,9003,590,3,513,168,485,44,53,1263,3,16,1282
9,24,9003,591,3,688,235,710,90,102,1825,0,29,1854
9,24,9003,592,3,260,95,506,44,43,948,0,12,960
9,24,9003,593,3,266,99,650,46,55,1116,1,4,1121
9,24,9003,594,3,350,118,556,50,54,1128,2,11,1141
9,24,9003,595,3,359,168,605,58,59,1249,0,22,1271
9,24,9003,596,3,373,123,505,64,52,1117,0,10,1127
9,24,9003,597,3,358,121,599,68,56,1202,1,16,1219
9,24,9003,598,3,247,102,525,45,52,971,0,30,1001
9,24,9003,599,3,364,145,572,64,59,1204,2,19,1225
9,24,9003,600,3,334,117,543,54,53,1101,1,14,1116
9,24,9003,601,3,292,110,501,56,66,1025,0,17,1042
9,24,9003,602,3,457,150,627,83,77,1394,0,13,1407
9,24,9003,603,3,486,158,470,49,61,1224,2,19,1245
9,24,9003,604,3,451,137,444,38,53,1123,1,18,1142
9,24,9003,605,3,530,144,453,48,56,1231,3,14,1248
9,24,9003,606,3,652,150,445,50,68,1365,0,23,1388
9,24,9003,607,3,257,83,497,53,57,947,0,21,968
9,24,9003,608,3,407,182,649,87,59,1384,3,22,1409
9,24,9003,609,3,394,157,505,75,70,1201,0,19,1220
9,24,9003,610,3,411,165,537,56,58,1227,0,27,1254
9,24,9003,611,3,285,125,610,43,54,1117,3,21,1141
9,24,9003,612,3,212,122,496,40,46,916,4,22,942
9,24,9003,613,3,64,44,241,18,18,385,0,0,385
9,24,9003,614,3,143,45,543,26,33,790,0,18,808
9,24,9003,615,3,181,92,573,41,40,927,1,17,945
9,24,9003,616,3,115,122,633,62,24,956,0,21,977
9,24,9003,617,3,55,52,373,58,18,556,0,22,578
9,24,9003,618,3,250,148,898,79,59,1434,0,24,1458
9,24,9003,619,3,242,235,364,47,35,923,1,13,937
9,24,9003,620,3,381,175,536,67,63,1222,1,15,1238
9,24,9003,621,3,613,147,277,36,41,1114,1,19,1134
9,24,9003,622,3,475,117,537,50,59,1238,1,19,1258
9,24,9003,623,3,540,152,600,60,71,1423,1,11,1435
9,24,9003,624,3,490,130,353,38,37,1048,1,8,1057
9,24,9003,625,3,380,104,213,24,29,750,0,3,753
9,24,9003,626,3,724,161,298,34,56,1273,0,12,1285
9,24,9003,627,3,263,192,418,36,43,952,0,19,971
9,24,9003,628,3,214,174,425,54,44,911,0,20,931
9,24,9003,629,3,355,190,447,45,57,1094,0,11,1105
9,24,9003,630,3,236,113,395,33,31,808,0,12,820
9,24,9003,631,3,416,179,553,49,49,1246,1,19,1266
9,24,9003,632,3,106,51,316,25,31,529,0,9,538
9,24,9003,633,3,87,53,408,36,22,606,0,25,631
9,24,9003,634,3,265,92,443,45,37,882,1,5,888
9,24,9003,635,3,229,119,631,49,54,1082,0,19,1101
9,24,9003,636,3,278,127,543,58,52,1058,0,8,1066
9,24,9003,637,3,321,121,599,77,52,1170,0,25,1195
9,24,9003,638,3,266,124,386,63,31,870,0,7,877
9,24,9003,639,3,167,85,494,43,20,809,0,13,822
9,24,9003,640,3,573,157,344,50,59,1183,0,12,1195
9,24,9003,641,3,399,264,514,61,65,1303,0,25,1328
9,24,9003,642,3,302,173,432,37,52,996,0,15,1011
9,24,9003,643,3,313,114,399,35,53,914,1,11,926
9,24,9003,644,3,519,178,487,47,40,1271,0,11,1282
9,24,9003,645,3,796,162,452,67,70,1547,0,17,1564
9,24,9003,646,3,320,148,532,45,64,1109,2,7,1118
9,24,9003,647,3,330,69,371,25,58,853,0,11,864
9,24,9003,648,3,300,71,242,25,40,678,1,7,686
9,24,9003,649,3,276,76,263,37,41,693,0,9,702
9,24,9003,650,3,612,187,340,37,56,1232,0,8,1240
9,24,9003,651,3,521,109,253,44,33,960,0,5,965
9,24,9003,652,3,716,187,348,54,97,1402,0,14,1416
9,24,9003,653,3,321,128,520,51,52,1072,2,19,1093
9,24,9003,654,3,310,130,479,65,49,1033,3,3,1039
9,24,9003,655,3,294,98,455,44,45,936,0,15,951
9,24,9003,656,3,242,100,464,51,40,897,2,14,913
9,24,9003,657,3,347,106,422,50,44,969,0,7,976
9,24,9003,658,3,274,107,494,58,56,989,0,13,1002
9,24,9003,659,3,326,111,546,57,58,1098,0,15,1113
9,24,9003,660,3,199,132,479,54,70,934,1,19,954
9,24,9003,661,3,392,168,489,67,63,1179,0,11,1190
9,24,9003,662,3,243,91,442,50,43,869,2,15,886
9,24,9003,663,3,209,109,388,40,40,786,0,11,797
9,24,9003,664,3,448,195,897,87,74,1701,0,19,1720
9,24,9003,665,3,712,153,463,55,64,1447,0,11,1458
9,24,9003,666,3,566,136,389,47,44,1182,1,12,1195
9,24,9003,667,3,376,117,357,50,47,947,2,16,965
9,24,9003,668,3,374,209,600,59,79,1321,0,14,1335
9,24,9003,669,3,314,99,605,69,64,1151,0,18,1169
9,24,9003,670,3,364,115,513,58,58,1108,1,14,1123
9,24,9003,671,3,411,80,312,44,64,911,3,7,921
9,24,9003,672,3,401,140,282,34,33,890,0,7,897
9,24,9003,673,3,574,158,270,37,48,1087,1,16,1104
9,24,9003,674,3,503,128,274,25,30,960,0,11,971
9,24,9003,675,3,605,186,332,45,68,1236,0,11,1247
9,24,9003,676,3,358,97,321,20,45,841,1,10,852
9,24,9003,677,3,261,152,682,65,47,1207,0,8,1215
9,24,9003,678,3,324,192,790,68,68,1442,5,12,1459
9,24,9003,679,3,193,64,423,40,40,760,0,10,770
9,24,9003,680,3,84,64,354,26,31,559,0,19,578
9,24,9003,681,3,223,88,426,46,39,822,0,14,836
9,24,9003,682,3,139,58,339,38,39,613,0,9,622
9,24,9003,683,3,242,59,223,19,25,568,0,5,573
9,24,9003,684,3,255,78,373,30,39,775,1,6,782
9,24,9003,685,3,97,76,306,41,15,535,0,10,545
9,24,9003,686,3,161,107,550,54,39,911,0,23,934
9,24,9003,687,3,116,82,505,43,29,775,2,20,797
9,24,9003,688,3,593,217,567,56,46,1479,0,20,1499
9,24,9003,689,3,444,122,286,34,56,942,0,12,954
9,24,9003,690,3,110,72,469,34,19,704,9,17,730
9,24,9003,691,3,144,76,367,34,23,644,4,12,660
9,24,9003,692,3,234,158,207,20,29,648,2,6,656
9,24,9003,694,3,743,183,428,53,89,1496,1,23,1520
9,24,9003,695,3,495,126,280,25,50,976,2,16,994
9,24,9003,696,3,568,172,403,46,91,1280,2,19,1301
9,24,9003,697,3,447,115,261,32,67,922,2,10,934
9,24,9003,698,3,385,117,339,42,53,936,1,15,952
9,24,9003,699,3,447,133,394,43,64,1081,2,15,1098
9,24,9003,700,3,290,107,453,40,55,945,2,10,957
9,24,9003,701,3,275,80,281,29,38,703,1,8,712
9,24,9003,702,3,532,133,332,30,58,1085,4,12,1101
9,24,9003,703,3,116,48,141,12,22,339,0,2,341
9,24,9003,704,3,503,112,298,41,47,1001,3,21,1025
9,24,9003,705,3,409,127,364,14,53,967,0,15,982
9,24,9003,706,3,427,120,281,27,51,906,0,23,929
9,24,9003,707,3,511,156,455,59,90,1271,2,21,1294
9,24,9003,708,3,443,156,298,25,52,974,2,20,996
9,24,9003,709,3,487,155,384,31,58,1115,1,13,1129
9,24,9003,710,3,284,94,361,32,54,825,1,18,844
9,24,9003,711,3,214,83,186,24,18,525,0,13,538
9,24,9003,712,3,405,159,463,40,62,1129,3,16,1148
9,24,9003,713,3,629,166,363,31,70,1259,4,11,1274
9,24,9003,714,3,344,95,345,36,45,865,0,7,872
9,24,9003,717,3,456,110,389,44,47,1046,0,16,1062
9,24,9003,718,3,489,136,440,49,84,1198,1,17,1216
9,24,9003,742,3,213,69,222,33,29,566,2,6,574
9,24,9003,744,3,271,66,274,27,38,676,0,11,687
9,25,9007,2758,3,149,80,778,54,61,1122,6,22,1150
9,25,9007,2850,3,128,56,462,42,30,718,2,12,732
9,25,9007,2851,3,140,93,492,38,45,808,0,16,824
9,25,9007,2873,3,233,96,914,80,66,1389,2,10,1401
9,25,9007,2874,3,162,83,659,56,48,1008,0,16,1024
9,25,9007,2875,3,141,101,570,63,32,907,1,22,930
9,25,9007,2876,3,153,95,557,55,42,902,1,20,923
9,25,9007,2877,3,213,80,412,61,50,816,1,8,825
9,25,9007,2890,3,198,77,304,44,36,659,1,11,671
9,25,9007,2891,3,186,68,349,39,35,677,0,14,691
9,25,9007,2892,3,76,67,397,47,37,624,0,7,631
9,25,9007,2893,3,173,64,464,64,36,801,2,12,815
9,25,9007,2894,3,153,97,580,58,45,933,2,20,955
9,25,9007,2895,3,180,90,639,65,48,1022,2,16,1040
9,25,9007,2900,3,127,130,648,43,45,993,2,30,1025
9,25,9007,2901,3,73,63,245,28,19,428,5,14,447
9,25,9007,2902,3,91,108,567,43,36,845,1,14,860
9,25,9007,2903,3,176,73,391,45,53,738,0,15,753
9,25,9007,2904,3,177,85,362,42,35,701,0,14,715
9,25,9007,2905,3,273,82,457,89,44,945,4,13,962
9,25,9007,2906,3,125,51,274,39,27,516,13,0,529
9,25,9007,2907,3,157,62,428,47,35,729,0,15,744
9,25,9007,2908,3,159,74,612,53,36,934,3,20,957
9,25,9007,2909,3,144,92,696,57,42,1031,4,21,1056
9,25,9007,2910,3,120,81,489,48,35,773,3,18,794
9,25,9007,2911,3,117,90,509,55,33,804,4,16,824
9,25,9007,2912,3,134,77,433,42,39,725,2,15,742
9,25,9007,2913,3,130,85,581,65,44,905,1,22,928
9,25,9007,2914,3,131,62,551,50,41,835,2,11,848
9,25,9007,2915,3,150,158,393,28,37,766,0,18,784
9,25,9007,2916,3,190,72,616,55,53,986,2,18,1006
9,25,9007,2917,3,101,71,498,41,42,753,5,48,806
9,25,9007,2918,3,157,78,623,63,52,973,2,22,997
9,25,9007,2919,3,93,81,536,32,37,779,4,16,799
9,25,9007,2920,3,119,71,559,48,35,832,3,15,850
9,25,9007,2921,3,103,71,522,43,30,769,1,26,796
9,25,9007,2922,3,82,67,540,40,53,782,4,14,800
9,25,9007,2924,3,84,74,517,52,54,781,6,19,806
9,25,9007,2925,3,134,98,697,51,54,1034,4,23,1061
9,25,9007,2926,3,140,94,561,22,42,859,3,31,893
9,25,9007,2927,3,152,58,584,47,42,883,3,16,902
9,25,9007,2928,3,142,82,634,43,57,958,4,25,987
9,25,9007,2929,3,136,75,603,46,31,891,2,12,905
9,25,9007,2930,3,126,55,491,38,39,749,3,14,766
9,25,9007,2931,3,158,94,563,58,50,923,7,13,943
9,25,9007,2932,3,163,74,558,43,32,870,0,12,882
9,25,9007,2933,3,161,51,501,46,55,814,1,10,825
9,25,9007,2934,3,157,142,799,86,70,1254,7,29,1290
9,25,9007,2935,3,188,150,846,90,75,1349,5,27,1381
9,25,9007,2936,3,151,72,436,26,33,718,0,5,723
9,25,9007,2937,3,132,73,494,44,23,766,0,16,782
9,25,9007,2938,3,127,89,483,35,32,766,3,13,782
9,25,9007,2939,3,49,37,262,26,18,392,5,8,405
9,25,9007,2940,3,161,78,490,33,48,810,1,13,824
9,25,9007,2941,3,172,122,581,62,47,984,2,21,1007
9,25,9007,2942,3,196,101,717,48,43,1105,3,37,1145
9,25,9007,2943,3,138,95,483,43,32,791,0,17,808
9,25,9007,2944,3,148,103,607,67,54,979,5,21,1005
9,25,9007,2945,3,160,111,682,53,64,1070,2,25,1097
9,25,9007,2947,3,122,109,601,51,33,916,4,12,932
9,25,9007,2948,3,119,91,594,55,45,904,2,29,935
9,25,9007,2949,3,109,48,488,32,24,701,0,13,714
9,25,9007,2950,3,75,48,418,28,17,586,1,14,601
9,25,9007,2951,3,136,82,521,58,48,845,2,6,853
9,25,9007,2952,3,162,67,553,48,39,869,2,12,883
9,25,9007,2953,3,91,68,477,35,44,715,4,21,740
9,25,9007,2954,3,132,88,550,34,38,842,3,13,858
9,25,9007,2955,3,84,52,646,43,44,869,4,20,893
9,25,9007,2956,3,111,95,505,48,38,797,0,26,823
9,25,9007,2957,3,153,93,1148,83,87,1564,8,51,1623
9,25,9007,2958,3,210,159,1793,124,92,2378,4,139,2521
9,25,9007,2959,3,84,65,514,45,39,747,8,24,779
9,25,9007,2960,3,83,48,540,52,48,771,1,23,795
9,25,9007,2961,3,133,136,708,68,66,1111,3,32,1146
9,25,9007,2962,3,72,69,552,35,38,766,0,16,782
9,25,9007,2966,3,44,46,209,21,14,334,0,6,340
9,25,9007,2967,3,61,92,371,29,19,572,2,8,582
9,25,9013,4095,3,292,54,474,80,60,960,1,11,972
9,25,9013,4096,3,222,103,641,74,46,1086,2,18,1106
9,25,9013,4097,3,177,59,410,48,39,733,1,22,756
9,25,9013,4098,3,398,97,283,37,50,865,1,15,881
9,25,9013,4099,3,319,84,181,11,28,623,0,10,633
9,25,9013,4100,3,451,125,210,33,32,851,0,5,856
9,25,9013,4101,3,471,137,218,29,26,881,0,10,891
9,25,9013,4102,3,187,103,587,67,43,987,4,20,1011
9,25,9013,4103,3,251,100,800,91,67,1309,1,16,1326
9,25,9013,4104,3,256,123,993,79,64,1515,5,31,1551
9,25,9013,4105,3,201,130,891,92,50,1364,8,41,1413
9,25,9013,4106,3,830,324,1317,128,123,2722,7,63,2792
9,25,9013,4107,3,161,168,701,61,30,1121,5,35,1161
9,25,9013,4108,3,164,110,678,70,56,1078,6,23,1107
9,25,9013,4109,3,240,132,619,79,58,1128,3,23,1154
9,25,9013,4110,3,223,127,535,60,45,990,5,23,1018
9,25,9013,4111,3,158,97,462,57,35,809,1,18,828
9,25,9013,4112,3,144,111,541,47,33,876,3,25,904
9,25,9013,4113,3,206,115,402,46,39,808,4,17,829
9,25,9013,4114,3,142,90,510,81,40,863,1,34,898
9,25,9013,4115,3,75,53,320,33,19,500,2,17,519
9,25,9013,4116,3,128,77,386,25,19,635,2,21,658
9,25,9013,4117,3,188,54,356,38,30,666,0,10,676
9,25,9013,4118,3,398,157,707,83,79,1424,3,28,1455
9,25,9013,4119,3,259,141,881,82,76,1439,1,29,1469
9,25,9013,4120,3,232,113,539,71,41,996,0,12,1008
9,25,9013,4121,3,211,68,386,45,26,736,3,20,759
9,25,9013,4122,3,584,173,444,68,83,1352,0,17,1369
9,25,9013,4123,3,418,95,351,31,33,928,1,18,947
9,25,9013,4124,3,246,128,607,55,47,1083,2,17,1102
9,25,9013,4125,3,154,81,541,57,30,863,6,18,887
9,25,9013,4130,3,268,112,450,52,52,934,1,7,942
9,25,9013,4131,3,237,108,305,37,39,726,0,10,736
9,25,9013,4132,3,254,65,405,39,22,785,0,13,798
9,25,9013,4133,3,211,89,335,35,25,695,0,20,715
9,25,9013,4134,3,227,69,244,36,29,605,0,6,611
9,25,9013,4135,3,243,107,517,41,40,948,0,19,967
9,25,9013,4136,3,140,73,392,45,42,692,0,21,713
9,25,9013,4137,3,177,109,460,87,33,866,3,16,885
9,25,9013,4138,3,218,122,492,60,36,928,2,13,943
9,25,9013,4139,3,189,84,449,59,35,816,1,18,835
9,25,9013,4140,3,191,147,672,88,38,1136,5,32,1173
9,25,9013,4141,3,127,85,512,49,22,795,1,6,802
9,25,9013,4142,3,223,125,697,92,46,1183,0,21,1204
9,25,9013,4143,3,159,96,577,68,40,940,0,22,962
9,25,9013,4144,3,186,154,985,114,72,1511,4,38,1553
9,25,9013,4145,3,105,107,715,64,24,1015,0,39,1054
9,25,9013,4146,3,157,126,813,55,45,1196,1,34,1231
9,25,9013,4147,3,64,52,419,37,17,589,0,12,601
9,25,9013,4148,3,148,138,840,96,47,1269,3,27,1299
9,25,9013,4149,3,132,113,711,57,32,1045,0,19,1064
9,25,9013,4150,3,120,94,666,54,34,968,11,29,1008
9,25,9013,4151,3,232,126,1005,82,60,1505,3,35,1543
9,25,9013,4152,3,157,166,695,53,40,1111,0,23,1134
9,25,9013,4153,3,147,120,868,62,42,1239,1,24,1264
9,25,9013,4154,3,128,124,636,59,42,989,2,20,1011
9,25,9013,4155,3,130,92,589,52,47,910,2,18,930
9,25,9013,4156,3,143,110,730,47,43,1073,1,24,1098
9,25,9013,4157,3,177,127,502,43,32,881,3,19,903
9,25,9013,4158,3,104,105,632,43,45,929,6,10,945
9,25,9013,4159,3,99,95,614,34,25,867,0,9,876
9,25,9013,4160,3,83,74,569,45,34,805,1,19,825
9,25,9013,4161,3,162,103,988,79,49,1381,3,41,1425
9,25,9013,4162,3,79,121,647,36,27,910,0,17,927
9,25,9013,4163,3,176,101,780,60,55,1172,3,26,1201
9,25,9013,4164,3,194,141,1325,94,61,1815,4,37,1856
9,25,9013,4165,3,189,130,1375,100,67,1861,2,43,1906
9,25,9013,4166,3,125,89,791,74,38,1117,2,33,1152
9,25,9013,4167,3,183,125,929,68,48,1353,1,27,1381
9,25,9013,4168,3,142,104,1010,97,53,1406,4,37,1447
9,25,9013,4169,3,166,97,879,85,51,1278,6,19,1303
9,25,9013,4170,3,156,155,1244,95,53,1703,5,61,1769
9,25,9013,4171,3,134,106,865,73,50,1228,0,30,1258
9,25,9013,4172,3,118,94,699,68,27,1006,1,19,1026
9,25,9013,4184,3,118,87,755,87,45,1092,0,25,1117
9,25,9013,4185,3,142,84,620,54,48,948,2,12,962
9,25,9013,4186,3,212,94,651,63,48,1068,2,18,1088
9,25,9013,4187,3,177,87,558,54,34,910,3,15,928
9,25,9013,4188,3,130,121,562,56,33,902,5,13,920
9,25,9013,4189,3,166,103,491,59,32,851,0,25,876
9,25,9013,4190,3,178,93,376,34,37,718,2,17,737
9,25,9013,4191,3,349,132,525,75,54,1135,1,21,1157
9,25,9013,4208,3,135,96,425,42,32,730,3,13,746
9,25,9013,4209,3,214,140,512,55,50,971,0,19,990
9,25,9013,4210,3,175,85,447,45,39,791,1,14,806
9,25,9013,4211,3,204,131,396,76,40,847,2,23,872
9,25,9013,4212,3,163,83,458,61,43,808,3,11,822
9,25,9013,4214,3,124,109,487,51,44,815,2,19,836
9,25,9013,4215,3,163,92,486,55,31,827,0,19,846
9,26,9008,2972,3,258,95,277,35,41,706,3,11,720
9,26,9008,2973,3,305,90,340,31,30,796,4,4,804
9,26,9008,2974,3,221,70,333,24,11,659,3,4,666
9,26,9008,2975,3,201,75,241,19,23,559,0,5,564
9,26,9008,2976,3,269,87,360,42,40,798,0,11,809
9,26,9008,2977,3,259,85,207,27,14,592,3,9,604
9,26,9008,2978,3,200,92,327,24,39,682,0,7,689
9,26,9008,2979,3,304,86,313,36,41,780,0,8,788
9,26,9008,2980,3,306,92,95,15,15,523,0,4,527
9,26,9008,2981,3,463,92,139,13,33,740,0,9,749
9,26,9008,2982,3,501,136,175,22,32,866,1,10,877
9,26,9008,2983,3,479,121,106,30,26,762,1,10,773
9,26,9008,2984,3,148,97,405,34,18,702,5,21,728
9,26,9008,2985,3,114,86,525,41,19,785,2,24,811
9,26,9008,2986,3,137,79,486,46,24,772,1,8,781
9,26,9008,2987,3,105,48,433,35,18,639,1,13,653
9,26,9008,2988,3,172,100,477,50,30,829,1,21,851
9,26,9008,2989,3,146,73,481,50,27,777,2,15,794
9,26,9008,2990,3,98,55,411,33,33,630,1,13,644
9,26,9008,2991,3,124,75,572,58,27,856,1,24,881
9,26,9008,2992,3,97,87,548,50,47,829,2,19,850
9,26,9008,2993,3,105,91,625,59,47,927,3,36,966
9,26,9008,2994,3,110,70,680,46,39,945,2,23,970
9,26,9008,2995,3,72,60,352,31,25,540,2,13,555
9,26,9008,2996,3,162,91,412,51,21,737,0,22,759
9,26,9008,2997,3,59,36,228,25,20,368,0,8,376
9,26,9008,2998,3,406,136,136,16,32,726,0,11,737
9,26,9008,2999,3,408,98,223,19,31,779,3,12,794
9,26,9008,3000,3,445,128,286,39,35,933,2,14,949
9,26,9008,3001,3,625,160,285,48,48,1166,2,13,1181
9,26,9008,3002,3,469,113,124,25,24,755,2,5,762
9,26,9008,3003,3,263,68,61,8,10,410,0,2,412
9,26,9008,3004,3,443,125,467,73,42,1150,3,10,1163
9,26,9008,3005,3,358,71,314,54,36,833,2,14,849
9,26,9008,3006,3,340,54,208,16,21,639,0,10,649
9,26,9008,3007,3,457,160,171,18,18,824,1,6,831
9,26,9008,3008,3,149,76,495,56,87,863,0,7,870
9,26,9008,3009,3,124,53,360,44,29,610,1,9,620
9,26,9008,3010,3,111,41,246,25,18,441,2,0,443
9,26,9008,3011,3,150,64,506,52,27,799,7,18,824
9,26,9008,3012,3,164,84,428,48,27,751,2,10,763
9,26,9008,3013,3,232,128,786,81,64,1291,1,23,1315
9,26,9008,3014,3,178,85,416,72,53,804,3,30,837
9,26,9008,3015,3,129,85,470,46,28,758,1,17,776
9,26,9008,3016,3,170,104,551,54,37,916,4,23,943
9,26,9008,3017,3,132,119,606,62,33,952,1,28,981
9,26,9008,3018,3,139,84,480,52,35,790,2,11,803
9,26,9008,3019,3,173,102,688,76,46,1085,4,22,1111
9,26,9008,3020,3,83,41,219,27,13,383,1,4,388
9,26,9008,3021,3,86,52,362,42,23,565,0,12,577
9,26,9008,3022,3,17,15,106,5,2,145,0,9,154
9,26,9008,3023,3,225,116,576,64,44,1025,7,19,1051
9,26,9008,3024,3,114,57,267,26,17,481,1,7,489
9,26,9008,3025,3,248,137,660,55,49,1149,2,27,1178
9,26,9008,3026,3,443,106,215,30,46,840,2,8,850
9,26,9008,3027,3,456,90,174,17,31,768,0,8,776
9,26,9008,3028,3,338,137,425,33,22,955,1,18,974
9,26,9008,3029,3,259,103,524,56,32,974,1,10,985
9,26,9008,3030,3,275,116,551,49,39,1030,1,16,1047
9,26,9008,3031,3,362,119,465,31,31,1008,0,15,1023
9,26,9008,3032,3,296,87,603,77,35,1098,0,21,1119
9,26,9008,3033,3,343,92,383,28,39,885,0,12,897
9,26,9008,3034,3,251,119,503,60,31,964,0,19,983
9,26,9008,3035,3,266,135,666,53,39,1159,2,13,1174
9,26,9008,3036,3,75,87,409,43,25,639,1,9,649
9,26,9008,3037,3,84,78,365,39,21,587,1,14,602
9,26,9008,3038,3,137,82,448,41,22,730,3,11,744
9,26,9008,3039,3,219,134,817,88,40,1298,2,31,1331
9,26,9008,3040,3,208,133,782,89,63,1275,2,31,1308
9,26,9008,3041,3,96,67,515,45,26,749,2,25,776
9,26,9008,3042,3,122,73,426,34,26,681,4,18,703
9,26,9008,3043,3,72,60,368,29,10,539,3,16,558
9,26,9008,3044,3,127,55,373,43,38,636,0,11,647
9,26,9008,3045,3,165,92,438,52,34,781,1,17,799
9,26,9008,3046,3,235,118,656,78,51,1138,1,21,1160
9,26,9008,3047,3,147,110,526,41,45,869,0,12,881
9,26,9008,3048,3,368,115,312,43,35,873,0,9,882
9,26,9008,3049,3,427,132,313,39,28,939,0,17,956
9,26,9008,3050,3,218,133,574,46,25,996,1,13,1010
9,26,9008,3051,3,251,77,457,50,35,870,0,20,890
9,26,9008,3052,3,175,79,476,48,36,814,1,8,823
9,26,9008,3053,3,203,98,545,58,35,939,3,16,958
9,26,9008,3054,3,200,61,255,25,23,564,1,13,578
9,26,9008,3055,3,388,59,221,26,40,734,2,11,747
9,26,9008,3056,3,316,103,417,33,30,899,0,11,910
9,26,9008,3057,3,247,75,104,14,22,462,1,3,466
9,26,9008,3058,3,239,130,507,39,41,956,1,40,997
9,26,9008,3059,3,242,136,705,81,47,1211,1,184,1396
9,26,9008,3060,3,165,115,531,41,32,884,4,16,904
9,26,9008,3061,3,293,170,698,75,49,1285,0,20,1305
9,26,9008,3062,3,410,146,522,46,42,1166,1,15,1182
9,26,9008,3063,3,263,107,397,35,29,831,0,9,840
9,26,9008,3064,3,192,104,463,47,23,829,1,11,841
9,26,9008,3065,3,93,66,438,25,21,643,1,6,650
9,26,9008,3066,3,156,155,726,62,40,1139,4,23,1166
9,26,9008,3067,3,113,116,622,38,38,927,0,21,948
9,26,9008,3068,3,166,120,623,77,35,1021,3,33,1057
9,26,9008,3069,3,159,94,547,53,39,892,4,21,917
9,26,9008,3070,3,171,84,449,71,44,819,4,18,841
9,26,9008,3071,3,189,113,786,90,58,1236,6,29,1271
9,26,9008,3072,3,98,65,524,28,30,745,5,17,767
9,26,9008,3073,3,101,73,362,31,23,590,0,18,608
9,26,9008,3074,3,195,113,635,53,36,1032,1,20,1053
9,26,9008,3075,3,87,55,290,21,21,474,3,0,477
9,26,9008,3076,3,141,81,404,39,19,684,2,16,702
9,26,9008,3077,3,188,111,627,62,45,1033,2,12,1047
9,26,9008,3078,3,293,142,547,52,43,1077,3,19,1099
9,26,9008,3079,3,241,114,440,43,38,876,0,13,889
9,26,9008,3080,3,99,71,331,22,12,535,0,11,546
9,26,9008,3081,3,199,112,518,51,29,909,2,21,932
9,26,9008,3082,3,253,65,363,32,26,739,1,20,760
9,26,9008,3083,3,301,128,502,58,46,1035,1,52,1088
9,26,9008,3084,3,95,94,306,25,15,535,1,9,545
9,26,9008,3085,3,151,124,406,43,41,765,1,19,785
9,26,9008,3086,3,173,144,628,58,41,1044,4,16,1064
9,26,9008,3087,3,189,161,887,78,57,1372,2,25,1399
9,26,9008,3088,3,240,232,1433,167,61,2133,11,77,2221
9,26,9008,3089,3,169,140,896,72,54,1331,5,54,1390
9,26,9008,3090,3,113,141,714,62,30,1060,4,43,1107
9,26,9008,3091,3,319,153,825,77,38,1412,4,14,1430
9,26,9008,3092,3,211,118,589,38,27,983,0,15,998
9,26,9008,3093,3,308,102,546,42,44,1042,3,13,1058
9,26,9008,3094,3,108,78,488,41,34,749,2,26,777
9,26,9008,3095,3,72,57,543,28,25,725,3,16,744
9,26,9008,3096,3,169,95,1206,78,39,1587,4,38,1629
9,26,9008,3097,3,169,136,786,74,46,1211,3,27,1241
9,26,9008,3098,3,43,34,317,20,17,431,2,10,443
9,26,9008,3099,3,125,87,528,48,30,818,3,15,836
9,26,9008,3100,3,89,64,368,15,26,562,1,20,583
9,26,9008,3101,3,156,46,268,19,19,508,3,8,519
9,26,9008,3102,3,109,36,460,33,22,660,2,18,680
9,26,9008,3103,3,106,45,349,41,29,570,2,13,585
9,26,9008,3104,3,87,74,551,41,39,792,1,26,819
9,26,9008,3105,3,256,111,576,69,34,1046,4,13,1063
9,26,9008,3106,3,153,68,518,62,36,837,2,16,855
9,26,9008,3107,3,14,14,62,11,7,108,0,0,108
9,26,9008,3108,3,69,40,234,20,11,374,0,3,377
9,26,9008,3109,3,92,55,531,56,31,765,3,16,784
9,26,9008,3110,3,88,60,311,33,18,510,1,19,530
9,26,9008,3111,3,215,82,370,36,29,732,3,5,740
9,26,9008,3112,3,135,59,370,35,19,618,0,19,637
9,26,9008,3113,3,106,52,338,91,19,606,3,5,614
9,26,9008,3114,3,118,60,525,50,35,788,2,21,811
9,26,9008,3115,3,82,66,302,25,23,498,2,16,516
9,26,9008,3116,3,134,73,370,33,33,643,5,7,655
9,26,9008,3117,3,156,60,572,47,35,870,2,21,893
9,26,9008,3118,3,137,161,1052,93,59,1502,7,24,1533
9,26,9010,3217,3,289,81,381,36,37,824,0,15,839
9,26,9010,3218,3,216,96,344,40,38,734,4,9,747
9,26,9010,3219,3,277,77,341,43,29,767,0,8,775
9,26,9010,3220,3,98,22,85,9,7,221,0,5,226
9,26,9010,3221,3,397,97,375,37,44,950,1,12,963
9,26,9010,3222,3,314,97,202,28,29,670,0,6,676
9,26,9010,3223,3,275,61,141,21,21,519,2,9,530
9,26,9010,3224,3,574,189,104,24,24,915,0,8,923
9,26,9010,3225,3,537,183,94,13,24,851,5,14,870
9,26,9010,3226,3,571,102,62,24,16,775,0,11,786
9,26,9010,3227,3,507,135,88,7,20,757,0,1,758
9,26,9010,3228,3,545,151,76,16,28,816,1,9,826
9,26,9010,3229,3,497,131,81,16,20,745,1,2,748
9,26,9010,3230,3,517,136,106,19,16,794,0,10,804
9,26,9010,3231,3,516,125,124,15,29,809,0,7,816
9,26,9010,3232,3,559,116,86,20,22,803,1,11,815
9,26,9010,3233,3,613,170,98,19,32,932,0,9,941
9,26,9010,3234,3,417,119,63,13,17,629,0,6,635
9,26,9010,3420,3,405,71,177,19,41,713,1,124,838
9,26,9010,3422,3,120,41,201,17,22,401,0,7,408
9,26,9010,3424,3,184,46,246,22,22,520,0,13,533
9,26,9010,3426,3,171,73,334,46,34,658,1,6,665
9,26,9010,3427,3,206,57,264,27,33,587,2,4,593
9,26,9010,3428,3,344,88,276,43,37,788,1,7,796
9,26,9010,3429,3,273,54,127,18,16,488,2,10,500
9,26,9010,3430,3,457,101,106,19,18,701,2,12,715
9,26,9010,3431,3,507,89,134,22,34,786,2,3,791
9,26,9010,3432,3,156,25,69,2,11,263,0,7,270
9,26,9010,3433,3,239,41,208,17,26,531,3,2,536
9,26,9010,3434,3,197,37,171,13,20,438,1,2,441
9,26,9010,3435,3,117,27,122,10,7,283,0,3,286
9,26,9010,3436,3,241,79,321,33,29,703,2,8,713
9,26,9010,3437,3,165,50,231,21,20,487,1,7,495
9,26,9010,3438,3,235,80,269,33,24,641,0,11,652
9,26,9010,3439,3,188,53,276,30,27,574,0,4,578
9,26,9010,3440,3,290,100,414,49,40,893,1,12,906
9,26,9010,3441,3,204,77,251,23,24,579,0,4,583
9,26,9010,3442,3,218,45,249,25,28,565,1,7,573
9,26,9010,3443,3,179,49,206,21,20,475,0,7,482
9,26,9010,3444,3,257,63,307,25,32,684,0,11,695
9,26,9010,3445,3,173,53,238,28,20,512,0,9,521
9,26,9010,3446,3,262,85,355,29,37,768,0,15,783
9,26,9010,3447,3,304,70,188,16,30,608,0,1,609
9,26,9010,3448,3,129,27,98,8,15,277,0,4,281
9,26,9010,3449,3,225,106,509,62,59,961,7,20,988
9,26,9010,3450,3,209,84,396,34,30,753,2,13,768
9,26,9010,3451,3,435,72,248,29,38,822,3,10,835
9,26,9010,3452,3,545,116,286,28,37,1012,0,17,1029
9,26,9010,3453,3,203,36,126,18,21,404,0,7,411
9,26,9010,3454,3,464,73,119,25,32,713,2,9,724
9,26,9010,3455,3,294,80,105,15,26,520,0,6,526
9,26,9010,3456,3,562,114,91,14,24,805,3,6,814
9,26,9010,3457,3,481,138,306,26,38,989,2,10,1001
9,26,9010,3458,3,288,81,343,37,44,793,1,11,805
9,26,9010,3459,3,442,102,65,7,22,638,0,11,649
9,26,9010,3460,3,328,79,81,16,20,524,0,3,527
9,26,9010,3461,3,281,55,97,12,23,468,0,4,472
9,26,9010,3462,3,366,76,124,23,33,622,0,11,633
9,26,9010,3463,3,468,113,237,20,51,889,1,11,901
9,26,9010,3464,3,254,53,116,9,16,448,2,0,450
9,26,9010,3465,3,487,90,169,26,50,822,1,8,831
9,26,9010,3466,3,350,84,95,22,31,582,0,6,588
9,26,9010,3467,3,308,71,75,13,24,491,0,6,497
9,26,9010,3468,3,284,79,140,26,18,547,0,11,558
9,26,9010,3469,3,391,84,174,16,31,696,2,16,714
9,26,9010,3470,3,258,59,116,13,21,467,0,7,474
9,26,9010,3471,3,359,69,137,22,36,623,1,5,629
9,26,9010,3472,3,333,88,226,33,38,718,1,17,736
9,26,9010,3474,3,151,44,178,22,14,409,0,4,413
9,26,9010,3475,3,175,72,230,29,22,528,3,6,537
9,26,9010,3476,3,153,92,216,21,23,505,0,5,510
9,26,9010,3483,3,293,66,450,33,32,874,0,19,893
9,26,9010,3485,3,9,4,28,4,1,46,0,1,47
9,26,9010,3486,3,516,135,613,36,52,1352,0,28,1380
9,26,9010,3487,3,546,54,86,8,28,722,0,7,729
9,26,9010,3488,3,439,52,179,30,27,727,1,5,733
9,26,9010,3489,3,517,101,181,20,22,841,0,9,850
9,26,9010,3500,3,474,88,255,29,39,885,0,22,907
9,26,9010,3501,3,588,79,286,27,38,1018,1,12,1031
9,26,9010,3502,3,349,50,137,18,23,577,0,6,583
9,26,9010,3503,3,296,50,298,32,26,702,1,6,709
9,26,9010,3504,3,479,96,106,21,21,723,0,6,729
9,26,9010,3505,3,450,87,205,29,41,812,1,5,818
9,26,9010,3506,3,294,55,412,49,23,833,1,10,844
9,26,9010,3526,3,231,51,432,38,36,788,0,13,801
9,26,9010,3527,3,401,61,155,30,33,680,0,9,689
9,26,9010,3528,3,432,90,264,23,40,849,0,11,860
9,26,9010,3529,3,261,94,422,48,37,862,0,19,881
9,26,9010,3530,3,617,86,193,28,48,972,0,9,981
9,26,9010,3531,3,60,18,36,4,6,124,0,1,125
9,26,9010,3541,3,311,62,290,27,35,725,0,11,736
9,26,9010,3542,3,417,117,608,68,72,1282,0,33,1315
9,26,9010,3543,3,286,73,539,54,40,992,1,26,1019
9,26,9010,3544,3,206,39,263,18,15,541,0,14,555
9,26,9010,3545,3,211,60,452,37,30,790,0,13,803
9,26,9010,3546,3,128,37,176,14,21,376,1,1,378
9,26,9010,3547,3,384,95,615,61,43,1198,1,24,1223
9,26,9010,3548,3,190,55,287,34,26,592,0,14,606
9,26,9010,3549,3,314,85,508,29,44,980,0,15,995
9,26,9010,3550,3,396,87,572,48,47,1150,3,15,1168
9,26,9010,3551,3,176,60,395,27,27,685,0,9,694
9,26,9010,3552,3,205,66,474,46,24,815,0,6,821
9,26,9010,3553,3,265,75,429,37,48,854,0,11,865
9,26,9010,3554,3,460,86,348,56,44,994,0,28,1022
9,26,9010,3555,3,185,39,261,37,37,559,0,0,559
9,26,9010,3556,3,568,125,488,66,63,1310,0,23,1333
9,26,9010,3557,3,550,73,188,40,39,890,0,6,896
9,26,9010,3574,3,153,45,501,23,31,753,0,24,777
9,26,9010,3575,3,387,55,335,43,37,857,0,16,873
9,26,9010,3576,3,551,94,108,23,39,815,0,3,818
9,26,9010,3577,3,166,31,428,23,21,669,0,14,683
9,26,9010,3578,3,300,110,682,57,48,1197,0,22,1219
9,26,9010,3608,3,177,29,65,19,12,302,0,1,303
9,27,9011,3609,3,177,157,843,77,43,1297,5,42,1344
9,27,9011,3610,3,134,113,498,47,27,819,1,26,846
9,27,9011,3611,3,83,133,492,44,33,785,5,16,806
9,27,9011,3612,3,82,105,446,43,30,706,1,12,719
9,27,9011,3613,3,89,88,525,36,25,763,0,17,780
9,27,9011,3614,3,171,178,824,65,44,1282,0,25,1307
9,27,9011,3615,3,165,203,783,74,48,1273,0,25,1298
9,27,9011,3616,3,164,177,817,74,58,1290,3,14,1307
9,27,9011,3617,3,144,218,698,48,41,1149,0,27,1176
9,27,9011,3618,3,130,296,769,79,56,1330,0,15,1345
9,27,9011,3619,3,156,209,652,55,31,1103,3,23,1129
9,27,9011,3620,3,218,233,959,66,64,1540,1,44,1585
9,27,9011,3621,3,48,56,268,23,12,407,1,6,414
9,27,9011,3622,3,206,154,805,84,35,1284,3,23,1310
9,27,9011,3623,3,217,188,729,65,42,1241,0,21,1262
9,27,9011,3624,3,121,119,624,70,41,975,1,22,998
9,27,9011,3625,3,156,136,607,58,39,996,2,23,1021
9,27,9011,3626,3,107,107,561,57,39,871,1,15,887
9,27,9011,3627,3,371,204,1260,102,80,2017,1,38,2056
9,27,9011,3628,3,1043,641,2968,331,238,5221,23,84,5328
9,27,9011,3629,3,216,142,832,73,61,1324,6,32,1362
9,27,9011,3630,3,174,86,518,41,39,858,3,17,878
9,27,9011,3631,3,89,59,178,22,19,367,1,6,374
9,27,9011,3632,3,239,175,714,59,49,1236,1,14,1251
9,27,9011,3633,3,230,144,586,75,49,1084,4,7,1095
9,27,9011,3634,3,238,178,509,52,45,1022,0,11,1033
9,27,9011,3635,3,151,103,605,48,40,947,1,25,973
9,27,9011,3636,3,393,421,1435,132,117,2498,1,51,2550
9,27,9011,3637,3,431,342,1351,140,109,2373,7,46,2426
9,27,9011,3638,3,122,110,515,50,25,822,2,18,842
9,27,9011,3639,3,136,196,568,53,28,981,0,15,996
9,27,9011,3640,3,165,237,604,59,36,1101,2,26,1129
9,27,9011,3641,3,133,182,587,55,35,992,0,7,999
9,27,9011,3642,3,169,191,646,51,31,1088,4,22,1114
9,27,9011,3643,3,183,174,722,73,72,1224,0,29,1253
9,27,9011,3644,3,132,179,693,60,44,1108,0,23,1131
9,27,9011,3645,3,143,181,654,47,24,1049,2,26,1077
9,27,9011,3646,3,99,143,422,34,17,715,0,11,726
9,27,9011,3647,3,136,152,531,56,27,902,0,23,925
9,27,9011,3648,3,170,126,488,31,33,848,2,24,874
9,27,9011,3649,3,113,155,526,51,45,890,3,19,912
9,27,9011,3650,3,151,116,570,56,28,921,1,13,935
9,27,9011,3651,3,153,146,485,67,44,895,0,28,923
9,27,9011,3652,3,170,136,367,37,21,731,0,17,748
9,27,9011,3653,3,219,183,1118,62,72,1654,0,24,1678
9,27,9011,3654,3,198,241,625,75,34,1173,0,28,1201
9,27,9011,3655,3,170,120,540,51,46,927,1,26,954
9,27,9011,3656,3,144,105,470,45,34,798,0,37,835
9,27,9011,3657,3,142,141,601,57,47,988,1,32,1021
9,27,9011,3658,3,145,142,459,55,37,838,0,18,856
9,27,9011,3659,3,224,148,620,64,41,1097,5,24,1126
9,27,9011,3660,3,173,156,666,56,45,1096,1,11,1108
9,27,9011,3661,3,162,157,654,67,37,1077,1,23,1101
9,27,9011,3662,3,74,120,690,57,30,971,1,21,993
9,27,9011,3663,3,148,205,686,55,18,1112,3,29,1144
9,27,9011,3664,3,176,196,591,59,36,1058,0,19,1077
9,27,9011,3665,3,145,206,735,69,35,1190,1,9,1200
9,27,9011,3666,3,124,160,599,67,33,983,0,23,1006
9,27,9011,3667,3,164,165,649,61,30,1069,1,9,1079
9,27,9011,3668,3,172,173,689,63,45,1142,3,22,1167
9,27,9011,3669,3,147,150,580,58,38,973,1,19,993
9,27,9011,3670,3,147,162,633,45,38,1025,0,19,1044
9,27,9011,3671,3,155,177,558,51,28,969,1,17,987
9,27,9011,3672,3,141,117,513,54,37,862,1,17,880
9,27,9011,3673,3,182,227,986,86,56,1537,2,36,1575
9,27,9011,3674,3,169,155,723,58,45,1150,1,35,1186
9,27,9011,3675,3,208,190,615,91,54,1158,0,30,1188
9,27,9011,3676,3,190,158,739,92,56,1235,0,36,1271
9,27,9011,3677,3,166,116,664,66,44,1056,0,21,1077
9,27,9011,3678,3,130,118,562,43,33,886,0,25,911
9,27,9011,3679,3,157,104,518,44,45,868,1,25,894
9,27,9011,3680,3,155,156,590,59,42,1002,1,34,1037
9,27,9011,3681,3,137,114,442,39,28,760,3,9,772
9,27,9011,3682,3,228,182,783,66,62,1321,0,33,1354
9,27,9011,3683,3,166,74,514,47,50,851,0,27,878
9,27,9011,3684,3,320,258,1264,114,93,2049,3,41,2093
9,27,9011,3685,3,186,130,597,53,54,1020,0,16,1036
9,27,9011,3686,3,185,122,587,64,51,1009,0,30,1039
9,27,9011,3687,3,179,141,588,43,55,1006,3,26,1035
9,27,9011,3688,3,162,111,539,57,42,911,1,17,929
9,27,9011,3689,3,134,110,599,56,26,925,0,25,950
9,27,9011,3690,3,141,144,499,49,40,873,0,18,891
9,27,9011,3691,3,528,526,1775,195,135,3159,5,34,3198
9,27,9011,3692,3,177,207,1027,92,45,1548,1,24,1573
9,27,9011,3693,3,177,236,581,74,42,1110,0,28,1138
9,27,9011,3694,3,186,177,542,49,23,977,2,16,995
9,27,9011,3695,3,215,297,582,70,56,1220,0,31,1251
9,27,9011,3696,3,207,242,528,66,27,1070,2,23,1095
9,27,9011,3697,3,171,176,491,75,32,945,0,30,975
9,27,9011,3698,3,115,135,489,63,30,832,0,20,852
9,27,9011,3699,3,146,203,424,58,47,878,0,29,907
9,27,9011,3700,3,255,235,575,92,33,1190,2,32,1224
9,27,9011,3701,3,190,222,539,82,48,1081,1,28,1110
9,27,9011,3702,3,191,234,517,53,37,1032,1,29,1062
9,27,9011,3703,3,185,268,746,94,48,1341,1,25,1367
9,27,9011,3704,3,198,223,577,71,49,1118,0,24,1142
9,27,9011,3705,3,210,231,554,91,54,1140,2,30,1172
9,27,9011,3706,3,213,167,653,86,44,1163,0,17,1180
9,27,9011,3707,3,117,145,522,69,56,909,1,21,931
9,27,9011,3708,3,195,343,720,102,63,1423,2,38,1463
9,27,9011,3709,3,203,186,607,66,44,1106,0,29,1135
9,27,9011,3710,3,139,98,559,60,43,899,4,19,922
9,27,9011,3711,3,180,179,863,104,60,1386,1,24,1411
9,27,9011,3712,3,137,194,574,53,36,994,1,28,1023
9,27,9011,3713,3,116,272,536,65,29,1018,4,13,1035
9,27,9011,3714,3,105,210,491,49,44,899,2,23,924
9,27,9011,3715,3,154,228,503,45,29,959,2,24,985
9,27,9011,3716,3,204,211,1031,89,60,1595,7,28,1630
9,27,9011,3717,3,229,234,1074,83,65,1685,4,34,1723
9,27,9011,3718,3,186,280,644,73,51,1234,3,35,1272
9,27,9011,3719,3,184,290,574,63,36,1147,5,26,1178
9,27,9011,3720,3,76,142,495,52,37,802,2,21,825
9,27,9011,3721,3,166,178,582,60,49,1035,2,20,1057
9,27,9011,3722,3,198,234,991,104,72,1599,3,41,1643
9,27,9011,3723,3,126,193,688,79,44,1130,2,11,1143
9,27,9011,3724,3,138,152,822,56,23,1191,1,25,1217
9,27,9011,3725,3,119,191,598,55,27,990,0,11,1001
9,27,9011,3726,3,127,132,618,34,25,936,0,23,959
9,27,9011,3727,3,96,198,660,42,34,1030,2,21,1053
9,27,9011,3728,3,125,190,764,62,32,1173,0,26,1199
9,27,9011,3729,3,101,333,569,63,37,1103,0,34,1137
9,27,9011,3730,3,85,118,490,31,23,747,0,20,767
9,27,9011,3731,3,100,198,499,43,17,857,0,37,894
9,27,9011,3732,3,96,127,407,37,27,694,1,16,711
9,27,9011,3733,3,149,127,424,37,37,774,2,21,797
9,27,9011,3734,3,90,79,156,22,14,361,0,2,363
9,27,9011,3735,3,72,65,136,17,11,301,0,4,305
9,27,9011,3736,3,87,69,148,23,24,351,0,8,359
9,27,9011,3737,3,74,61,161,22,20,338,0,10,348
9,27,9011,3738,3,309,535,571,84,91,1590,0,31,1621
9,27,9011,3739,3,70,56,149,26,12,313,0,7,320
9,27,9011,3740,3,66,83,294,23,14,480,1,14,495
9,27,9011,3741,3,99,83,410,42,25,659,7,18,684
10,1,10002,42,3,107,89,74,5,0,275,1,1,277
10,1,10002,43,3,5,17,8,0,0,30,0,0,30
10,1,10002,44,3,43,25,12,1,0,81,0,1,82
10,1,10002,45,3,19,24,6,1,0,50,0,0,50
10,1,10002,46,3,18,6,3,0,0,27,0,2,29
10,1,10002,47,3,54,35,12,0,0,101,0,1,102
10,1,10002,48,3,23,19,43,2,3,90,0,0,90
10,1,10002,50,3,11,47,5,0,1,64,0,3,67
10,1,10002,51,3,2,41,12,0,0,55,0,0,55
10,1,10002,52,3,3,10,5,0,0,18,0,0,18
10,1,10002,53,3,8,37,24,0,0,69,0,3,72
10,1,10002,54,3,3,4,34,0,0,41,0,0,41
10,1,10002,55,3,53,6,8,8,0,75,0,3,78
10,1,10002,56,3,26,51,4,46,1,128,0,9,137
10,1,10005,118,3,878,660,376,104,27,2045,10,83,2138
10,1,10005,119,3,138,115,129,6,5,393,7,14,414
10,1,10005,120,3,148,147,102,30,6,433,3,31,467
10,1,10005,123,3,182,150,143,17,6,498,2,26,526
10,1,10005,125,3,188,109,131,16,8,452,3,23,478
10,1,10005,130,3,315,359,80,29,2,785,10,20,815
10,1,10005,131,3,313,259,80,24,7,683,3,7,693
10,1,10005,132,3,307,274,96,26,13,716,1,19,736
10,1,10005,133,3,203,245,69,20,7,544,2,18,564
10,1,10005,134,3,166,216,74,14,9,479,10,8,497
10,1,10005,135,3,458,300,154,29,16,957,8,29,994
10,1,10005,163,3,260,210,87,36,11,604,6,14,624
10,1,10005,164,3,163,233,65,18,2,481,3,14,498
10,1,10005,165,3,143,116,51,12,4,326,1,12,339
10,1,10005,166,3,165,221,103,12,4,505,4,17,526
10,1,10005,167,3,230,229,124,35,8,626,2,15,643
10,1,10005,168,3,267,236,97,43,2,645,4,10,659
10,1,10005,198,3,232,220,108,37,9,606,2,10,618
10,1,10005,199,3,257,208,91,62,11,629,14,25,668
10,1,10005,200,3,133,180,61,33,7,414,4,12,430
10,1,10005,201,3,276,344,133,45,6,804,16,17,837
10,1,10005,204,3,728,641,373,89,27,1858,11,57,1926
10,1,10005,299,3,199,211,96,26,10,542,0,21,563
10,1,10005,300,3,174,176,101,22,4,477,6,29,512
10,1,10005,301,3,670,626,281,84,22,1683,4,56,1743
10,1,10005,322,3,298,185,179,46,6,714,1,20,735
10,1,10005,329,3,200,194,82,30,10,516,7,8,531
10,1,10005,330,3,349,164,142,55,16,726,4,10,740
10,1,10005,331,3,428,242,166,73,15,924,6,7,937
10,1,10005,332,3,268,229,93,34,5,629,0,24,653
10,1,10005,333,3,270,149,80,19,10,528,0,25,553
10,1,10005,334,3,194,190,120,12,13,529,3,18,550
10,1,10005,335,3,184,192,116,16,11,519,1,18,538
10,1,10005,336,3,241,237,102,25,9,614,4,17,635
10,1,10005,339,3,284,170,83,22,10,569,6,14,589
10,1,10005,340,3,328,264,127,25,10,754,5,17,776
10,1,10005,341,3,220,119,65,28,4,436,0,8,444
10,1,10005,342,3,142,155,44,11,5,357,6,8,371
10,1,10005,343,3,216,172,65,20,9,482,4,0,486
10,1,10005,344,3,332,286,124,29,13,784,3,28,815
10,1,10005,345,3,347,210,146,55,17,775,0,18,793
10,1,10005,346,3,479,413,199,77,20,1188,6,32,1226
10,1,10005,347,3,203,171,156,23,6,559,2,11,572
10,1,10005,348,3,160,196,121,32,5,514,1,15,530
10,1,10005,349,3,506,344,224,27,16,1117,6,37,1160
10,1,10005,350,3,120,129,84,24,6,363,0,14,377
10,1,10005,351,3,109,101,81,27,14,332,0,9,341
10,1,10005,352,3,16,87,16,2,2,123,0,0,123
10,1,10005,353,3,14,104,8,0,0,126,0,1,127
10,1,10005,356,3,87,70,33,3,4,197,3,6,206
10,1,10005,357,3,71,73,173,3,2,322,0,12,334
10,1,10005,358,3,31,178,13,3,0,225,0,0,225
10,1,10005,359,3,3,21,2,2,0,28,0,0,28
10,1,10005,360,3,12,36,7,6,2,63,0,3,66
10,1,10005,361,3,171,152,233,5,5,566,4,15,585
10,1,10005,370,3,109,261,47,7,2,426,1,26,453
10,1,10005,371,3,187,132,126,16,4,465,0,14,479
10,1,10005,372,3,99,72,62,9,5,247,7,8,262
10,1,10005,373,3,38,58,15,2,3,116,0,0,116
10,1,10005,374,3,37,198,6,3,0,244,0,3,247
10,1,10005,375,3,28,38,47,2,4,119,0,12,131
10,1,10005,376,3,289,205,102,27,9,632,3,20,655
10,1,10005,386,3,20,144,8,0,0,172,0,0,172
10,1,10005,387,3,13,36,9,0,0,58,0,4,62
10,1,10005,388,3,60,112,115,3,2,292,0,3,295
10,1,10005,389,3,249,88,115,14,7,473,5,17,495
10,1,10005,390,3,105,40,57,3,1,206,2,0,208
10,1,10005,394,3,108,35,21,7,3,174,1,8,183
10,1,10005,395,3,167,130,93,6,0,396,4,15,415
10,1,10005,396,3,82,102,45,11,3,243,0,7,250
10,1,10005,397,3,279,130,55,11,1,476,7,21,504
10,1,10005,398,3,384,216,93,20,10,723,6,25,754
10,1,10005,399,3,264,136,84,18,7,509,1,13,523
10,1,10005,400,3,221,195,102,9,4,531,0,24,555
10,1,10005,401,3,104,283,36,4,1,428,0,12,440
10,1,10005,402,3,233,116,49,13,2,413,2,61,476
10,1,10005,403,3,180,148,73,16,4,421,1,14,436
10,1,10005,404,3,47,44,46,2,0,139,0,5,144
10,1,10005,405,3,120,117,180,11,2,430,3,10,443
10,1,10005,406,3,0,14,13,1,0,28,0,0,28
10,1,10005,407,3,51,78,8,1,0,138,1,6,145
10,1,10005,408,3,42,40,26,2,1,111,1,3,115
10,1,10005,409,3,145,380,112,8,4,649,9,13,671
10,1,10005,410,3,460,70,59,9,3,601,1,19,621
10,1,10005,411,3,208,227,98,17,9,559,11,14,584
10,1,10005,412,3,99,203,165,11,7,485,5,10,500
10,1,10005,413,3,55,91,73,2,2,223,4,2,229
10,1,10005,414,3,82,109,67,2,3,263,6,6,275
10,1,10005,415,3,17,29,17,1,1,65,1,0,66
10,1,10005,416,3,60,155,29,7,4,255,0,3,258
10,1,10005,417,3,10,94,1,1,0,106,0,3,109
10,1,10005,418,3,8,11,11,1,0,31,0,0,31
10,1,10009,638,3,293,156,30,10,4,493,2,10,505
10,1,10009,639,3,180,94,15,10,3,302,0,8,310
10,1,10009,640,3,10,70,0,1,0,81,0,6,87
10,1,10009,641,3,53,145,3,1,0,202,0,5,207
10,1,10009,642,3,77,120,6,0,1,204,0,3,207
10,1,10009,643,3,43,132,6,1,0,182,1,3,186
10,1,10009,644,3,164,230,12,1,0,407,0,9,416
10,1,10009,645,3,99,14,2,0,0,115,0,2,117
10,1,10009,646,3,31,16,3,1,0,51,0,1,52
10,1,10009,647,3,32,13,2,0,0,47,0,2,49
10,1,10009,648,3,12,30,2,1,0,45,0,0,45
10,1,10009,649,3,35,34,1,0,0,70,0,2,72
10,1,10009,650,3,8,24,1,0,0,33,0,0,33
10,1,10009,651,3,43,33,14,1,0,91,0,3,94
10,1,10009,653,3,84,18,10,8,1,121,0,1,122
10,1,10009,654,3,236,193,12,3,0,444,1,10,455
10,1,10009,655,3,43,135,8,0,0,186,0,0,186
10,1,10009,656,3,118,84,17,2,0,221,0,8,229
10,1,10009,657,3,20,14,4,0,0,38,0,0,38
10,1,10009,658,3,27,70,6,0,1,104,1,4,109
10,1,10009,659,3,51,85,28,1,0,165,0,5,170
10,1,10009,660,3,4,41,3,1,1,50,0,1,51
10,1,10009,661,3,70,93,71,2,0,236,1,10,247
10,1,10009,662,3,53,45,12,0,1,111,0,2,113
10,1,10009,663,3,31,53,12,5,3,104,0,2,106
10,1,10014,796,3,203,152,12,9,1,377,0,6,383
10,1,10014,797,3,183,159,12,3,4,361,0,3,364
10,1,10014,798,3,51,67,17,1,0,136,0,1,137
10,1,10014,799,3,94,50,7,4,3,158,0,5,163
10,1,10014,800,3,124,169,15,7,5,320,0,9,329
10,1,10014,801,3,9,86,1,1,0,97,0,8,105
10,1,10014,802,3,6,50,5,0,0,61,0,2,63
10,1,10014,803,3,54,94,4,0,2,154,0,6,160
10,1,10014,804,3,3,81,1,1,0,86,0,2,88
10,1,10014,805,3,14,88,3,0,0,105,0,0,105
10,1,10014,806,3,60,93,1,1,0,155,2,8,165
10,1,10014,807,3,106,101,7,8,0,222,0,15,237
10,1,10014,808,3,101,178,16,0,1,296,1,15,312
10,1,10014,809,3,174,186,26,1,8,395,0,46,441
10,1,10014,810,3,185,274,14,4,4,481,3,46,530
10,1,10014,811,3,311,418,45,9,14,797,0,44,841
10,1,10014,812,3,22,128,3,0,0,153,0,13,166
10,1,10014,813,3,56,141,7,4,1,209,0,15,224
10,1,10014,814,3,33,167,5,1,1,207,0,8,215
10,1,10014,815,3,16,146,2,1,0,165,0,26,191
10,1,10014,816,3,202,283,17,3,1,506,0,35,541
10,1,10014,817,3,95,372,60,0,1,528,0,29,557
10,1,10014,818,3,89,19,0,0,0,108,0,1,109
10,1,10014,819,3,25,17,1,0,1,44,1,4,49
10,1,10014,820,3,132,163,3,0,3,301,0,28,329
10,1,10014,821,3,497,283,39,7,1,827,0,65,892
10,1,10014,822,3,262,338,56,0,12,668,9,67,744
10,1,10014,823,3,114,59,103,1,1,278,0,18,296
10,1,10014,824,3,15,45,2,0,0,62,1,0,63
10,1,10014,825,3,181,209,7,0,0,397,0,16,413
10,1,10014,826,3,256,253,9,20,1,539,0,16,555
10,1,10014,827,3,161,165,23,2,0,351,0,17,368
10,1,10020,947,3,128,81,119,3,1,332,0,6,338
10,1,10020,948,3,52,157,23,1,1,234,0,5,239
10,1,10020,949,3,25,7,46,0,0,78,0,2,80
10,1,10020,950,3,38,21,20,2,0,81,0,0,81
10,1,10020,951,3,26,12,52,2,0,92,0,1,93
10,1,10020,952,3,23,20,28,0,0,71,0,1,72
10,1,10020,953,3,7,62,24,0,0,93,0,0,93
10,1,10020,954,3,44,30,35,1,0,110,0,2,112
10,1,10020,955,3,73,37,14,0,1,125,0,1,126
10,1,10020,956,3,84,84,84,0,0,252,0,3,255
10,1,10020,957,3,14,3,29,0,0,46,0,0,46
10,1,10020,958,3,24,7,21,0,0,52,0,1,53
10,1,10020,959,3,28,31,69,1,0,129,0,1,130
10,1,10020,960,3,38,3,8,0,0,49,0,0,49
10,1,10024,1015,3,279,147,86,34,1,547,2,14,563
10,1,10024,1016,3,158,141,46,19,1,365,0,9,374
10,1,10024,1017,3,285,259,74,41,4,663,0,10,673
10,1,10024,1018,3,309,259,110,34,5,717,0,4,721
10,1,10024,1019,3,452,291,119,50,5,917,0,27,944
10,1,10024,1020,3,203,204,55,32,4,498,0,12,510
10,1,10024,1021,3,254,159,36,38,4,491,0,5,496
10,1,10024,1022,3,215,185,42,24,1,467,0,14,481
10,1,10024,1023,3,408,250,75,41,3,777,1,22,800
10,1,10024,1024,3,436,316,61,45,4,862,1,12,875
10,1,10024,1025,3,13,170,5,2,2,192,0,9,201
10,1,10024,1026,3,19,59,1,2,0,81,0,0,81
10,1,10024,1027,3,216,230,51,14,0,511,0,17,528
10,1,10024,1028,3,87,137,15,9,0,248,0,5,253
10,1,10024,1029,3,31,222,15,1,1,270,0,7,277
10,1,10024,1030,3,95,142,12,4,0,253,0,3,256
10,1,10024,1031,3,51,57,13,3,0,124,0,2,126
10,1,10024,1032,3,46,55,19,2,2,124,0,4,128
10,1,10024,1033,3,63,54,25,4,0,146,0,7,153
10,1,10024,1034,3,70,140,31,5,1,247,2,1,250
10,1,10024,1035,3,43,45,17,2,0,107,1,2,110
10,1,10024,1036,3,11,52,8,0,0,71,0,2,73
10,1,10024,1037,3,134,142,6,1,1,284,0,5,289
10,1,10024,1038,3,68,54,8,0,1,131,0,1,132
10,1,10024,1039,3,39,62,7,0,0,108,0,3,111
10,1,10024,1040,3,207,114,25,7,0,353,0,6,359
10,1,10024,1041,3,7,39,1,0,0,47,0,0,47
10,1,10024,1042,3,36,61,1,0,0,98,0,7,105
10,1,10024,1043,3,78,140,18,2,0,238,0,1,239
10,1,10024,1044,3,188,86,26,9,1,310,0,12,322
10,1,10024,1045,3,88,72,19,0,0,179,0,6,185
10,1,10024,1046,3,122,136,119,0,4,381,1,8,390
10,1,10024,1047,3,44,110,36,0,2,192,0,11,203
10,1,10024,1048,3,39,92,12,0,0,143,0,1,144
10,1,10024,1049,3,91,80,18,0,2,191,0,4,195
10,1,10024,1050,3,83,161,11,1,0,256,0,8,264
10,1,10024,1051,3,25,49,2,0,0,76,0,3,79
10,1,10024,1052,3,4,16,0,0,0,20,0,1,21
10,1,10024,1053,3,8,70,3,3,0,84,0,0,84
10,1,10024,1054,3,21,47,23,1,0,92,0,1,93
10,1,10024,1055,3,40,101,9,3,0,153,0,0,153
10,1,10024,1056,3,4,15,4,0,0,23,0,2,25
10,1,10024,1057,3,3,15,2,0,0,20,0,2,22
10,1,10024,1058,3,8,53,1,0,0,62,0,3,65
10,1,10024,1059,3,18,41,3,0,0,62,0,0,62
10,1,10024,1060,3,13,36,6,1,0,56,0,7,63
10,1,10024,1061,3,13,177,3,2,2,197,0,25,222
10,1,10024,1062,3,4,22,2,0,0,28,0,0,28
10,1,10027,1098,3,115,149,69,10,2,345,0,0,345
10,1,10027,1099,3,137,229,170,24,4,564,1,5,570
10,1,10027,1100,3,109,126,110,5,6,356,1,6,363
10,1,10027,1101,3,26,5,5,0,0,36,0,0,36
10,1,10027,1102,3,11,50,27,0,0,88,0,2,90
10,1,10027,1103,3,47,31,6,1,0,85,0,1,86
10,1,10027,1104,3,42,82,6,3,0,133,0,3,136
10,1,10027,1105,3,18,9,22,0,0,49,0,0,49
10,1,10027,1106,3,26,36,8,2,0,72,0,5,77
10,1,10027,1107,3,76,73,18,5,2,174,0,4,178
10,1,10027,1108,3,116,69,19,10,0,214,0,4,218
10,1,10027,1109,3,114,46,16,12,0,188,0,8,196
10,1,10027,1110,3,107,64,4,8,0,183,0,4,187
10,1,10027,1111,3,31,3,1,1,0,36,0,2,38
10,1,10027,1112,3,233,78,12,21,3,347,0,13,360
10,1,10027,1113,3,27,16,3,3,0,49,0,0,49
10,1,10027,1114,3,49,51,12,11,1,124,1,4,129
10,1,10027,1115,3,29,52,12,3,0,96,0,5,101
10,1,10027,1116,3,84,80,11,4,1,180,1,6,187
10,1,10027,1117,3,82,52,17,4,1,156,0,5,161
10,1,10027,1118,3,52,37,6,10,0,105,0,5,110
10,1,10027,1119,3,43,10,5,1,0,59,0,2,61
10,1,10027,1120,3,79,37,15,1,0,132,0,3,135
10,1,10027,1121,3,51,32,7,1,0,91,0,2,93
10,1,10027,1122,3,96,72,6,1,0,175,0,4,179
10,1,10027,1123,3,34,19,6,0,0,59,0,1,60
10,1,10027,1125,3,4,57,34,0,1,96,0,1,97
10,1,10027,1126,3,96,48,9,11,0,164,0,0,164
10,1,10027,1127,3,44,113,75,0,2,234,0,5,239
10,1,10027,1128,3,28,70,10,3,0,111,2,7,120
10,1,10027,1130,3,59,17,10,0,0,86,0,2,88
10,1,10027,1131,3,34,54,14,0,0,102,0,6,108
10,1,10027,1132,3,31,58,3,4,2,98,0,1,99
10,1,10027,1133,3,3,7,2,0,1,13,0,1,14
10,1,10027,1134,3,56,56,19,3,0,134,0,4,138
10,1,10027,1135,3,31,63,2,0,0,96,0,2,98
10,1,10027,1136,3,2,83,7,2,0,94,0,0,94
10,1,10027,1137,3,10,67,4,2,0,83,0,1,84
10,1,10027,1138,3,18,35,19,1,0,73,0,2,75
10,1,10027,1139,3,10,81,8,2,1,102,0,0,102
10,1,10033,1200,3,214,229,69,86,4,602,0,14,616
10,1,10033,1201,3,501,456,84,62,6,1109,0,27,1136
10,1,10033,1202,3,247,334,71,35,0,687,5,20,712
10,1,10033,1203,3,220,180,39,29,3,471,2,10,483
10,1,10033,1204,3,194,239,74,35,3,545,2,1,548
10,1,10033,1205,3,272,229,83,47,6,637,0,10,647
10,1,10033,1206,3,162,154,23,39,6,384,1,5,390
10,1,10033,1207,3,256,335,95,83,7,776,1,26,803
10,1,10033,1208,3,251,213,43,47,3,557,0,16,573
10,1,10033,1209,3,139,139,28,20,6,332,0,3,335
10,1,10033,1210,3,128,143,25,24,1,321,1,6,328
10,1,10033,1211,3,148,160,44,34,8,394,0,10,404
10,1,10033,1212,3,332,303,97,62,5,799,3,15,817
10,1,10033,1213,3,274,316,75,43,1,709,1,19,729
10,1,10033,1214,3,99,150,32,33,5,319,1,11,331
10,1,10033,1215,3,76,18,6,11,0,111,0,6,117
10,1,10033,1217,3,54,21,8,1,0,84,0,3,87
10,1,10033,1218,3,50,9,3,3,1,66,1,1,68
10,1,10033,1219,3,169,128,18,25,4,344,2,13,359
10,1,10033,1220,3,102,58,59,9,3,231,0,5,236
10,1,10033,1221,3,46,21,3,2,0,72,0,0,72
10,1,10033,1222,3,110,114,16,6,2,248,0,4,252
10,1,10033,1223,3,21,21,1,0,0,43,1,0,44
10,1,10033,1224,3,80,71,17,8,7,183,2,6,191
10,1,10033,1225,3,30,41,13,3,1,88,1,0,89
10,1,10033,1226,3,22,38,3,7,1,71,2,0,73
10,1,10033,1227,3,28,80,5,2,0,115,0,1,116
10,1,10033,1228,3,62,51,9,10,3,135,0,0,135
10,1,10033,1229,3,148,55,24,9,2,238,0,7,245
10,1,10033,1230,3,38,11,5,4,0,58,0,1,59
10,1,10033,1231,3,75,94,5,0,1,175,0,2,177
10,1,10033,1232,3,29,28,7,0,1,65,0,1,66
10,1,10033,1233,3,51,19,7,1,0,78,0,2,80
10,1,10033,1234,3,130,50,17,5,0,202,0,4,206
10,1,10033,1235,3,112,82,5,7,5,211,2,7,220
10,1,10033,1236,3,125,140,15,8,1,289,0,2,291
10,1,10033,1237,3,56,70,4,5,0,135,0,0,135
10,1,10033,1238,3,120,84,8,5,1,218,0,8,226
10,1,10033,1239,3,74,194,21,7,2,298,1,10,309
10,1,10033,1240,3,80,169,32,10,2,293,0,7,300
10,1,10033,1241,3,37,36,10,2,0,85,0,3,88
10,1,10033,1242,3,75,83,18,6,0,182,0,3,185
10,1,10033,1243,3,53,110,21,1,0,185,0,9,194
10,1,10033,1244,3,85,106,24,15,2,232,2,13,247
10,1,10033,1245,3,108,125,59,25,4,321,1,12,334
10,1,10033,1246,3,50,49,23,4,0,126,1,2,129
10,1,10033,1247,3,45,31,5,4,0,85,0,3,88
10,1,10033,1248,3,50,52,10,3,0,115,0,3,118
10,1,10033,1249,3,169,56,16,7,0,248,0,9,257
10,1,10033,1250,3,35,109,12,2,0,158,0,8,166
10,1,10033,1251,3,54,22,2,0,0,78,0,1,79
10,1,10033,1252,3,19,18,5,0,0,42,0,0,42
10,1,10033,1253,3,67,14,4,0,0,85,0,3,88
10,1,10033,1254,3,34,24,2,0,0,60,0,1,61
10,1,10033,1255,3,57,19,10,1,0,87,0,3,90
10,1,10033,1256,3,36,75,7,2,1,121,0,3,124
10,1,10033,1257,3,112,70,2,0,0,184,0,3,187
10,1,10033,1258,3,69,60,5,1,0,135,0,6,141
10,1,10033,1259,3,59,63,7,4,0,133,0,9,142
10,1,10033,1260,3,158,95,30,7,0,290,0,4,294
10,1,10033,1261,3,88,87,3,2,1,181,0,3,184
10,1,10034,1263,3,94,139,78,17,3,331,3,7,341
10,1,10034,1264,3,110,130,69,13,4,326,0,9,335
10,1,10034,1265,3,119,123,147,15,3,407,0,11,418
10,1,10034,1266,3,172,164,154,13,5,508,2,14,524
10,1,10034,1267,3,10,24,43,0,0,77,0,0,77
10,1,10034,1268,3,32,57,57,1,2,149,1,4,154
10,1,10034,1269,3,64,22,21,1,0,108,1,1,110
10,1,10034,1270,3,10,13,2,0,0,25,1,0,26
10,1,10034,1271,3,78,50,15,1,2,146,8,2,156
10,1,10034,1272,3,36,21,21,1,1,80,3,1,84
10,1,10034,1273,3,52,87,26,0,1,166,1,10,177
10,1,10035,1274,3,137,286,43,8,2,476,0,16,492
10,1,10035,1275,3,155,157,39,8,4,363,0,4,367
10,1,10035,1276,3,1,43,0,0,0,44,0,0,44
10,1,10035,1277,3,32,266,28,2,0,328,0,11,339
10,1,10035,1278,3,10,41,4,0,1,56,0,0,56
10,1,10035,1279,3,16,94,13,1,1,125,0,5,130
10,1,10035,1280,3,11,116,6,0,2,135,0,3,138
10,1,10035,1281,3,41,335,33,2,1,412,0,4,416
10,1,10035,1282,3,33,113,28,1,0,175,0,0,175
10,1,10035,1283,3,7,57,9,3,0,76,0,0,76
10,1,10035,1284,3,6,24,3,0,0,33,0,4,37
10,1,10035,1285,3,10,90,1,0,0,101,0,4,105
10,1,10035,1286,3,51,43,29,0,0,123,0,5,128
10,1,10035,1287,3,7,55,3,0,1,66,0,0,66
10,1,10035,1288,3,9,78,27,1,0,115,1,3,119
10,1,10035,1289,3,50,49,34,4,0,137,0,1,138
10,1,10035,1290,3,132,101,47,3,2,285,1,7,293
10,1,10035,1291,3,30,27,8,1,0,66,0,1,67
10,1,10035,1292,3,122,62,7,0,1,192,0,5,197
10,1,10035,1293,3,33,35,52,0,0,120,0,1,121
10,1,10035,1294,3,16,289,15,1,0,321,0,7,328
10,1,10035,1295,3,12,54,15,0,0,81,0,3,84
10,1,10035,1296,3,22,52,5,0,0,79,0,4,83
10,1,10035,1297,3,66,98,11,2,0,177,0,2,179
10,1,10035,1298,3,92,129,6,0,0,227,0,6,233
10,1,10035,1299,3,22,116,19,0,1,158,0,6,164
10,1,10035,1300,3,168,102,18,5,1,294,0,7,301
10,1,10035,1301,3,14,67,44,0,0,125,0,1,126
10,1,10035,1302,3,10,57,5,0,0,72,0,1,73
10,1,10035,1303,3,5,8,1,0,0,14,0,0,14
10,1,10035,1304,3,18,33,1,0,0,52,0,3,55
10,1,10035,1305,3,31,23,1,0,0,55,0,0,55
10,1,10036,1306,3,236,168,55,31,5,495,0,10,505
10,1,10036,1307,3,80,99,33,7,3,222,0,0,222
10,1,10036,1308,3,91,75,24,7,2,199,0,0,199
10,1,10036,1309,3,225,149,57,34,3,468,0,5,473
10,1,10036,1310,3,209,136,32,32,1,410,1,12,423
10,1,10036,1311,3,22,230,4,0,0,256,0,3,259
10,1,10036,1312,3,49,72,3,2,0,126,0,2,128
10,1,10036,1313,3,26,29,3,0,1,59,0,2,61
10,1,10036,1314,3,11,108,4,1,0,124,0,0,124
10,1,10036,1315,3,3,100,4,0,1,108,0,0,108
10,1,10036,1316,3,77,66,2,0,0,145,0,2,147
10,1,10036,1317,3,14,32,8,0,0,54,0,0,54
10,1,10036,1318,3,79,54,28,0,1,162,0,5,167
10,1,10036,1319,3,98,19,4,3,1,125,0,1,126
10,1,10036,1320,3,35,17,12,0,0,64,0,2,66
10,1,10036,1321,3,104,63,13,5,3,188,1,3,192
10,1,10036,1322,3,51,26,5,0,2,84,0,3,87
10,1,10036,1323,3,38,25,5,0,1,69,0,3,72
10,1,10036,1324,3,119,40,9,2,1,171,0,9,180
10,1,10036,1325,3,65,44,1,2,4,116,0,7,123
10,1,10036,1326,3,94,42,17,11,2,166,0,0,166
10,1,10036,1327,3,47,11,6,4,2,70,0,1,71
10,1,10036,1328,3,27,44,7,1,0,79,1,3,83
10,1,10036,1329,3,72,40,8,22,0,142,0,6,148
10,1,10036,1330,3,99,177,7,6,1,290,0,8,298
10,1,10036,1331,3,31,45,2,1,0,79,0,1,80
10,1,10036,1332,3,26,32,1,0,0,59,0,1,60
10,1,10038,1360,3,135,131,37,3,3,309,0,10,319
10,1,10038,1361,3,84,66,34,9,6,199,0,5,204
10,1,10038,1362,3,80,83,31,8,3,205,0,8,213
10,1,10038,1363,3,20,46,6,0,1,73,0,0,73
10,1,10038,1364,3,15,46,1,0,0,62,0,0,62
10,1,10038,1365,3,17,115,6,0,0,138,0,0,138
10,1,10038,1366,3,15,9,5,0,2,31,0,0,31
10,1,10038,1367,3,44,12,5,0,0,61,1,0,62
10,1,10038,1368,3,15,52,5,1,0,73,0,2,75
10,1,10038,1369,3,84,174,74,2,4,338,4,17,359
10,1,10038,1370,3,32,35,3,3,1,74,0,5,79
10,1,10038,1371,3,41,49,12,1,0,103,0,0,103
10,1,10038,1372,3,44,95,22,3,0,164,0,0,164
10,1,10038,1373,3,147,78,31,3,1,260,0,5,265
10,1,10033,1391,3,93,57,49,7,4,210,0,2,212
10,2,10007,436,3,157,246,75,25,13,516,0,2,518
10,2,10007,437,3,241,304,64,14,5,628,2,5,635
10,2,10007,438,3,205,300,245,6,3,759,7,12,778
10,2,10007,439,3,841,1487,351,59,30,2768,4,37,2809
10,2,10007,440,3,176,319,64,14,4,577,6,10,593
10,2,10007,441,3,138,310,48,8,5,509,0,3,512
10,2,10007,442,3,152,269,58,7,5,491,1,5,497
10,2,10007,443,3,317,552,166,14,5,1054,2,26,1082
10,2,10007,444,3,163,313,113,7,5,601,5,16,622
10,2,10007,445,3,126,241,132,11,3,513,0,12,525
10,2,10007,446,3,402,994,385,46,14,1841,4,55,1900
10,2,10007,447,3,1572,2479,663,111,55,4880,9,41,4930
10,2,10007,448,3,439,642,149,35,8,1273,1,14,1288
10,2,10007,449,3,328,390,110,9,6,843,0,3,846
10,2,10007,450,3,276,338,84,10,5,713,1,7,721
10,2,10007,451,3,256,428,98,27,6,815,1,2,818
10,2,10007,452,3,255,541,162,19,13,990,0,23,1013
10,2,10007,453,3,365,460,94,11,3,933,1,9,943
10,2,10007,454,3,69,187,146,2,4,408,2,16,426
10,2,10007,455,3,145,252,72,18,7,494,0,11,505
10,2,10007,456,3,112,209,93,6,4,424,1,6,431
10,2,10007,457,3,58,129,64,2,5,258,0,5,263
10,2,10007,458,3,83,172,88,9,1,353,0,6,359
10,2,10007,459,3,213,425,132,13,1,784,1,8,793
10,2,10007,460,3,120,443,83,6,8,660,1,14,675
10,2,10007,461,3,220,339,117,10,16,702,0,5,707
10,2,10007,462,3,194,296,62,10,8,570,2,10,582
10,2,10007,463,3,130,314,67,7,6,524,0,6,530
10,2,10007,464,3,215,399,75,10,5,704,1,8,713
10,2,10007,465,3,119,207,39,7,3,375,2,1,378
10,2,10007,466,3,123,203,33,3,0,362,0,8,370
10,2,10007,467,3,269,446,92,12,3,822,2,5,829
10,2,10007,468,3,117,242,63,4,5,431,0,5,436
10,2,10007,469,3,113,282,46,5,7,453,0,6,459
10,2,10007,470,3,92,89,24,5,3,213,0,10,223
10,2,10007,471,3,302,589,115,22,9,1037,1,12,1050
10,2,10007,472,3,323,453,99,26,6,907,1,14,922
10,2,10007,473,3,287,542,110,15,5,959,3,2,964
10,2,10007,474,3,289,419,110,9,9,836,1,15,852
10,2,10007,475,3,304,357,74,8,10,753,0,9,762
10,2,10007,476,3,121,291,81,4,3,500,1,12,513
10,2,10007,477,3,67,139,57,6,2,271,0,4,275
10,2,10007,478,3,134,164,51,0,5,354,3,4,361
10,2,10007,479,3,122,195,66,7,2,392,1,2,395
10,2,10007,480,3,144,244,74,7,1,470,1,4,475
10,2,10007,481,3,176,242,72,3,6,499,1,2,502
10,2,10007,482,3,185,262,60,11,3,521,1,17,539
10,2,10007,483,3,171,211,36,14,15,447,1,20,468
10,2,10007,484,3,156,317,75,8,6,562,0,16,578
10,2,10007,485,3,240,337,122,9,4,712,0,15,727
10,2,10007,486,3,188,403,138,12,17,758,3,25,786
10,2,10007,487,3,146,405,163,9,7,730,1,18,749
10,2,10007,488,3,721,1398,492,53,42,2706,5,43,2754
10,2,10007,489,3,135,272,97,14,4,522,1,8,531
10,2,10007,490,3,132,217,119,7,2,477,0,10,487
10,2,10007,491,3,270,576,201,11,8,1066,5,9,1080
10,2,10007,492,3,165,298,96,8,3,570,1,16,587
10,2,10007,493,3,158,293,103,9,4,567,1,8,576
10,2,10007,494,3,267,339,66,14,16,702,1,8,711
10,2,10007,495,3,275,337,79,9,6,706,0,9,715
10,2,10007,496,3,164,197,68,8,9,446,0,0,446
10,2,10007,497,3,127,162,56,6,2,353,1,7,361
10,2,10007,498,3,227,302,69,14,7,619,1,5,625
10,2,10007,499,3,152,307,83,10,3,555,0,17,572
10,2,10007,500,3,197,337,100,8,6,648,0,7,655
10,2,10007,501,3,216,316,78,6,3,619,0,4,623
10,2,10007,502,3,488,605,149,36,12,1290,0,11,1301
10,2,10007,503,3,253,416,92,34,6,801,0,11,812
10,2,10007,504,3,235,305,64,20,3,627,0,7,634
10,2,10007,505,3,293,344,78,8,2,725,0,8,733
10,2,10007,506,3,188,278,75,16,8,565,0,10,575
10,2,10007,507,3,236,252,84,14,11,597,0,6,603
10,2,10007,508,3,157,186,77,6,3,429,1,6,436
10,2,10007,509,3,109,232,63,13,3,420,0,3,423
10,2,10007,510,3,227,554,187,8,10,986,0,19,1005
10,2,10007,511,3,103,246,119,3,1,472,0,18,490
10,2,10007,512,3,118,321,109,6,6,560,0,14,574
10,2,10007,513,3,104,279,88,9,2,482,10,7,499
10,2,10007,514,3,119,222,72,3,2,418,2,12,432
10,2,10007,515,3,177,390,99,7,4,677,0,14,691
10,2,10007,516,3,129,160,57,8,6,360,0,8,368
10,2,10007,517,3,155,197,46,12,2,412,0,5,417
10,2,10007,518,3,103,157,31,6,3,300,0,3,303
10,2,10007,519,3,227,303,82,9,11,632,0,5,637
10,2,10007,520,3,287,339,83,17,9,735,1,7,743
10,2,10007,521,3,202,329,70,8,8,617,0,23,640
10,2,10007,522,3,193,320,78,5,12,608,0,4,612
10,2,10007,523,3,175,248,73,8,5,509,1,2,512
10,2,10007,524,3,87,187,50,4,2,330,0,2,332
10,2,10007,525,3,180,418,104,10,3,715,8,0,723
10,2,10007,526,3,109,294,116,10,9,538,2,13,553
10,2,10007,527,3,167,270,97,7,7,548,1,6,555
10,2,10007,528,3,99,281,163,12,3,558,0,16,574
10,2,10007,529,3,224,345,108,15,12,704,0,5,709
10,2,10007,530,3,207,402,124,12,11,756,0,26,782
10,2,10007,531,3,140,415,209,5,4,773,3,11,787
10,2,10007,532,3,151,219,50,11,5,436,0,3,439
10,2,10007,533,3,247,216,54,8,4,529,0,4,533
10,2,10007,534,3,159,200,28,2,4,393,0,12,405
10,2,10007,535,3,524,477,84,6,12,1103,0,5,1108
10,2,10007,536,3,461,339,60,18,13,891,1,12,904
10,2,10007,537,3,294,211,33,11,6,555,0,5,560
10,2,10007,538,3,251,283,57,11,7,609,0,7,616
10,2,10007,539,3,159,285,108,4,7,563,0,10,573
10,2,10007,540,3,138,260,75,6,4,483,1,3,487
10,2,10007,541,3,839,1334,354,46,27,2600,12,25,2637
10,2,10007,542,3,266,319,69,10,8,672,0,0,672
10,2,10007,543,3,194,247,46,13,7,507,0,6,513
10,2,10007,544,3,193,278,56,10,4,541,2,5,548
10,2,10007,545,3,166,184,64,10,4,428,2,3,433
10,2,10007,546,3,260,303,46,14,7,630,0,3,633
10,2,10007,547,3,108,245,97,6,6,462,0,11,473
10,2,10007,548,3,172,313,135,8,7,635,1,13,649
10,2,10007,549,3,105,178,61,5,6,355,1,7,363
10,2,10007,550,3,183,277,148,6,9,623,6,15,644
10,2,10007,551,3,152,329,72,16,4,573,6,9,588
10,2,10007,552,3,377,387,38,4,4,810,0,14,824
10,2,10007,553,3,119,280,121,7,9,536,2,9,547
10,2,10007,554,3,80,225,188,2,4,499,3,0,502
10,2,10007,555,3,67,136,105,3,2,313,0,6,319
10,2,10007,556,3,19,84,51,1,2,157,0,6,163
10,2,10007,557,3,9,53,14,0,1,77,0,0,77
10,2,10007,558,3,86,243,104,4,1,438,1,0,439
10,2,10007,559,3,91,279,88,3,1,462,0,14,476
10,2,10007,560,3,78,270,127,4,3,482,0,5,487
10,2,10007,561,3,222,461,180,18,2,883,2,20,905
10,2,10007,562,3,45,324,187,12,2,570,1,9,580
10,2,10007,563,3,19,130,128,4,1,282,0,5,287
10,2,10007,564,3,247,255,227,19,7,755,0,19,774
10,2,10007,565,3,139,155,140,7,2,443,2,15,460
10,2,10007,566,3,64,267,200,2,1,534,0,17,551
10,2,10007,567,3,143,284,193,18,5,643,2,26,671
10,2,10007,568,3,47,109,44,4,3,207,0,0,207
10,2,10007,569,3,70,300,102,17,1,490,0,16,506
10,2,10007,570,3,103,240,83,25,3,454,0,5,459
10,2,10007,571,3,149,395,90,2,5,641,2,6,649
10,2,10007,572,3,63,270,77,3,1,414,0,16,430
10,2,10007,573,3,54,210,60,6,2,332,0,12,344
10,2,10007,574,3,75,350,380,16,7,828,1,13,842
10,2,10007,575,3,111,123,59,6,1,300,0,0,300
10,2,10007,576,3,31,60,69,11,1,172,0,7,179
10,2,10007,577,3,41,208,39,3,2,293,0,7,300
10,2,10007,578,3,86,105,95,3,2,291,1,6,298
10,2,10007,579,3,92,265,98,3,4,462,0,16,478
10,2,10007,580,3,84,186,64,4,3,341,0,9,350
10,2,10007,581,3,131,310,107,2,6,556,6,7,569
10,2,10007,582,3,72,232,156,10,15,485,2,4,491
10,2,10007,583,3,67,357,170,19,6,619,4,21,644
10,2,10007,584,3,65,137,104,4,5,315,2,12,329
10,2,10007,585,3,295,325,167,12,10,809,5,28,842
10,2,10007,586,3,61,110,69,4,3,247,1,7,255
10,2,10007,587,3,57,104,23,1,2,187,1,4,192
10,2,10007,588,3,148,285,225,10,13,681,4,13,698
10,2,10007,589,3,80,244,172,13,5,514,4,10,528
10,2,10007,590,3,107,266,201,6,1,581,0,13,594
10,2,10007,591,3,69,223,177,7,2,478,0,10,488
10,2,10007,592,3,126,173,220,11,2,532,2,12,546
10,2,10007,593,3,54,73,41,3,4,175,2,11,188
10,2,10007,594,3,103,164,85,10,2,364,2,8,374
10,2,10007,595,3,90,135,53,2,1,281,7,12,300
10,2,10007,596,3,41,158,47,2,4,252,4,5,261
10,2,10007,597,3,163,470,195,7,5,840,2,32,874
10,2,10007,598,3,88,120,30,3,1,242,1,8,251
10,2,10007,600,3,262,344,126,5,3,740,3,3,746
10,2,10007,601,3,122,370,272,15,4,783,0,20,803
10,2,10007,602,3,55,140,45,0,4,244,0,7,251
10,2,10007,603,3,299,368,189,13,2,871,3,21,895
10,2,10007,604,3,156,177,71,4,3,411,5,10,426
10,2,10007,605,3,118,335,140,5,5,603,5,22,630
10,2,10007,606,3,16,39,11,1,0,67,0,1,68
10,2,10007,607,3,85,360,102,8,4,559,1,9,569
10,2,10007,608,3,90,372,96,3,6,567,1,17,585
10,2,10007,609,3,89,168,95,10,2,364,3,8,375
10,2,10007,610,3,70,150,54,11,2,287,0,5,292
10,2,10007,611,3,134,298,89,8,8,537,1,9,547
10,2,10012,689,3,519,607,268,23,11,1428,2,22,1452
10,2,10012,690,3,431,505,187,33,20,1176,0,20,1196
10,2,10012,691,3,220,229,95,10,4,558,0,4,562
10,2,10012,692,3,266,255,98,22,13,654,0,3,657
10,2,10012,693,3,197,307,143,12,16,675,0,5,680
10,2,10012,694,3,483,417,180,13,18,1111,5,15,1131
10,2,10012,695,3,372,451,224,30,7,1084,1,9,1094
10,2,10012,696,3,391,303,138,21,14,867,0,10,877
10,2,10012,697,3,425,400,168,37,13,1043,1,14,1058
10,2,10012,698,3,348,420,180,16,10,974,0,9,983
10,2,10012,699,3,370,331,120,33,8,862,1,9,872
10,2,10012,700,3,194,242,73,9,1,519,0,15,534
10,2,10012,701,3,251,337,141,13,2,744,2,19,765
10,2,10012,702,3,312,209,63,4,13,601,0,2,603
10,2,10012,703,3,297,249,79,5,3,633,0,7,640
10,2,10012,704,3,409,257,85,23,10,784,2,5,791
10,2,10012,705,3,590,569,184,28,13,1384,3,16,1403
10,2,10012,706,3,138,211,108,11,2,470,1,7,478
10,2,10012,707,3,157,184,58,8,1,408,2,3,413
10,2,10012,708,3,195,235,104,8,4,546,0,6,552
10,2,10012,709,3,137,161,114,8,1,421,0,11,432
10,2,10012,710,3,188,317,108,9,4,626,0,0,626
10,2,10012,711,3,293,407,126,24,6,856,1,11,868
10,2,10012,712,3,289,266,75,9,3,642,1,15,658
10,2,10012,713,3,307,251,93,6,9,666,0,7,673
10,2,10012,714,3,275,239,71,14,8,607,1,1,609
10,2,10012,715,3,292,299,92,15,8,706,0,4,710
10,2,10012,716,3,207,197,98,5,6,513,0,9,522
10,2,10012,717,3,105,194,65,10,3,377,0,21,398
10,2,10012,718,3,217,233,101,8,7,566,1,7,574
10,2,10012,719,3,307,307,88,14,7,723,0,16,739
10,2,10012,720,3,287,355,100,16,11,769,0,13,782
10,2,10012,721,3,257,373,98,16,7,751,0,20,771
10,2,10012,722,3,387,474,139,22,4,1026,3,24,1053
10,2,10012,723,3,387,361,133,13,8,902,3,11,916
10,2,10012,724,3,213,284,135,2,1,635,1,23,659
10,2,10012,725,3,108,195,75,8,5,391,2,6,399
10,2,10012,726,3,166,235,70,13,5,489,1,8,498
10,2,10012,727,3,219,319,225,15,6,784,0,7,791
10,2,10012,728,3,74,50,88,3,2,217,0,10,227
10,2,10012,729,3,105,57,4,0,0,166,1,2,169
10,2,10012,730,3,503,290,123,3,3,922,0,27,949
10,2,10012,731,3,179,110,42,4,1,336,2,5,343
10,2,10012,732,3,243,127,107,7,6,490,1,12,503
10,2,10012,733,3,487,324,209,18,9,1047,3,19,1069
10,2,10012,734,3,219,253,38,3,3,516,2,14,532
10,2,10012,735,3,337,385,135,36,6,899,5,37,941
10,2,10012,736,3,100,149,7,1,0,257,0,11,268
10,2,10012,737,3,303,305,105,16,1,730,1,14,745
10,2,10012,738,3,354,462,166,20,2,1004,0,22,1026
10,2,10012,739,3,356,258,123,8,3,748,0,15,763
10,2,10012,740,3,90,78,59,7,0,234,0,3,237
10,2,10012,741,3,219,309,135,14,4,681,0,11,692
10,2,10012,742,3,165,265,163,7,2,602,2,18,622
10,2,10012,743,3,111,145,30,4,1,291,0,11,302
10,2,10012,744,3,110,176,98,6,2,392,0,13,405
10,2,10012,745,3,164,177,111,4,2,458,2,7,467
10,2,10012,746,3,397,209,189,18,6,819,3,14,836
10,2,10012,747,3,310,404,156,18,2,890,2,7,899
10,2,10012,748,3,236,152,132,11,5,536,3,11,550
10,2,10012,749,3,211,154,122,8,3,498,1,17,516
10,2,10012,750,3,168,148,67,14,3,400,0,6,406
10,2,10012,751,3,175,203,76,8,4,466,3,11,480
10,2,10012,752,3,176,142,75,7,8,408,2,9,419
10,2,10012,753,3,182,186,112,8,3,491,4,12,507
10,2,10012,754,3,290,311,228,52,1,882,2,28,912
10,2,10012,755,3,240,162,240,16,0,658,2,11,671
10,2,10012,756,3,298,175,160,12,3,648,0,26,674
10,2,10012,757,3,217,205,105,6,4,537,2,0,539
10,2,10012,758,3,111,24,49,5,2,191,0,6,197
10,2,10012,759,3,94,26,44,2,0,166,0,2,168
10,2,10012,760,3,306,198,197,9,2,712,1,15,728
10,2,10012,761,3,488,341,131,6,4,970,0,24,994
10,2,10012,762,3,216,175,75,1,1,468,1,10,479
10,2,10012,763,3,307,273,164,8,2,754,2,9,765
10,2,10012,764,3,323,157,55,1,1,537,0,12,549
10,2,10012,765,3,97,47,8,1,0,153,1,5,159
10,2,10012,766,3,26,12,4,1,0,43,0,1,44
10,2,10012,767,3,194,36,42,5,0,277,1,15,293
10,2,10012,768,3,33,23,24,1,0,81,0,5,86
10,3,10001,1,3,129,145,49,30,9,362,2,8,372
10,3,10001,2,3,245,161,73,36,10,525,1,16,542
10,3,10001,3,3,306,330,146,67,12,861,0,11,872
10,3,10001,4,3,151,134,59,15,7,366,3,8,377
10,3,10001,5,3,230,188,92,43,18,571,0,20,591
10,3,10001,6,3,362,257,120,56,12,807,0,23,830
10,3,10001,7,3,149,134,40,17,7,347,1,7,355
10,3,10001,8,3,108,155,62,7,5,337,0,12,349
10,3,10001,9,3,129,187,59,6,2,383,0,8,391
10,3,10001,10,3,14,83,6,1,1,105,0,2,107
10,3,10001,11,3,13,20,14,1,0,48,0,1,49
10,3,10001,12,3,20,19,10,1,1,51,0,6,57
10,3,10001,13,3,108,116,61,3,3,291,0,12,303
10,3,10001,14,3,62,90,56,1,1,210,0,1,211
10,3,10001,15,3,146,119,96,8,4,373,2,16,391
10,3,10001,16,3,78,61,6,2,2,149,2,2,153
10,3,10001,17,3,56,15,7,0,0,78,0,1,79
10,3,10001,18,3,14,17,1,0,0,32,0,1,33
10,3,10001,19,3,29,27,6,1,0,63,0,2,65
10,3,10001,20,3,78,35,23,1,1,138,0,5,143
10,3,10001,21,3,25,15,18,1,1,60,0,2,62
10,3,10001,22,3,241,138,39,18,5,441,3,7,451
10,3,10001,23,3,112,92,85,8,5,302,2,9,313
10,3,10001,24,3,51,93,45,2,1,192,0,4,196
10,3,10001,25,3,122,74,93,13,3,305,1,7,313
10,3,10001,26,3,160,146,95,5,3,409,0,11,420
10,3,10001,27,3,159,179,108,6,2,454,1,12,467
10,3,10001,28,3,97,127,89,21,1,335,0,8,343
10,3,10001,29,3,162,148,175,38,3,526,0,16,542
10,3,10001,30,3,213,172,93,11,5,494,0,12,506
10,3,10001,31,3,84,104,93,10,1,292,4,8,304
10,3,10001,32,3,79,73,18,4,3,177,0,5,182
10,3,10001,33,3,29,40,66,2,0,137,3,5,145
10,3,10001,34,3,25,29,4,1,0,59,2,2,63
10,3,10001,35,3,89,31,4,1,0,125,1,0,126
10,3,10001,36,3,6,29,5,0,0,40,0,0,40
10,3,10001,37,3,130,228,68,14,3,443,5,3,451
10,3,10001,38,3,87,100,79,4,0,270,2,4,276
10,3,10001,39,3,11,73,30,1,0,115,2,2,119
10,3,10001,40,3,98,83,28,14,0,223,1,8,232
10,3,10003,57,3,107,113,32,14,2,268,1,6,275
10,3,10003,58,3,45,66,14,0,0,125,0,1,126
10,3,10003,59,3,21,30,12,2,0,65,0,1,66
10,3,10003,60,3,31,96,26,3,2,158,0,3,161
10,3,10003,61,3,5,47,10,1,0,63,0,6,69
10,3,10003,62,3,27,56,22,2,0,107,0,2,109
10,3,10003,63,3,83,232,67,9,1,392,0,6,398
10,3,10003,64,3,22,68,35,3,0,128,0,4,132
10,3,10003,65,3,27,92,80,6,3,208,0,4,212
10,3,10004,66,3,308,289,77,48,9,731,2,13,746
10,3,10004,67,3,207,221,67,28,4,527,1,1,529
10,3,10004,68,3,223,159,45,42,3,472,1,14,487
10,3,10004,69,3,433,358,136,61,11,999,4,19,1022
10,3,10004,70,3,202,151,65,20,1,439,3,10,452
10,3,10004,72,3,79,49,30,24,1,183,2,10,195
10,3,10004,73,3,276,87,88,9,2,462,0,5,467
10,3,10004,74,3,90,27,11,5,0,133,0,4,137
10,3,10004,75,3,142,81,51,17,7,298,0,14,312
10,3,10004,76,3,162,130,66,7,9,374,1,7,382
10,3,10004,77,3,51,33,13,3,0,100,2,2,104
10,3,10004,78,3,40,126,51,11,1,229,0,8,237
10,3,10004,79,3,58,66,15,3,0,142,0,3,145
10,3,10004,80,3,315,100,61,33,3,512,2,19,533
10,3,10004,81,3,33,121,6,2,0,162,0,9,171
10,3,10004,82,3,30,63,7,6,1,107,1,7,115
10,3,10004,83,3,86,30,0,1,0,117,0,0,117
10,3,10004,84,3,62,73,9,10,2,156,1,5,162
10,3,10004,85,3,76,24,11,3,0,114,0,1,115
10,3,10004,86,3,94,44,6,2,0,146,3,2,151
10,3,10004,87,3,90,114,114,8,1,327,2,16,345
10,3,10004,88,3,19,21,6,1,0,47,0,0,47
10,3,10004,89,3,52,60,6,22,0,140,1,1,142
10,3,10004,90,3,48,19,28,4,0,99,0,3,102
10,3,10004,91,3,49,38,34,3,1,125,1,1,127
10,3,10004,92,3,15,14,1,1,1,32,2,4,38
10,3,10004,93,3,9,24,9,1,0,43,1,2,46
10,3,10004,94,3,140,130,18,12,0,300,1,18,319
10,3,10004,95,3,130,167,42,6,0,345,6,9,360
10,3,10004,96,3,103,89,23,2,0,217,2,5,224
10,3,10004,97,3,123,97,18,7,0,245,0,0,245
10,3,10004,99,3,135,150,42,64,3,394,9,22,425
10,3,10004,100,3,161,169,39,63,5,437,10,9,456
10,3,10004,101,3,98,81,35,9,3,226,1,13,240
10,3,10004,102,3,62,91,47,8,8,216,4,7,227
10,3,10004,103,3,174,86,53,5,0,318,0,17,335
10,3,10004,104,3,56,36,17,1,1,111,2,8,121
10,3,10004,105,3,153,89,73,9,8,332,3,11,346
10,3,10004,106,3,104,93,57,5,1,260,0,10,270
10,3,10004,107,3,14,48,16,6,2,86,2,6,94
10,3,10006,420,3,144,151,124,21,4,444,0,4,448
10,3,10006,421,3,14,15,9,0,1,39,0,1,40
10,3,10006,422,3,104,185,147,3,4,443,3,16,462
10,3,10006,423,3,28,36,100,0,0,164,0,1,165
10,3,10006,424,3,58,125,158,1,0,342,2,12,356
10,3,10006,425,3,42,52,39,4,0,137,0,2,139
10,3,10006,426,3,68,167,63,5,2,305,0,10,315
10,3,10006,427,3,27,86,28,1,1,143,1,6,150
10,3,10006,428,3,29,92,9,2,2,134,0,3,137
10,3,10006,429,3,87,111,58,11,2,269,2,4,275
10,3,10006,430,3,145,166,118,5,1,435,1,5,441
10,3,10006,431,3,127,145,49,11,0,332,0,5,337
10,3,10006,432,3,5,56,2,0,0,63,3,5,71
10,3,10006,433,3,21,102,6,0,1,130,0,0,130
10,3,10006,434,3,15,40,9,1,1,66,1,2,69
10,3,10006,435,3,151,145,44,7,3,350,0,4,354
10,3,10008,612,3,256,213,212,21,3,705,2,20,727
10,3,10008,613,3,170,183,215,12,1,581,0,21,602
10,3,10008,614,3,174,248,314,27,6,769,2,17,788
10,3,10008,615,3,257,171,202,24,5,659,2,14,675
10,3,10008,616,3,183,273,170,32,7,665,1,13,679
10,3,10008,617,3,128,129,194,28,1,480,1,6,487
10,3,10008,618,3,147,124,148,26,7,452,3,4,459
10,3,10008,619,3,154,202,215,30,5,606,0,17,623
10,3,10008,620,3,175,191,194,8,1,569,0,4,573
10,3,10008,621,3,205,215,202,21,3,646,5,26,677
10,3,10008,622,3,140,123,56,4,3,326,2,12,340
10,3,10008,623,3,4,36,11,4,0,55,0,2,57
10,3,10008,624,3,173,91,117,13,0,394,1,10,405
10,3,10008,625,3,268,134,116,7,7,532,5,12,549
10,3,10008,626,3,34,72,91,1,1,199,0,9,208
10,3,10008,627,3,62,104,47,3,2,218,2,7,227
10,3,10008,628,3,191,168,179,36,0,574,1,10,585
10,3,10008,629,3,264,188,94,18,5,569,0,16,585
10,3,10008,630,3,191,441,144,18,3,797,1,7,805
10,3,10008,631,3,89,70,51,3,0,213,0,5,218
10,3,10008,632,3,92,102,197,9,3,403,0,13,416
10,3,10008,633,3,83,80,237,4,2,406,1,13,420
10,3,10008,634,3,112,64,283,5,2,466,2,23,491
10,3,10008,635,3,164,149,130,17,4,464,3,14,481
10,3,10008,636,3,201,238,187,32,9,667,87,29,783
10,3,10008,637,3,36,61,69,4,0,170,0,0,170
10,3,10010,664,3,147,153,17,2,1,320,0,4,324
10,3,10010,665,3,12,29,3,0,1,45,0,2,47
10,3,10010,666,3,65,67,2,0,0,134,0,3,137
10,3,10010,667,3,150,46,6,12,1,215,0,4,219
10,3,10010,668,3,216,190,22,13,2,443,0,13,456
10,3,10010,669,3,36,27,5,0,1,69,0,1,70
10,3,10010,670,3,132,124,11,3,0,270,0,4,274
10,3,10010,671,3,159,106,31,5,0,301,0,3,304
10,3,10011,672,3,120,45,4,7,2,178,0,0,178
10,3,10011,673,3,79,26,3,5,0,113,0,3,116
10,3,10011,674,3,81,46,10,3,0,140,2,0,142
10,3,10011,675,3,79,51,9,2,2,143,0,1,144
10,3,10011,676,3,23,25,11,4,1,64,0,2,66
10,3,10011,677,3,32,21,3,2,2,60,0,0,60
10,3,10011,678,3,131,83,27,5,1,247,2,8,257
10,3,10011,679,3,47,52,14,2,2,117,0,0,117
10,3,10011,680,3,23,45,2,4,0,74,0,0,74
10,3,10011,681,3,68,42,5,8,2,125,0,7,132
10,3,10011,682,3,14,38,2,1,0,55,0,2,57
10,3,10011,683,3,54,49,3,3,1,110,0,3,113
10,3,10011,684,3,98,85,11,1,0,195,0,6,201
10,3,10011,685,3,24,72,20,2,1,119,1,3,123
10,3,10011,686,3,106,46,31,4,1,188,0,0,188
10,3,10011,687,3,74,85,19,6,3,187,0,9,196
10,3,10011,688,3,28,29,23,0,0,80,0,3,83
10,3,10013,769,3,491,317,115,17,9,949,2,20,971
10,3,10013,770,3,179,175,55,15,7,431,1,4,436
10,3,10013,771,3,174,159,62,14,1,410,0,4,414
10,3,10013,772,3,34,65,37,1,1,138,0,9,147
10,3,10013,773,3,28,59,13,1,4,105,0,4,109
10,3,10013,774,3,20,45,5,0,0,70,0,5,75
10,3,10013,775,3,4,34,5,0,0,43,0,3,46
10,3,10013,776,3,2,18,5,0,0,25,0,0,25
10,3,10013,777,3,158,196,153,2,4,513,0,11,524
10,3,10013,778,3,140,158,140,10,4,452,2,10,464
10,3,10013,780,3,66,43,192,2,7,310,1,12,323
10,3,10013,781,3,25,26,13,4,0,68,0,3,71
10,3,10013,782,3,56,25,21,0,1,103,1,12,116
10,3,10013,783,3,67,17,20,0,1,105,2,2,109
10,3,10013,785,3,110,70,101,4,2,287,0,10,297
10,3,10013,786,3,147,118,172,4,3,444,2,4,450
10,3,10013,787,3,97,92,109,6,0,304,1,16,321
10,3,10013,788,3,327,251,241,17,7,843,2,11,856
10,3,10013,789,3,234,159,129,12,5,539,1,8,548
10,3,10013,790,3,107,144,142,5,3,401,0,14,415
10,3,10013,791,3,120,68,116,12,4,320,0,4,324
10,3,10013,792,3,81,189,264,3,5,542,3,14,559
10,3,10013,793,3,188,21,30,2,2,243,0,6,249
10,3,10013,794,3,62,23,5,0,0,90,0,0,90
10,3,10013,795,3,31,40,37,2,3,113,0,3,116
10,3,10015,828,3,149,139,98,16,5,407,0,11,418
10,3,10015,829,3,83,114,140,4,7,348,0,15,363
10,3,10015,830,3,144,132,75,7,2,360,2,5,367
10,3,10015,831,3,136,150,75,6,3,370,1,17,388
10,3,10015,832,3,52,56,58,5,3,174,0,3,177
10,3,10015,833,3,96,87,142,12,0,337,0,9,346
10,3,10015,834,3,144,52,129,10,2,337,2,7,346
10,3,10015,835,3,72,66,109,6,1,254,0,0,254
10,3,10015,836,3,61,37,133,2,1,234,0,6,240
10,3,10015,837,3,84,82,135,3,0,304,0,0,304
10,3,10015,838,3,96,57,92,3,2,250,1,2,253
10,3,10015,839,3,158,194,229,8,3,592,1,14,607
10,3,10015,840,3,58,137,140,11,2,348,2,6,356
10,3,10015,841,3,26,49,47,1,1,124,0,1,125
10,3,10015,842,3,46,80,72,4,1,203,0,14,217
10,3,10015,843,3,24,41,23,1,0,89,0,1,90
10,3,10015,844,3,30,45,54,1,2,132,0,3,135
10,3,10016,845,3,120,180,101,42,8,451,2,11,464
10,3,10016,846,3,169,305,203,41,19,737,0,13,750
10,3,10016,847,3,100,158,169,10,6,443,0,15,458
10,3,10016,848,3,103,148,65,26,2,344,1,22,367
10,3,10016,849,3,195,61,50,9,2,317,5,14,336
10,3,10016,850,3,275,156,92,18,3,544,14,14,572
10,3,10016,851,3,186,100,100,11,3,400,3,9,412
10,3,10016,852,3,21,69,23,1,0,114,0,3,117
10,3,10016,853,3,41,34,19,2,2,98,0,2,100
10,3,10016,854,3,60,53,28,0,1,142,6,0,148
10,3,10016,855,3,120,74,51,16,2,263,4,9,276
10,3,10016,856,3,69,78,73,0,0,220,0,14,234
10,3,10016,857,3,190,185,174,7,4,560,0,19,579
10,3,10016,858,3,7,29,8,0,0,44,0,0,44
10,3,10016,859,3,18,14,8,3,0,43,0,0,43
10,3,10016,860,3,189,127,70,4,5,395,3,4,402
10,3,10016,861,3,211,153,90,22,5,481,7,7,495
10,3,10016,862,3,40,58,9,0,1,108,4,2,114
10,3,10016,863,3,128,99,45,14,0,286,2,11,299
10,3,10016,864,3,76,78,21,3,2,180,6,8,194
10,3,10016,865,3,66,30,43,4,1,144,0,12,156
10,3,10017,866,3,208,276,91,29,9,613,1,18,632
10,3,10017,867,3,114,128,37,15,3,297,0,4,301
10,3,10017,868,3,232,177,74,31,7,521,1,17,539
10,3,10017,869,3,292,226,70,37,4,629,0,10,639
10,3,10017,870,3,146,152,66,26,5,395,1,24,420
10,3,10017,871,3,110,104,53,13,4,284,1,7,292
10,3,10017,872,3,83,77,15,2,0,177,0,9,186
10,3,10017,873,3,44,52,34,4,2,136,0,5,141
10,3,10017,874,3,110,132,16,11,7,276,0,11,287
10,3,10017,875,3,76,124,17,4,0,221,0,9,230
10,3,10017,876,3,49,61,8,8,0,126,0,0,126
10,3,10017,877,3,64,85,20,3,1,173,2,5,180
10,3,10017,878,3,31,87,4,2,1,125,2,4,131
10,3,10017,879,3,94,125,18,14,0,251,0,4,255
10,3,10017,880,3,98,72,26,1,1,198,0,12,210
10,3,10017,881,3,188,180,47,17,5,437,1,2,440
10,3,10017,882,3,85,161,40,9,1,296,0,12,308
10,3,10017,883,3,33,40,4,1,0,78,0,2,80
10,3,10017,884,3,51,53,10,0,0,114,0,6,120
10,3,10017,885,3,24,78,7,3,0,112,1,6,119
10,3,10017,886,3,79,73,15,3,1,171,0,2,173
10,3,10017,887,3,69,101,32,6,4,212,0,4,216
10,3,10017,888,3,171,73,11,4,0,259,0,6,265
10,3,10017,889,3,146,158,154,0,5,463,0,7,470
10,3,10017,890,3,119,150,13,2,2,286,0,5,291
10,3,10017,891,3,200,194,59,22,3,478,0,16,494
10,3,10017,892,3,11,16,20,3,0,50,0,3,53
10,3,10017,893,3,23,44,6,3,0,76,0,1,77
10,3,10017,894,3,84,114,13,2,1,214,3,14,231
10,3,10018,895,3,120,325,46,36,2,529,2,10,541
10,3,10018,896,3,13,47,3,0,0,63,0,3,66
10,3,10018,897,3,37,72,3,1,0,113,0,6,119
10,3,10018,898,3,43,57,2,0,0,102,0,6,108
10,3,10018,899,3,91,92,2,2,0,187,0,9,196
10,3,10018,900,3,20,33,1,1,0,55,1,0,56
10,3,10018,901,3,18,58,0,2,1,79,0,1,80
10,3,10018,902,3,110,211,9,1,1,332,0,16,348
10,3,10018,903,3,18,36,3,1,0,58,0,2,60
10,3,10018,904,3,24,121,8,1,0,154,0,0,154
10,3,10018,905,3,37,36,11,7,0,91,0,4,95
10,3,10018,906,3,141,123,50,20,2,336,1,13,350
10,3,10018,907,3,139,118,31,24,1,313,0,8,321
10,3,10018,908,3,145,132,55,16,4,352,0,10,362
10,3,10018,909,3,142,131,34,8,0,315,0,5,320
10,3,10018,910,3,182,157,38,13,2,392,0,6,398
10,3,10018,911,3,237,114,8,6,2,367,1,4,372
10,3,10018,912,3,18,60,6,1,1,86,0,6,92
10,3,10018,913,3,61,64,23,24,1,173,0,7,180
10,3,10019,914,3,114,119,36,59,1,329,0,5,334
10,3,10019,915,3,167,141,58,47,4,417,0,8,425
10,3,10019,916,3,231,175,58,94,8,566,0,11,577
10,3,10019,917,3,193,291,80,81,3,648,0,7,655
10,3,10019,918,3,49,9,2,5,0,65,0,3,68
10,3,10019,919,3,46,48,18,9,0,121,3,1,125
10,3,10019,920,3,27,11,0,1,0,39,0,1,40
10,3,10019,921,3,33,7,3,1,0,44,0,0,44
10,3,10019,922,3,27,16,7,1,0,51,0,2,53
10,3,10019,923,3,22,61,8,2,2,95,0,2,97
10,3,10019,924,3,14,47,10,1,0,72,0,0,72
10,3,10019,925,3,13,10,1,1,0,25,0,0,25
10,3,10019,926,3,32,8,1,1,0,42,0,0,42
10,3,10019,927,3,25,15,5,0,1,46,0,3,49
10,3,10019,928,3,59,20,8,1,0,88,0,2,90
10,3,10019,929,3,6,59,5,0,0,70,0,2,72
10,3,10019,930,3,35,18,2,1,0,56,0,1,57
10,3,10019,931,3,30,18,4,2,1,55,0,1,56
10,3,10019,932,3,21,42,7,0,1,71,0,0,71
10,3,10019,933,3,120,15,14,0,1,150,0,0,150
10,3,10019,934,3,91,49,7,0,1,148,0,7,155
10,3,10019,935,3,29,101,1,5,3,139,2,2,143
10,3,10019,936,3,61,32,2,3,0,98,0,1,99
10,3,10019,937,3,203,84,29,14,1,331,0,3,334
10,3,10019,938,3,22,9,8,0,0,39,0,4,43
10,3,10019,939,3,44,94,22,5,2,167,0,9,176
10,3,10019,940,3,38,35,12,0,1,86,0,1,87
10,3,10019,941,3,23,19,8,2,0,52,1,0,53
10,3,10019,942,3,100,33,18,4,1,156,0,3,159
10,3,10019,943,3,82,48,4,2,0,136,0,5,141
10,3,10019,944,3,12,37,3,1,0,53,0,0,53
10,3,10019,945,3,13,51,7,3,1,75,0,2,77
10,3,10019,946,3,114,77,28,12,0,231,0,5,236
10,3,10021,961,3,167,146,85,52,2,452,1,13,466
10,3,10021,962,3,173,143,69,40,6,431,0,2,433
10,3,10021,963,3,189,198,68,61,1,517,1,13,531
10,3,10021,964,3,71,138,105,22,2,338,3,10,351
10,3,10021,965,3,102,135,56,26,3,322,5,7,334
10,3,10021,966,3,53,69,17,4,1,144,0,4,148
10,3,10021,967,3,124,154,56,25,3,362,0,8,370
10,3,10021,968,3,32,219,37,5,1,294,2,15,311
10,3,10021,969,3,67,126,54,4,3,254,0,10,264
10,3,10021,970,3,40,70,23,3,0,136,4,7,147
10,3,10021,971,3,143,125,29,9,2,308,0,9,317
10,3,10021,972,3,48,132,150,4,4,338,11,5,354
10,3,10021,973,3,57,131,22,4,3,217,0,10,227
10,3,10021,974,3,32,88,47,3,1,171,0,2,173
10,3,10021,975,3,10,59,110,1,0,180,0,2,182
10,3,10021,976,3,4,88,29,0,0,121,0,2,123
10,3,10022,977,3,167,139,89,41,0,436,0,11,447
10,3,10022,978,3,192,111,103,22,2,430,1,8,439
10,3,10022,979,3,176,110,94,30,8,418,1,14,433
10,3,10022,980,3,217,305,116,81,7,726,2,23,751
10,3,10022,981,3,42,18,5,4,0,69,0,5,74
10,3,10022,982,3,42,31,11,5,0,89,0,1,90
10,3,10022,983,3,37,63,57,6,2,165,0,7,172
10,3,10022,985,3,14,121,100,12,1,248,0,6,254
10,3,10022,986,3,106,61,76,6,0,249,6,10,265
10,3,10022,987,3,22,32,7,1,0,62,0,1,63
10,3,10022,988,3,19,16,40,6,1,82,0,3,85
10,3,10022,989,3,127,113,88,14,1,343,0,9,352
10,3,10022,990,3,174,104,71,17,0,366,1,7,374
10,3,10022,991,3,153,93,27,20,0,293,4,5,302
10,3,10023,992,3,194,159,86,27,3,469,1,11,481
10,3,10023,993,3,252,337,208,84,6,887,0,24,911
10,3,10023,994,3,184,250,158,62,2,656,8,14,678
10,3,10023,995,3,350,281,177,86,11,905,6,19,930
10,3,10023,996,3,153,226,141,28,4,552,0,7,559
10,3,10023,997,3,79,115,135,11,1,341,4,9,354
10,3,10023,998,3,54,113,36,3,2,208,3,7,218
10,3,10023,999,3,75,87,52,12,4,230,0,11,241
10,3,10023,1000,3,182,158,99,23,5,467,3,11,481
10,3,10023,1001,3,99,158,50,14,2,323,3,13,339
10,3,10023,1002,3,106,77,55,6,1,245,0,8,253
10,3,10023,1003,3,209,176,390,6,3,784,9,2,795
10,3,10023,1004,3,111,114,138,27,5,395,1,12,408
10,3,10023,1005,3,109,97,139,15,3,363,0,6,369
10,3,10023,1006,3,61,153,81,7,7,309,1,10,320
10,3,10023,1007,3,59,127,33,6,0,225,0,7,232
10,3,10023,1008,3,45,245,35,7,1,333,1,6,340
10,3,10023,1009,3,76,99,71,3,1,250,0,4,254
10,3,10023,1010,3,177,172,115,10,9,483,5,21,509
10,3,10023,1011,3,58,34,24,2,1,119,2,5,126
10,3,10023,1012,3,66,79,46,25,2,218,2,5,225
10,3,10023,1013,3,157,51,77,7,2,294,2,2,298
10,3,10023,1014,3,214,84,66,6,1,371,6,10,387
10,3,10025,1063,3,257,175,97,35,6,570,0,10,580
10,3,10025,1064,3,209,194,84,28,2,517,0,5,522
10,3,10025,1065,3,156,167,93,31,4,451,0,10,461
10,3,10025,1066,3,44,34,24,6,0,108,0,5,113
10,3,10025,1067,3,49,28,11,2,0,90,0,0,90
10,3,10025,1068,3,189,219,64,20,2,494,1,16,511
10,3,10025,1069,3,59,48,16,2,0,125,1,4,130
10,3,10025,1070,3,70,57,30,17,2,176,3,3,182
10,3,10025,1071,3,145,67,30,8,1,251,0,3,254
10,3,10025,1072,3,33,21,3,0,2,59,0,0,59
10,3,10025,1073,3,6,29,9,2,0,46,0,0,46
10,3,10025,1074,3,32,32,9,0,1,74,0,1,75
10,3,10025,1075,3,32,79,29,3,1,144,0,7,151
10,3,10025,1076,3,6,23,10,0,0,39,0,0,39
10,3,10025,1077,3,25,71,14,2,1,113,0,5,118
10,3,10025,1078,3,29,28,60,1,0,118,1,5,124
10,3,10025,1079,3,15,52,61,1,0,129,0,3,132
10,3,10025,1080,3,120,57,57,7,1,242,4,4,250
10,3,10025,1081,3,121,59,13,4,0,197,1,6,204
10,3,10025,1082,3,88,79,26,8,1,202,1,2,205
10,3,10025,1083,3,87,112,64,8,2,273,0,1,274
10,3,10025,1084,3,21,46,1,2,0,70,0,2,72
10,3,10025,1085,3,3,25,1,5,0,34,0,1,35
10,3,10026,1086,3,83,207,44,31,3,368,0,14,382
10,3,10026,1087,3,24,72,4,1,0,101,1,1,103
10,3,10026,1088,3,21,89,8,1,0,119,1,0,120
10,3,10026,1089,3,43,54,1,3,0,101,0,8,109
10,3,10026,1090,3,17,48,4,2,0,71,0,5,76
10,3,10026,1091,3,23,25,9,0,2,59,0,1,60
10,3,10026,1092,3,45,79,39,4,2,169,0,1,170
10,3,10026,1093,3,40,32,3,1,0,76,0,3,79
10,3,10026,1094,3,70,49,14,10,0,143,0,5,148
10,3,10026,1095,3,36,36,6,0,0,78,0,1,79
10,3,10026,1096,3,31,75,4,47,1,158,0,13,171
10,3,10026,1097,3,25,71,16,4,1,117,1,4,122
10,3,10028,1140,3,154,66,11,2,1,234,0,9,243
10,3,10028,1141,3,237,100,18,3,2,360,1,18,379
10,3,10028,1142,3,9,45,4,0,2,60,0,1,61
10,3,10028,1143,3,63,31,16,0,1,111,0,0,111
10,3,10028,1144,3,32,22,15,3,1,73,1,2,76
10,3,10028,1145,3,35,53,11,1,0,100,0,3,103
10,3,10028,1146,3,26,10,3,0,0,39,0,4,43
10,3,10028,1147,3,59,79,43,2,1,184,4,5,193
10,3,10028,1148,3,46,78,5,0,1,130,0,0,130
10,3,10028,1149,3,21,47,6,0,0,74,0,3,77
10,3,10028,1150,3,98,24,6,0,1,129,0,3,132
10,3,10028,1151,3,90,131,5,0,1,227,0,11,238
10,3,10028,1152,3,45,14,38,0,0,97,0,8,105
10,3,10028,1153,3,23,7,2,1,1,34,0,8,42
10,3,10028,1154,3,55,20,2,0,0,77,0,0,77
10,3,10028,1155,3,17,19,2,0,0,38,6,2,46
10,3,10029,1156,3,143,216,49,35,0,443,0,14,457
10,3,10029,1157,3,160,179,61,16,3,419,3,24,446
10,3,10029,1158,3,134,152,32,22,2,342,0,15,357
10,3,10029,1159,3,8,66,12,4,0,90,0,1,91
10,3,10029,1160,3,132,134,25,3,0,294,3,6,303
10,3,10029,1161,3,69,132,8,4,0,213,0,5,218
10,3,10029,1162,3,20,89,9,5,0,123,0,0,123
10,3,10029,1163,3,73,40,10,5,4,132,0,9,141
10,3,10029,1164,3,23,64,13,1,1,102,0,0,102
10,3,10029,1165,3,21,87,1,2,0,111,0,2,113
10,3,10029,1166,3,45,25,20,19,2,111,0,8,119
10,3,10029,1167,3,66,134,22,12,1,235,0,20,255
10,3,10029,1168,3,44,57,10,4,1,116,0,6,122
10,3,10029,1169,3,133,167,42,17,6,365,0,13,378
10,3,10029,1170,3,29,48,7,2,1,87,0,4,91
10,3,10029,1171,3,125,97,42,21,1,286,0,5,291
10,3,10029,1172,3,87,110,38,10,3,248,0,11,259
10,3,10029,1173,3,36,112,8,12,2,170,0,14,184
10,3,10029,1174,3,51,99,12,12,2,176,0,18,194
10,3,10029,1175,3,26,65,4,0,0,95,0,4,99
10,3,10029,1176,3,17,54,6,6,1,84,0,3,87
10,3,10029,1177,3,15,44,9,3,0,71,1,0,72
10,3,10029,1178,3,4,47,5,2,0,58,0,1,59
10,3,10030,1179,3,87,123,9,1,0,220,0,3,223
10,3,10030,1180,3,124,109,12,8,0,253,0,4,257
10,3,10030,1181,3,120,78,6,5,0,209,0,4,213
10,3,10030,1182,3,70,146,2,4,0,222,0,3,225
10,3,10031,1183,3,103,118,33,1,0,255,0,4,259
10,3,10031,1184,3,48,12,16,2,0,78,0,8,86
10,3,10031,1185,3,13,22,3,0,0,38,0,1,39
10,3,10031,1186,3,26,22,2,1,0,51,0,1,52
10,3,10031,1187,3,34,57,9,4,0,104,0,6,110
10,3,10031,1188,3,21,32,5,1,0,59,0,0,59
10,3,10031,1189,3,18,20,0,1,0,39,0,1,40
10,3,10031,1190,3,17,36,25,0,0,78,0,0,78
10,3,10032,1191,3,141,65,60,9,1,276,0,13,289
10,3,10032,1192,3,345,168,75,11,5,604,0,21,625
10,3,10032,1193,3,182,140,54,17,4,397,0,4,401
10,3,10032,1194,3,132,84,36,5,3,260,1,4,265
10,3,10032,1195,3,43,57,44,0,0,144,0,8,152
10,3,10032,1196,3,5,25,10,1,0,41,0,0,41
10,3,10032,1197,3,92,153,97,11,3,356,3,7,366
10,3,10032,1198,3,48,128,49,0,1,226,0,8,234
10,3,10032,1199,3,161,111,80,5,0,357,2,12,371
10,3,10037,1333,3,194,140,195,24,5,558,1,7,566
10,3,10037,1334,3,125,115,149,6,3,398,2,2,402
10,3,10037,1335,3,172,131,202,18,5,528,0,15,543
10,3,10037,1336,3,100,104,124,11,3,342,1,2,345
10,3,10037,1337,3,82,104,165,19,2,372,0,3,375
10,3,10037,1338,3,101,105,129,17,5,357,0,0,357
10,3,10037,1339,3,97,102,165,8,5,377,1,10,388
10,3,10037,1340,3,73,82,154,1,2,312,0,5,317
10,3,10037,1341,3,75,82,127,34,3,321,0,6,327
10,3,10037,1342,3,31,44,45,5,1,126,0,3,129
10,3,10037,1343,3,4,7,24,1,1,37,0,1,38
10,3,10037,1344,3,27,21,138,2,1,189,0,1,190
10,3,10037,1345,3,24,20,8,0,0,52,0,3,55
10,3,10037,1346,3,25,60,101,8,1,195,0,3,198
10,3,10037,1347,3,64,133,249,10,1,457,0,6,463
10,3,10037,1348,3,9,35,14,0,0,58,0,1,59
10,3,10037,1349,3,56,33,83,5,2,179,1,3,183
10,3,10037,1350,3,23,27,31,2,0,83,0,11,94
10,3,10037,1351,3,5,40,3,0,0,48,0,3,51
10,3,10037,1352,3,87,97,94,18,2,298,1,12,311
10,3,10037,1353,3,136,262,216,36,8,658,2,7,667
10,3,10037,1354,3,98,137,145,45,3,428,5,12,445
10,3,10037,1355,3,19,43,47,10,1,120,0,0,120
10,3,10037,1356,3,58,22,24,4,0,108,0,0,108
10,3,10037,1357,3,102,134,268,37,3,544,0,11,555
10,3,10037,1358,3,157,112,195,45,8,517,0,14,531
10,3,10037,1359,3,92,210,164,10,7,483,2,10,495
10,3,10039,1374,3,205,169,90,21,7,492,3,13,508
10,3,10039,1375,3,210,267,83,25,10,595,2,18,615
10,3,10039,1376,3,155,191,88,50,7,491,2,7,500
10,3,10039,1377,3,326,171,56,26,2,581,1,5,587
10,3,10039,1378,3,195,109,34,12,5,355,3,9,367
10,3,10039,1379,3,190,123,63,25,6,407,4,10,421
10,3,10039,1380,3,265,158,59,25,6,513,2,12,527
10,3,10039,1381,3,158,176,126,42,8,510,3,11,524
10,3,10039,1382,3,141,155,67,14,8,385,8,14,407
10,3,10039,1383,3,246,182,82,25,6,541,3,9,553
10,3,10039,1384,3,175,191,102,16,9,493,1,10,504
10,3,10039,1385,3,79,171,78,9,2,339,2,9,350
10,3,10039,1386,3,56,101,20,3,1,181,3,0,184
10,3,10039,1387,3,194,305,98,10,6,613,3,9,625
10,3,10039,1388,3,43,22,9,2,0,76,0,4,80
10,3,10039,1389,3,76,58,28,3,0,165,0,10,175
10,3,10039,1390,3,106,83,37,4,0,230,4,6,240
10,4,10005,108,3,1021,412,354,109,17,1913,1,19,1933
10,4,10005,109,3,253,230,83,38,11,615,0,11,626
10,4,10005,110,3,2390,1983,769,274,74,5490,25,73,5588
10,4,10005,111,3,1185,913,422,181,36,2737,13,51,2801
10,4,10005,112,3,224,171,82,24,5,506,0,10,516
10,4,10005,113,3,208,190,97,27,8,530,2,5,537
10,4,10005,114,3,330,231,92,34,10,697,12,8,717
10,4,10005,115,3,256,151,91,51,8,557,0,5,562
10,4,10005,116,3,179,170,81,24,2,456,1,6,463
10,4,10005,117,3,290,211,93,39,7,640,2,10,652
10,4,10005,121,3,121,129,71,18,4,343,6,8,357
10,4,10005,122,3,90,112,133,11,6,352,0,11,363
10,4,10005,124,3,208,196,154,19,10,587,3,19,609
10,4,10005,126,3,222,191,147,28,6,594,14,27,635
10,4,10005,127,3,181,227,104,21,5,538,2,39,579
10,4,10005,128,3,409,698,224,36,9,1376,20,49,1445
10,4,10005,129,3,280,395,123,31,6,835,2,19,856
10,4,10005,136,3,350,372,118,40,11,891,11,26,928
10,4,10005,137,3,589,512,169,69,8,1347,3,15,1365
10,4,10005,138,3,325,288,130,37,6,786,1,8,795
10,4,10005,139,3,368,311,169,52,14,914,0,11,925
10,4,10005,140,3,308,183,115,21,5,632,1,11,644
10,4,10005,141,3,467,205,135,30,10,847,0,11,858
10,4,10005,142,3,634,279,114,41,9,1077,1,10,1088
10,4,10005,143,3,330,239,130,35,13,747,4,15,766
10,4,10005,144,3,404,281,169,47,11,912,1,11,924
10,4,10005,145,3,512,368,131,41,6,1058,2,16,1076
10,4,10005,146,3,838,460,231,87,24,1640,1,32,1673
10,4,10005,147,3,620,420,280,87,9,1416,0,18,1434
10,4,10005,148,3,658,473,253,69,27,1480,13,20,1513
10,4,10005,149,3,303,250,96,38,5,692,0,6,698
10,4,10005,150,3,280,272,205,32,10,799,4,16,819
10,4,10005,151,3,387,237,112,38,7,781,4,4,789
10,4,10005,152,3,627,272,111,29,7,1046,1,7,1054
10,4,10005,153,3,214,152,87,17,1,471,2,13,486
10,4,10005,154,3,368,218,142,42,7,777,0,9,786
10,4,10005,155,3,363,263,231,45,13,915,8,18,941
10,4,10005,156,3,200,294,141,25,6,666,8,19,693
10,4,10005,157,3,370,330,170,48,7,925,5,24,954
10,4,10005,158,3,255,151,104,21,7,538,2,11,551
10,4,10005,159,3,304,200,86,31,4,625,5,21,651
10,4,10005,160,3,221,169,75,14,2,481,3,8,492
10,4,10005,161,3,368,309,116,28,4,825,6,11,842
10,4,10005,162,3,405,344,126,27,6,908,9,22,939
10,4,10005,169,3,352,232,112,43,7,746,4,19,769
10,4,10005,170,3,404,290,111,27,6,838,2,15,855
10,4,10005,171,3,197,285,95,31,20,628,5,4,637
10,4,10005,172,3,276,249,175,33,6,739,0,20,759
10,4,10005,173,3,350,251,168,41,5,815,0,14,829
10,4,10005,174,3,207,148,62,18,8,443,3,6,452
10,4,10005,175,3,223,170,83,16,2,494,2,13,509
10,4,10005,176,3,265,263,133,33,5,699,2,14,715
10,4,10005,177,3,208,142,151,10,6,517,2,32,551
10,4,10005,178,3,196,247,221,18,5,687,2,18,707
10,4,10005,179,3,195,182,144,12,4,537,2,18,557
10,4,10005,180,3,168,204,143,12,13,540,4,15,559
10,4,10005,181,3,342,239,154,41,14,790,2,7,799
10,4,10005,182,3,241,194,70,13,8,526,2,6,534
10,4,10005,183,3,240,136,63,14,6,459,2,10,471
10,4,10005,184,3,364,164,106,33,7,674,4,20,698
10,4,10005,185,3,383,140,77,29,6,635,0,14,649
10,4,10005,186,3,228,84,59,8,8,387,0,3,390
10,4,10005,187,3,249,182,81,29,3,544,4,12,560
10,4,10005,188,3,499,227,129,22,3,880,4,15,899
10,4,10005,189,3,253,129,75,21,4,482,0,7,489
10,4,10005,190,3,269,155,85,21,5,535,3,4,542
10,4,10005,191,3,314,143,100,21,10,588,1,7,596
10,4,10005,192,3,345,187,73,21,4,630,2,6,638
10,4,10005,193,3,198,96,55,23,1,373,3,13,389
10,4,10005,194,3,349,179,114,32,9,683,6,7,696
10,4,10005,195,3,381,232,122,44,10,789,0,12,801
10,4,10005,196,3,231,155,55,35,1,477,1,8,486
10,4,10005,197,3,276,159,98,25,6,564,2,18,584
10,4,10005,202,3,514,343,133,51,11,1052,2,21,1075
10,4,10005,203,3,380,182,108,41,6,717,1,5,723
10,4,10005,205,3,303,168,67,20,12,570,0,12,582
10,4,10005,206,3,340,98,67,22,3,530,1,6,537
10,4,10005,207,3,210,99,72,12,3,396,0,11,407
10,4,10005,208,3,332,137,99,27,8,603,1,8,612
10,4,10005,209,3,274,131,73,11,11,500,0,5,505
10,4,10005,210,3,340,174,120,25,7,666,3,6,675
10,4,10005,211,3,315,148,86,25,8,582,1,2,585
10,4,10005,212,3,311,127,69,13,12,532,2,3,537
10,4,10005,213,3,296,165,95,12,7,575,1,7,583
10,4,10005,214,3,214,127,59,10,4,414,0,6,420
10,4,10005,215,3,301,140,75,29,3,548,2,7,557
10,4,10005,216,3,265,88,43,11,5,412,0,4,416
10,4,10005,217,3,378,122,71,11,5,587,0,5,592
10,4,10005,218,3,590,454,199,125,19,1387,1,15,1403
10,4,10005,219,3,52,42,19,9,2,124,0,0,124
10,4,10005,220,3,88,158,42,10,3,301,2,7,310
10,4,10005,221,3,121,132,45,13,5,316,0,14,330
10,4,10005,222,3,291,223,95,28,13,650,1,13,664
10,4,10005,223,3,332,264,98,31,8,733,1,20,754
10,4,10005,224,3,466,257,126,38,4,891,1,18,910
10,4,10005,225,3,454,240,142,30,10,876,1,23,900
10,4,10005,226,3,248,121,75,19,3,466,3,10,479
10,4,10005,227,3,421,240,128,22,5,816,3,5,824
10,4,10005,228,3,430,193,108,26,3,760,1,11,772
10,4,10005,229,3,242,116,52,15,2,427,0,9,436
10,4,10005,230,3,231,99,51,11,1,393,0,7,400
10,4,10005,231,3,266,94,79,14,6,459,0,11,470
10,4,10005,232,3,190,102,55,16,0,363,1,4,368
10,4,10005,233,3,288,109,44,14,4,459,0,3,462
10,4,10005,234,3,252,93,48,7,4,404,2,4,410
10,4,10005,235,3,207,93,31,7,2,340,0,2,342
10,4,10005,236,3,345,128,87,8,6,574,0,6,580
10,4,10005,237,3,572,213,126,16,3,930,0,7,937
10,4,10005,238,3,508,252,172,34,7,973,2,4,979
10,4,10005,239,3,342,172,100,27,8,649,0,5,654
10,4,10005,240,3,345,147,47,12,6,557,0,14,571
10,4,10005,241,3,174,108,56,18,1,357,1,6,364
10,4,10005,242,3,289,155,85,20,1,550,0,8,558
10,4,10005,243,3,407,240,93,20,11,771,1,6,778
10,4,10005,244,3,164,131,68,9,7,379,1,3,383
10,4,10005,245,3,295,181,72,13,4,565,5,4,574
10,4,10005,246,3,145,111,40,18,1,315,2,4,321
10,4,10005,247,3,422,329,139,37,10,937,1,13,951
10,4,10005,248,3,377,223,156,31,20,807,6,10,823
10,4,10005,249,3,412,424,198,89,11,1134,0,20,1154
10,4,10005,250,3,154,157,92,11,6,420,2,13,435
10,4,10005,251,3,142,150,72,17,10,391,1,14,406
10,4,10005,252,3,228,238,114,25,15,620,3,18,641
10,4,10005,253,3,320,294,91,29,14,748,11,31,790
10,4,10005,254,3,242,292,134,19,18,705,2,20,727
10,4,10005,255,3,364,329,143,24,6,866,5,27,898
10,4,10005,256,3,369,318,108,30,7,832,0,9,841
10,4,10005,257,3,260,231,82,29,11,613,5,11,629
10,4,10005,258,3,325,268,87,28,9,717,2,11,730
10,4,10005,259,3,224,243,79,16,5,567,2,11,580
10,4,10005,260,3,320,251,118,21,17,727,4,26,757
10,4,10005,261,3,261,185,100,24,5,575,1,13,589
10,4,10005,262,3,329,311,225,43,14,922,3,16,941
10,4,10005,263,3,197,169,68,9,4,447,0,4,451
10,4,10005,264,3,220,168,85,18,7,498,1,6,505
10,4,10005,265,3,222,114,48,18,8,410,1,6,417
10,4,10005,266,3,238,104,85,19,8,454,1,11,466
10,4,10005,267,3,246,139,74,17,3,479,3,5,487
10,4,10005,268,3,210,127,52,10,5,404,0,11,415
10,4,10005,269,3,344,232,125,30,5,736,2,9,747
10,4,10005,270,3,489,250,105,43,6,893,0,21,914
10,4,10005,271,3,515,296,165,43,3,1022,0,13,1035
10,4,10005,272,3,203,175,93,25,5,501,4,12,517
10,4,10005,273,3,274,201,87,17,1,580,1,18,599
10,4,10005,274,3,218,186,72,16,6,498,0,11,509
10,4,10005,275,3,343,292,94,27,11,767,2,14,783
10,4,10005,276,3,1014,825,375,116,22,2352,3,27,2382
10,4,10005,277,3,138,141,61,14,8,362,3,10,375
10,4,10005,278,3,186,220,142,10,6,564,11,18,593
10,4,10005,279,3,176,201,83,13,10,483,2,9,494
10,4,10005,280,3,173,206,64,17,7,467,0,12,479
10,4,10005,281,3,240,272,112,32,15,671,1,9,681
10,4,10005,282,3,92,87,48,12,2,241,1,3,245
10,4,10005,283,3,265,301,167,67,10,810,0,6,816
10,4,10005,284,3,232,258,99,34,7,630,7,10,647
10,4,10005,285,3,194,189,50,22,9,464,1,13,478
10,4,10005,286,3,401,332,168,67,13,981,3,20,1004
10,4,10005,287,3,224,116,62,16,2,420,0,8,428
10,4,10005,288,3,228,305,85,30,6,654,3,15,672
10,4,10005,289,3,320,262,97,35,7,721,1,11,733
10,4,10005,290,3,271,295,111,32,7,716,1,9,726
10,4,10005,291,3,227,232,82,29,12,582,6,14,602
10,4,10005,292,3,303,295,88,26,6,718,1,11,730
10,4,10005,293,3,374,330,129,19,7,859,5,11,875
10,4,10005,294,3,312,335,116,26,6,795,5,15,815
10,4,10005,295,3,363,257,116,42,7,785,4,7,796
10,4,10005,296,3,712,301,181,57,17,1268,4,16,1288
10,4,10005,297,3,310,216,107,62,8,703,2,11,716
10,4,10005,298,3,441,269,166,56,12,944,5,6,955
10,4,10005,302,3,661,525,267,137,14,1604,4,23,1631
10,4,10005,303,3,241,565,83,27,11,927,6,17,950
10,4,10005,304,3,479,295,130,57,6,967,3,23,993
10,4,10005,305,3,211,131,61,12,3,418,4,10,432
10,4,10005,306,3,347,198,167,48,7,767,5,11,783
10,4,10005,307,3,331,161,131,34,11,668,1,10,679
10,4,10005,308,3,335,196,86,38,4,659,2,13,674
10,4,10005,309,3,436,234,124,55,11,860,4,10,874
10,4,10005,310,3,284,251,110,79,9,733,0,17,750
10,4,10005,311,3,329,168,112,52,2,663,3,8,674
10,4,10005,312,3,433,408,158,121,10,1130,3,13,1146
10,4,10005,313,3,183,132,91,17,5,428,0,5,433
10,4,10005,314,3,242,123,82,17,4,468,1,12,481
10,4,10005,315,3,474,291,123,45,14,947,3,12,962
10,4,10005,316,3,427,251,140,51,15,884,1,24,909
10,4,10005,317,3,170,93,40,31,3,337,3,6,346
10,4,10005,318,3,168,124,52,17,6,367,1,4,372
10,4,10005,319,3,560,261,152,46,11,1030,4,17,1051
10,4,10005,320,3,457,261,122,23,5,868,0,12,880
10,4,10005,321,3,265,202,207,31,11,716,2,8,726
10,4,10005,323,3,217,206,145,20,4,592,10,51,653
10,4,10005,324,3,255,204,106,20,7,592,4,16,612
10,4,10005,325,3,344,271,168,41,14,838,5,3,846
10,4,10005,326,3,157,73,112,16,7,365,12,4,381
10,4,10005,327,3,399,195,274,20,3,891,3,8,902
10,4,10005,328,3,340,220,150,34,7,751,3,23,777
10,4,10005,337,3,234,113,162,15,12,536,2,17,555
10,4,10005,338,3,359,209,148,43,6,765,4,11,780
10,4,10005,354,3,76,136,65,3,2,282,4,11,297
10,4,10005,355,3,139,139,87,12,0,377,3,13,393
10,4,10005,362,3,93,147,66,3,2,311,2,17,330
10,4,10005,363,3,149,103,35,3,1,291,0,5,296
10,4,10005,364,3,151,75,41,6,2,275,0,3,278
10,4,10005,365,3,108,68,30,6,3,215,0,2,217
10,4,10005,366,3,49,43,31,1,0,124,0,2,126
10,4,10005,367,3,5,14,6,3,0,28,0,1,29
10,4,10005,368,3,53,42,11,5,3,114,0,3,117
10,4,10005,369,3,248,314,110,20,12,704,3,24,731
10,4,10005,377,3,156,165,142,15,3,481,3,24,508
10,4,10005,378,3,136,160,53,7,4,360,0,13,373
10,4,10005,379,3,219,148,61,4,3,435,1,9,445
10,4,10005,380,3,138,170,117,3,6,434,0,22,456
10,4,10005,381,3,157,238,200,4,6,605,5,27,637
10,4,10005,382,3,109,66,43,1,0,219,6,8,233
10,4,10005,383,3,269,153,40,6,0,468,4,1,473
10,4,10005,384,3,131,94,48,5,0,278,1,3,282
10,4,10005,385,3,242,234,64,6,8,554,0,27,581
10,4,10005,391,3,133,159,75,11,3,381,3,11,395
10,4,10005,392,3,125,183,116,9,2,435,0,21,456
10,4,10005,393,3,142,210,153,15,0,520,4,17,541
10,4,10005,419,3,19,38,6,1,0,64,0,5,69
11,1,11006,331,3,104,238,32,4,9,387,0,49,436
11,1,11006,332,3,188,133,53,1,3,378,0,41,419
11,1,11006,333,3,275,273,39,4,8,599,3,44,646
11,1,11006,334,3,165,150,27,9,4,355,0,43,398
11,1,11006,335,3,222,253,8,2,15,500,1,29,530
11,1,11022,1894,3,323,149,31,10,10,523,0,13,536
11,1,11022,1895,3,509,258,31,11,3,812,2,14,828
11,1,11022,1896,3,389,154,21,10,7,581,4,10,595
11,1,11022,1897,3,359,212,14,5,2,592,0,14,606
11,1,11022,1898,3,116,8,3,0,0,127,0,8,135
11,1,11022,1899,3,179,124,7,5,3,318,0,21,339
11,1,11022,1900,3,113,52,8,0,0,173,2,7,182
11,1,11022,1901,3,231,518,13,7,4,773,1,21,795
11,1,11022,1902,3,49,2,3,0,2,56,0,1,57
11,1,11022,1903,3,241,37,15,3,1,297,0,28,325
11,1,11022,1904,3,198,116,11,4,2,331,0,10,341
11,1,11022,1905,3,233,165,52,8,7,465,2,8,475
11,1,11022,1906,3,218,159,24,2,3,406,0,14,420
11,1,11022,1907,3,270,63,29,1,2,365,0,21,386
11,1,11022,1908,3,235,30,16,4,1,286,1,11,298
11,1,11022,1909,3,143,37,2,0,1,183,1,13,197
11,1,11022,1910,3,425,101,48,5,4,583,0,21,604
11,1,11022,1911,3,301,146,27,0,2,476,0,29,505
11,1,11029,2347,3,235,170,170,11,39,625,4,24,653
11,1,11029,2348,3,235,159,135,13,32,574,1,23,598
11,1,11029,2349,3,312,128,123,12,32,607,0,25,632
11,1,11029,2350,3,260,184,120,4,25,593,2,33,628
11,1,11029,2351,3,145,65,55,4,18,287,4,17,308
11,1,11029,2352,3,200,104,98,4,26,432,1,12,445
11,1,11029,2353,3,103,80,46,4,26,259,1,17,277
11,1,11029,2354,3,175,46,152,2,19,394,0,30,424
11,1,11029,2355,3,48,70,27,0,1,146,0,4,150
11,1,11029,2356,3,386,152,166,4,59,767,0,52,819
11,1,11029,2357,3,95,34,50,2,8,189,0,9,198
11,1,11029,2358,3,412,180,112,5,12,721,6,39,766
11,1,11029,2359,3,255,63,117,5,15,455,0,40,495
11,1,11029,2360,3,187,38,152,13,17,407,7,35,449
11,1,11029,2361,3,175,14,112,0,10,311,1,17,329
11,1,11029,2362,3,42,39,24,1,9,115,1,7,123
11,1,11029,2363,3,176,59,54,3,12,304,0,23,327
11,1,11029,2364,3,157,45,44,0,9,255,0,15,270
11,1,11029,2365,3,156,32,60,0,8,256,0,20,276
11,1,11029,2366,3,121,47,55,0,9,232,0,34,266
11,1,11029,2367,3,138,29,24,2,6,199,0,9,208
11,1,11029,2368,3,282,31,92,3,6,414,2,15,431
11,1,11029,2369,3,267,68,55,6,7,403,4,16,423
11,1,11029,2370,3,82,28,69,2,2,183,2,16,201
11,1,11029,2371,3,329,37,84,1,22,473,2,40,515
11,1,11029,2372,3,120,84,35,1,11,251,1,35,287
11,1,11029,2373,3,144,117,137,8,17,423,0,26,449
11,1,11029,2374,3,219,110,51,7,13,400,8,38,446
11,1,11030,2375,3,327,153,65,11,2,558,1,37,596
11,1,11030,2376,3,181,140,56,24,7,408,0,16,424
11,1,11030,2377,3,330,139,36,21,8,534,0,44,578
11,1,11030,2378,3,303,172,71,12,9,567,1,24,592
11,1,11030,2379,3,338,196,58,13,10,615,2,39,656
11,1,11030,2380,3,381,230,63,18,14,706,2,15,723
11,1,11030,2381,3,295,236,69,16,14,630,4,22,656
11,1,11030,2382,3,367,163,65,25,6,626,2,22,650
11,1,11030,2383,3,362,182,86,20,14,664,2,15,681
11,1,11030,2384,3,272,209,51,8,9,549,2,7,558
11,1,11030,2385,3,561,223,79,27,16,906,2,40,948
11,1,11030,2386,3,296,197,47,12,13,565,2,17,584
11,1,11030,2387,3,349,127,44,6,8,534,5,27,566
11,1,11030,2388,3,304,152,59,12,11,538,2,21,561
11,1,11030,2389,3,267,123,46,18,9,463,3,16,482
11,1,11030,2390,3,737,197,43,13,4,994,1,26,1021
11,1,11030,2391,3,132,116,25,16,4,293,0,18,311
11,1,11030,2392,3,418,127,33,6,4,588,1,38,627
11,1,11030,2393,3,312,130,11,4,2,459,5,11,475
11,1,11030,2394,3,337,85,11,2,2,437,1,11,449
11,1,11030,2395,3,153,78,41,5,5,282,3,9,294
11,1,11030,2396,3,252,76,19,2,1,350,0,9,359
11,1,11030,2397,3,240,70,19,4,1,334,1,10,345
11,1,11030,2398,3,416,160,30,10,5,621,10,10,641
11,1,11030,2399,3,462,160,105,24,12,763,1,25,789
11,1,11030,2400,3,269,74,25,5,5,378,10,12,400
11,1,11030,2401,3,279,125,17,2,3,426,2,10,438
11,1,11030,2402,3,131,42,17,3,1,194,0,10,204
11,1,11030,2403,3,167,50,20,3,3,243,1,23,267
11,1,11030,2404,3,42,112,10,3,0,167,0,11,178
11,1,11030,2405,3,380,162,34,4,4,584,0,10,594
11,1,11030,2406,3,246,75,86,2,2,411,4,35,450
11,1,11030,2407,3,242,135,21,6,2,406,3,26,435
11,1,11030,2408,3,284,92,32,11,3,422,0,14,436
11,1,11030,2409,3,366,189,31,19,4,609,5,14,628
11,1,11030,2410,3,120,43,66,4,3,236,1,13,250
11,1,11030,2411,3,68,138,59,1,1,267,0,0,267
11,1,11030,2412,3,131,101,76,1,2,311,1,24,336
11,1,11030,2413,3,383,165,52,1,3,604,5,32,641
11,1,11030,2414,3,303,202,121,12,7,645,6,29,680
11,1,11030,2415,3,147,104,109,5,2,367,2,26,395
11,1,11030,2416,3,68,88,12,2,4,174,2,8,184
11,1,11030,2417,3,213,81,32,3,7,336,1,28,365
11,1,11030,2418,3,163,32,22,2,1,220,0,7,227
11,1,11030,2419,3,103,55,44,4,2,208,1,18,227
11,1,11030,2420,3,370,120,18,14,5,527,0,29,556
11,1,11030,2421,3,282,120,77,2,6,487,2,24,513
11,1,11030,2422,3,315,37,51,7,1,411,1,13,425
11,1,11030,2423,3,194,94,38,10,3,339,3,12,354
11,1,11030,2424,3,198,101,37,8,5,349,2,38,389
11,1,11030,2425,3,170,139,70,6,5,390,7,19,416
11,1,11030,2426,3,318,62,32,7,2,421,0,12,433
11,1,11030,2427,3,203,109,113,5,13,443,5,18,466
11,1,11030,2428,3,70,68,26,3,1,168,7,9,184
11,1,11030,2429,3,138,152,77,4,6,377,2,36,415
11,1,11030,2430,3,114,106,25,4,3,252,3,9,264
11,1,11030,2431,3,213,69,42,9,2,335,0,11,346
11,1,11030,2432,3,178,60,47,5,1,291,0,8,299
11,1,11030,2433,3,141,61,125,8,4,339,0,14,353
11,1,11030,2434,3,160,117,54,6,2,339,0,24,363
11,1,11030,2435,3,244,42,70,3,0,359,1,24,384
11,1,11030,2436,3,255,193,16,2,2,468,3,22,493
11,1,11030,2437,3,118,61,81,3,2,265,7,14,286
11,1,11030,2438,3,236,47,41,13,0,337,2,9,348
11,1,11030,2439,3,282,102,49,4,4,441,2,19,462
11,1,11030,2440,3,278,105,19,9,1,412,3,34,449
11,1,11030,2441,3,290,46,34,5,3,378,3,30,411
11,1,11030,2442,3,211,82,17,1,3,314,0,17,331
11,1,11030,2443,3,120,66,39,5,4,234,0,21,255
11,1,11030,2444,3,202,51,17,3,2,275,3,13,291
11,1,11030,2445,3,119,65,11,6,1,202,3,7,212
11,1,11033,2543,3,211,227,160,11,21,630,2,17,649
11,1,11033,2544,3,309,287,269,15,29,909,3,37,949
11,1,11033,2545,3,373,244,365,17,41,1040,5,52,1097
11,1,11033,2546,3,217,186,244,9,15,671,3,17,691
11,1,11033,2547,3,134,192,113,4,3,446,0,18,464
11,1,11033,2548,3,311,348,332,13,22,1026,1,44,1071
11,1,11033,2549,3,279,203,325,11,23,841,13,37,891
11,1,11033,2550,3,155,107,204,6,6,478,1,22,501
11,1,11033,2551,3,654,389,563,21,32,1659,30,82,1771
11,1,11033,2552,3,193,229,282,12,23,739,0,32,771
11,1,11033,2553,3,296,269,286,15,27,893,6,26,925
11,1,11033,2554,3,330,193,263,9,24,819,2,15,836
11,1,11033,2555,3,184,130,181,5,7,507,0,23,530
11,1,11033,2556,3,351,242,374,13,41,1021,3,52,1076
11,1,11033,2557,3,455,272,316,15,39,1097,4,40,1141
11,1,11033,2558,3,347,150,269,14,26,806,4,46,856
11,1,11033,2559,3,239,129,240,8,15,631,2,25,658
11,1,11033,2560,3,369,277,423,17,22,1108,2,43,1153
11,1,11033,2561,3,284,175,265,9,21,754,5,36,795
11,1,11033,2562,3,29,3,4,0,0,36,0,2,38
11,1,11033,2563,3,96,9,10,0,0,115,3,6,124
11,1,11033,2564,3,65,3,4,0,0,72,0,1,73
11,1,11033,2565,3,18,5,6,0,0,29,0,0,29
11,1,11033,2566,3,61,18,11,2,1,93,0,17,110
11,1,11033,2567,3,17,3,11,0,0,31,1,1,33
11,1,11033,2568,3,34,17,58,1,8,118,1,12,131
11,1,11033,2569,3,149,30,60,3,3,245,2,17,264
11,1,11033,2570,3,48,12,13,0,0,73,0,22,95
11,1,11033,2571,3,110,24,84,6,2,226,1,16,243
11,1,11033,2572,3,229,86,70,6,2,393,6,47,446
11,1,11033,2573,3,263,167,106,11,15,562,5,37,604
11,1,11033,2574,3,413,111,113,7,3,647,1,36,684
11,1,11033,2575,3,86,65,79,4,13,247,0,36,283
11,1,11033,2576,3,90,38,43,2,12,185,1,12,198
11,1,11033,2577,3,124,56,41,4,3,228,5,23,256
11,1,11033,2578,3,213,47,33,2,4,299,4,14,317
11,1,11033,2579,3,316,92,88,10,5,511,4,37,552
11,1,11033,2580,3,29,17,70,1,0,117,0,4,121
11,1,11033,2581,3,501,76,170,7,2,756,11,44,811
11,1,11033,2582,3,297,64,74,4,4,443,1,34,478
11,1,11033,2583,3,333,57,60,5,10,465,3,32,500
11,1,11033,2584,3,425,98,108,10,11,652,3,33,688
11,1,11033,2585,3,204,88,139,3,3,437,9,37,483
11,1,11033,2586,3,239,122,186,14,14,575,3,12,590
11,1,11033,2587,3,260,221,318,9,11,819,1,89,909
11,1,11033,2588,3,202,120,198,15,12,547,7,50,604
11,1,11033,2589,3,128,169,180,2,3,482,4,39,525
11,1,11033,2590,3,293,47,153,2,6,501,3,66,570
11,1,11033,2591,3,305,90,100,11,10,516,0,30,546
11,1,11033,2592,3,235,111,193,22,20,581,3,43,627
11,1,11033,2593,3,237,80,158,5,16,496,7,20,523
11,1,11033,2594,3,179,84,56,5,2,326,4,18,348
11,1,11033,2595,3,293,100,221,12,4,630,3,59,692
11,1,11033,2596,3,107,17,52,1,2,179,2,18,199
11,1,11033,2597,3,300,51,53,2,3,409,0,26,435
11,1,11033,2598,3,525,127,155,17,8,832,6,24,862
11,1,11033,2599,3,223,133,210,6,9,581,4,27,612
11,1,11033,2600,3,345,45,82,8,1,481,0,36,517
11,1,11033,2601,3,468,110,74,10,11,673,8,29,710
11,1,11033,2602,3,643,113,146,18,12,932,4,32,968
11,1,11034,2603,3,403,260,79,6,6,754,0,28,782
11,1,11034,2604,3,391,284,62,3,6,746,0,35,781
11,1,11034,2605,3,70,230,11,0,0,311,0,18,329
11,1,11034,2606,3,36,26,7,1,0,70,0,5,75
11,1,11034,2607,3,99,33,5,1,0,138,0,11,149
11,1,11043,2891,3,423,358,117,10,5,913,0,31,944
11,1,11043,2892,3,471,294,138,8,6,917,1,22,940
11,1,11043,2893,3,59,16,8,0,1,84,0,9,93
11,1,11043,2894,3,144,57,24,2,0,227,1,26,254
11,1,11043,2895,3,79,124,21,2,0,226,0,34,260
11,1,11043,2896,3,46,33,20,2,0,101,0,7,108
11,1,11043,2897,3,100,140,23,0,2,265,0,69,334
11,1,11043,2898,3,106,93,43,1,4,247,2,18,267
11,1,11043,2899,3,190,420,46,4,0,660,0,55,715
11,1,11043,2900,3,248,229,123,9,7,616,0,42,658
11,1,11043,2901,3,168,91,32,5,0,296,0,31,327
11,1,11043,2902,3,167,240,66,11,8,492,0,36,528
11,1,11043,2903,3,325,364,62,2,2,755,4,52,811
11,1,11043,2904,3,178,206,96,4,3,487,0,29,516
11,1,11043,2905,3,319,176,92,6,4,597,1,20,618
11,1,11045,2934,3,103,100,27,1,1,232,0,20,252
11,1,11045,2935,3,379,278,31,1,4,693,0,33,726
11,1,11045,2936,3,108,49,16,0,1,174,0,2,176
11,1,11045,2937,3,120,70,10,0,0,200,0,14,214
11,1,11045,2938,3,78,89,4,0,1,172,0,8,180
11,1,11045,2939,3,117,72,3,0,0,192,0,13,205
11,1,11045,2940,3,231,277,10,0,1,519,0,37,556
11,1,11045,2941,3,99,103,12,0,1,215,0,14,229
11,1,11045,2942,3,165,223,5,1,1,395,0,21,416
11,1,11045,2943,3,218,147,21,1,0,387,1,42,430
11,1,11045,2944,3,178,75,25,3,1,282,1,28,311
11,1,11045,2945,3,119,109,25,0,4,257,0,22,279
11,1,11045,2946,3,86,126,23,0,0,235,0,14,249
11,1,11045,2947,3,4,19,0,0,0,23,0,3,26
11,1,11045,2948,3,118,60,5,0,3,186,0,17,203
11,2,11003,141,3,869,101,311,58,27,1366,5,57,1428
11,2,11003,142,3,290,37,163,20,10,520,1,16,537
11,2,11003,143,3,573,117,297,35,31,1053,1,22,1076
11,2,11003,144,3,262,57,136,23,14,492,1,10,503
11,2,11003,145,3,753,142,309,31,30,1265,6,30,1301
11,2,11003,146,3,544,61,181,35,12,833,1,29,863
11,2,11003,147,3,361,55,198,16,16,646,0,9,655
11,2,11003,148,3,354,65,148,32,23,622,0,14,636
11,2,11003,149,3,465,72,230,36,22,825,2,19,846
11,2,11003,150,3,287,69,144,18,16,534,2,15,551
11,2,11003,151,3,271,35,146,17,11,480,4,13,497
11,2,11003,152,3,344,60,160,21,14,599,0,18,617
11,2,11003,153,3,445,58,170,40,21,734,0,6,740
11,2,11003,154,3,425,63,166,25,23,702,0,18,720
11,2,11003,155,3,614,94,223,39,32,1002,17,33,1052
11,2,11003,156,3,648,109,236,31,23,1047,2,23,1072
11,2,11003,157,3,1136,185,486,101,49,1957,5,31,1993
11,2,11003,158,3,474,75,164,40,14,767,5,18,790
11,2,11003,159,3,397,68,168,29,18,680,1,22,703
11,2,11003,160,3,374,38,141,16,14,583,2,12,597
11,2,11003,161,3,166,48,93,15,13,335,0,7,342
11,2,11003,162,3,210,29,65,23,8,335,0,9,344
11,2,11003,163,3,343,64,155,22,17,601,0,2,603
11,2,11003,164,3,534,57,198,52,15,856,3,18,877
11,2,11003,165,3,352,62,155,20,14,603,2,17,622
11,2,11003,166,3,98,26,62,12,8,206,0,0,206
11,2,11003,167,3,167,34,106,13,5,325,0,10,335
11,2,11003,168,3,405,75,224,34,23,761,2,11,774
11,2,11003,169,3,431,90,181,55,12,769,1,16,786
11,2,11003,170,3,282,53,134,30,11,510,1,11,522
11,2,11003,171,3,374,66,167,21,12,640,2,20,662
11,2,11003,172,3,663,149,330,60,33,1235,6,35,1276
11,2,11003,173,3,839,132,356,82,35,1444,5,38,1487
11,2,11003,174,3,294,60,172,43,16,585,3,17,605
11,2,11003,175,3,512,80,220,39,22,873,4,37,914
11,2,11003,176,3,278,47,143,17,20,505,0,5,510
11,2,11003,177,3,410,105,58,13,6,592,0,21,613
11,2,11003,178,3,147,5,18,2,1,173,0,9,182
11,2,11003,179,3,313,47,30,6,1,397,2,28,427
11,2,11003,180,3,240,55,165,10,4,474,2,27,503
11,2,11003,181,3,133,14,85,5,6,243,1,10,254
11,2,11003,182,3,209,23,66,5,0,303,3,14,320
11,2,11003,183,3,320,20,101,4,6,451,2,23,476
11,2,11003,184,3,214,21,122,7,8,372,0,17,389
11,2,11003,185,3,233,33,183,23,10,482,3,16,501
11,2,11003,186,3,174,18,90,16,5,303,0,18,321
11,2,11003,187,3,125,17,44,4,2,192,0,9,201
11,2,11003,188,3,462,102,101,19,16,700,7,10,717
11,2,11003,189,3,264,83,92,11,4,454,1,19,474
11,2,11003,190,3,398,43,139,18,11,609,3,15,627
11,2,11003,191,3,208,62,43,1,3,317,2,33,352
11,2,11003,192,3,147,25,76,4,0,252,0,21,273
11,2,11003,193,3,137,20,60,4,1,222,1,6,229
11,2,11003,194,3,333,64,107,9,5,518,0,39,557
11,2,11003,195,3,140,16,29,0,2,187,2,4,193
11,2,11003,196,3,43,28,59,1,1,132,0,7,139
11,2,11003,197,3,430,67,81,12,9,599,3,31,633
11,2,11003,198,3,163,6,41,6,6,222,2,4,228
11,2,11003,199,3,108,19,8,1,1,137,4,8,149
11,2,11003,200,3,418,62,154,18,24,676,2,16,694
11,2,11003,201,3,163,26,172,1,7,369,1,16,386
11,2,11003,202,3,134,104,118,2,4,362,2,18,382
11,2,11003,203,3,127,64,17,2,4,214,2,9,225
11,2,11003,204,3,133,17,54,0,1,205,0,11,216
11,2,11003,205,3,203,5,110,6,1,325,8,24,357
11,2,11003,206,3,274,29,124,4,4,435,11,29,475
11,2,11003,207,3,144,42,64,0,0,250,0,19,269
11,2,11003,208,3,228,57,106,9,1,401,4,12,417
11,2,11003,209,3,146,13,28,4,0,191,0,5,196
11,2,11003,210,3,124,80,109,11,7,331,2,24,357
11,2,11003,211,3,103,25,34,2,0,164,0,0,164
11,2,11003,212,3,121,64,103,8,0,296,1,9,306
11,2,11003,213,3,165,90,52,16,8,331,0,21,352
11,2,11003,214,3,110,122,88,8,4,332,7,41,380
11,2,11003,215,3,113,32,14,0,0,159,0,24,183
11,2,11003,216,3,303,97,176,7,7,590,0,23,613
11,2,11003,217,3,135,26,25,3,2,191,2,18,211
11,2,11003,218,3,382,81,120,12,6,601,3,20,624
11,2,11003,219,3,282,60,94,10,4,450,4,35,489
11,2,11003,220,3,188,42,123,8,6,367,0,15,382
11,2,11003,221,3,82,12,8,5,0,107,0,4,111
11,2,11003,222,3,268,28,59,3,3,361,2,19,382
11,2,11003,223,3,221,32,47,3,8,311,4,16,331
11,2,11003,224,3,216,58,48,14,8,344,0,15,359
11,2,11003,225,3,167,41,97,6,3,314,4,9,327
11,2,11003,226,3,130,70,104,4,6,314,1,21,336
11,2,11003,227,3,201,130,105,7,6,449,0,60,509
11,2,11003,228,3,121,25,29,8,2,185,1,0,186
11,2,11003,229,3,170,81,69,13,1,334,1,13,348
11,2,11003,230,3,184,23,40,8,4,259,0,12,271
11,2,11003,231,3,100,83,40,10,2,235,3,10,248
11,2,11003,232,3,58,16,7,1,1,83,3,3,89
11,2,11003,233,3,221,33,65,2,1,322,1,0,323
11,2,11003,234,3,65,21,14,0,1,101,0,9,110
11,2,11003,235,3,202,43,54,6,3,308,4,21,333
11,2,11003,236,3,330,11,69,0,11,421,0,23,444
11,2,11003,237,3,137,65,30,4,3,239,0,7,246
11,2,11003,238,3,151,23,108,8,1,291,0,39,330
11,2,11003,239,3,71,23,40,1,1,136,0,9,145
11,2,11003,240,3,68,8,27,1,0,104,0,21,125
11,2,11003,241,3,116,14,34,3,2,169,0,20,189
11,2,11003,242,3,167,23,26,3,1,220,3,18,241
11,2,11003,243,3,178,18,22,2,0,220,0,2,222
11,2,11009,609,3,440,218,114,37,12,821,1,34,856
11,2,11009,610,3,232,138,48,17,6,441,0,17,458
11,2,11009,611,3,426,205,107,43,6,787,4,37,828
11,2,11009,612,3,310,218,95,30,7,660,0,39,699
11,2,11009,613,3,359,190,83,25,11,668,1,14,683
11,2,11009,614,3,278,116,43,37,4,478,2,12,492
11,2,11009,615,3,300,144,20,16,5,485,0,15,500
11,2,11009,616,3,400,212,94,33,13,752,2,24,778
11,2,11009,617,3,384,231,132,33,25,805,0,26,831
11,2,11009,618,3,312,173,89,44,15,633,1,25,659
11,2,11009,619,3,380,142,78,32,6,638,0,22,660
11,2,11009,620,3,231,238,28,15,11,523,1,8,532
11,2,11009,621,3,234,105,148,14,9,510,1,19,530
11,2,11009,622,3,203,81,48,2,1,335,0,10,345
11,2,11009,623,3,302,101,96,14,3,516,0,25,541
11,2,11009,624,3,101,79,26,1,0,207,0,20,227
11,2,11009,625,3,252,55,11,3,0,321,0,37,358
11,2,11009,626,3,105,119,18,9,1,252,2,20,274
11,2,11009,627,3,251,167,44,6,9,477,1,25,503
11,2,11009,628,3,182,129,12,1,0,324,1,18,343
11,2,11009,629,3,180,56,22,4,4,266,1,10,277
11,2,11009,630,3,486,163,71,60,6,786,2,30,818
11,2,11009,631,3,174,198,27,6,4,409,0,41,450
11,2,11009,632,3,208,95,19,6,2,330,1,6,337
11,2,11009,633,3,127,262,27,4,1,421,0,11,432
11,2,11009,634,3,227,110,37,6,3,383,0,10,393
11,2,11009,635,3,124,105,14,0,2,245,0,18,263
11,2,11009,636,3,202,319,52,30,2,605,4,25,634
11,2,11009,637,3,342,199,18,1,2,562,2,36,600
11,2,11009,638,3,342,289,107,5,4,747,5,28,780
11,2,11009,639,3,142,254,39,4,4,443,0,33,476
11,2,11009,640,3,141,91,22,11,7,272,0,7,279
11,2,11009,641,3,389,192,107,37,10,735,3,27,765
11,2,11009,642,3,129,150,67,9,1,356,2,23,381
11,2,11009,643,3,385,133,54,19,10,601,2,9,612
11,2,11009,644,3,250,68,44,13,5,380,2,7,389
11,2,11009,645,3,581,190,101,17,19,908,5,31,944
11,2,11009,646,3,367,167,87,18,6,645,1,18,664
11,2,11009,647,3,230,65,32,23,2,352,2,8,362
11,2,11009,648,3,349,109,56,25,5,544,1,7,552
11,2,11009,649,3,387,91,68,26,10,582,1,11,594
11,2,11009,650,3,457,129,56,20,9,671,2,13,686
11,2,11009,651,3,145,34,9,0,1,189,0,8,197
11,2,11013,740,3,570,177,136,85,137,1105,0,49,1154
11,2,11013,741,3,510,134,91,76,180,991,2,43,1036
11,2,11013,742,3,273,59,39,19,81,471,3,66,540
11,2,11013,743,3,95,38,38,11,53,235,2,23,260
11,2,11013,744,3,122,41,59,15,54,291,2,56,349
11,2,11013,745,3,141,46,65,9,36,297,3,10,310
11,2,11013,746,3,246,95,90,21,62,514,1,61,576
11,2,11013,747,3,571,149,201,43,192,1156,10,145,1311
11,2,11013,748,3,287,115,135,19,270,826,4,93,923
11,2,11013,749,3,336,77,51,29,145,638,1,47,686
11,2,11013,750,3,147,132,50,14,138,481,4,27,512
11,2,11013,751,3,183,56,40,14,132,425,0,50,475
11,2,11032,2505,3,484,95,236,23,12,850,1,29,880
11,2,11032,2506,3,556,186,305,42,17,1106,2,35,1143
11,2,11032,2507,3,430,181,334,44,21,1010,1,28,1039
11,2,11032,2508,3,395,162,209,17,17,800,0,19,819
11,2,11032,2509,3,295,78,146,23,15,557,8,19,584
11,2,11032,2510,3,325,164,148,25,10,672,1,19,692
11,2,11032,2511,3,319,84,187,17,10,617,1,7,625
11,2,11032,2512,3,416,136,179,21,8,760,3,20,783
11,2,11032,2513,3,304,101,195,21,16,637,2,14,653
11,2,11032,2514,3,703,125,400,67,21,1316,0,23,1339
11,2,11032,2515,3,607,74,82,37,6,806,1,9,816
11,2,11032,2516,3,378,43,39,42,10,512,0,29,541
11,2,11032,2517,3,254,42,22,38,0,356,1,17,374
11,2,11032,2518,3,74,5,21,4,4,108,0,4,112
11,2,11032,2519,3,295,56,95,17,14,477,0,16,493
11,2,11032,2520,3,281,65,62,31,8,447,4,0,451
11,2,11032,2521,3,286,44,66,10,7,413,1,16,430
11,2,11032,2522,3,218,55,68,21,6,368,1,20,389
11,2,11032,2523,3,621,62,96,32,6,817,1,18,836
11,2,11032,2524,3,502,51,69,30,10,662,1,26,689
11,2,11032,2525,3,234,39,34,18,5,330,2,20,352
11,2,11032,2526,3,295,47,70,28,11,451,2,27,480
11,2,11032,2527,3,271,73,89,19,8,460,3,35,498
11,2,11032,2528,3,474,45,257,19,8,803,1,35,839
11,2,11032,2529,3,360,10,184,16,9,579,1,14,594
11,2,11032,2530,3,434,41,77,33,13,598,0,21,619
11,2,11032,2531,3,443,146,176,39,12,816,1,30,847
11,2,11032,2532,3,385,122,94,42,11,654,0,28,682
11,2,11032,2533,3,244,43,61,32,16,396,0,27,423
11,2,11032,2534,3,184,85,20,6,1,296,0,20,316
11,2,11032,2535,3,400,71,93,39,17,620,1,66,687
11,2,11032,2536,3,391,114,67,55,9,636,2,23,661
11,2,11032,2537,3,382,89,114,44,9,638,1,29,668
11,2,11032,2538,3,178,111,97,24,5,415,7,20,442
11,2,11032,2539,3,172,50,46,12,4,284,0,20,304
11,2,11032,2540,3,261,106,32,3,3,405,0,19,424
11,2,11032,2541,3,164,115,108,17,6,410,2,15,427
11,2,11032,2542,3,343,86,135,14,12,590,0,56,646
11,2,11040,2778,3,505,369,181,16,23,1094,10,72,1176
11,2,11040,2779,3,344,163,153,29,40,729,0,84,813
11,2,11040,2780,3,184,278,96,12,24,594,1,79,674
11,2,11040,2781,3,168,136,201,4,17,526,0,100,626
11,2,11040,2782,3,100,19,31,3,9,162,0,15,177
11,2,11040,2783,3,263,173,253,8,24,721,1,115,837
11,2,11040,2784,3,211,78,232,5,14,540,0,65,605
11,2,11040,2785,3,275,158,337,3,27,800,0,106,906
11,2,11040,2786,3,10,25,10,0,1,46,0,2,48
11,2,11040,2787,3,101,106,31,1,6,245,0,38,283
11,2,11040,2788,3,34,23,12,0,2,71,0,12,83
11,2,11040,2789,3,44,43,4,0,3,94,0,7,101
11,3,11020,1265,3,537,320,54,25,19,955,10,24,989
11,3,11020,1266,3,592,266,63,37,25,983,8,33,1024
11,3,11020,1270,3,420,191,57,20,16,704,1,27,732
11,3,11020,1271,3,376,181,36,22,9,624,9,18,651
11,3,11020,1272,3,577,174,59,22,20,852,2,23,877
11,3,11020,1273,3,748,244,58,33,22,1105,5,17,1127
11,3,11020,1274,3,419,148,59,32,17,675,4,5,684
11,3,11020,1275,3,276,99,9,7,6,397,2,14,413
11,3,11020,1276,3,667,398,90,32,24,1211,10,56,1277
11,3,11020,1277,3,648,301,59,17,22,1047,5,49,1101
11,3,11020,1278,3,974,281,143,44,40,1482,8,34,1524
11,3,11020,1279,3,1000,262,113,44,41,1460,8,8,1476
11,3,11020,1280,3,531,241,50,37,33,892,4,12,908
11,3,11020,1283,3,909,195,107,43,28,1282,6,6,1294
11,3,11020,1284,3,1052,434,152,45,31,1714,18,59,1791
11,3,11020,1285,3,2103,547,327,147,103,3227,2,30,3259
11,3,11020,1286,3,662,220,58,36,17,993,1,16,1010
11,3,11020,1287,3,612,195,48,31,23,909,0,10,919
11,3,11020,1288,3,742,189,67,24,32,1054,3,15,1072
11,3,11020,1289,3,599,256,69,22,17,963,15,44,1022
11,3,11020,1292,3,846,225,88,34,26,1219,4,32,1255
11,3,11020,1293,3,584,196,47,32,28,887,1,22,910
11,3,11020,1294,3,502,207,58,22,19,808,1,15,824
11,3,11020,1295,3,424,145,54,54,19,696,4,10,710
11,3,11020,1296,3,344,132,43,39,14,572,7,5,584
11,3,11020,1297,3,1021,432,144,51,37,1685,23,25,1733
11,3,11020,1298,3,906,363,125,45,58,1497,0,36,1533
11,3,11020,1299,3,387,99,49,19,22,576,2,7,585
11,3,11020,1300,3,521,165,74,33,24,817,2,12,831
11,3,11020,1301,3,502,166,55,35,20,778,0,16,794
11,3,11020,1302,3,410,146,40,32,16,644,4,17,665
11,3,11020,1303,3,493,144,59,16,26,738,2,13,753
11,3,11020,1304,3,1441,263,177,60,70,2011,3,25,2039
11,3,11020,1305,3,362,146,33,40,6,587,0,17,604
11,3,11020,1306,3,618,205,59,27,27,936,3,19,958
11,3,11020,1307,3,538,188,46,28,16,816,0,18,834
11,3,11020,1308,3,1014,497,126,63,43,1743,24,59,1826
11,3,11020,1309,3,877,414,97,44,39,1471,5,59,1535
11,3,11020,1310,3,982,376,70,51,29,1508,0,40,1548
11,3,11020,1311,3,296,82,42,25,16,461,0,9,470
11,3,11020,1312,3,629,197,60,44,17,947,1,42,990
11,3,11020,1314,3,711,114,61,41,26,953,2,13,968
11,3,11020,1315,3,500,124,21,25,19,689,2,6,697
11,3,11020,1316,3,660,97,48,30,21,856,2,9,867
11,3,11020,1317,3,548,147,42,40,18,795,0,7,802
11,3,11020,1318,3,354,174,32,19,10,589,0,6,595
11,3,11020,1319,3,536,190,43,13,15,797,0,14,811
11,3,11020,1320,3,659,211,50,33,13,966,10,34,1010
11,3,11020,1321,3,374,139,73,23,22,631,4,27,662
11,3,11020,1322,3,1402,602,204,78,54,2340,21,50,2411
11,3,11020,1323,3,799,352,87,33,21,1292,11,27,1330
11,3,11020,1324,3,487,216,54,37,24,818,3,27,848
11,3,11020,1325,3,408,166,49,14,21,658,1,19,678
11,3,11020,1326,3,427,114,34,21,17,613,1,22,636
11,3,11020,1327,3,365,76,48,18,19,526,0,2,528
11,3,11020,1328,3,615,98,51,26,14,804,3,10,817
11,3,11020,1329,3,613,103,40,24,17,797,0,12,809
11,3,11020,1330,3,781,173,49,30,19,1052,3,24,1079
11,3,11020,1331,3,453,101,54,25,28,661,4,6,671
11,3,11020,1332,3,571,156,62,26,20,835,3,30,868
11,3,11020,1333,3,588,257,81,31,24,981,7,31,1019
11,3,11020,1334,3,530,225,53,25,23,856,10,12,878
11,3,11020,1335,3,653,210,68,38,25,994,7,30,1031
11,3,11020,1336,3,419,212,52,15,15,713,8,11,732
11,3,11020,1337,3,1287,267,109,60,54,1777,4,26,1807
11,3,11020,1338,3,394,75,35,9,11,524,2,12,538
11,3,11020,1339,3,613,144,42,27,11,837,5,26,868
11,3,11020,1340,3,733,152,48,33,24,990,6,19,1015
11,3,11020,1341,3,815,156,68,38,13,1090,1,21,1112
11,3,11020,1342,3,724,158,58,25,23,988,5,19,1012
11,3,11020,1343,3,540,147,52,26,22,787,11,10,808
11,3,11020,1344,3,601,167,39,24,16,847,15,14,876
11,3,11020,1345,3,441,118,32,33,18,642,7,12,661
11,3,11020,1346,3,460,164,40,23,26,713,5,11,729
11,3,11020,1347,3,433,228,53,19,19,752,2,27,781
11,3,11020,1348,3,516,192,51,22,13,794,5,20,819
11,3,11020,1349,3,1769,364,235,85,66,2519,8,30,2557
11,3,11020,1350,3,600,160,51,30,20,861,3,24,888
11,3,11020,1351,3,522,124,65,23,29,763,6,5,774
11,3,11020,1352,3,680,204,70,47,26,1027,4,17,1048
11,3,11020,1353,3,693,138,54,19,12,916,6,20,942
11,3,11020,1354,3,773,142,37,26,17,995,2,11,1008
11,3,11020,1355,3,653,151,44,16,10,874,4,16,894
11,3,11020,1356,3,855,151,67,40,20,1133,8,15,1156
11,3,11020,1357,3,659,124,44,22,8,857,5,13,875
11,3,11020,1358,3,557,128,38,24,18,765,6,11,782
11,3,11020,1359,3,554,120,50,24,10,758,2,21,781
11,3,11020,1360,3,539,122,30,23,16,730,2,6,738
11,3,11020,1361,3,530,127,48,35,20,760,2,9,771
11,3,11020,1362,3,650,203,53,43,15,964,8,26,998
11,3,11020,1363,3,718,179,40,38,20,995,2,16,1013
11,3,11020,1364,3,609,271,92,31,26,1029,9,25,1063
11,3,11020,1365,3,1493,350,180,83,71,2177,5,20,2202
11,3,11020,1366,3,594,124,27,19,8,772,4,14,790
11,3,11020,1367,3,606,166,66,37,19,894,2,9,905
11,3,11020,1368,3,360,155,27,21,10,573,2,9,584
11,3,11020,1369,3,608,227,73,28,20,956,8,22,986
11,3,11020,1370,3,812,208,52,32,34,1138,7,10,1155
11,3,11020,1371,3,356,82,30,14,25,507,2,5,514
11,3,11020,1372,3,626,172,63,19,25,905,8,25,938
11,3,11020,1373,3,433,94,43,17,13,600,2,11,613
11,3,11020,1374,3,490,139,43,20,8,700,4,22,726
11,3,11020,1375,3,389,87,25,15,19,535,3,23,561
11,3,11020,1376,3,340,98,24,11,6,479,2,10,491
11,3,11020,1377,3,388,72,27,8,17,512,0,13,525
11,3,11020,1378,3,394,108,40,21,15,578,2,9,589
11,3,11020,1379,3,480,98,41,20,15,654,2,19,675
11,3,11020,1380,3,223,52,19,12,5,311,0,6,317
11,3,11020,1381,3,177,76,21,31,10,315,1,12,328
11,3,11020,1382,3,438,192,65,23,17,735,4,13,752
11,3,11020,1383,3,337,79,34,9,4,463,0,3,466
11,3,11020,1384,3,411,88,37,16,18,570,1,9,580
11,3,11020,1385,3,831,180,51,32,22,1116,5,22,1143
11,3,11020,1386,3,513,129,61,23,14,740,4,16,760
11,3,11020,1387,3,533,155,60,32,24,804,4,17,825
11,3,11020,1388,3,558,240,73,19,13,903,0,21,924
11,3,11020,1389,3,611,152,59,33,29,884,8,6,898
11,3,11020,1390,3,706,250,71,31,30,1088,3,35,1126
11,3,11020,1391,3,789,150,59,21,16,1035,2,15,1052
11,3,11020,1392,3,2675,448,361,134,122,3740,4,34,3778
11,3,11020,1393,3,533,217,48,32,14,844,3,37,884
11,3,11020,1394,3,702,92,81,38,26,939,1,9,949
11,3,11020,1395,3,609,212,62,38,16,937,6,33,976
11,3,11020,1396,3,755,223,83,44,42,1147,5,31,1183
11,3,11020,1397,3,671,150,50,25,25,921,2,21,944
11,3,11020,1398,3,689,101,51,24,15,880,1,11,892
11,3,11020,1403,3,180,61,39,6,4,290,2,11,303
11,3,11020,1404,3,362,124,49,17,11,563,3,11,577
11,3,11020,1405,3,304,160,33,9,14,520,3,10,533
11,3,11020,1406,3,231,84,21,5,2,343,0,4,347
11,3,11020,1407,3,346,124,28,25,7,530,1,9,540
11,3,11020,1408,3,561,106,42,25,21,755,0,19,774
11,3,11020,1409,3,592,148,67,18,23,848,0,14,862
11,3,11020,1410,3,479,130,45,17,28,699,2,17,718
11,3,11020,1411,3,464,164,73,11,20,732,0,20,752
11,3,11020,1412,3,495,131,60,21,11,718,2,13,733
11,3,11020,1413,3,515,97,41,19,14,686,2,8,696
11,3,11020,1414,3,984,232,108,47,60,1431,2,26,1459
11,3,11020,1415,3,868,158,98,31,40,1195,3,10,1208
11,3,11020,1416,3,511,221,66,24,14,836,0,23,859
11,3,11020,1417,3,447,136,40,10,16,649,2,11,662
11,3,11020,1418,3,419,116,42,18,20,615,2,23,640
11,3,11020,1419,3,210,87,32,6,10,345,0,7,352
11,3,11020,1420,3,258,115,40,10,8,431,1,10,442
11,3,11020,1429,3,241,85,22,12,12,372,0,13,385
11,3,11020,1430,3,348,88,36,14,9,495,0,7,502
11,3,11020,1431,3,200,71,30,11,11,323,5,1,329
11,3,11020,1432,3,290,73,38,17,7,425,2,0,427
11,3,11020,1433,3,360,70,34,20,10,494,0,9,503
11,3,11020,1434,3,264,71,61,11,10,417,1,7,425
11,3,11020,1435,3,262,81,57,22,10,432,1,14,447
11,3,11020,1436,3,415,160,62,25,19,681,2,14,697
11,3,11020,1437,3,702,104,58,29,36,929,0,14,943
11,3,11020,1438,3,655,157,51,22,13,898,1,26,925
11,3,11020,1439,3,702,119,48,25,33,927,3,9,939
11,3,11020,1440,3,596,84,65,23,24,792,1,7,800
11,3,11020,1442,3,253,81,29,16,5,384,0,8,392
11,3,11020,1443,3,246,73,29,10,11,369,0,6,375
11,3,11020,1450,3,604,151,49,31,27,862,1,21,884
11,3,11020,1451,3,659,240,142,31,34,1106,2,13,1121
11,3,11020,1452,3,527,206,65,25,22,845,0,17,862
11,3,11020,1453,3,650,180,61,29,27,947,3,7,957
11,3,11020,1470,3,65,23,8,0,2,98,1,0,99
11,3,11020,1472,3,219,32,6,1,0,258,0,10,268
11,3,11020,1474,3,243,62,12,4,12,333,4,27,364
11,3,11020,1475,3,100,124,21,4,2,251,1,0,252
11,3,11020,1476,3,89,86,16,0,1,192,0,9,201
11,3,11020,1479,3,323,199,26,5,6,559,12,32,603
11,3,11020,1480,3,503,339,59,13,8,922,0,30,952
11,3,11020,1481,3,395,178,46,31,15,665,2,20,687
11,3,11020,1482,3,144,111,13,0,1,269,0,10,279
11,3,11020,1485,3,388,181,65,17,9,660,13,18,691
11,3,11020,1486,3,222,145,24,8,4,403,1,16,420
11,3,11020,1487,3,476,446,87,8,11,1028,12,21,1061
11,3,11020,1488,3,168,79,44,7,6,304,1,8,313
11,3,11020,1489,3,624,288,95,23,22,1052,13,34,1099
11,3,11020,1495,3,868,316,87,44,17,1332,3,56,1391
11,3,11020,1496,3,1274,495,132,41,27,1969,16,45,2030
11,3,11020,1497,3,248,364,25,4,7,648,4,9,661
11,3,11020,1498,3,273,282,25,3,4,587,4,14,605
11,3,11020,1499,3,320,153,15,3,5,496,3,10,509
11,3,11020,1500,3,1832,764,342,97,84,3119,56,90,3265
11,3,11020,1503,3,125,74,16,0,0,215,0,10,225
11,3,11020,1504,3,544,365,52,10,10,981,15,32,1028
11,3,11020,1505,3,243,135,33,5,7,423,3,16,442
11,3,11020,1506,3,332,319,46,8,10,715,5,11,731
11,3,11020,1508,3,193,447,30,9,3,682,4,29,715
11,3,11020,1509,3,343,406,37,3,7,796,8,47,851
11,3,11020,1510,3,427,487,86,13,20,1033,11,26,1070
11,3,11020,1512,3,161,264,58,4,3,490,1,18,509
11,3,11020,1513,3,273,103,42,9,9,436,0,17,453
11,4,11014,752,3,333,141,94,31,23,622,2,37,661
11,4,11014,753,3,659,227,140,60,23,1109,0,47,1156
11,4,11014,754,3,403,199,83,29,23,737,9,45,791
11,4,11014,755,3,612,222,119,70,41,1064,6,46,1116
11,4,11014,756,3,446,253,126,52,25,902,2,38,942
11,4,11014,757,3,296,154,55,27,16,548,0,25,573
11,4,11014,758,3,430,144,89,43,16,722,0,38,760
11,4,11014,759,3,524,199,100,50,19,892,1,32,925
11,4,11014,760,3,954,422,189,109,43,1717,0,95,1812
11,4,11014,761,3,389,181,68,35,15,688,0,24,712
11,4,11014,762,3,461,160,100,34,26,781,4,7,792
11,4,11014,763,3,427,194,63,38,17,739,3,24,766
11,4,11014,764,3,418,156,73,40,27,714,1,21,736
11,4,11014,765,3,656,340,170,56,33,1255,0,43,1298
11,4,11014,766,3,495,214,84,32,13,838,5,60,903
11,4,11014,767,3,413,188,63,41,13,718,6,29,753
11,4,11014,768,3,390,112,119,35,15,671,0,32,703
11,4,11014,769,3,420,175,81,34,10,720,0,37,757
11,4,11014,770,3,449,206,82,35,10,782,0,18,800
11,4,11014,771,3,232,84,63,13,9,401,1,21,423
11,4,11014,772,3,581,285,108,48,27,1049,7,66,1122
11,4,11014,773,3,457,158,84,58,15,772,1,32,805
11,4,11014,774,3,506,216,93,53,13,881,1,42,924
11,4,11014,775,3,630,291,115,53,34,1123,2,71,1196
11,4,11014,776,3,255,64,54,4,1,378,3,15,396
11,4,11014,777,3,220,90,68,9,8,395,5,42,442
11,4,11014,778,3,277,160,90,15,8,550,5,27,582
11,4,11014,779,3,195,69,77,8,7,356,2,18,376
11,4,11014,780,3,318,59,37,9,7,430,7,26,463
11,4,11014,781,3,379,158,62,7,6,612,4,10,626
11,4,11014,782,3,197,129,41,3,7,377,4,27,408
11,4,11014,783,3,206,41,34,3,4,288,1,24,313
11,4,11014,784,3,379,80,39,6,4,508,4,24,536
11,4,11014,785,3,220,101,49,4,6,380,3,33,416
11,4,11014,786,3,237,99,33,15,10,394,1,28,423
11,4,11014,787,3,233,119,50,10,2,414,0,34,448
11,4,11014,788,3,211,104,104,8,28,455,4,29,488
11,4,11014,789,3,127,66,7,2,1,203,4,10,217
11,4,11014,790,3,619,74,81,28,10,812,1,48,861
11,4,11014,791,3,259,122,65,2,8,456,4,42,502
11,4,11014,792,3,471,109,55,21,10,666,4,45,715
11,4,11014,793,3,549,159,84,31,8,831,1,42,874
11,4,11014,794,3,227,120,59,12,5,423,1,53,477
11,4,11014,795,3,285,160,55,7,5,512,1,33,546
11,4,11014,796,3,207,202,38,17,7,471,2,34,507
11,4,11014,797,3,463,248,68,31,10,820,4,66,890
11,4,11014,798,3,224,56,57,4,4,345,0,45,390
11,4,11014,799,3,135,59,38,9,4,245,0,0,245
11,4,11014,800,3,135,73,53,5,10,276,0,30,306
11,4,11014,801,3,280,280,77,14,12,663,2,46,711
11,4,11014,802,3,304,263,62,26,3,658,1,29,688
11,4,11014,803,3,485,43,59,14,34,635,8,30,673
11,4,11014,804,3,436,98,91,21,7,653,0,48,701
11,4,11014,805,3,350,251,46,7,3,657,0,25,682
11,4,11014,806,3,179,112,40,5,3,339,0,36,375
11,4,11014,807,3,254,94,97,7,10,462,6,43,511
11,4,11014,808,3,567,198,112,19,9,905,8,19,932
11,4,11014,809,3,611,101,58,27,13,810,0,46,856
11,4,11014,810,3,246,87,75,7,9,424,1,35,460
11,4,11014,811,3,313,160,74,5,6,558,0,26,584
11,4,11014,812,3,63,37,8,2,3,113,0,16,129
11,4,11014,813,3,274,174,33,6,1,488,2,37,527
11,4,11014,814,3,165,65,22,6,3,261,0,0,261
11,4,11014,815,3,148,113,38,8,3,310,1,51,362
11,4,11014,816,3,258,67,36,4,1,366,1,25,392
11,4,11014,817,3,222,72,42,14,7,357,5,28,390
11,4,11014,818,3,292,188,49,13,11,553,0,65,618
11,4,11014,819,3,92,51,79,8,5,235,1,21,257
11,4,11014,820,3,171,109,43,14,2,339,3,56,398
11,4,11014,821,3,327,120,102,13,12,574,1,61,636
11,4,11014,822,3,171,122,29,3,10,335,1,47,383
11,4,11015,823,3,290,343,67,16,20,736,0,14,750
11,4,11015,824,3,315,328,80,50,34,807,2,25,834
11,4,11015,825,3,242,141,70,19,17,489,0,8,497
11,4,11015,826,3,218,224,57,25,15,539,0,26,565
11,4,11015,827,3,244,279,73,30,11,637,1,15,653
11,4,11015,828,3,318,347,123,40,19,847,0,19,866
11,4,11015,829,3,193,199,79,35,24,530,4,9,543
11,4,11015,830,3,204,283,57,24,11,579,3,6,588
11,4,11015,831,3,202,238,87,38,13,578,0,24,602
11,4,11015,832,3,266,304,121,38,22,751,2,22,775
11,4,11015,833,3,194,248,60,23,21,546,0,5,551
11,4,11015,834,3,293,332,86,41,52,804,0,18,822
11,4,11015,835,3,303,275,106,31,58,773,2,25,800
11,4,11015,836,3,251,342,106,48,27,774,8,28,810
11,4,11015,837,3,262,267,87,35,24,675,2,10,687
11,4,11015,838,3,215,219,96,26,28,584,1,5,590
11,4,11015,839,3,133,142,72,25,4,376,1,6,383
11,4,11015,840,3,80,90,51,4,7,232,0,5,237
11,4,11015,841,3,240,188,85,28,13,554,6,4,564
11,4,11015,842,3,190,241,73,15,13,532,5,9,546
11,4,11015,843,3,206,182,66,26,17,497,0,0,497
11,4,11015,844,3,210,247,78,25,23,583,0,25,608
11,4,11015,845,3,433,312,77,40,23,885,5,14,904
11,4,11015,846,3,266,258,60,32,20,636,0,8,644
11,4,11015,847,3,194,170,57,19,17,457,1,4,462
11,4,11015,848,3,120,118,50,10,8,306,0,6,312
11,4,11015,849,3,115,83,24,13,4,239,2,4,245
11,4,11015,850,3,237,224,76,45,12,594,3,10,607
11,4,11015,851,3,256,309,79,44,28,716,1,14,731
11,4,11015,852,3,243,263,82,68,16,672,3,24,699
11,4,11015,853,3,454,592,175,71,47,1339,1,49,1389
11,4,11015,854,3,403,440,169,50,32,1094,1,18,1113
11,4,11015,855,3,293,255,88,46,32,714,3,18,735
11,4,11015,856,3,137,145,45,18,14,359,0,3,362
11,4,11015,857,3,276,327,90,47,27,767,0,12,779
11,4,11015,858,3,210,242,59,42,14,567,0,12,579
11,4,11015,859,3,137,110,39,11,18,315,0,0,315
11,4,11015,860,3,143,172,60,14,12,401,2,13,416
11,4,11015,861,3,273,272,77,20,21,663,0,17,680
11,4,11015,862,3,233,313,83,30,23,682,0,13,695
11,4,11015,863,3,217,184,56,27,14,498,0,6,504
11,4,11015,864,3,248,209,63,26,26,572,0,7,579
11,4,11015,865,3,298,265,103,38,24,728,0,18,746
11,4,11015,866,3,283,358,97,55,23,816,5,19,840
11,4,11015,867,3,355,434,104,39,17,949,0,10,959
11,4,11015,868,3,182,147,68,23,14,434,2,8,444
11,4,11015,869,3,182,173,82,22,7,466,0,8,474
11,4,11015,870,3,243,222,62,20,12,559,5,14,578
11,4,11015,871,3,232,177,68,22,7,506,0,9,515
11,4,11015,872,3,290,348,101,29,14,782,1,15,798
11,4,11015,873,3,529,511,135,63,32,1270,1,24,1295
11,4,11015,874,3,310,285,65,20,14,694,1,10,705
11,4,11015,875,3,509,312,119,31,25,996,2,20,1018
11,4,11015,876,3,524,329,114,46,27,1040,5,24,1069
11,4,11015,877,3,345,222,72,41,10,690,4,11,705
11,4,11015,878,3,1783,1358,532,197,109,3979,10,74,4063
11,4,11015,879,3,84,78,26,15,5,208,0,9,217
11,4,11015,880,3,127,65,11,1,2,206,0,16,222
11,4,11015,881,3,133,29,10,1,0,173,2,4,179
11,4,11015,882,3,63,94,18,1,5,181,2,9,192
11,4,11015,883,3,175,70,22,0,2,269,0,15,284
11,4,11015,884,3,31,65,5,0,0,101,0,2,103
11,4,11015,885,3,283,91,24,3,4,405,0,6,411
11,4,11015,886,3,79,67,10,2,0,158,0,3,161
11,4,11015,887,3,246,245,24,13,3,531,1,7,539
11,4,11015,888,3,431,76,32,8,4,551,3,13,567
11,4,11015,889,3,389,130,50,12,4,585,0,21,606
11,4,11015,890,3,320,159,28,13,8,528,0,14,542
11,4,11015,891,3,90,46,8,1,2,147,0,5,152
11,4,11015,892,3,29,15,2,1,0,47,0,2,49
11,4,11015,893,3,99,74,39,7,4,223,0,18,241
11,4,11015,894,3,167,153,41,22,10,393,1,12,406
11,4,11015,895,3,217,124,47,1,6,395,2,3,400
11,4,11015,896,3,566,366,134,32,12,1110,0,38,1148
11,4,11015,897,3,433,210,66,23,16,748,1,22,771
11,4,11015,898,3,316,243,54,25,11,649,1,21,671
11,4,11015,899,3,477,376,104,35,21,1013,1,39,1053
11,4,11015,900,3,221,61,22,7,3,314,1,19,334
11,4,11015,901,3,297,186,51,19,7,560,0,29,589
11,4,11015,902,3,460,287,85,23,17,872,0,16,888
11,4,11015,903,3,290,188,77,25,8,588,0,14,602
11,4,11015,904,3,306,183,34,13,13,549,1,27,577
11,4,11015,905,3,303,189,61,7,13,573,1,16,590
11,4,11015,906,3,160,104,32,9,7,312,0,11,323
11,4,11015,907,3,251,185,27,9,9,481,1,1,483
11,4,11015,908,3,355,343,55,21,3,777,6,35,818
11,4,11015,909,3,548,128,107,30,7,820,1,16,837
11,4,11015,910,3,503,111,36,5,11,666,2,26,694
11,4,11015,911,3,351,89,16,8,7,471,2,17,490
11,4,11015,912,3,527,183,176,12,7,905,7,26,938
11,4,11015,913,3,316,56,15,6,1,394,1,8,403
11,4,11015,914,3,534,122,30,3,2,691,2,18,711
11,4,11015,915,3,583,464,133,78,53,1311,0,9,1320
11,4,11017,931,3,230,56,47,16,6,355,0,1,356
11,4,11017,932,3,390,91,85,29,15,610,0,7,617
11,4,11017,940,3,590,122,63,33,11,819,0,9,828
11,4,11017,941,3,592,135,65,37,16,845,0,7,852
11,4,11017,945,3,415,102,77,32,12,638,0,5,643
11,4,11017,951,3,721,191,151,62,33,1158,1,10,1169
11,4,11017,964,3,338,86,59,15,6,504,3,11,518
11,4,11017,965,3,217,43,48,14,13,335,2,1,338
11,4,11017,966,3,394,460,168,32,18,1072,18,23,1113
11,4,11017,967,3,526,298,185,33,13,1055,16,42,1113
11,4,11017,968,3,165,419,103,22,16,725,0,12,737
11,4,11017,969,3,337,118,62,23,10,550,6,18,574
11,4,11017,979,3,403,116,109,31,9,668,0,16,684
11,4,11017,980,3,841,478,270,46,22,1657,10,61,1728
11,4,11017,981,3,258,72,115,11,3,459,6,13,478
11,4,11017,997,3,377,147,109,15,11,659,1,12,672
11,4,11017,998,3,176,169,64,12,7,428,5,9,442
11,4,11017,999,3,193,306,101,20,6,626,12,6,644
11,4,11017,1000,3,994,344,199,63,31,1631,11,28,1670
11,4,11017,1025,3,274,77,106,15,5,477,7,18,502
11,4,11017,1026,3,258,155,126,17,10,566,6,11,583
11,4,11017,1027,3,222,96,33,12,10,373,0,7,380
11,4,11017,1028,3,239,235,81,27,7,589,1,17,607
11,4,11017,1029,3,374,153,67,20,12,626,1,12,639
11,4,11017,1117,3,399,318,89,25,4,835,2,13,850
11,4,11017,1118,3,289,119,33,9,8,458,11,6,475
11,4,11017,1119,3,356,163,55,15,7,596,4,24,624
11,4,11017,1120,3,287,155,37,8,6,493,8,18,519
11,4,11017,1121,3,412,158,60,16,3,649,8,20,677
11,4,11017,1125,3,248,145,92,10,4,499,6,10,515
11,4,11017,1126,3,119,357,51,1,2,530,4,58,592
11,4,11017,1128,3,308,78,47,7,5,445,1,14,460
11,4,11017,1129,3,511,127,70,11,13,732,5,31,768
11,4,11017,1133,3,311,148,38,8,7,512,1,11,524
11,4,11017,1134,3,316,258,34,9,5,622,2,12,636
11,4,11017,1136,3,473,160,60,12,9,714,5,31,750
11,4,11017,1137,3,494,125,67,23,16,725,8,18,751
11,4,11017,1140,3,439,235,80,10,3,767,7,45,819
11,4,11017,1141,3,388,177,88,8,4,665,1,33,699
11,4,11017,1144,3,433,64,32,25,10,564,0,10,574
11,4,11017,1145,3,226,50,42,5,5,328,3,0,331
11,4,11017,1146,3,135,22,22,2,1,182,0,6,188
11,4,11017,1147,3,436,90,42,12,9,589,3,17,609
11,4,11017,1148,3,609,197,144,15,12,977,7,37,1021
11,4,11017,1156,3,131,46,12,8,2,199,0,5,204
11,4,11017,1159,3,567,152,32,11,2,764,0,5,769
11,4,11017,1163,3,502,259,80,21,5,867,1,17,885
11,5,11020,1261,3,672,344,87,44,28,1175,10,49,1234
11,5,11020,1262,3,345,155,30,17,8,555,0,19,574
11,5,11020,1263,3,427,173,27,23,6,656,1,16,673
11,5,11020,1264,3,366,95,24,8,5,498,2,16,516
11,5,11020,1267,3,664,227,60,41,23,1015,4,35,1054
11,5,11020,1268,3,331,114,39,20,19,523,2,13,538
11,5,11020,1269,3,720,445,81,40,24,1310,15,51,1376
11,5,11020,1281,3,690,160,52,22,17,941,5,26,972
11,5,11020,1282,3,1768,265,125,38,41,2237,2,44,2283
11,5,11020,1290,3,258,47,17,13,3,338,0,4,342
11,5,11020,1291,3,273,39,32,6,8,358,1,2,361
11,5,11020,1313,3,483,57,42,14,26,622,3,1,626
11,5,11020,1399,3,263,43,25,14,4,349,2,2,353
11,5,11020,1400,3,413,78,38,21,10,560,1,8,569
11,5,11020,1401,3,298,52,27,12,7,396,0,4,400
11,5,11020,1402,3,265,33,31,5,7,341,3,3,347
11,5,11020,1422,3,290,56,30,7,8,391,1,9,401
11,5,11020,1423,3,174,32,31,9,7,253,2,0,255
11,5,11020,1424,3,288,78,39,6,10,421,1,12,434
11,5,11020,1425,3,285,78,52,11,11,437,1,10,448
11,5,11020,1426,3,233,48,48,12,8,349,0,11,360
11,5,11020,1458,3,175,54,33,6,11,279,0,6,285
11,5,11020,1459,3,336,72,54,9,9,480,0,4,484
11,5,11020,1471,3,64,19,4,0,0,87,0,3,90
11,5,11020,1473,3,455,192,22,12,3,684,0,21,705
11,5,11020,1477,3,1343,541,179,69,51,2183,18,76,2277
11,5,11020,1478,3,289,50,18,2,8,367,3,15,385
11,5,11020,1483,3,426,257,57,23,16,779,8,31,818
11,5,11020,1484,3,54,6,4,0,0,64,0,5,69
11,5,11020,1490,3,436,350,90,16,13,905,4,42,951
11,5,11020,1491,3,586,338,114,38,29,1105,5,50,1160
11,5,11020,1492,3,493,244,52,30,20,839,10,21,870
11,5,11020,1493,3,344,188,61,26,19,638,0,29,667
11,5,11020,1494,3,1379,802,236,92,60,2569,22,69,2660
11,5,11020,1674,3,959,206,99,74,45,1383,0,16,1399
11,5,11020,1675,3,952,146,101,49,30,1278,4,7,1289
11,5,11020,1676,3,524,136,70,33,14,777,5,15,797
11,5,11020,1677,3,689,392,122,50,30,1283,5,46,1334
11,5,11020,1678,3,387,110,38,25,12,572,1,13,586
11,5,11020,1679,3,582,85,70,22,14,773,1,10,784
11,5,11020,1680,3,539,131,49,19,15,753,2,5,760
11,5,11020,1681,3,2168,517,236,68,75,3064,12,57,3133
11,5,11020,1682,3,393,97,37,16,12,555,2,2,559
11,5,11020,1683,3,537,92,47,25,17,718,0,7,725
11,5,11020,1684,3,409,136,40,26,14,625,2,12,639
11,5,11020,1685,3,266,56,37,15,16,390,0,7,397
11,5,11020,1686,3,464,124,46,15,23,672,3,13,688
11,5,11020,1687,3,1309,158,62,20,17,1566,2,20,1588
11,5,11020,1688,3,448,111,33,26,15,633,0,9,642
11,5,11020,1689,3,644,119,71,29,25,888,4,15,907
11,5,11020,1690,3,585,150,70,32,19,856,6,10,872
11,5,11020,1691,3,721,205,62,32,17,1037,4,11,1052
11,5,11020,1692,3,703,109,74,43,27,956,2,11,969
11,5,11020,1693,3,533,114,64,25,27,763,1,4,768
11,5,11020,1694,3,1146,130,61,30,34,1401,3,6,1410
11,5,11020,1695,3,956,158,75,29,38,1256,1,9,1266
11,5,11020,1696,3,817,199,94,29,20,1159,1,19,1179
11,5,11020,1697,3,1445,166,113,53,32,1809,5,14,1828
11,5,11020,1698,3,723,88,53,27,22,913,0,14,927
11,5,11020,1699,3,510,60,34,17,15,636,2,5,643
11,5,11020,1700,3,905,146,69,32,26,1178,6,23,1207
11,5,11020,1701,3,544,94,32,23,10,703,0,5,708
11,5,11020,1702,3,798,122,30,9,15,974,2,4,980
11,5,11020,1703,3,189,32,12,5,8,246,0,0,246
11,5,11020,1704,3,815,79,46,15,13,968,1,7,976
11,5,11020,1705,3,801,85,54,18,14,972,0,12,984
11,5,11020,1706,3,566,116,25,23,12,742,5,16,763
11,5,11020,1707,3,346,70,32,18,10,476,1,8,485
11,5,11020,1708,3,793,103,73,25,16,1010,2,10,1022
11,5,11020,1709,3,806,155,47,22,18,1048,2,24,1074
11,5,11020,1710,3,543,124,72,32,14,785,5,12,802
11,5,11020,1711,3,752,93,45,19,10,919,0,5,924
11,5,11020,1712,3,348,27,37,4,11,427,0,5,432
11,5,11020,1713,3,725,79,34,16,13,867,0,11,878
11,5,11020,1714,3,751,88,40,14,11,904,0,17,921
11,5,11020,1715,3,622,97,46,16,18,799,0,5,804
11,5,11020,1716,3,468,85,53,17,16,639,2,10,651
11,5,11020,1717,3,605,79,40,15,11,750,0,6,756
11,5,11020,1718,3,678,107,32,28,14,859,4,23,886
11,5,11020,1719,3,783,170,53,29,22,1057,3,22,1082
11,5,11020,1720,3,582,106,34,21,12,755,4,23,782
11,5,11020,1721,3,525,134,48,14,11,732,0,24,756
11,5,11020,1722,3,550,205,130,33,23,941,4,27,972
11,5,11020,1723,3,494,122,76,51,33,776,2,10,788
11,5,11020,1724,3,506,142,61,60,12,781,5,4,790
11,5,11020,1725,3,306,43,16,7,1,373,1,10,384
11,5,11020,1726,3,509,141,41,18,12,721,0,16,737
11,5,11020,1727,3,619,201,36,17,15,888,2,30,920
11,5,11020,1728,3,466,45,26,11,11,559,1,7,567
11,5,11020,1729,3,524,98,34,26,15,697,3,8,708
11,5,11020,1730,3,430,139,20,9,16,614,2,14,630
11,5,11020,1731,3,732,209,84,33,20,1078,7,16,1101
11,5,11020,1732,3,746,285,78,30,17,1156,0,24,1180
11,5,11020,1733,3,804,223,90,35,15,1167,5,37,1209
11,5,11020,1734,3,678,156,51,25,12,922,7,16,945
11,5,11020,1735,3,450,176,47,15,16,704,3,12,719
11,5,11020,1736,3,415,110,36,16,10,587,1,17,605
11,5,11020,1737,3,540,114,39,20,4,717,9,6,732
11,5,11020,1738,3,336,108,32,19,4,499,1,11,511
11,5,11020,1739,3,597,153,51,26,17,844,1,18,863
11,5,11020,1740,3,482,96,61,19,18,676,8,14,698
11,5,11020,1741,3,1014,337,93,62,35,1541,8,37,1586
11,5,11020,1742,3,458,166,58,17,15,714,4,14,732
11,5,11020,1743,3,305,95,27,13,6,446,0,7,453
11,5,11020,1744,3,491,102,41,25,12,671,0,11,682
11,5,11020,1745,3,652,191,95,24,15,977,3,40,1020
11,5,11020,1746,3,484,110,38,24,9,665,1,20,686
11,5,11020,1747,3,980,341,122,60,29,1532,3,52,1587
11,5,11020,1748,3,654,135,51,25,18,883,4,13,900
11,5,11020,1749,3,477,181,43,23,21,745,5,5,755
11,5,11020,1750,3,353,137,50,14,18,572,6,20,598
11,5,11020,1751,3,555,197,61,39,24,876,2,25,903
11,5,11020,1752,3,525,220,56,12,15,828,3,51,882
11,5,11020,1753,3,750,178,59,33,21,1041,10,20,1071
11,5,11020,1754,3,670,177,70,23,22,962,12,36,1010
11,5,11020,1755,3,563,117,56,24,14,774,1,11,786
11,5,11020,1756,3,473,83,38,10,6,610,0,9,619
11,5,11020,1757,3,257,61,22,0,11,351,4,3,358
11,5,11020,1758,3,524,98,57,17,17,713,1,8,722
11,5,11020,1759,3,676,170,56,25,17,944,3,22,969
11,5,11020,1760,3,776,143,53,33,24,1029,2,15,1046
11,5,11020,1761,3,436,105,32,23,17,613,1,9,623
11,5,11020,1762,3,437,89,49,18,16,609,0,9,618
11,5,11020,1763,3,466,118,26,17,11,638,2,8,648
11,5,11020,1764,3,624,117,60,26,14,841,2,20,863
11,5,11020,1765,3,585,172,68,28,20,873,4,17,894
11,5,11020,1766,3,619,165,85,26,21,916,1,20,937
11,5,11020,1767,3,638,164,48,18,20,888,2,12,902
11,5,11020,1768,3,546,191,72,28,19,856,0,16,872
11,5,11020,1769,3,565,188,65,23,20,861,3,20,884
11,5,11020,1770,3,868,198,77,32,17,1192,2,9,1203
11,5,11020,1771,3,534,124,51,23,17,749,1,13,763
11,5,11020,1772,3,439,114,48,26,13,640,2,11,653
11,5,11020,1773,3,511,161,50,24,10,756,3,19,778
11,5,11020,1774,3,590,180,75,30,17,892,6,31,929
11,5,11020,1775,3,568,140,63,25,18,814,6,17,837
11,5,11020,1776,3,385,96,24,14,11,530,1,14,545
11,5,11020,1777,3,397,96,33,14,3,543,2,4,549
11,5,11020,1778,3,383,85,36,17,11,532,11,3,546
11,5,11020,1779,3,527,158,53,33,8,779,2,19,800
11,5,11020,1780,3,551,182,51,24,19,827,0,23,850
11,5,11020,1781,3,517,171,57,15,21,781,4,12,797
11,5,11020,1782,3,574,121,52,21,14,782,1,22,805
11,5,11020,1783,3,485,123,38,15,8,669,2,16,687
11,5,11020,1784,3,470,115,50,20,14,669,4,21,694
11,5,11020,1785,3,510,151,46,24,12,743,2,12,757
11,5,11020,1786,3,642,197,70,27,24,960,12,15,987
11,5,11020,1787,3,1091,269,117,62,33,1572,9,26,1607
11,5,11020,1788,3,286,87,47,7,12,439,0,12,451
11,5,11020,1789,3,532,117,42,14,14,719,0,14,733
11,5,11020,1790,3,467,156,65,18,20,726,0,12,738
11,5,11020,1791,3,541,144,45,25,17,772,2,18,792
11,5,11020,1792,3,631,179,58,40,10,918,1,28,947
11,5,11020,1793,3,405,173,66,24,12,680,1,11,692
11,5,11020,1794,3,1590,424,207,99,53,2373,3,33,2409
11,5,11020,1795,3,579,145,37,25,10,796,6,27,829
11,5,11020,1796,3,573,145,54,15,20,807,3,33,843
11,5,11020,1797,3,510,153,54,14,12,743,1,18,762
11,5,11020,1798,3,383,74,27,19,7,510,2,11,523
11,5,11020,1799,3,313,77,43,25,6,464,2,1,467
11,5,11020,1800,3,493,122,42,14,13,684,2,8,694
11,5,11020,1801,3,396,117,65,25,12,615,2,17,634
11,5,11020,1802,3,597,127,44,16,20,804,0,15,819
11,5,11020,1803,3,731,241,76,27,28,1103,4,31,1138
11,5,11020,1804,3,396,103,31,15,8,553,2,7,562
11,5,11020,1805,3,594,86,38,17,6,741,0,11,752
11,5,11020,1806,3,379,122,61,8,15,585,2,5,592
11,5,11020,1807,3,403,90,21,19,9,542,3,12,557
11,5,11020,1808,3,262,71,39,12,6,390,1,4,395
11,5,11020,1809,3,1219,361,197,68,46,1891,5,31,1927
11,5,11020,1810,3,518,186,67,29,20,820,7,14,841
11,5,11020,1811,3,444,99,29,13,11,596,1,7,604
11,5,11020,1812,3,196,174,48,9,7,434,5,7,446
11,5,11020,1813,3,1017,151,57,20,29,1274,3,17,1294
11,5,11020,1814,3,544,159,73,20,22,818,2,24,844
11,5,11020,1815,3,297,53,29,6,8,393,0,5,398
11,5,11020,1816,3,664,66,61,19,17,827,0,8,835
11,5,11020,1817,3,665,151,43,21,12,892,4,16,912
11,5,11020,1818,3,434,232,58,32,15,771,6,27,804
11,5,11020,1819,3,199,109,51,12,4,375,8,8,391
11,5,11020,1820,3,255,94,48,14,8,419,0,11,430
11,5,11020,1821,3,315,127,40,22,12,516,0,13,529
11,5,11020,1823,3,509,165,41,11,13,739,3,15,757
11,5,11020,1824,3,483,187,53,15,8,746,3,23,772
11,5,11020,1825,3,477,133,49,23,13,695,5,13,713
11,5,11020,1826,3,777,177,71,31,18,1074,3,12,1089
11,5,11020,1827,3,721,139,69,33,13,975,4,8,987
11,5,11020,1828,3,506,165,53,19,14,757,3,32,792
11,5,11020,1829,3,698,105,69,22,16,910,1,16,927
11,5,11020,1830,3,457,133,60,17,9,676,1,8,685
11,5,11020,1831,3,690,122,41,19,16,888,1,23,912
11,5,11020,1832,3,583,172,66,20,15,856,6,23,885
11,5,11020,1833,3,460,140,42,13,6,661,5,12,678
11,5,11020,1834,3,484,181,47,14,14,740,3,23,766
11,5,11020,1835,3,479,163,46,19,12,719,7,22,748
11,5,11020,1836,3,459,156,57,17,15,704,0,28,732
11,5,11020,1837,3,660,157,63,26,16,922,2,7,931
11,5,11020,1838,3,473,171,41,21,14,720,2,14,736
11,5,11020,1839,3,565,142,76,24,15,822,5,13,840
11,5,11020,1840,3,568,133,52,21,13,787,3,17,807
11,5,11020,1841,3,607,148,46,26,22,849,6,23,878
11,5,11020,1846,3,894,175,91,40,23,1223,7,15,1245
11,5,11020,1847,3,1103,278,106,49,50,1586,3,16,1605
11,5,11020,3006,3,342,156,31,14,12,555,1,18,574
11,5,11020,3007,3,303,41,17,15,9,385,2,2,389
11,5,11020,3008,3,313,77,38,12,6,446,7,7,460
11,5,11020,3009,3,316,83,33,9,17,458,7,13,478
11,5,11020,3010,3,264,48,25,15,6,358,3,4,365
11,5,11020,3011,3,349,110,46,8,13,526,7,16,549
11,5,11020,3012,3,334,83,37,10,10,474,3,13,490
11,5,11020,3013,3,122,45,23,2,1,193,2,8,203
11,5,11020,3014,3,348,87,50,18,16,519,2,9,530
11,5,11020,3015,3,73,21,9,4,4,111,0,3,114
11,5,11020,3016,3,51,43,15,2,0,111,1,7,119
11,5,11020,3017,3,280,99,34,8,8,429,2,4,435
11,5,11020,3018,3,266,71,36,22,12,407,6,4,417
11,5,11020,3019,3,302,93,39,15,8,457,4,4,465
11,5,11020,3020,3,368,106,13,19,21,527,3,12,542
11,5,11020,3021,3,357,111,37,17,17,539,1,11,551
11,5,11020,3022,3,295,146,32,11,17,501,0,7,508
11,5,11020,3023,3,250,130,20,12,10,422,3,7,432
11,5,11020,3024,3,276,126,42,16,23,483,0,7,490
11,5,11020,3025,3,350,165,29,21,17,582,2,12,596
11,5,11020,3026,3,318,76,45,21,7,467,6,6,479
11,5,11020,3027,3,285,82,30,15,17,429,1,5,435
11,5,11020,3028,3,281,117,31,17,17,463,2,12,477
11,5,11020,3029,3,288,96,27,16,10,437,8,0,445
11,5,11020,3030,3,273,93,46,13,10,435,3,9,447
11,6,11020,1421,3,369,101,49,7,11,537,6,11,554
11,6,11020,1427,3,304,57,39,12,10,422,0,4,426
11,6,11020,1428,3,309,117,47,22,15,510,4,13,527
11,6,11020,1441,3,261,49,20,5,7,342,1,7,350
11,6,11020,1444,3,241,41,46,10,12,350,1,6,357
11,6,11020,1445,3,190,32,22,7,5,256,1,3,260
11,6,11020,1446,3,327,75,43,13,5,463,2,3,468
11,6,11020,1447,3,296,63,42,15,9,425,0,7,432
11,6,11020,1448,3,260,83,42,17,9,411,1,6,418
11,6,11020,1449,3,203,109,32,15,7,366,3,4,373
11,6,11020,1454,3,232,47,17,5,4,305,0,0,305
11,6,11020,1455,3,200,48,36,10,3,297,7,6,310
11,6,11020,1456,3,324,75,28,12,11,450,2,7,459
11,6,11020,1457,3,185,37,18,8,5,253,2,3,258
11,6,11020,1460,3,368,90,49,20,9,536,3,9,548
11,6,11020,1461,3,519,121,52,15,16,723,13,2,738
11,6,11020,1462,3,272,59,33,15,7,386,2,6,394
11,6,11020,1463,3,421,94,53,14,8,590,2,10,602
11,6,11020,1464,3,239,97,23,8,6,373,7,11,391
11,6,11020,1465,3,359,246,51,18,13,687,5,27,719
11,6,11020,1466,3,317,96,30,10,10,463,0,10,473
11,6,11020,1467,3,400,108,36,22,9,575,1,12,588
11,6,11020,1468,3,490,258,82,27,13,870,19,20,909
11,6,11020,1469,3,255,99,25,14,9,402,0,10,412
11,6,11020,1501,3,646,378,83,126,12,1245,8,46,1299
11,6,11020,1502,3,472,322,67,22,17,900,6,41,947
11,6,11020,1507,3,322,46,11,4,3,386,3,2,391
11,6,11020,1511,3,393,70,30,10,3,506,1,16,523
11,6,11020,1514,3,368,72,27,6,5,478,0,4,482
11,6,11020,1515,3,470,56,38,14,6,584,1,6,591
11,6,11020,1516,3,622,116,46,14,6,804,1,8,813
11,6,11020,1517,3,594,174,56,13,11,848,0,8,856
11,6,11020,1518,3,755,153,80,40,14,1042,7,23,1072
11,6,11020,1519,3,657,106,36,15,15,829,0,3,832
11,6,11020,1520,3,318,60,20,6,7,411,0,4,415
11,6,11020,1521,3,379,73,27,11,15,505,1,6,512
11,6,11020,1522,3,429,128,48,25,13,643,0,9,652
11,6,11020,1523,3,452,115,37,16,11,631,4,8,643
11,6,11020,1524,3,375,88,32,19,7,521,1,8,530
11,6,11020,1525,3,421,116,46,18,11,612,1,7,620
11,6,11020,1526,3,615,133,51,13,19,831,2,16,849
11,6,11020,1527,3,419,72,20,16,12,539,0,2,541
11,6,11020,1528,3,450,75,36,12,12,585,2,4,591
11,6,11020,1529,3,692,102,50,21,17,882,2,3,887
11,6,11020,1530,3,586,131,55,21,21,814,6,19,839
11,6,11020,1531,3,540,128,113,33,23,837,1,9,847
11,6,11020,1532,3,746,148,70,34,19,1017,1,16,1034
11,6,11020,1533,3,622,110,58,30,12,832,2,6,840
11,6,11020,1534,3,569,113,79,18,14,793,0,9,802
11,6,11020,1535,3,567,95,72,20,11,765,0,3,768
11,6,11020,1536,3,334,85,61,18,13,511,0,8,519
11,6,11020,1537,3,639,151,45,36,14,885,3,15,903
11,6,11020,1538,3,688,164,52,27,18,949,2,21,972
11,6,11020,1539,3,549,168,66,23,6,812,1,22,835
11,6,11020,1540,3,419,122,44,23,6,614,5,16,635
11,6,11020,1541,3,241,80,33,11,5,370,0,11,381
11,6,11020,1542,3,263,96,29,8,7,403,1,6,410
11,6,11020,1543,3,423,130,59,22,14,648,6,8,662
11,6,11020,1544,3,368,63,30,12,9,482,0,4,486
11,6,11020,1545,3,496,88,40,14,6,644,5,9,658
11,6,11020,1546,3,558,128,49,23,11,769,5,20,794
11,6,11020,1547,3,847,129,81,31,21,1109,4,19,1132
11,6,11020,1548,3,760,170,84,20,20,1054,0,9,1063
11,6,11020,1549,3,293,110,53,10,5,471,5,5,481
11,6,11020,1550,3,293,127,30,6,5,461,1,6,468
11,6,11020,1551,3,266,69,39,14,10,398,4,10,412
11,6,11020,1552,3,594,185,53,22,7,861,4,15,880
11,6,11020,1553,3,625,145,47,21,15,853,2,19,874
11,6,11020,1554,3,694,146,69,36,18,963,0,28,991
11,6,11020,1555,3,586,183,79,26,8,882,0,16,898
11,6,11020,1556,3,600,200,39,19,16,874,1,14,889
11,6,11020,1557,3,636,207,52,28,24,947,0,16,963
11,6,11020,1558,3,659,233,90,40,20,1042,0,31,1073
11,6,11020,1559,3,694,137,64,41,20,956,4,12,972
11,6,11020,1560,3,503,200,79,65,19,866,0,11,877
11,6,11020,1561,3,1118,184,129,56,38,1525,1,8,1534
11,6,11020,1562,3,628,131,86,21,26,892,2,5,899
11,6,11020,1563,3,449,76,58,28,16,627,2,3,632
11,6,11020,1564,3,475,93,64,17,19,668,0,2,670
11,6,11020,1565,3,466,120,62,39,15,702,1,4,707
11,6,11020,1566,3,616,239,109,51,19,1034,3,18,1055
11,6,11020,1567,3,644,185,97,56,9,991,1,14,1006
11,6,11020,1568,3,439,126,61,18,10,654,3,15,672
11,6,11020,1569,3,639,182,52,30,14,917,5,15,937
11,6,11020,1570,3,557,80,48,22,12,719,0,6,725
11,6,11020,1571,3,291,114,32,9,4,450,0,19,469
11,6,11020,1572,3,331,81,38,9,10,469,0,13,482
11,6,11020,1573,3,266,76,26,13,6,387,2,1,390
11,6,11020,1574,3,635,139,61,21,15,871,7,10,888
11,6,11020,1575,3,525,106,56,18,12,717,9,10,736
11,6,11020,1576,3,446,87,34,17,9,593,3,3,599
11,6,11020,1577,3,560,169,56,17,4,806,2,11,819
11,6,11020,1578,3,334,124,43,17,10,528,1,8,537
11,6,11020,1579,3,252,113,32,10,4,411,0,7,418
11,6,11020,1580,3,234,100,17,11,2,364,2,4,370
11,6,11020,1581,3,700,114,83,38,20,955,8,9,972
11,6,11020,1582,3,337,75,29,26,13,480,2,4,486
11,6,11020,1583,3,716,168,100,42,31,1057,1,9,1067
11,6,11020,1584,3,530,86,49,24,25,714,0,5,719
11,6,11020,1585,3,1562,328,151,57,41,2139,9,32,2180
11,6,11020,1586,3,539,95,56,39,15,744,3,6,753
11,6,11020,1587,3,475,129,54,29,13,700,7,10,717
11,6,11020,1588,3,743,165,90,48,28,1074,3,23,1100
11,6,11020,1589,3,555,229,91,37,15,927,9,9,945
11,6,11020,1590,3,676,272,75,37,16,1076,2,17,1095
11,6,11020,1591,3,1053,333,74,35,17,1512,6,37,1555
11,6,11020,1592,3,641,227,80,23,18,989,4,9,1002
11,6,11020,1593,3,686,251,58,26,11,1032,4,18,1054
11,6,11020,1594,3,737,230,87,25,22,1101,1,16,1118
11,6,11020,1595,3,457,161,52,17,12,699,1,10,710
11,6,11020,1596,3,518,176,52,22,11,779,14,12,805
11,6,11020,1597,3,285,118,32,14,10,459,8,7,474
11,6,11020,1598,3,511,169,55,16,14,765,3,7,775
11,6,11020,1599,3,279,124,64,16,7,490,2,9,501
11,6,11020,1600,3,533,147,51,20,17,768,9,13,790
11,6,11020,1601,3,540,193,73,13,10,829,4,22,855
11,6,11020,1602,3,263,91,33,10,10,407,0,10,417
11,6,11020,1603,3,631,180,65,21,13,910,7,20,937
11,6,11020,1604,3,1088,313,106,52,27,1586,15,18,1619
11,6,11020,1605,3,340,187,36,12,11,586,1,13,600
11,6,11020,1606,3,476,179,55,29,18,757,1,5,763
11,6,11020,1607,3,295,95,34,18,9,451,4,7,462
11,6,11020,1608,3,501,170,45,13,11,740,1,11,752
11,6,11020,1609,3,571,177,49,15,8,820,8,18,846
11,6,11020,1610,3,483,153,73,34,14,757,2,17,776
11,6,11020,1611,3,521,296,101,50,21,989,10,19,1018
11,6,11020,1612,3,530,359,73,23,13,998,1,16,1015
11,6,11020,1613,3,1077,359,146,55,40,1677,9,27,1713
11,6,11020,1614,3,2056,513,221,105,58,2953,14,47,3014
11,6,11020,1615,3,457,114,43,8,15,637,4,10,651
11,6,11020,1616,3,499,85,60,23,17,684,4,11,699
11,6,11020,1617,3,564,142,82,32,15,835,2,9,846
11,6,11020,1618,3,422,97,66,21,16,622,4,5,631
11,6,11020,1619,3,396,91,65,25,12,589,3,6,598
11,6,11020,1620,3,1648,548,229,93,59,2577,29,23,2629
11,6,11020,1621,3,468,116,81,37,24,726,1,13,740
11,6,11020,1622,3,262,74,50,23,17,426,0,3,429
11,6,11020,1623,3,519,229,70,24,22,864,1,33,898
11,6,11020,1624,3,397,149,28,14,12,600,1,13,614
11,6,11020,1625,3,361,138,55,10,12,576,6,14,596
11,6,11020,1626,3,889,227,101,41,23,1281,7,19,1307
11,6,11020,1627,3,747,243,147,35,19,1191,5,38,1234
11,6,11020,1628,3,442,198,38,31,14,723,7,13,743
11,6,11020,1629,3,602,223,92,54,9,980,2,26,1008
11,6,11020,1630,3,417,84,56,25,13,595,2,4,601
11,6,11020,1631,3,881,332,150,48,25,1436,12,20,1468
11,6,11020,1632,3,2819,727,325,127,83,4081,29,53,4163
11,6,11020,1633,3,1187,275,123,53,42,1680,12,19,1711
11,6,11020,1634,3,2858,753,446,205,121,4383,21,55,4459
11,6,11020,1635,3,1026,222,156,60,43,1507,1,8,1516
11,6,11020,1636,3,342,142,50,15,21,570,3,15,588
11,6,11020,1637,3,399,167,69,20,14,669,12,18,699
11,6,11020,1638,3,300,180,47,18,9,554,14,17,585
11,6,11020,1639,3,335,280,56,23,10,704,6,42,752
11,6,11020,1640,3,323,157,102,23,7,612,4,27,643
11,6,11020,1641,3,986,435,171,48,42,1682,15,33,1730
11,6,11020,1642,3,2498,937,301,123,73,3932,46,109,4087
11,6,11020,1643,3,1340,673,219,65,57,2354,27,49,2430
11,6,11020,1644,3,795,451,124,32,31,1433,14,28,1475
11,6,11020,1645,3,667,448,88,28,16,1247,16,43,1306
11,6,11020,1646,3,831,435,101,40,35,1442,13,36,1491
11,6,11020,1647,3,2303,1004,329,120,81,3837,31,107,3975
11,6,11020,1648,3,178,70,23,2,2,275,0,8,283
11,6,11020,1649,3,346,418,107,27,12,910,9,13,932
11,6,11020,1650,3,338,448,78,20,12,896,4,22,922
11,6,11020,1651,3,461,177,62,16,13,729,6,25,760
11,6,11020,1652,3,276,378,82,14,8,758,11,34,803
11,6,11020,1653,3,624,196,73,11,14,918,6,24,948
11,6,11020,1654,3,639,214,63,15,15,946,7,34,987
11,6,11020,1655,3,361,344,63,15,16,799,7,26,832
11,6,11020,1656,3,197,165,31,6,9,408,1,13,422
11,6,11020,1657,3,359,259,20,9,12,659,0,10,669
11,6,11020,1658,3,786,671,121,52,27,1657,14,66,1737
11,6,11020,1659,3,241,157,47,4,6,455,2,17,474
11,6,11020,1660,3,385,177,94,9,11,676,4,23,703
11,6,11020,1661,3,413,223,107,15,8,766,4,9,779
11,6,11020,1662,3,539,414,125,15,22,1115,2,43,1160
11,6,11020,1663,3,601,226,28,11,4,870,0,20,890
11,6,11020,1664,3,643,250,94,13,17,1017,1,34,1052
11,6,11020,1665,3,503,380,146,15,7,1051,5,30,1086
11,6,11020,1666,3,169,70,33,6,5,283,1,5,289
11,6,11020,1667,3,440,486,148,31,6,1111,4,33,1148
11,6,11020,1668,3,281,172,232,4,1,690,0,6,696
11,6,11020,1669,3,292,191,280,19,13,795,4,18,817
11,6,11020,1670,3,191,233,60,14,5,503,1,12,516
11,6,11020,1671,3,230,184,63,5,1,483,4,18,505
11,6,11020,1672,3,786,273,76,43,21,1199,3,32,1234
11,6,11020,1673,3,416,168,48,13,9,654,1,17,672
11,6,11020,1842,3,639,182,62,21,15,919,7,19,945
11,6,11020,1843,3,315,116,39,10,11,491,0,10,501
11,6,11020,1844,3,383,133,35,19,7,577,1,16,594
11,6,11020,1845,3,549,184,50,26,7,816,7,15,838
11,6,11020,1848,3,511,152,51,29,8,751,7,16,774
11,6,11020,1849,3,612,173,64,24,17,890,4,10,904
11,6,11020,1850,3,488,104,36,7,17,652,5,24,681
11,6,11020,1851,3,641,166,41,35,23,906,5,17,928
11,6,11020,1852,3,577,179,57,28,14,855,1,11,867
11,6,11020,1853,3,496,140,79,27,13,755,3,7,765
11,6,11020,1854,3,580,192,42,21,13,848,5,9,862
11,6,11020,1855,3,521,117,49,22,10,719,8,18,745
11,6,11020,1856,3,725,109,58,28,14,934,1,19,954
11,6,11020,1857,3,672,178,64,29,16,959,9,19,987
11,6,11020,1858,3,709,279,80,26,21,1115,8,14,1137
11,7,11025,2034,3,643,238,44,19,7,951,1,11,963
11,7,11025,2035,3,926,290,60,18,16,1310,2,24,1336
11,7,11025,2036,3,1514,356,104,32,22,2028,4,30,2062
11,7,11025,2037,3,590,280,35,9,6,920,0,12,932
11,7,11025,2038,3,658,378,53,21,6,1116,1,15,1132
11,7,11025,2039,3,747,382,61,30,11,1231,4,18,1253
11,7,11025,2040,3,277,322,30,11,4,644,0,6,650
11,7,11025,2041,3,608,352,31,17,8,1016,1,18,1035
11,7,11025,2042,3,1591,566,114,39,25,2335,6,29,2370
11,7,11025,2043,3,505,308,52,13,6,884,2,23,909
11,7,11025,2044,3,613,203,38,13,6,873,7,24,904
11,7,11025,2045,3,527,150,46,9,2,734,4,23,761
11,7,11025,2046,3,337,119,31,1,5,493,0,20,513
11,7,11025,2047,3,234,165,37,5,1,442,2,8,452
11,7,11025,2048,3,392,115,34,7,2,550,1,8,559
11,7,11025,2049,3,457,260,42,17,9,785,6,29,820
11,7,11025,2050,3,386,262,26,6,8,688,3,17,708
11,7,11025,2051,3,426,152,23,6,4,611,1,6,618
11,7,11025,2052,3,637,94,12,9,2,754,0,5,759
11,7,11025,2053,3,596,41,21,6,5,669,0,10,679
11,7,11025,2054,3,394,53,5,4,1,457,0,8,465
11,7,11025,2055,3,314,134,10,3,3,464,0,11,475
11,7,11025,2056,3,127,75,2,0,1,205,1,6,212
11,7,11025,2057,3,163,138,8,4,2,315,2,23,340
11,7,11025,2058,3,205,75,9,7,0,296,3,7,306
11,7,11026,2059,3,184,84,45,139,3,455,1,4,460
11,7,11026,2060,3,315,89,75,84,2,565,2,8,575
11,7,11026,2061,3,253,150,100,127,8,638,0,13,651
11,7,11026,2062,3,418,151,151,195,12,927,0,20,947
11,7,11026,2063,3,209,98,88,104,6,505,1,4,510
11,7,11026,2064,3,360,151,97,150,3,761,0,20,781
11,7,11026,2065,3,348,111,122,166,7,754,2,21,777
11,7,11026,2066,3,276,99,62,173,8,618,0,16,634
11,7,11026,2067,3,194,125,85,101,3,508,0,18,526
11,7,11026,2068,3,346,153,151,127,0,777,0,19,796
11,7,11026,2069,3,295,101,91,140,6,633,1,9,643
11,7,11026,2070,3,163,80,65,134,3,445,4,22,471
11,7,11026,2071,3,243,80,99,105,9,536,0,22,558
11,7,11026,2072,3,243,192,177,9,2,623,1,23,647
11,7,11026,2073,3,37,24,3,8,0,72,0,4,76
11,7,11026,2074,3,223,79,82,92,4,480,2,17,499
11,7,11026,2075,3,61,49,28,13,1,152,0,9,161
11,7,11026,2076,3,67,51,51,10,1,180,0,0,180
11,7,11026,2077,3,60,12,28,6,0,106,0,9,115
11,7,11026,2078,3,60,3,42,3,0,108,0,11,119
11,7,11026,2079,3,235,57,160,13,1,466,1,14,481
11,7,11026,2080,3,24,30,71,20,2,147,0,6,153
11,7,11026,2081,3,90,78,30,1,0,199,0,5,204
11,7,11026,2082,3,31,50,60,18,1,160,0,3,163
11,7,11026,2083,3,68,3,10,17,0,98,1,0,99
11,7,11026,2084,3,145,42,30,25,0,242,0,19,261
11,7,11026,2085,3,251,138,81,31,5,506,0,15,521
11,7,11026,2086,3,445,70,132,25,5,677,1,27,705
11,7,11026,2087,3,125,50,84,23,2,284,0,0,284
11,7,11026,2088,3,176,107,151,33,4,471,0,37,508
11,7,11026,2089,3,126,39,61,7,1,234,0,7,241
11,7,11026,2090,3,47,57,18,10,0,132,0,5,137
11,7,11026,2091,3,11,25,45,2,0,83,0,1,84
11,7,11026,2092,3,58,62,94,52,1,267,0,22,289
11,7,11026,2093,3,91,41,64,7,2,205,0,10,215
11,7,11026,2094,3,8,21,41,2,0,72,0,2,74
11,7,11026,2095,3,229,192,117,38,3,579,0,13,592
11,7,11026,2096,3,30,118,113,10,1,272,2,8,282
11,7,11026,2097,3,33,46,130,12,0,221,0,10,231
11,7,11026,2098,3,121,186,64,16,3,390,0,23,413
11,7,11026,2099,3,207,41,53,8,0,309,2,18,329
11,7,11026,2100,3,40,38,103,2,0,183,0,6,189
11,7,11026,2101,3,92,70,168,6,1,337,1,15,353
11,7,11026,2102,3,223,70,78,13,1,385,0,15,400
11,7,11026,2103,3,29,9,90,7,0,135,0,1,136
11,7,11026,2104,3,41,15,67,1,2,126,0,2,128
11,7,11026,2105,3,34,87,228,17,4,370,0,15,385
11,7,11026,2106,3,123,37,137,4,1,302,0,12,314
11,7,11026,2107,3,144,21,26,2,2,195,0,12,207
11,7,11026,2108,3,69,41,106,5,2,223,2,15,240
11,7,11031,2446,3,128,41,8,6,4,187,0,17,204
11,7,11031,2447,3,493,163,48,14,13,731,1,5,737
11,7,11031,2448,3,760,166,36,22,5,989,1,15,1005
11,7,11031,2449,3,768,237,52,14,10,1081,5,11,1097
11,7,11031,2450,3,582,205,27,15,5,834,0,6,840
11,7,11031,2451,3,573,241,30,10,2,856,0,14,870
11,7,11031,2452,3,611,284,33,7,4,939,5,16,960
11,7,11031,2453,3,707,254,47,11,2,1021,1,32,1054
11,7,11031,2454,3,789,208,36,16,9,1058,0,10,1068
11,7,11031,2455,3,80,39,19,3,1,142,0,10,152
11,7,11031,2456,3,452,186,20,9,8,675,0,5,680
11,7,11031,2457,3,515,198,39,23,8,783,0,16,799
11,7,11031,2458,3,389,200,33,13,8,643,5,9,657
11,7,11031,2459,3,385,118,33,15,9,560,1,6,567
11,7,11031,2460,3,487,177,24,12,6,706,0,9,715
11,7,11031,2461,3,403,187,44,14,4,652,0,7,659
11,7,11031,2462,3,342,155,47,15,2,561,0,12,573
11,7,11031,2463,3,739,286,38,21,11,1095,0,15,1110
11,7,11031,2464,3,275,97,24,7,5,408,0,7,415
11,7,11031,2465,3,707,152,31,14,9,913,1,16,930
11,7,11031,2466,3,681,220,54,17,8,980,0,21,1001
11,7,11031,2467,3,396,157,28,13,4,598,0,8,606
11,7,11031,2468,3,778,235,72,20,8,1113,1,24,1138
11,7,11031,2469,3,600,242,43,16,5,906,5,11,922
11,7,11031,2470,3,796,216,62,18,13,1105,3,12,1120
11,7,11031,2471,3,651,171,44,16,5,887,3,11,901
11,7,11031,2472,3,458,108,27,12,4,609,2,16,627
11,7,11031,2473,3,580,208,44,16,11,859,0,27,886
11,7,11031,2474,3,1007,361,106,41,21,1536,0,17,1553
11,7,11031,2475,3,1318,429,116,46,17,1926,1,24,1951
11,7,11031,2476,3,621,221,54,26,8,930,2,25,957
11,7,11031,2477,3,2006,659,190,72,23,2950,4,46,3000
11,7,11031,2478,3,304,136,30,7,7,484,0,7,491
11,7,11031,2479,3,688,221,64,18,10,1001,5,21,1027
11,7,11031,2480,3,351,158,17,14,4,544,0,14,558
11,7,11031,2481,3,695,190,40,15,8,948,1,22,971
11,7,11031,2482,3,541,273,23,7,7,851,5,23,879
11,7,11031,2483,3,236,245,23,4,1,509,2,30,541
11,7,11031,2484,3,114,122,19,1,4,260,3,0,263
11,7,11031,2485,3,565,167,43,12,10,797,5,22,824
11,7,11031,2486,3,750,264,91,21,8,1134,8,29,1171
11,7,11031,2487,3,411,170,41,4,1,627,1,10,638
11,7,11031,2488,3,170,195,86,6,1,458,1,7,466
11,7,11031,2489,3,186,127,13,1,0,327,1,11,339
11,7,11031,2490,3,156,357,78,10,1,602,0,28,630
11,7,11031,2491,3,212,206,17,6,3,444,1,15,460
11,7,11031,2492,3,182,214,65,4,2,467,5,38,510
11,7,11031,2493,3,148,157,26,3,3,337,1,19,357
11,7,11031,2494,3,187,355,60,4,4,610,3,11,624
11,7,11031,2495,3,263,131,34,8,2,438,1,16,455
11,7,11031,2496,3,290,334,167,11,4,806,1,28,835
11,7,11031,2497,3,201,112,24,3,1,341,0,18,359
11,7,11031,2498,3,132,167,57,5,1,362,2,19,383
11,7,11031,2499,3,142,200,106,5,2,455,1,17,473
11,7,11031,2500,3,237,54,17,0,1,309,0,7,316
11,7,11031,2501,3,224,120,14,9,2,369,0,23,392
11,7,11031,2502,3,265,107,13,3,2,390,1,23,414
11,7,11031,2503,3,215,116,15,5,4,355,0,9,364
11,7,11031,2504,3,269,59,6,2,1,337,2,21,360
11,7,11037,2654,3,620,264,185,45,21,1135,5,25,1165
11,7,11037,2655,3,565,183,120,40,10,918,2,35,955
11,7,11037,2656,3,439,174,88,37,20,758,1,10,769
11,7,11037,2657,3,358,181,126,35,16,716,4,17,737
11,7,11037,2658,3,307,193,111,40,7,658,0,24,682
11,7,11037,2659,3,424,242,162,52,19,899,3,33,935
11,7,11037,2660,3,339,192,125,28,13,697,0,17,714
11,7,11037,2661,3,246,128,100,34,12,520,0,18,538
11,7,11037,2662,3,391,146,149,39,17,742,2,19,763
11,7,11037,2663,3,499,131,116,67,24,837,3,18,858
11,7,11037,2664,3,900,282,258,84,40,1564,0,33,1597
11,7,11037,2665,3,272,95,98,26,20,511,1,14,526
11,7,11037,2666,3,322,165,110,40,14,651,1,12,664
11,7,11037,2667,3,253,121,67,30,11,482,0,16,498
11,7,11037,2668,3,373,157,124,54,22,730,2,13,745
11,7,11037,2669,3,485,174,159,50,21,889,2,21,912
11,7,11037,2670,3,383,143,143,55,16,740,10,10,760
11,7,11037,2671,3,325,139,123,43,17,647,0,14,661
11,7,11037,2672,3,194,86,38,17,5,340,1,4,345
11,7,11037,2673,3,404,136,99,34,11,684,3,20,707
11,7,11037,2674,3,180,59,73,17,7,336,0,6,342
11,7,11037,2675,3,313,160,99,42,27,641,7,20,668
11,7,11037,2676,3,536,192,133,67,26,954,3,22,979
11,7,11037,2677,3,242,106,70,22,5,445,1,12,458
11,7,11037,2678,3,531,138,126,39,12,846,3,22,871
11,7,11037,2679,3,280,134,91,42,14,561,3,13,577
11,7,11037,2680,3,305,128,101,36,11,581,1,18,600
11,7,11037,2681,3,405,165,125,54,21,770,3,19,792
11,7,11037,2682,3,491,206,167,38,30,932,5,21,958
11,7,11037,2683,3,866,328,329,68,36,1627,4,50,1681
11,7,11037,2684,3,484,162,137,21,9,813,3,29,845
11,7,11037,2685,3,304,115,91,21,17,548,1,21,570
11,7,11037,2686,3,353,129,103,28,16,629,0,17,646
11,7,11037,2687,3,159,179,175,8,15,536,3,5,544
11,7,11037,2688,3,90,399,36,3,4,532,1,43,576
11,7,11037,2689,3,271,112,116,3,4,506,0,23,529
11,7,11037,2690,3,236,372,167,22,7,804,9,39,852
11,7,11037,2691,3,129,195,51,11,5,391,4,13,408
11,7,11037,2692,3,385,239,150,12,8,794,4,24,822
11,7,11037,2693,3,146,274,90,5,2,517,3,22,542
11,7,11037,2694,3,442,381,126,21,4,974,4,23,1001
11,7,11037,2695,3,406,182,79,14,6,687,4,33,724
11,7,11037,2696,3,263,232,64,6,3,568,1,30,599
11,7,11037,2697,3,48,126,30,4,2,210,1,0,211
11,7,11037,2698,3,335,86,74,15,10,520,0,20,540
11,7,11037,2699,3,478,179,117,16,10,800,5,18,823
11,7,11037,2700,3,675,188,310,22,14,1209,2,19,1230
11,7,11037,2701,3,92,191,45,2,0,330,0,10,340
11,7,11037,2702,3,271,250,174,12,7,714,1,33,748
11,7,11037,2703,3,573,68,170,20,5,836,1,24,861
11,7,11037,2704,3,393,101,143,11,10,658,0,15,673
11,7,11037,2705,3,486,244,122,30,7,889,1,24,914
11,7,11037,2706,3,370,97,58,10,5,540,1,12,553
11,7,11037,2707,3,263,112,31,10,4,420,0,4,424
11,7,11037,2708,3,24,81,22,1,0,128,0,5,133
11,7,11037,2709,3,405,138,204,14,8,769,4,21,794
11,7,11037,2710,3,336,85,98,15,4,538,1,14,553
11,7,11037,2711,3,201,85,50,14,14,364,1,0,365
11,7,11037,2712,3,203,464,213,20,12,912,2,41,955
11,7,11037,2713,3,89,141,24,4,5,263,4,18,285
11,7,11037,2714,3,341,182,64,26,10,623,3,19,645
11,7,11037,2715,3,238,58,55,15,7,373,0,15,388
11,7,11037,2716,3,211,54,61,7,8,341,0,13,354
11,7,11037,2717,3,612,195,101,32,11,951,2,38,991
11,7,11037,2718,3,316,107,45,18,6,492,3,19,514
11,7,11037,2719,3,521,101,74,22,6,724,4,15,743
11,7,11037,2720,3,690,157,123,23,10,1003,0,43,1046
11,7,11037,2721,3,250,146,105,14,7,522,2,34,558
11,7,11037,2722,3,257,95,88,5,6,451,0,8,459
11,7,11037,2723,3,197,41,35,14,6,293,0,0,293
11,7,11037,2724,3,329,89,190,9,4,621,1,4,626
11,7,11037,2725,3,600,215,194,18,5,1032,5,33,1070
11,7,11037,2726,3,394,101,121,13,8,637,4,21,662
11,7,11037,2727,3,439,164,100,15,4,722,2,20,744
11,7,11037,2728,3,298,152,46,8,3,507,0,12,519
11,7,11037,2729,3,92,19,67,0,0,178,1,0,179
11,7,11037,2730,3,359,197,70,11,10,647,0,14,661
11,7,11037,2731,3,126,38,27,2,1,194,0,13,207
11,8,11024,2026,3,355,284,223,19,76,957,0,32,989
11,8,11024,2027,3,219,141,92,7,53,512,0,199,711
11,8,11024,2028,3,280,177,212,8,100,777,0,26,803
11,8,11024,2029,3,429,351,170,9,64,1023,0,53,1076
11,8,11024,2030,3,395,156,116,3,50,720,1,42,763
11,8,11024,2031,3,413,88,29,7,37,574,0,14,588
11,8,11024,2032,3,136,125,70,8,64,403,2,21,426
11,8,11024,2033,3,105,36,84,3,30,258,2,8,268
11,8,11027,2109,3,149,91,48,8,5,301,0,4,305
11,8,11027,2110,3,863,545,307,46,31,1792,4,33,1829
11,8,11027,2111,3,986,379,244,38,20,1667,2,15,1684
11,8,11027,2112,3,618,302,250,31,25,1226,1,17,1244
11,8,11027,2113,3,202,147,97,13,10,469,0,8,477
11,8,11027,2114,3,397,303,138,12,15,865,0,4,869
11,8,11027,2115,3,215,183,91,13,3,505,0,2,507
11,8,11027,2116,3,195,191,91,11,10,498,0,6,504
11,8,11027,2117,3,266,175,117,7,13,578,1,10,589
11,8,11027,2118,3,338,208,115,15,21,697,0,5,702
11,8,11027,2119,3,239,232,70,14,14,569,2,11,582
11,8,11027,2120,3,292,164,131,8,11,606,0,3,609
11,8,11027,2121,3,856,336,173,66,24,1455,3,22,1480
11,8,11027,2122,3,208,152,69,10,12,451,0,11,462
11,8,11027,2123,3,373,280,120,23,7,803,0,10,813
11,8,11027,2124,3,292,169,49,9,9,528,1,14,543
11,8,11027,2125,3,299,197,130,10,11,647,3,12,662
11,8,11027,2126,3,220,182,88,22,18,530,1,8,539
11,8,11027,2127,3,381,147,76,20,14,638,4,19,661
11,8,11027,2128,3,265,236,85,10,8,604,1,4,609
11,8,11027,2129,3,440,229,122,51,14,856,0,13,869
11,8,11027,2130,3,228,142,79,5,9,463,0,2,465
11,8,11027,2131,3,387,148,121,25,14,695,0,8,703
11,8,11027,2132,3,303,113,59,13,5,493,0,5,498
11,8,11027,2133,3,385,219,134,26,18,782,0,12,794
11,8,11027,2134,3,421,250,144,23,8,846,4,13,863
11,8,11027,2135,3,414,154,107,19,8,702,3,17,722
11,8,11027,2136,3,437,182,111,27,16,773,0,12,785
11,8,11027,2137,3,194,119,68,14,5,400,0,13,413
11,8,11027,2138,3,192,104,60,8,5,369,2,11,382
11,8,11027,2139,3,248,154,86,13,8,509,3,7,519
11,8,11027,2140,3,412,170,110,15,10,717,4,16,737
11,8,11027,2141,3,422,247,122,22,10,823,0,11,834
11,8,11027,2142,3,220,123,47,15,5,410,4,8,422
11,8,11027,2143,3,350,162,75,16,12,615,0,4,619
11,8,11027,2144,3,428,165,88,19,11,711,8,17,736
11,8,11027,2145,3,213,85,90,9,6,403,1,12,416
11,8,11027,2146,3,491,147,99,22,13,772,3,9,784
11,8,11027,2147,3,314,174,122,21,10,641,2,11,654
11,8,11027,2148,3,389,122,86,11,9,617,1,4,622
11,8,11027,2149,3,251,110,53,9,7,430,0,7,437
11,8,11027,2150,3,343,153,87,10,8,601,2,9,612
11,8,11027,2151,3,363,147,122,19,16,667,1,12,680
11,8,11027,2152,3,245,83,46,4,11,389,9,4,402
11,8,11027,2153,3,268,135,85,19,8,515,2,11,528
11,8,11027,2154,3,281,118,53,15,4,471,3,7,481
11,8,11027,2155,3,236,106,64,11,8,425,1,11,437
11,8,11027,2156,3,251,141,81,15,16,504,2,9,515
11,8,11027,2157,3,310,149,80,19,7,565,0,11,576
11,8,11027,2158,3,210,103,60,9,9,391,3,2,396
11,8,11027,2159,3,433,171,93,26,12,735,1,15,751
11,8,11027,2160,3,444,187,110,15,11,767,5,9,781
11,8,11027,2161,3,252,154,99,19,3,527,2,16,545
11,8,11027,2162,3,253,165,97,28,10,553,5,18,576
11,8,11027,2163,3,480,247,94,25,8,854,5,27,886
11,8,11027,2164,3,571,269,142,39,26,1047,2,22,1071
11,8,11027,2165,3,288,155,89,15,16,563,5,10,578
11,8,11027,2166,3,423,167,124,11,11,736,4,9,749
11,8,11027,2167,3,299,206,84,26,12,627,1,15,643
11,8,11027,2168,3,363,164,90,17,11,645,3,14,662
11,8,11027,2169,3,285,120,97,15,12,529,2,7,538
11,8,11027,2170,3,380,161,90,18,8,657,2,20,679
11,8,11027,2171,3,439,189,101,26,24,779,0,14,793
11,8,11027,2172,3,208,174,67,12,7,468,0,9,477
11,8,11027,2173,3,210,149,85,14,12,470,0,10,480
11,8,11027,2174,3,216,124,69,11,9,429,2,8,439
11,8,11027,2175,3,282,118,74,12,3,489,0,12,501
11,8,11027,2176,3,471,277,118,28,10,904,8,24,936
11,8,11027,2177,3,849,341,212,54,31,1487,3,19,1509
11,8,11027,2178,3,711,286,178,32,32,1239,12,28,1279
11,8,11027,2179,3,969,397,276,51,43,1736,8,20,1764
11,8,11027,2180,3,403,161,91,13,16,684,4,6,694
11,8,11027,2181,3,776,287,148,31,20,1262,7,20,1289
11,8,11027,2182,3,375,152,83,20,9,639,1,10,650
11,8,11027,2183,3,380,135,90,13,16,634,2,16,652
11,8,11027,2184,3,711,235,195,40,21,1202,3,22,1227
11,8,11027,2185,3,782,279,190,22,26,1299,9,23,1331
11,8,11027,2186,3,528,170,144,23,10,875,4,14,893
11,8,11027,2187,3,472,134,91,23,14,734,1,17,752
11,8,11027,2188,3,574,233,169,18,24,1018,6,19,1043
11,8,11027,2189,3,115,160,79,19,15,388,1,9,398
11,8,11027,2190,3,662,260,126,34,15,1097,9,17,1123
11,8,11027,2191,3,496,156,105,23,17,797,1,9,807
11,8,11027,2192,3,392,139,96,16,12,655,1,12,668
11,8,11027,2193,3,1525,577,338,83,50,2573,9,65,2647
11,8,11027,2194,3,642,202,168,33,21,1066,3,8,1077
11,8,11027,2195,3,465,148,72,18,17,720,3,9,732
11,8,11027,2196,3,373,140,75,19,10,617,0,12,629
11,8,11027,2197,3,922,289,162,44,15,1432,7,30,1469
11,8,11027,2198,3,527,330,246,41,31,1175,3,11,1189
11,8,11027,2199,3,194,14,3,1,1,213,0,14,227
11,8,11027,2200,3,307,39,27,2,1,376,1,22,399
11,8,11027,2201,3,244,67,27,2,4,344,5,10,359
11,8,11027,2202,3,268,125,57,6,0,456,3,7,466
11,8,11027,2203,3,200,43,30,5,9,287,0,16,303
11,8,11027,2204,3,598,183,152,23,27,983,7,28,1018
11,8,11027,2205,3,162,37,13,6,1,219,1,11,231
11,8,11027,2206,3,222,83,26,10,4,345,3,15,363
11,8,11027,2207,3,375,136,21,5,4,541,0,22,563
11,8,11027,2208,3,310,84,22,16,5,437,0,29,466
11,8,11027,2209,3,216,192,18,6,2,434,3,20,457
11,8,11027,2210,3,284,129,36,11,9,469,2,39,510
11,8,11027,2211,3,155,82,38,6,5,286,2,24,312
11,8,11027,2212,3,279,53,99,16,11,458,5,20,483
11,8,11027,2213,3,220,50,122,5,7,404,0,21,425
11,8,11027,2214,3,207,26,6,3,1,243,1,7,251
11,8,11027,2215,3,316,61,14,7,4,402,3,15,420
11,8,11027,2216,3,481,73,16,4,3,577,2,39,618
11,8,11027,2217,3,255,190,39,17,5,506,1,19,526
11,8,11027,2218,3,394,91,59,11,6,561,0,17,578
11,8,11027,2219,3,566,125,87,16,11,805,4,32,841
11,8,11027,2220,3,371,54,17,8,1,451,2,11,464
11,8,11027,2221,3,352,90,20,4,3,469,1,9,479
11,8,11027,2222,3,270,208,36,4,9,527,1,20,548
11,8,11027,2223,3,631,143,111,14,7,906,4,37,947
11,8,11027,2224,3,538,54,43,7,6,648,4,8,660
11,8,11027,2225,3,536,62,38,12,4,652,2,18,672
11,8,11027,2226,3,509,127,61,11,5,713,4,15,732
11,8,11027,2227,3,380,119,32,12,4,547,0,4,551
11,8,11027,2228,3,615,129,31,13,2,790,1,16,807
11,8,11027,2229,3,346,43,10,5,1,405,2,5,412
11,8,11027,2230,3,730,147,96,19,6,998,7,30,1035
11,8,11027,2231,3,788,54,39,15,10,906,3,16,925
11,8,11027,2232,3,565,70,41,14,7,697,1,23,721
11,8,11027,2233,3,548,85,41,5,12,691,7,41,739
11,8,11027,2234,3,385,103,36,5,6,535,3,26,564
11,8,11027,2235,3,216,42,17,2,6,283,0,6,289
11,8,11027,2236,3,421,63,38,9,8,539,1,11,551
11,8,11027,2237,3,242,65,9,6,5,327,2,0,329
11,8,11027,2238,3,509,93,83,13,8,706,0,8,714
11,8,11027,2239,3,562,106,77,14,5,764,1,14,779
11,8,11027,2240,3,343,126,59,8,3,539,1,11,551
11,8,11027,2241,3,324,96,39,17,4,480,5,19,504
11,8,11027,2242,3,511,95,65,26,12,709,0,10,719
11,8,11027,2243,3,503,108,58,28,5,702,11,4,717
11,8,11027,2244,3,498,110,91,39,7,745,5,9,759
11,8,11027,2245,3,494,106,61,35,10,706,6,21,733
11,8,11027,2246,3,314,108,45,32,5,504,1,9,514
11,8,11027,2247,3,275,40,15,7,5,342,0,10,352
11,8,11027,2248,3,500,108,31,10,8,657,3,25,685
11,8,11027,2249,3,396,42,79,9,2,528,1,19,548
11,8,11027,2250,3,223,33,49,14,6,325,3,5,333
11,8,11027,2251,3,479,73,71,10,6,639,1,11,651
11,8,11027,2252,3,442,174,78,13,12,719,1,14,734
11,8,11027,2253,3,569,89,46,12,7,723,3,23,749
11,8,11027,2254,3,388,61,40,7,6,502,1,17,520
11,8,11027,2255,3,115,32,31,4,1,183,0,11,194
11,8,11027,2256,3,123,47,24,2,3,199,0,0,199
11,8,11027,2257,3,305,77,76,13,6,477,1,18,496
11,8,11027,2258,3,362,38,28,16,5,449,2,19,470
11,8,11027,2259,3,244,49,99,4,2,398,1,11,410
11,8,11027,2260,3,312,192,61,7,9,581,8,12,601
11,8,11027,2261,3,344,61,22,11,2,440,2,4,446
11,8,11027,2262,3,237,116,25,6,0,384,3,13,400
11,8,11035,2608,3,399,74,59,31,10,573,4,17,594
11,8,11035,2609,3,474,103,71,67,12,727,8,13,748
11,8,11035,2610,3,531,130,53,29,7,750,7,20,777
11,8,11035,2611,3,371,98,47,44,7,567,2,19,588
11,8,11035,2612,3,519,194,110,67,18,908,5,31,944
11,8,11035,2613,3,640,198,124,56,23,1041,2,20,1063
11,8,11035,2614,3,469,148,112,60,13,802,8,25,835
11,8,11035,2615,3,451,207,88,54,14,814,0,29,843
11,8,11035,2616,3,235,71,50,20,5,381,1,1,383
11,8,11035,2617,3,429,189,83,36,17,754,2,24,780
11,8,11035,2618,3,291,147,111,33,11,593,1,15,609
11,8,11035,2619,3,296,176,69,22,14,577,1,18,596
11,8,11035,2620,3,462,222,90,70,19,863,0,14,877
11,8,11035,2621,3,398,144,68,44,25,679,0,33,712
11,8,11035,2622,3,494,172,87,73,11,837,3,19,859
11,8,11035,2623,3,466,134,87,53,7,747,10,11,768
11,8,11035,2624,3,460,149,90,39,11,749,0,33,782
11,8,11035,2625,3,725,251,145,89,20,1230,7,26,1263
11,8,11035,2626,3,959,244,154,103,37,1497,8,43,1548
11,8,11035,2627,3,201,53,38,16,4,312,1,17,330
11,8,11035,2628,3,172,112,25,14,3,326,2,34,362
11,8,11035,2629,3,180,62,79,26,6,353,0,23,376
11,8,11035,2630,3,500,367,101,68,11,1047,11,32,1090
11,8,11035,2631,3,307,155,76,30,10,578,9,27,614
11,8,11035,2632,3,178,105,141,60,10,494,3,43,540
11,8,11035,2633,3,462,164,94,66,8,794,3,28,825
11,8,11035,2634,3,131,68,64,6,4,273,2,6,281
11,8,11035,2635,3,291,150,83,24,8,556,5,13,574
11,8,11035,2636,3,453,287,93,93,9,935,4,22,961
11,8,11035,2637,3,516,294,82,80,7,979,12,27,1018
11,8,11035,2638,3,303,216,208,97,8,832,3,65,900
11,8,11035,2639,3,611,117,97,28,3,856,5,20,881
11,8,11035,2640,3,356,161,111,31,7,666,2,20,688
11,8,11035,2641,3,162,68,195,18,8,451,2,8,461
11,8,11035,2642,3,188,171,181,37,7,584,6,20,610
11,8,11035,2643,3,393,96,67,46,5,607,2,24,633
11,8,11044,2906,3,568,157,105,53,33,916,1,13,930
11,8,11044,2907,3,428,103,92,36,24,683,1,22,706
11,8,11044,2908,3,594,164,124,61,35,978,3,5,986
11,8,11044,2909,3,409,168,115,39,34,765,2,19,786
11,8,11044,2910,3,471,134,143,34,22,804,2,18,824
11,8,11044,2911,3,636,116,142,34,36,964,4,18,986
11,8,11044,2912,3,468,180,117,32,25,822,0,19,841
11,8,11044,2913,3,504,155,122,63,43,887,0,31,918
11,8,11044,2914,3,415,85,96,35,42,673,2,8,683
11,8,11044,2915,3,420,150,85,37,38,730,2,12,744
11,8,11044,2916,3,296,180,92,43,38,649,2,8,659
11,8,11044,2917,3,281,106,82,42,11,522,0,9,531
11,8,11044,2918,3,455,130,100,57,30,772,0,17,789
11,8,11044,2919,3,384,214,74,28,23,723,7,14,744
11,8,11044,2920,3,306,87,44,17,11,465,0,17,482
11,8,11044,2921,3,492,243,50,18,14,817,0,16,833
11,8,11044,2922,3,490,135,56,20,15,716,2,22,740
11,8,11044,2923,3,594,123,42,30,17,806,0,27,833
11,8,11044,2924,3,450,227,35,18,8,738,0,17,755
11,8,11044,2925,3,353,119,53,29,19,573,4,17,594
11,8,11044,2926,3,142,41,25,8,8,224,1,13,238
11,8,11044,2927,3,632,162,60,26,17,897,1,23,921
11,8,11044,2928,3,368,95,33,17,8,521,1,13,535
11,8,11044,2929,3,892,201,90,26,19,1228,2,27,1257
11,8,11044,2930,3,438,133,45,28,17,661,1,12,674
11,8,11044,2931,3,279,83,33,20,19,434,0,6,440
11,8,11044,2932,3,247,162,45,19,8,481,1,31,513
11,8,11044,2933,3,363,107,45,19,17,551,3,26,580
11,9,11017,929,3,729,194,95,16,20,1054,7,21,1082
11,9,11017,930,3,1068,429,194,34,31,1756,13,39,1808
11,9,11017,933,3,585,221,80,24,15,925,1,14,940
11,9,11017,934,3,669,196,99,37,20,1021,2,14,1037
11,9,11017,935,3,507,117,43,17,15,699,0,6,705
11,9,11017,936,3,439,121,57,15,8,640,1,8,649
11,9,11017,937,3,471,106,81,10,11,679,6,14,699
11,9,11017,938,3,461,131,87,26,10,715,2,4,721
11,9,11017,939,3,659,165,70,17,16,927,0,12,939
11,9,11017,942,3,288,164,57,34,5,548,0,5,553
11,9,11017,943,3,514,144,80,27,20,785,0,8,793
11,9,11017,944,3,996,252,134,45,27,1454,1,11,1466
11,9,11017,946,3,445,126,73,15,17,676,0,4,680
11,9,11017,947,3,649,173,108,43,23,996,3,15,1014
11,9,11017,948,3,678,206,65,22,15,986,1,3,990
11,9,11017,949,3,553,165,67,21,13,819,3,4,826
11,9,11017,950,3,582,201,65,15,15,878,3,12,893
11,9,11017,952,3,475,160,49,16,13,713,1,3,717
11,9,11017,953,3,595,219,62,25,9,910,0,10,920
11,9,11017,954,3,399,115,41,25,13,593,0,6,599
11,9,11017,955,3,360,157,54,13,20,604,3,13,620
11,9,11017,956,3,457,135,72,22,10,696,1,11,708
11,9,11017,957,3,529,149,49,14,10,751,4,24,779
11,9,11017,958,3,765,251,150,24,19,1209,16,39,1264
11,9,11017,959,3,402,127,55,31,10,625,6,12,643
11,9,11017,960,3,709,236,98,24,26,1093,7,16,1116
11,9,11017,961,3,379,131,58,11,11,590,2,10,602
11,9,11017,962,3,379,166,38,9,6,598,0,5,603
11,9,11017,963,3,391,185,82,27,21,706,4,13,723
11,9,11017,970,3,165,106,27,13,2,313,1,7,321
11,9,11017,971,3,393,152,78,25,11,659,1,10,670
11,9,11017,972,3,343,156,63,28,5,595,1,14,610
11,9,11017,973,3,925,295,139,36,23,1418,3,43,1464
11,9,11017,974,3,416,141,53,20,6,636,4,10,650
11,9,11017,975,3,467,149,73,15,8,712,10,20,742
11,9,11017,976,3,295,102,32,25,5,459,2,6,467
11,9,11017,977,3,272,132,69,24,14,511,3,13,527
11,9,11017,978,3,466,183,59,20,9,737,6,16,759
11,9,11017,982,3,360,132,75,21,9,597,2,20,619
11,9,11017,983,3,428,134,34,13,8,617,0,8,625
11,9,11017,984,3,305,136,58,10,15,524,1,14,539
11,9,11017,985,3,196,56,38,11,6,307,3,6,316
11,9,11017,986,3,223,92,34,7,3,359,0,4,363
11,9,11017,987,3,1070,260,184,49,27,1590,6,23,1619
11,9,11017,988,3,367,126,37,10,8,548,0,3,551
11,9,11017,989,3,488,145,46,7,10,696,1,7,704
11,9,11017,990,3,223,96,41,8,2,370,0,10,380
11,9,11017,991,3,302,142,50,9,14,517,1,12,530
11,9,11017,992,3,413,151,65,14,8,651,0,9,660
11,9,11017,993,3,441,188,52,24,11,716,2,13,731
11,9,11017,994,3,389,171,85,18,1,664,6,16,686
11,9,11017,995,3,290,132,68,17,9,516,1,17,534
11,9,11017,996,3,223,81,24,6,7,341,1,5,347
11,9,11017,1001,3,236,61,30,11,4,342,3,7,352
11,9,11017,1002,3,349,119,61,7,8,544,1,5,550
11,9,11017,1003,3,218,98,35,11,6,368,0,8,376
11,9,11017,1004,3,236,89,46,18,8,397,4,7,408
11,9,11017,1005,3,334,134,70,19,4,561,3,5,569
11,9,11017,1006,3,579,193,71,25,11,879,2,3,884
11,9,11017,1007,3,418,156,77,16,10,677,3,16,696
11,9,11017,1008,3,377,120,52,25,8,582,2,8,592
11,9,11017,1009,3,424,143,56,13,10,646,2,17,665
11,9,11017,1010,3,395,155,89,42,14,695,1,10,706
11,9,11017,1011,3,328,82,40,11,2,463,1,0,464
11,9,11017,1012,3,344,137,68,22,8,579,3,8,590
11,9,11017,1013,3,327,112,61,20,4,524,0,6,530
11,9,11017,1014,3,254,95,41,12,10,412,0,7,419
11,9,11017,1015,3,319,117,60,9,6,511,0,6,517
11,9,11017,1016,3,263,81,58,17,4,423,0,6,429
11,9,11017,1017,3,338,110,36,22,11,517,2,12,531
11,9,11017,1018,3,304,100,48,21,11,484,2,5,491
11,9,11017,1019,3,426,120,42,12,16,616,6,11,633
11,9,11017,1020,3,259,107,44,10,3,423,5,13,441
11,9,11017,1021,3,347,184,78,18,15,642,11,21,674
11,9,11017,1022,3,281,97,49,17,10,454,6,7,467
11,9,11017,1023,3,193,66,32,9,1,301,2,1,304
11,9,11017,1024,3,361,140,58,13,13,585,0,9,594
11,9,11017,1030,3,178,76,46,14,4,318,2,1,321
11,9,11017,1031,3,227,93,39,11,5,375,3,5,383
11,9,11017,1032,3,388,108,62,21,7,586,4,7,597
11,9,11017,1033,3,238,78,45,5,6,372,0,4,376
11,9,11017,1034,3,408,176,61,11,9,665,3,8,676
11,9,11017,1035,3,385,192,78,37,10,702,4,18,724
11,9,11017,1036,3,476,167,75,16,12,746,1,27,774
11,9,11017,1037,3,423,161,71,21,15,691,3,23,717
11,9,11017,1038,3,680,234,115,43,21,1093,4,11,1108
11,9,11017,1039,3,446,145,89,21,13,714,1,18,733
11,9,11017,1040,3,471,151,90,29,14,755,1,22,778
11,9,11017,1041,3,463,149,72,23,12,719,3,16,738
11,9,11017,1042,3,240,120,46,5,11,422,0,6,428
11,9,11017,1043,3,207,97,38,6,5,353,2,0,355
11,9,11017,1044,3,367,133,92,34,8,634,4,15,653
11,9,11017,1045,3,361,145,55,25,9,595,2,12,609
11,9,11017,1046,3,336,180,89,18,10,633,1,9,643
11,9,11017,1047,3,368,142,51,20,12,593,5,11,609
11,9,11017,1048,3,286,107,31,13,7,444,2,4,450
11,9,11017,1049,3,327,140,68,14,6,555,5,8,568
11,9,11017,1050,3,377,174,64,30,12,657,3,20,680
11,9,11017,1051,3,634,241,95,27,8,1005,1,18,1024
11,9,11017,1052,3,614,222,74,23,20,953,2,13,968
11,9,11017,1053,3,329,216,71,14,7,637,0,17,654
11,9,11017,1054,3,395,155,74,35,6,665,2,14,681
11,9,11017,1055,3,339,116,66,31,12,564,3,14,581
11,9,11017,1056,3,382,151,56,14,10,613,0,18,631
11,9,11017,1057,3,483,187,68,18,14,770,2,10,782
11,9,11017,1058,3,455,199,66,23,9,752,2,18,772
11,9,11017,1059,3,1490,516,251,69,47,2373,19,17,2409
11,9,11017,1060,3,888,293,164,84,25,1454,5,29,1488
11,9,11017,1061,3,459,191,104,27,7,788,3,1,792
11,9,11017,1062,3,443,163,52,19,13,690,4,11,705
11,9,11017,1063,3,518,193,114,39,16,880,0,8,888
11,9,11017,1064,3,356,143,100,20,6,625,1,5,631
11,9,11017,1065,3,326,147,49,13,3,538,4,5,547
11,9,11017,1066,3,399,83,101,13,7,603,4,15,622
11,9,11017,1067,3,394,168,84,25,23,694,0,18,712
11,9,11017,1068,3,527,223,63,32,13,858,3,10,871
11,9,11017,1069,3,290,148,76,8,5,527,1,15,543
11,9,11017,1070,3,296,214,62,27,13,612,3,16,631
11,9,11017,1071,3,427,247,90,19,6,789,8,14,811
11,9,11017,1072,3,376,256,81,26,5,744,8,19,771
11,9,11017,1073,3,533,194,93,25,13,858,6,8,872
11,9,11017,1074,3,654,223,109,42,18,1046,3,14,1063
11,9,11017,1075,3,295,150,63,7,15,530,4,28,562
11,9,11017,1076,3,143,119,62,12,8,344,4,12,360
11,9,11017,1077,3,1141,333,148,57,28,1707,4,20,1731
11,9,11017,1078,3,935,359,164,71,26,1555,14,28,1597
11,9,11017,1079,3,207,108,42,11,5,373,4,13,390
11,9,11017,1080,3,369,318,130,20,16,853,9,13,875
11,9,11017,1081,3,308,150,77,20,9,564,0,10,574
11,9,11017,1082,3,521,243,97,34,23,918,7,19,944
11,9,11017,1083,3,306,120,33,15,3,477,6,10,493
11,9,11017,1084,3,353,158,82,38,12,643,4,9,656
11,9,11017,1085,3,269,110,52,14,5,450,5,5,460
11,9,11017,1086,3,260,137,45,15,3,460,3,14,477
11,9,11017,1087,3,343,161,98,16,8,626,0,25,651
11,9,11017,1088,3,244,100,55,12,2,413,6,12,431
11,9,11017,1089,3,278,159,91,4,3,535,2,10,547
11,9,11017,1090,3,208,162,54,9,5,438,2,5,445
11,9,11017,1091,3,362,190,101,22,8,683,8,8,699
11,9,11017,1092,3,177,132,58,18,6,391,1,12,404
11,9,11017,1093,3,401,230,92,21,11,755,2,12,769
11,9,11017,1094,3,466,189,112,38,8,813,7,8,828
11,9,11017,1095,3,354,213,79,19,9,674,3,20,697
11,9,11017,1096,3,253,210,77,15,8,563,3,6,572
11,9,11017,1097,3,209,141,51,11,6,418,0,6,424
11,9,11017,1098,3,255,153,99,15,9,531,2,8,541
11,9,11017,1099,3,1612,537,250,88,47,2534,3,47,2584
11,9,11017,1100,3,278,146,61,17,7,509,2,17,528
11,9,11017,1101,3,309,143,55,19,4,530,7,24,561
11,9,11017,1102,3,288,136,65,18,10,517,8,12,537
11,9,11017,1103,3,568,306,120,23,24,1041,5,39,1085
11,9,11017,1104,3,425,209,80,23,14,751,4,17,772
11,9,11017,1105,3,620,324,103,63,25,1135,2,11,1148
11,9,11017,1106,3,541,314,146,38,15,1054,5,7,1066
11,9,11017,1107,3,482,274,113,30,16,915,14,15,944
11,9,11017,1108,3,364,148,39,14,6,571,4,25,600
11,9,11017,1109,3,360,93,48,24,13,538,0,9,547
11,9,11017,1110,3,863,258,148,59,18,1346,1,8,1355
11,9,11017,1111,3,439,133,86,26,18,702,4,5,711
11,9,11017,1112,3,272,78,69,18,10,447,2,3,452
11,9,11017,1113,3,431,152,85,41,16,725,3,10,738
11,9,11017,1114,3,304,89,109,8,1,511,0,4,515
11,9,11017,1115,3,464,110,74,8,4,660,7,19,686
11,9,11017,1116,3,641,192,72,16,3,924,2,24,950
11,9,11017,1122,3,465,172,56,13,8,714,3,17,734
11,9,11017,1123,3,380,70,56,5,8,519,2,9,530
11,9,11017,1124,3,456,104,24,9,13,606,2,19,627
11,9,11017,1127,3,96,21,17,4,1,139,0,8,147
11,9,11017,1130,3,119,52,30,0,1,202,2,10,214
11,9,11017,1131,3,396,119,25,1,2,543,2,28,573
11,9,11017,1132,3,579,111,90,7,6,793,3,35,831
11,9,11017,1135,3,149,42,15,2,3,211,1,8,220
11,9,11017,1138,3,440,172,41,13,13,679,2,7,688
11,9,11017,1139,3,527,196,69,9,9,810,6,21,837
11,9,11017,1142,3,218,115,27,3,2,365,0,18,383
11,9,11017,1143,3,169,60,5,1,0,235,2,19,256
11,9,11017,1149,3,875,207,100,25,26,1233,2,7,1242
11,9,11017,1150,3,679,224,75,17,15,1010,0,8,1018
11,9,11017,1151,3,375,112,55,6,4,552,2,35,589
11,9,11017,1152,3,496,281,112,4,19,912,0,38,950
11,9,11017,1153,3,347,264,86,14,3,714,5,26,745
11,9,11017,1154,3,233,266,71,7,4,581,2,14,597
11,9,11017,1155,3,344,87,57,9,0,497,1,10,508
11,9,11017,1157,3,410,210,72,7,6,705,7,28,740
11,9,11017,1158,3,545,119,103,10,6,783,3,48,834
11,9,11017,1160,3,313,88,37,4,2,444,0,23,467
11,9,11017,1161,3,246,156,92,20,4,518,9,26,553
11,9,11017,1162,3,693,128,42,17,4,884,9,11,904
11,9,11017,1164,3,510,198,102,25,9,844,7,23,874
11,9,11017,1165,3,378,335,131,57,6,907,9,22,938
11,9,11017,1166,3,599,107,96,12,8,822,2,11,835
11,9,11017,1167,3,485,199,52,16,11,763,6,28,797
11,9,11017,1168,3,528,185,46,15,10,784,7,34,825
11,9,11017,1169,3,428,133,60,16,3,640,4,16,660
11,9,11017,1170,3,311,105,59,12,3,490,3,33,526
11,9,11017,1171,3,164,131,49,9,2,355,1,21,377
11,9,11017,1172,3,257,132,142,9,26,566,4,32,602
11,9,11017,1173,3,242,146,126,11,7,532,5,13,550
11,9,11017,1174,3,196,278,257,5,7,743,0,16,759
11,9,11017,1175,3,246,71,148,5,10,480,1,20,501
11,9,11017,1176,3,381,170,98,28,17,694,15,61,770
11,9,11017,1177,3,777,368,116,41,14,1316,4,18,1338
11,10,11021,1859,3,378,117,99,33,16,643,0,20,663
11,10,11021,1860,3,357,118,77,22,17,591,0,21,612
11,10,11021,1861,3,462,202,79,26,10,779,3,12,794
11,10,11021,1862,3,295,99,71,13,16,494,0,14,508
11,10,11021,1863,3,312,81,75,22,9,499,2,3,504
11,10,11021,1864,3,420,199,159,37,13,828,2,13,843
11,10,11021,1865,3,257,82,73,16,6,434,1,9,444
11,10,11021,1866,3,331,121,87,17,9,565,1,4,570
11,10,11021,1867,3,470,130,109,22,9,740,3,23,766
11,10,11021,1868,3,435,126,73,29,10,673,1,7,681
11,10,11021,1869,3,521,159,147,34,16,877,2,18,897
11,10,11021,1870,3,460,135,133,53,22,803,2,19,824
11,10,11021,1871,3,253,88,51,24,8,424,0,11,435
11,10,11021,1872,3,320,125,90,27,7,569,5,17,591
11,10,11021,1873,3,449,119,101,26,12,707,1,10,718
11,10,11021,1874,3,470,99,110,19,12,710,0,11,721
11,10,11021,1875,3,534,156,106,34,19,849,4,16,869
11,10,11021,1876,3,402,101,61,16,13,593,0,19,612
11,10,11021,1877,3,413,80,54,23,13,583,0,16,599
11,10,11021,1878,3,413,88,87,29,19,636,1,4,641
11,10,11021,1879,3,323,116,78,26,6,549,0,12,561
11,10,11021,1880,3,350,117,67,20,12,566,1,17,584
11,10,11021,1881,3,145,54,32,9,6,246,0,4,250
11,10,11021,1882,3,375,138,108,25,12,658,0,20,678
11,10,11021,1883,3,299,103,76,18,10,506,1,9,516
11,10,11021,1884,3,501,156,127,51,24,859,4,8,871
11,10,11021,1885,3,521,138,99,34,19,811,0,8,819
11,10,11021,1886,3,520,137,105,31,23,816,1,9,826
11,10,11021,1887,3,111,88,33,0,3,235,0,16,251
11,10,11021,1888,3,55,41,16,0,0,112,0,26,138
11,10,11021,1889,3,151,69,32,7,3,262,1,8,271
11,10,11021,1890,3,266,69,37,19,10,401,4,22,427
11,10,11021,1891,3,115,111,41,3,4,274,1,19,294
11,10,11021,1892,3,276,120,36,9,6,447,1,6,454
11,10,11021,1893,3,158,164,30,6,4,362,4,16,382
11,10,11028,2263,3,314,109,245,56,28,752,4,23,779
11,10,11028,2264,3,244,89,163,67,21,584,3,15,602
11,10,11028,2265,3,288,111,201,117,32,749,4,15,768
11,10,11028,2266,3,111,64,84,55,29,343,2,12,357
11,10,11028,2267,3,123,107,68,29,16,343,6,5,354
11,10,11028,2268,3,256,156,212,54,23,701,5,25,731
11,10,11028,2269,3,235,77,151,73,33,569,0,5,574
11,10,11028,2270,3,264,83,118,72,20,557,5,16,578
11,10,11028,2271,3,252,72,98,35,26,483,2,18,503
11,10,11028,2272,3,151,97,98,18,19,383,1,14,398
11,10,11028,2273,3,296,98,122,27,21,564,3,23,590
11,10,11028,2274,3,367,163,187,88,34,839,1,22,862
11,10,11028,2275,3,259,137,216,48,34,694,4,18,716
11,10,11028,2276,3,269,140,164,28,14,615,5,16,636
11,10,11028,2277,3,194,95,128,33,20,470,2,11,483
11,10,11028,2278,3,246,79,189,33,23,570,0,12,582
11,10,11028,2279,3,264,71,100,53,45,533,1,13,547
11,10,11028,2280,3,178,98,115,49,34,474,0,16,490
11,10,11028,2281,3,86,51,78,13,11,239,1,6,246
11,10,11028,2282,3,253,74,111,50,25,513,0,28,541
11,10,11028,2283,3,203,74,101,21,12,411,0,11,422
11,10,11028,2284,3,218,84,93,18,10,423,1,15,439
11,10,11028,2285,3,312,139,160,38,37,686,12,22,720
11,10,11028,2286,3,176,63,103,22,17,381,0,16,397
11,10,11028,2287,3,299,131,277,58,55,820,5,17,842
11,10,11028,2288,3,244,182,162,24,16,628,6,29,663
11,10,11028,2289,3,192,150,144,26,13,525,9,9,543
11,10,11028,2290,3,148,134,94,12,9,397,2,19,418
11,10,11028,2291,3,210,27,99,7,5,348,185,11,544
11,10,11028,2292,3,115,50,94,7,8,274,1,14,289
11,10,11028,2293,3,134,42,74,8,6,264,0,6,270
11,10,11028,2294,3,193,20,48,12,4,277,1,6,284
11,10,11028,2295,3,242,27,91,14,6,380,1,3,384
11,10,11028,2296,3,213,19,32,3,6,273,0,6,279
11,10,11028,2297,3,386,131,45,4,10,576,0,9,585
11,10,11028,2298,3,323,58,44,8,5,438,0,14,452
11,10,11028,2299,3,306,90,48,6,5,455,0,7,462
11,10,11028,2300,3,84,43,56,6,7,196,3,5,204
11,10,11028,2301,3,73,54,101,7,6,241,1,11,253
11,10,11028,2302,3,139,118,94,5,6,362,1,21,384
11,10,11028,2303,3,119,55,37,4,7,222,0,13,235
11,10,11028,2304,3,95,88,57,3,6,249,2,10,261
11,10,11028,2305,3,176,147,95,3,8,429,2,16,447
11,10,11028,2306,3,177,75,99,16,14,381,2,29,412
11,10,11028,2307,3,41,91,72,8,7,219,0,11,230
11,10,11028,2308,3,147,130,107,10,14,408,0,5,413
11,10,11028,2309,3,76,14,123,13,5,231,0,8,239
11,10,11028,2310,3,104,41,193,5,4,347,1,5,353
11,10,11028,2311,3,243,61,83,16,18,421,0,11,432
11,10,11028,2312,3,226,97,86,27,21,457,1,16,474
11,10,11028,2313,3,223,66,67,15,21,392,0,8,400
11,10,11028,2314,3,254,104,124,19,17,518,0,20,538
11,10,11028,2315,3,323,95,99,15,14,546,0,14,560
11,10,11028,2316,3,118,86,118,11,8,341,0,3,344
11,10,11028,2317,3,146,90,201,11,8,456,2,10,468
11,10,11028,2318,3,118,50,123,9,7,307,0,16,323
11,10,11028,2319,3,181,85,169,36,12,483,0,21,504
11,10,11028,2320,3,248,97,180,15,19,559,0,20,579
11,10,11028,2321,3,130,31,57,1,4,223,0,0,223
11,10,11028,2322,3,163,31,49,3,3,249,1,11,261
11,10,11028,2323,3,155,29,57,11,4,256,0,22,278
11,10,11028,2324,3,207,55,101,9,20,392,3,20,415
11,10,11028,2325,3,200,102,76,19,24,421,3,10,434
11,10,11028,2326,3,211,72,95,34,4,416,3,19,438
11,10,11028,2327,3,323,63,109,31,4,530,1,10,541
11,10,11028,2328,3,257,79,65,27,4,432,2,10,444
11,10,11028,2329,3,277,138,111,30,8,564,8,23,595
11,10,11028,2330,3,201,136,70,14,7,428,0,18,446
11,10,11028,2331,3,211,165,61,23,6,466,2,17,485
11,10,11028,2332,3,233,148,88,15,14,498,0,19,517
11,10,11028,2333,3,192,95,100,28,6,421,2,24,447
11,10,11028,2334,3,174,92,73,8,8,355,0,5,360
11,10,11028,2335,3,158,92,77,16,9,352,0,15,367
11,10,11028,2336,3,132,73,67,15,8,295,1,6,302
11,10,11028,2337,3,166,65,106,8,17,362,3,26,391
11,10,11028,2338,3,306,81,124,21,5,537,10,18,565
11,10,11028,2339,3,223,14,56,1,6,300,2,8,310
11,10,11028,2340,3,169,44,75,3,10,301,1,8,310
11,10,11028,2341,3,155,127,43,4,4,333,2,28,363
11,10,11028,2342,3,127,58,131,12,6,334,0,12,346
11,10,11028,2343,3,89,25,20,1,2,137,0,2,139
11,10,11028,2344,3,110,22,47,10,3,192,1,0,193
11,10,11028,2345,3,173,27,37,12,2,251,1,13,265
11,10,11028,2346,3,80,9,23,2,2,116,1,6,123
11,10,11036,2644,3,134,77,83,6,2,302,0,11,313
11,10,11036,2645,3,198,151,84,7,4,444,0,22,466
11,10,11036,2646,3,208,117,53,13,2,393,0,25,418
11,10,11036,2647,3,195,104,107,16,4,426,1,15,442
11,10,11036,2648,3,111,74,74,2,1,262,0,16,278
11,10,11036,2649,3,101,172,165,16,1,455,0,20,475
11,10,11036,2650,3,58,118,89,1,1,267,0,23,290
11,10,11036,2651,3,56,35,42,1,2,136,0,18,154
11,10,11036,2652,3,86,92,76,1,0,255,0,27,282
11,10,11036,2653,3,64,77,84,2,0,227,1,32,260
11,10,11039,2744,3,340,93,94,16,10,553,2,19,574
11,10,11039,2745,3,338,81,169,32,2,622,0,7,629
11,10,11039,2746,3,282,120,127,23,6,558,0,29,587
11,10,11039,2747,3,296,102,140,23,10,571,0,17,588
11,10,11039,2748,3,88,14,41,8,4,155,1,7,163
11,10,11039,2749,3,372,192,163,14,3,744,3,29,776
11,10,11039,2750,3,332,128,109,19,7,595,0,14,609
11,10,11039,2751,3,186,146,134,15,4,485,4,11,500
11,10,11039,2752,3,269,96,133,20,1,519,0,21,540
11,10,11039,2753,3,192,97,111,4,6,410,0,24,434
11,10,11039,2754,3,133,16,17,4,3,173,0,0,173
11,10,11039,2755,3,65,10,9,2,1,87,0,5,92
11,10,11039,2756,3,76,60,16,6,2,160,0,17,177
11,10,11039,2757,3,52,81,21,2,4,160,0,7,167
11,10,11039,2758,3,209,27,19,2,1,258,1,8,267
11,10,11039,2759,3,165,89,18,8,1,281,0,7,288
11,10,11039,2760,3,111,28,15,2,1,157,0,3,160
11,10,11039,2761,3,351,308,154,23,7,843,0,38,881
11,10,11039,2762,3,146,95,27,2,2,272,1,6,279
11,10,11039,2763,3,218,276,41,4,8,547,1,14,562
11,10,11039,2764,3,93,44,33,2,1,173,0,29,202
11,10,11039,2765,3,216,120,219,19,7,581,3,16,600
11,10,11039,2766,3,128,82,140,7,1,358,1,8,367
11,10,11039,2767,3,160,104,213,12,3,492,0,29,521
11,10,11039,2768,3,360,42,73,16,7,498,0,12,510
11,10,11039,2769,3,272,59,76,12,11,430,1,14,445
11,10,11039,2770,3,208,69,51,9,5,342,6,8,356
11,10,11039,2771,3,394,61,66,14,8,543,1,19,563
11,10,11039,2772,3,181,49,66,7,6,309,0,12,321
11,10,11039,2773,3,108,261,106,6,4,485,2,30,517
11,10,11039,2774,3,147,118,55,2,2,324,0,27,351
11,10,11039,2775,3,160,96,62,7,7,332,0,13,345
11,10,11039,2776,3,173,59,27,2,2,263,2,11,276
11,10,11039,2777,3,290,162,76,9,8,545,7,30,582
11,10,11041,2790,3,693,394,110,52,21,1270,3,37,1310
11,10,11041,2791,3,912,469,178,51,23,1633,9,49,1691
11,10,11041,2792,3,493,368,82,37,16,996,5,38,1039
11,10,11041,2793,3,551,247,110,47,13,968,7,33,1008
11,10,11041,2794,3,449,300,107,32,5,893,1,25,919
11,10,11041,2795,3,183,247,38,5,5,478,0,29,507
11,10,11041,2796,3,364,222,69,31,12,698,0,23,721
11,10,11041,2797,3,388,231,106,36,21,782,11,10,803
11,10,11041,2798,3,409,263,111,40,19,842,6,30,878
11,10,11041,2799,3,493,242,99,38,14,886,0,22,908
11,10,11041,2800,3,512,219,117,17,12,877,2,31,910
11,10,11041,2801,3,500,244,94,30,15,883,1,23,907
11,10,11041,2802,3,466,271,81,34,20,872,1,23,896
11,10,11041,2803,3,403,210,64,31,13,721,2,23,746
11,10,11041,2804,3,446,251,68,39,13,817,2,11,830
11,10,11041,2805,3,207,125,30,17,2,381,0,21,402
11,10,11041,2806,3,378,184,77,32,7,678,0,14,692
11,10,11041,2807,3,592,354,151,54,29,1180,0,45,1225
11,10,11041,2808,3,486,148,95,34,15,778,6,19,803
11,10,11041,2809,3,739,321,212,61,25,1358,6,41,1405
11,10,11041,2810,3,273,218,37,12,7,547,3,14,564
11,10,11041,2811,3,76,116,23,6,3,224,1,32,257
11,10,11041,2812,3,125,189,28,3,7,352,0,17,369
11,10,11041,2813,3,156,236,87,8,7,494,4,27,525
11,10,11041,2814,3,119,203,51,9,2,384,0,59,443
11,10,11041,2815,3,60,80,13,0,3,156,1,14,171
11,10,11046,2949,3,220,346,192,51,15,824,3,37,864
11,10,11046,2950,3,191,159,119,32,14,515,1,23,539
11,10,11046,2951,3,177,186,154,33,16,566,1,27,594
11,10,11046,2952,3,120,167,109,26,12,434,0,11,445
11,10,11046,2953,3,59,82,48,15,5,209,0,9,218
11,10,11046,2954,3,184,259,189,56,20,708,0,42,750
11,10,11046,2955,3,200,243,163,68,24,698,0,29,727
11,10,11046,2956,3,225,259,185,52,29,750,2,48,800
11,10,11046,2957,3,148,138,95,34,8,423,0,23,446
11,10,11046,2958,3,240,230,153,52,22,697,1,35,733
11,10,11046,2959,3,322,444,285,75,28,1154,2,26,1182
11,10,11046,2960,3,127,263,77,28,17,512,1,32,545
11,10,11046,2961,3,133,268,175,38,28,642,1,12,655
11,10,11046,2962,3,174,284,129,54,14,655,26,54,735
11,10,11046,2963,3,155,344,128,40,12,679,4,44,727
11,10,11046,2964,3,487,164,39,10,5,705,0,32,737
11,10,11046,2965,3,365,147,76,7,3,598,3,16,617
11,10,11046,2966,3,257,156,33,8,4,458,2,15,475
11,10,11046,2967,3,57,169,25,4,4,259,0,8,267
11,10,11046,2968,3,107,74,29,1,5,216,0,12,228
11,10,11046,2969,3,161,153,43,8,6,371,0,29,400
11,10,11046,2970,3,47,173,21,4,4,249,0,8,257
11,10,11046,2971,3,74,143,95,10,7,329,0,43,372
11,10,11046,2972,3,94,154,5,1,1,255,0,14,269
11,10,11046,2973,3,84,98,123,5,5,315,0,5,320
11,10,11046,2974,3,173,71,37,4,5,290,0,8,298
11,10,11046,2975,3,23,197,267,9,3,499,1,41,541
11,10,11046,2976,3,98,56,18,3,0,175,1,5,181
11,10,11046,2977,3,103,81,43,14,11,252,2,4,258
11,10,11046,2978,3,109,99,51,15,5,279,1,10,290
11,10,11046,2979,3,144,110,63,7,3,327,0,10,337
11,10,11046,2980,3,210,74,54,7,6,351,0,22,373
11,10,11046,2981,3,74,132,56,6,9,277,1,31,309
11,10,11046,2982,3,82,101,19,4,3,209,0,8,217
11,10,11046,2983,3,136,152,83,8,4,383,0,22,405
11,10,11046,2984,3,183,356,75,19,15,648,3,44,695
11,10,11046,2985,3,107,51,29,11,1,199,2,9,210
11,10,11046,2986,3,141,167,14,3,4,329,0,29,358
11,10,11046,2987,3,173,131,64,6,6,380,0,20,400
11,10,11046,2988,3,50,101,13,5,5,174,0,5,179
11,10,11046,2989,3,104,28,15,5,2,154,0,3,157
11,10,11046,2990,3,155,142,44,6,7,354,2,10,366
11,10,11046,2991,3,242,203,14,7,6,472,6,18,496
11,10,11046,2992,3,319,104,16,3,4,446,1,8,455
11,10,11046,2993,3,261,145,16,8,8,438,1,24,463
11,10,11046,2994,3,236,227,28,6,4,501,1,47,549
11,10,11046,2995,3,111,108,9,8,1,237,0,10,247
11,10,11046,2996,3,127,131,15,0,7,280,0,40,320
11,10,11046,2997,3,265,233,21,7,6,532,0,42,574
11,10,11046,2998,3,356,185,63,23,8,635,6,19,660
11,10,11046,2999,3,346,128,78,10,8,570,0,23,593
11,10,11046,3000,3,354,189,40,12,6,601,6,16,623
11,10,11046,3001,3,464,218,50,16,8,756,4,22,782
11,10,11046,3002,3,90,187,26,8,3,314,3,25,342
11,10,11046,3003,3,203,124,11,9,4,351,0,17,368
11,10,11046,3004,3,169,62,23,3,1,258,1,59,318
11,10,11046,3005,3,259,72,39,1,4,375,0,16,391
11,11,11001,1,3,440,270,61,34,8,813,0,21,834
11,11,11001,2,3,604,292,67,36,11,1010,0,30,1040
11,11,11001,3,3,518,245,46,40,10,859,1,29,889
11,11,11001,4,3,500,202,38,34,8,782,0,21,803
11,11,11001,5,3,382,217,47,40,4,690,0,11,701
11,11,11001,6,3,547,338,57,57,7,1006,1,35,1042
11,11,11001,7,3,432,261,58,28,10,789,0,21,810
11,11,11001,8,3,487,286,76,42,12,903,2,28,933
11,11,11001,9,3,566,338,71,82,11,1068,1,27,1096
11,11,11001,10,3,567,270,52,28,12,929,1,18,948
11,11,11001,11,3,589,361,75,73,16,1114,0,28,1142
11,11,11001,12,3,296,238,73,11,6,624,5,47,676
11,11,11001,13,3,87,156,83,2,3,331,1,11,343
11,11,11001,14,3,115,47,35,7,2,206,0,22,228
11,11,11001,15,3,104,96,57,0,3,260,0,19,279
11,11,11001,16,3,196,227,256,5,2,686,2,48,736
11,11,11001,17,3,106,131,321,7,9,574,1,29,604
11,11,11001,18,3,236,85,56,1,5,383,0,19,402
11,11,11001,19,3,179,172,135,3,2,491,4,18,513
11,11,11001,20,3,454,230,109,7,6,806,1,26,833
11,11,11001,21,3,211,265,102,15,6,599,2,30,631
11,11,11001,22,3,334,403,102,4,4,847,5,45,897
11,11,11001,23,3,120,63,21,1,1,206,2,1,209
11,11,11001,24,3,432,218,200,37,4,891,2,21,914
11,11,11001,25,3,239,126,52,11,2,430,0,21,451
11,11,11001,26,3,444,204,30,5,6,689,0,18,707
11,11,11001,27,3,352,147,63,9,7,578,2,17,597
11,11,11001,28,3,182,50,12,5,1,250,1,3,254
11,11,11001,29,3,213,126,27,4,5,375,2,21,398
11,11,11001,30,3,185,92,55,6,7,345,0,17,362
11,11,11001,31,3,384,143,23,9,6,565,0,13,578
11,11,11001,32,3,335,160,21,5,3,524,1,14,539
11,11,11001,33,3,276,82,15,11,3,387,0,8,395
11,11,11001,34,3,343,120,166,9,16,654,4,43,701
11,11,11001,35,3,130,134,52,4,5,325,0,21,346
11,11,11001,36,3,109,191,64,6,3,373,0,8,381
11,11,11001,37,3,388,124,33,9,14,568,1,27,596
11,11,11001,38,3,549,289,144,33,16,1031,1,23,1055
11,11,11001,39,3,321,195,33,24,5,578,3,13,594
11,11,11001,40,3,280,262,28,11,2,583,6,31,620
11,11,11001,41,3,498,133,65,22,9,727,1,15,743
11,11,11001,42,3,199,102,64,7,6,378,2,17,397
11,11,11001,43,3,77,78,20,2,1,178,1,4,183
11,11,11001,44,3,215,38,25,7,0,285,0,12,297
11,11,11001,45,3,90,55,39,16,3,203,0,9,212
11,11,11001,46,3,157,105,66,9,3,340,2,10,352
11,11,11001,47,3,384,98,102,5,6,595,0,14,609
11,11,11001,48,3,123,205,63,8,2,401,0,22,423
11,11,11001,49,3,81,198,27,4,1,311,0,3,314
11,11,11001,50,3,102,145,384,4,0,635,0,35,670
11,11,11008,567,3,288,176,60,12,12,548,1,14,563
11,11,11008,568,3,206,181,53,16,13,469,1,17,487
11,11,11008,569,3,234,147,43,7,8,439,0,6,445
11,11,11008,570,3,256,197,52,28,11,544,1,13,558
11,11,11008,571,3,305,208,48,27,12,600,0,22,622
11,11,11008,572,3,230,159,43,16,6,454,0,22,476
11,11,11008,573,3,169,168,49,21,5,412,0,9,421
11,11,11008,574,3,305,279,66,19,16,685,0,28,713
11,11,11008,575,3,325,329,72,17,21,764,1,43,808
11,11,11008,576,3,169,144,52,12,8,385,0,24,409
11,11,11008,577,3,82,141,14,4,3,244,1,15,260
11,11,11008,578,3,135,94,56,8,3,296,4,14,314
11,11,11008,579,3,93,239,19,6,2,359,0,22,381
11,11,11008,580,3,21,55,8,1,0,85,0,8,93
11,11,11008,581,3,87,69,6,6,0,168,0,6,174
11,11,11008,582,3,217,264,17,9,4,511,0,15,526
11,11,11008,583,3,55,186,41,5,8,295,0,8,303
11,11,11008,584,3,26,88,3,1,0,118,0,14,132
11,11,11008,585,3,43,51,3,0,0,97,0,9,106
11,11,11008,586,3,90,163,22,2,1,278,0,28,306
11,11,11008,587,3,73,250,5,6,6,340,0,6,346
11,11,11008,588,3,42,60,9,0,0,111,0,5,116
11,11,11008,589,3,128,116,31,2,1,278,0,21,299
11,11,11008,590,3,83,102,11,1,1,198,0,7,205
11,11,11008,591,3,51,97,73,2,2,225,1,26,252
11,11,11008,592,3,66,84,7,0,0,157,0,9,166
11,11,11008,593,3,127,96,28,5,0,256,0,7,263
11,11,11008,594,3,195,280,113,8,1,597,0,61,658
11,11,11008,595,3,36,67,67,1,1,172,0,18,190
11,11,11008,596,3,186,90,53,6,6,341,0,18,359
11,11,11008,597,3,115,242,49,16,7,429,0,28,457
11,11,11008,598,3,15,72,3,0,0,90,0,0,90
11,11,11008,599,3,29,102,58,2,2,193,0,17,210
11,11,11008,600,3,41,89,16,2,0,148,0,10,158
11,11,11008,601,3,131,228,34,8,0,401,0,20,421
11,11,11008,602,3,110,114,22,3,2,251,0,16,267
11,11,11008,603,3,93,252,15,0,1,361,0,13,374
11,11,11008,604,3,162,203,76,4,6,451,1,33,485
11,11,11008,605,3,21,25,22,0,1,69,0,4,73
11,11,11008,606,3,186,103,36,8,2,335,0,24,359
11,11,11008,607,3,63,101,7,2,1,174,2,23,199
11,11,11008,608,3,35,51,5,0,1,92,0,7,99
11,11,11012,717,3,162,125,75,11,4,377,1,2,380
11,11,11012,718,3,251,144,101,15,9,520,1,19,540
11,11,11012,719,3,193,150,82,11,4,440,0,13,453
11,11,11012,720,3,252,223,70,27,10,582,0,13,595
11,11,11012,721,3,127,101,45,9,6,288,0,10,298
11,11,11012,722,3,242,171,115,28,5,561,0,16,577
11,11,11012,723,3,263,226,137,14,5,645,0,13,658
11,11,11012,724,3,178,192,137,18,10,535,0,15,550
11,11,11012,725,3,175,295,132,17,9,628,1,30,659
11,11,11012,726,3,259,272,153,16,14,714,1,18,733
11,11,11012,727,3,72,123,36,3,4,238,238,7,483
11,11,11012,728,3,131,117,28,2,1,279,1,9,289
11,11,11012,729,3,140,81,22,2,0,245,0,7,252
11,11,11012,730,3,25,25,5,0,1,56,0,0,56
11,11,11012,731,3,154,111,38,7,2,312,3,5,320
11,11,11012,732,3,174,104,95,7,3,383,0,11,394
11,11,11012,733,3,87,21,96,0,0,204,0,9,213
11,11,11012,734,3,65,37,40,1,1,144,0,3,147
11,11,11012,735,3,16,17,4,0,0,37,0,0,37
11,11,11012,736,3,236,381,128,14,2,761,5,44,810
11,11,11012,737,3,94,67,79,1,2,243,0,6,249
11,11,11012,738,3,415,305,148,19,9,896,3,19,918
11,11,11012,739,3,377,138,76,4,5,600,0,18,618
11,11,11016,916,3,245,302,52,12,13,624,1,5,630
11,11,11016,917,3,442,381,51,18,21,913,0,25,938
11,11,11016,918,3,253,277,43,26,12,611,0,11,622
11,11,11016,919,3,418,225,41,7,3,694,0,21,715
11,11,11016,920,3,58,90,29,3,3,183,0,13,196
11,11,11016,921,3,228,86,132,7,4,457,1,16,474
11,11,11016,922,3,395,215,160,10,13,793,1,17,811
11,11,11016,923,3,301,207,370,24,13,915,2,27,944
11,11,11016,924,3,142,102,140,0,3,387,0,20,407
11,11,11016,925,3,188,157,197,10,11,563,0,56,619
11,11,11016,926,3,30,64,144,7,1,246,2,5,253
11,11,11016,927,3,201,324,61,8,4,598,0,7,605
11,11,11016,928,3,387,174,56,10,13,640,1,25,666
11,11,11023,1912,3,497,172,96,21,15,801,6,39,846
11,11,11023,1913,3,499,212,116,33,10,870,2,20,892
11,11,11023,1914,3,246,82,53,11,5,397,1,19,417
11,11,11023,1915,3,478,166,77,17,7,745,0,30,775
11,11,11023,1916,3,572,134,111,24,12,853,2,321,1176
11,11,11023,1917,3,385,187,76,23,15,686,1,19,706
11,11,11023,1918,3,364,170,49,16,5,604,0,8,612
11,11,11023,1919,3,292,99,28,11,6,436,0,8,444
11,11,11023,1920,3,365,107,66,9,6,553,2,12,567
11,11,11023,1921,3,281,107,49,24,5,466,2,24,492
11,11,11023,1922,3,331,168,104,20,13,636,0,14,650
11,11,11023,1923,3,323,127,93,15,8,566,1,23,590
11,11,11023,1924,3,395,178,60,20,3,656,1,5,662
11,11,11023,1925,3,228,125,44,12,5,414,0,8,422
11,11,11023,1926,3,475,167,57,13,11,723,1,13,737
11,11,11023,1927,3,686,337,168,66,24,1281,1,34,1316
11,11,11023,1928,3,390,152,45,19,5,611,3,15,629
11,11,11023,1929,3,417,196,82,38,13,746,2,21,769
11,11,11023,1930,3,372,185,80,32,15,684,0,11,695
11,11,11023,1931,3,514,251,141,50,10,966,0,21,987
11,11,11023,1932,3,380,183,101,29,6,699,4,21,724
11,11,11023,1933,3,25,101,5,2,0,133,0,16,149
11,11,11023,1934,3,49,50,3,1,0,103,0,14,117
11,11,11023,1935,3,55,60,8,2,2,127,1,11,139
11,11,11023,1936,3,62,28,8,1,2,101,0,4,105
11,11,11023,1937,3,34,19,6,0,1,60,0,7,67
11,11,11023,1938,3,33,27,0,0,0,60,0,2,62
11,11,11023,1939,3,107,36,17,0,4,164,1,1,166
11,11,11023,1940,3,337,113,27,2,2,481,2,16,499
11,11,11023,1941,3,134,22,26,2,0,184,0,8,192
11,11,11023,1942,3,152,109,69,0,0,330,0,22,352
11,11,11023,1943,3,282,100,41,9,5,437,1,21,459
11,11,11023,1944,3,101,181,51,4,4,341,0,27,368
11,11,11023,1945,3,211,109,34,0,2,356,1,4,361
11,11,11023,1946,3,41,74,13,5,1,134,0,25,159
11,11,11023,1947,3,347,113,53,4,2,519,5,28,552
11,11,11023,1948,3,318,167,60,32,2,579,2,22,603
11,11,11023,1949,3,267,53,17,6,3,346,1,21,368
11,11,11023,1950,3,109,21,31,2,0,163,0,12,175
11,11,11023,1951,3,41,35,9,0,1,86,0,4,90
11,11,11023,1952,3,305,63,19,8,3,398,0,11,409
11,11,11023,1953,3,153,44,36,5,2,240,0,11,251
11,11,11023,1954,3,238,62,33,8,1,342,0,16,358
11,11,11023,1955,3,153,97,32,2,1,285,0,8,293
11,11,11023,1956,3,337,143,89,20,1,590,0,13,603
11,11,11023,1957,3,544,53,79,9,0,685,0,71,756
11,11,11023,1958,3,78,52,19,0,2,151,0,5,156
11,11,11023,1959,3,138,98,49,5,12,302,1,12,315
11,11,11023,1960,3,313,66,135,21,6,541,0,17,558
11,11,11023,1961,3,204,105,49,5,1,364,0,12,376
11,11,11023,1962,3,422,56,65,5,11,559,9,15,583
11,11,11023,1963,3,382,61,163,7,5,618,1,31,650
11,11,11023,1964,3,319,141,54,16,12,542,0,28,570
11,11,11023,1965,3,187,66,38,66,5,362,0,0,362
11,11,11023,1966,3,305,33,26,4,2,370,0,17,387
11,11,11023,1967,3,258,98,82,2,9,449,1,24,474
11,11,11023,1968,3,376,210,127,11,9,733,3,25,761
11,11,11023,1969,3,549,175,165,15,18,922,2,23,947
11,11,11023,1970,3,188,96,230,6,2,522,1,23,546
11,11,11023,1971,3,311,108,35,9,3,466,4,19,489
11,11,11023,1972,3,317,111,46,5,5,484,0,19,503
11,11,11023,1973,3,297,91,97,4,10,499,3,14,516
11,11,11023,1974,3,543,148,240,7,7,945,2,26,973
11,11,11023,1975,3,434,55,28,4,3,524,1,13,538
11,11,11023,1976,3,508,217,118,15,8,866,0,12,878
11,11,11023,1977,3,316,153,100,6,3,578,0,19,597
11,11,11023,1978,3,116,20,10,1,2,149,2,4,155
11,11,11023,1979,3,269,73,84,24,4,454,0,12,466
11,11,11023,1980,3,153,61,38,14,1,267,0,15,282
11,11,11023,1981,3,91,349,102,10,4,556,0,5,561
11,11,11023,1982,3,553,90,154,34,7,838,0,28,866
11,11,11023,1983,3,257,91,41,23,4,416,0,18,434
11,11,11023,1984,3,180,101,42,2,6,331,2,22,355
11,11,11023,1985,3,320,21,24,3,0,368,0,5,373
11,11,11023,1986,3,316,85,112,6,5,524,1,18,543
11,11,11023,1987,3,298,199,132,90,3,722,0,35,757
11,11,11023,1988,3,418,110,105,9,6,648,1,21,670
11,11,11023,1989,3,217,48,48,3,3,319,0,7,326
11,11,11023,1990,3,335,75,86,14,2,512,0,17,529
11,11,11023,1991,3,290,54,68,9,2,423,0,3,426
11,11,11023,1992,3,199,66,51,2,0,318,0,2,320
11,11,11023,1993,3,170,166,73,14,8,431,0,10,441
11,11,11023,1994,3,235,80,85,6,6,412,0,4,416
11,11,11023,1995,3,203,94,64,4,3,368,2,9,379
11,11,11023,1996,3,224,61,225,6,3,519,0,13,532
11,11,11023,1997,3,126,104,79,2,4,315,3,14,332
11,11,11023,1998,3,232,207,50,5,2,496,0,35,531
11,11,11023,1999,3,164,32,34,2,0,232,2,9,243
11,11,11023,2000,3,120,53,10,3,2,188,0,5,193
11,11,11023,2001,3,185,188,68,1,2,444,1,26,471
11,11,11023,2002,3,254,174,61,5,2,496,4,11,511
11,11,11023,2003,3,215,114,64,2,1,396,2,13,411
11,11,11023,2004,3,200,50,92,1,3,346,1,19,366
11,11,11023,2005,3,262,98,114,2,6,482,0,13,495
11,11,11023,2006,3,257,141,39,8,3,448,0,26,474
11,11,11023,2007,3,178,47,66,1,0,292,0,5,297
11,11,11023,2008,3,151,63,141,8,2,365,0,6,371
11,11,11023,2009,3,260,126,102,16,5,509,0,32,541
11,11,11023,2010,3,126,98,35,2,1,262,0,11,273
11,11,11023,2011,3,165,21,119,6,0,311,1,12,324
11,11,11023,2012,3,147,101,60,6,2,316,1,8,325
11,11,11023,2013,3,181,128,48,7,1,365,1,17,383
11,11,11023,2014,3,203,57,42,4,0,306,0,14,320
11,11,11023,2015,3,40,121,28,11,5,205,0,7,212
11,11,11023,2016,3,84,215,123,9,4,435,0,19,454
11,11,11023,2017,3,213,174,68,5,2,462,1,36,499
11,11,11023,2018,3,408,80,302,4,1,795,1,29,825
11,11,11023,2019,3,250,46,83,5,0,384,0,5,389
11,11,11023,2020,3,216,79,93,0,5,393,0,20,413
11,11,11023,2021,3,119,196,99,4,0,418,0,28,446
11,11,11023,2022,3,111,77,33,6,1,228,1,13,242
11,11,11023,2023,3,321,18,39,5,2,385,0,3,388
11,11,11023,2024,3,257,41,57,9,7,371,0,11,382
11,11,11023,2025,3,311,93,187,1,6,598,5,14,617
11,12,11007,336,3,2187,399,385,135,160,3266,13,53,3332
11,12,11007,337,3,197,51,45,9,9,311,2,6,319
11,12,11007,338,3,764,145,168,65,55,1197,3,13,1213
11,12,11007,339,3,809,184,194,60,47,1294,0,27,1321
11,12,11007,340,3,513,146,125,38,28,850,9,33,892
11,12,11007,341,3,1061,365,202,44,58,1730,11,41,1782
11,12,11007,342,3,629,161,86,35,20,931,10,15,956
11,12,11007,343,3,562,150,174,51,36,973,9,16,998
11,12,11007,344,3,375,107,43,15,17,557,14,8,579
11,12,11007,345,3,333,83,71,19,24,530,1,13,544
11,12,11007,346,3,437,92,87,28,28,672,2,24,698
11,12,11007,347,3,3232,612,597,307,197,4945,26,48,5019
11,12,11007,348,3,463,75,59,16,12,625,4,17,646
11,12,11007,349,3,444,79,72,27,14,636,5,17,658
11,12,11007,350,3,436,123,78,34,25,696,5,25,726
11,12,11007,351,3,456,175,156,64,38,889,1,17,907
11,12,11007,352,3,626,227,130,34,50,1067,22,22,1111
11,12,11007,353,3,352,154,104,27,27,664,2,19,685
11,12,11007,354,3,258,108,61,9,17,453,3,10,466
11,12,11007,355,3,511,182,125,29,42,889,2,24,915
11,12,11007,356,3,613,198,142,43,38,1034,2,26,1062
11,12,11007,357,3,346,119,78,38,24,605,8,10,623
11,12,11007,358,3,180,86,73,33,12,384,0,11,395
11,12,11007,359,3,494,229,166,78,33,1000,4,4,1008
11,12,11007,360,3,511,128,60,27,35,761,2,16,779
11,12,11007,361,3,497,112,102,35,28,774,7,18,799
11,12,11007,362,3,993,161,226,58,51,1489,6,18,1513
11,12,11007,363,3,530,98,59,32,37,756,2,13,771
11,12,11007,364,3,595,93,81,21,33,823,4,8,835
11,12,11007,365,3,320,58,46,15,11,450,0,12,462
11,12,11007,366,3,1382,285,201,124,90,2082,7,31,2120
11,12,11007,367,3,365,88,43,34,20,550,5,8,563
11,12,11007,368,3,478,86,79,38,21,702,1,11,714
11,12,11007,369,3,432,97,111,40,23,703,5,7,715
11,12,11007,370,3,431,125,89,37,22,704,4,19,727
11,12,11007,371,3,486,122,90,15,25,738,0,12,750
11,12,11007,372,3,392,92,72,29,17,602,0,13,615
11,12,11007,373,3,591,148,103,24,24,890,11,19,920
11,12,11007,374,3,453,102,79,26,20,680,0,12,692
11,12,11007,375,3,440,129,98,22,24,713,12,15,740
11,12,11007,376,3,485,102,136,27,38,788,2,12,802
11,12,11007,377,3,488,100,64,28,24,704,2,12,718
11,12,11007,378,3,548,104,85,22,32,791,10,15,816
11,12,11007,379,3,521,113,82,39,20,775,4,10,789
11,12,11007,380,3,333,86,56,31,19,525,1,6,532
11,12,11007,381,3,524,167,96,49,51,887,0,18,905
11,12,11007,382,3,497,98,52,33,39,719,1,10,730
11,12,11007,383,3,507,100,76,31,31,745,2,9,756
11,12,11007,384,3,748,114,124,39,55,1080,1,13,1094
11,12,11007,385,3,412,71,93,25,31,632,1,7,640
11,12,11007,386,3,478,95,126,29,37,765,1,10,776
11,12,11007,387,3,503,147,117,39,35,841,2,21,864
11,12,11007,388,3,519,176,91,15,26,827,0,21,848
11,12,11007,389,3,438,134,65,15,22,674,0,13,687
11,12,11007,390,3,489,127,98,31,27,772,0,13,785
11,12,11007,391,3,444,142,76,18,25,705,4,16,725
11,12,11007,392,3,484,127,92,24,29,756,2,25,783
11,12,11007,393,3,477,131,121,29,45,803,1,12,816
11,12,11007,394,3,351,74,56,18,16,515,1,2,518
11,12,11007,395,3,218,51,40,10,23,342,1,5,348
11,12,11007,396,3,311,73,51,28,39,502,5,5,512
11,12,11007,397,3,355,103,46,21,23,548,2,8,558
11,12,11007,398,3,474,128,77,31,29,739,2,14,755
11,12,11007,399,3,522,153,103,29,25,832,3,20,855
11,12,11007,400,3,446,107,50,10,10,623,5,20,648
11,12,11007,401,3,543,105,72,20,21,761,2,17,780
11,12,11007,402,3,1328,294,199,51,54,1926,6,36,1968
11,12,11007,403,3,313,86,41,16,19,475,0,7,482
11,12,11007,404,3,282,88,49,15,26,460,2,3,465
11,12,11007,405,3,320,57,57,19,28,481,0,12,493
11,12,11007,406,3,310,97,46,19,19,491,0,7,498
11,12,11007,407,3,453,94,61,28,29,665,4,8,677
11,12,11007,408,3,469,113,93,49,25,749,2,12,763
11,12,11007,409,3,391,99,112,24,32,658,1,11,670
11,12,11007,410,3,452,80,94,30,33,689,2,6,697
11,12,11007,411,3,431,93,72,16,29,641,3,12,656
11,12,11007,412,3,2200,447,491,183,163,3484,5,69,3558
11,12,11007,413,3,482,102,63,20,19,686,0,13,699
11,12,11007,414,3,446,97,107,37,31,718,2,12,732
11,12,11007,415,3,654,118,109,40,46,967,0,23,990
11,12,11007,416,3,515,129,83,30,26,783,2,21,806
11,12,11007,417,3,291,86,67,23,13,480,3,9,492
11,12,11007,418,3,280,118,80,27,24,529,1,7,537
11,12,11007,419,3,302,83,62,26,19,492,0,8,500
11,12,11007,420,3,285,63,63,14,10,435,0,3,438
11,12,11007,421,3,289,117,63,17,27,513,5,9,527
11,12,11007,422,3,549,137,103,28,38,855,1,12,868
11,12,11007,423,3,316,97,36,8,12,469,2,10,481
11,12,11007,424,3,326,99,51,23,20,519,2,12,533
11,12,11007,425,3,298,78,42,15,12,445,0,16,461
11,12,11007,426,3,364,95,60,8,17,544,3,11,558
11,12,11007,427,3,306,88,72,21,18,505,4,9,518
11,12,11007,428,3,197,71,45,12,11,336,4,5,345
11,12,11007,429,3,204,61,24,17,12,318,0,6,324
11,12,11007,430,3,72,17,25,1,9,124,1,3,128
11,12,11007,431,3,515,129,87,34,43,808,3,8,819
11,12,11007,432,3,388,87,63,25,24,587,0,7,594
11,12,11007,433,3,258,79,54,21,17,429,0,0,429
11,12,11007,434,3,468,101,94,21,24,708,1,12,721
11,12,11007,435,3,530,115,80,29,33,787,5,14,806
11,12,11007,438,3,379,99,63,43,32,616,8,13,637
11,12,11007,439,3,224,76,44,26,23,393,0,10,403
11,12,11007,440,3,134,28,15,11,9,197,0,1,198
11,12,11007,441,3,286,82,60,22,19,469,0,7,476
11,12,11007,442,3,536,145,102,31,27,841,2,11,854
11,12,11007,443,3,572,137,120,31,39,899,6,6,911
11,12,11007,444,3,345,117,46,22,19,549,0,3,552
11,12,11007,445,3,388,108,81,18,29,624,0,12,636
11,12,11007,446,3,300,75,64,15,25,479,1,4,484
11,12,11007,453,3,400,117,80,27,39,663,3,21,687
11,12,11007,454,3,346,143,64,18,31,602,2,6,610
11,12,11007,455,3,462,130,80,21,13,706,1,8,715
11,12,11007,456,3,580,141,150,31,33,935,1,15,951
11,12,11007,457,3,337,104,46,21,20,528,1,8,537
11,12,11007,458,3,202,52,30,10,8,302,6,8,316
11,12,11007,459,3,576,122,148,23,41,910,0,15,925
11,12,11007,460,3,787,134,168,60,51,1200,5,11,1216
11,12,11007,461,3,213,74,52,8,16,363,1,7,371
11,12,11007,462,3,161,39,35,10,11,256,0,4,260
11,12,11007,463,3,258,55,44,19,19,395,3,15,413
11,12,11007,464,3,273,61,47,16,21,418,1,7,426
11,12,11007,469,3,269,79,56,20,12,436,0,8,444
11,12,11007,470,3,261,99,35,11,12,418,1,4,423
11,12,11007,471,3,1189,383,337,97,76,2082,7,33,2122
11,12,11007,472,3,486,131,106,19,21,763,2,16,781
11,12,11007,473,3,773,257,193,38,37,1298,8,28,1334
11,12,11007,482,3,573,135,119,26,36,889,5,27,921
11,12,11007,493,3,281,37,34,14,3,369,0,4,373
11,12,11007,494,3,187,62,25,2,4,280,1,0,281
11,12,11007,495,3,416,202,39,5,12,674,2,17,693
11,12,11007,496,3,78,176,24,1,1,280,0,7,287
11,12,11007,497,3,442,130,58,6,7,643,1,38,682
11,12,11007,498,3,284,91,133,12,6,526,2,21,549
11,12,11007,499,3,399,154,52,8,2,615,4,27,646
11,12,11007,500,3,424,186,70,10,4,694,3,16,713
11,12,11007,501,3,589,201,142,36,21,989,2,13,1004
11,12,11007,502,3,276,94,56,10,7,443,0,10,453
11,12,11007,503,3,646,227,124,17,14,1028,2,21,1051
11,12,11007,504,3,368,169,70,15,8,630,1,19,650
11,12,11007,505,3,587,148,110,18,7,870,5,20,895
11,12,11007,506,3,416,101,52,17,10,596,3,18,617
11,12,11007,507,3,476,197,72,23,13,781,4,29,814
11,12,11007,508,3,165,104,29,6,4,308,3,11,322
11,12,11007,509,3,240,327,46,2,2,617,6,13,636
11,12,11007,510,3,273,79,55,9,2,418,2,9,429
11,12,11007,511,3,393,143,72,10,17,635,9,15,659
11,12,11007,512,3,412,212,62,8,20,714,2,14,730
11,12,11007,513,3,512,237,76,24,22,871,13,14,898
11,12,11007,514,3,708,214,142,42,43,1149,1,28,1178
11,12,11007,515,3,33,18,29,9,2,91,0,0,91
11,12,11007,516,3,127,37,51,22,2,239,6,5,250
11,12,11007,517,3,209,111,68,45,8,441,3,12,456
11,12,11007,518,3,305,227,128,56,21,737,7,25,769
11,12,11007,519,3,310,136,147,54,10,657,5,21,683
11,12,11007,520,3,453,165,134,51,13,816,11,28,855
11,12,11007,521,3,296,209,127,76,12,720,1,20,741
11,12,11007,522,3,142,85,40,11,2,280,3,10,293
11,12,11007,523,3,473,103,101,23,12,712,4,20,736
11,12,11007,524,3,266,88,32,11,16,413,1,15,429
11,12,11007,525,3,285,110,23,4,5,427,4,13,444
11,12,11007,526,3,750,294,67,18,29,1158,5,30,1193
11,12,11007,527,3,348,168,85,16,10,627,7,12,646
11,12,11007,528,3,418,85,35,17,71,626,3,22,651
11,12,11007,529,3,678,187,180,26,12,1083,16,48,1147
11,12,11007,530,3,426,217,47,10,4,704,14,10,728
11,12,11007,531,3,346,121,54,27,7,555,4,4,563
11,12,11007,532,3,423,113,55,29,10,630,0,11,641
11,12,11007,533,3,238,132,35,10,13,428,0,9,437
11,12,11007,539,3,468,67,49,14,11,609,0,13,622
11,12,11007,542,3,136,242,26,23,8,435,2,14,451
11,12,11007,543,3,295,108,15,34,6,458,0,5,463
11,12,11007,544,3,98,39,5,4,2,148,1,6,155
11,12,11007,545,3,214,83,8,9,3,317,1,12,330
11,12,11007,546,3,463,145,68,24,10,710,1,15,726
11,12,11007,547,3,605,65,44,20,13,747,2,15,764
11,12,11007,548,3,41,17,1,4,1,64,0,1,65
11,12,11007,549,3,193,37,6,5,2,243,0,7,250
11,12,11007,550,3,328,45,12,5,6,396,0,21,417
11,12,11007,553,3,274,68,18,7,20,387,1,7,395
11,12,11007,554,3,251,121,52,17,6,447,2,10,459
11,12,11007,555,3,294,64,48,13,8,427,2,11,440
11,12,11007,556,3,329,91,22,16,7,465,2,6,473
11,12,11007,557,3,313,49,28,20,7,417,2,8,427
11,12,11007,558,3,509,125,50,33,9,726,1,24,751
11,12,11007,559,3,203,48,26,32,5,314,1,9,324
11,12,11007,560,3,224,59,22,10,5,320,1,15,336
11,12,11007,561,3,80,21,13,0,1,115,1,4,120
11,12,11007,566,3,63,41,7,3,2,116,0,7,123
11,13,11007,436,3,835,99,143,38,44,1159,2,18,1179
11,13,11007,437,3,464,87,87,25,20,683,2,12,697
11,13,11007,447,3,213,66,26,12,15,332,1,4,337
11,13,11007,448,3,372,71,75,36,13,567,5,7,579
11,13,11007,449,3,588,96,89,23,10,806,1,5,812
11,13,11007,450,3,755,183,93,40,28,1099,1,24,1124
11,13,11007,451,3,394,84,63,55,17,613,0,7,620
11,13,11007,452,3,472,120,100,25,24,741,3,11,755
11,13,11007,465,3,408,81,68,23,8,588,3,15,606
11,13,11007,466,3,495,221,80,21,15,832,4,15,851
11,13,11007,467,3,358,71,81,20,18,548,0,11,559
11,13,11007,468,3,498,72,74,13,22,679,0,12,691
11,13,11007,474,3,530,92,83,28,25,758,4,16,778
11,13,11007,475,3,511,111,82,26,18,748,3,17,768
11,13,11007,476,3,547,166,105,30,18,866,6,17,889
11,13,11007,477,3,869,111,143,46,26,1195,3,27,1225
11,13,11007,478,3,453,85,105,29,22,694,2,14,710
11,13,11007,479,3,473,127,97,22,18,737,9,13,759
11,13,11007,480,3,523,133,109,28,26,819,11,20,850
11,13,11007,481,3,470,113,92,28,10,713,3,11,727
11,13,11007,483,3,541,122,76,32,20,791,2,18,811
11,13,11007,484,3,270,51,54,27,17,419,2,11,432
11,13,11007,485,3,318,77,52,12,7,466,7,8,481
11,13,11007,486,3,397,134,100,12,15,658,10,25,693
11,13,11007,487,3,437,230,123,27,21,838,10,28,876
11,13,11007,488,3,246,93,71,14,4,428,7,11,446
11,13,11007,489,3,452,149,85,18,20,724,3,25,752
11,13,11007,490,3,419,112,60,18,16,625,3,5,633
11,13,11007,491,3,613,130,85,22,21,871,0,23,894
11,13,11007,492,3,363,61,28,15,9,476,2,10,488
11,13,11007,534,3,312,44,26,11,3,396,1,4,401
11,13,11007,535,3,112,79,5,4,1,201,2,4,207
11,13,11007,536,3,206,178,30,5,3,422,4,9,435
11,13,11007,537,3,170,110,14,9,4,307,2,11,320
11,13,11007,538,3,521,92,39,18,6,676,3,25,704
11,13,11007,540,3,386,39,21,6,4,456,1,6,463
11,13,11007,541,3,495,43,43,15,9,605,3,10,618
11,13,11007,551,3,317,110,25,17,6,475,0,12,487
11,13,11007,552,3,304,80,24,12,2,422,1,10,433
11,13,11007,562,3,37,7,9,0,1,54,0,0,54
11,13,11007,563,3,328,246,40,8,7,629,3,37,669
11,13,11007,564,3,256,55,30,20,13,374,4,9,387
11,13,11007,565,3,240,50,15,10,5,320,0,10,330
11,13,11011,662,3,349,55,83,41,15,543,2,9,554
11,13,11011,663,3,354,75,72,59,10,570,1,18,589
11,13,11011,664,3,439,87,77,90,23,716,3,13,732
11,13,11011,665,3,342,55,50,53,17,517,1,22,540
11,13,11011,666,3,414,110,88,70,17,699,3,17,719
11,13,11011,667,3,313,89,73,44,11,530,4,15,549
11,13,11011,668,3,616,151,142,189,36,1134,7,19,1160
11,13,11011,669,3,479,57,78,54,18,686,1,15,702
11,13,11011,670,3,460,95,88,78,17,738,2,18,758
11,13,11011,671,3,562,161,107,87,19,936,2,14,952
11,13,11011,672,3,476,93,94,64,15,742,3,15,760
11,13,11011,673,3,366,76,70,69,13,594,1,8,603
11,13,11011,674,3,321,59,84,52,18,534,0,10,544
11,13,11011,675,3,280,73,75,60,13,501,0,17,518
11,13,11011,676,3,885,208,215,146,33,1487,2,35,1524
11,13,11011,677,3,478,97,111,54,16,756,1,20,777
11,13,11011,678,3,351,91,49,58,16,565,0,11,576
11,13,11011,679,3,560,98,126,120,21,925,4,16,945
11,13,11011,680,3,340,79,84,54,8,565,4,11,580
11,13,11011,681,3,449,86,133,138,16,822,6,34,862
11,13,11011,682,3,471,128,114,83,13,809,4,30,843
11,13,11011,683,3,509,143,94,76,13,835,4,18,857
11,13,11011,684,3,586,127,138,79,15,945,1,27,973
11,13,11011,685,3,423,100,102,71,20,716,3,0,719
11,13,11011,686,3,443,97,85,73,20,718,7,13,738
11,13,11011,687,3,389,83,126,44,16,658,4,17,679
11,13,11011,688,3,425,119,146,57,9,756,8,11,775
11,13,11011,689,3,473,116,169,68,17,843,4,26,873
11,13,11011,690,3,401,100,96,46,13,656,4,20,680
11,13,11011,691,3,536,141,127,73,18,895,6,18,919
11,13,11011,692,3,351,117,142,43,9,662,3,19,684
11,13,11011,693,3,61,10,13,0,2,86,0,4,90
11,13,11011,694,3,541,178,112,76,15,922,12,23,957
11,13,11011,695,3,419,166,116,19,4,724,1,18,743
11,13,11011,696,3,299,72,86,31,3,491,0,18,509
11,13,11011,697,3,544,91,81,26,6,748,0,33,781
11,13,11011,698,3,417,77,90,23,8,615,0,15,630
11,13,11011,699,3,308,105,124,43,3,583,0,12,595
11,13,11011,700,3,225,53,60,12,6,356,1,20,377
11,13,11011,701,3,296,40,62,93,5,496,1,20,517
11,13,11011,702,3,288,33,74,22,8,425,3,6,434
11,13,11011,703,3,218,73,26,13,3,333,0,6,339
11,13,11011,704,3,107,28,10,2,0,147,0,6,153
11,13,11011,705,3,353,150,97,18,4,622,0,32,654
11,13,11011,706,3,79,31,48,0,0,158,0,12,170
11,13,11011,707,3,204,33,37,14,1,289,2,12,303
11,13,11011,708,3,258,112,80,17,5,472,4,10,486
11,13,11011,709,3,337,40,33,4,6,420,2,11,433
11,13,11011,710,3,279,74,33,7,3,396,0,23,419
11,13,11011,711,3,164,16,15,3,4,202,1,0,203
11,13,11011,712,3,149,27,27,5,1,209,0,12,221
11,13,11011,713,3,283,37,73,13,5,411,0,17,428
11,13,11011,714,3,154,39,12,10,2,217,0,11,228
11,13,11011,715,3,190,28,22,8,2,250,5,6,261
11,13,11011,716,3,396,47,48,9,4,504,0,24,528
11,13,11018,1178,3,470,283,138,48,20,959,0,19,978
11,13,11018,1179,3,234,138,110,24,6,512,1,10,523
11,13,11018,1180,3,151,169,57,20,1,398,0,12,410
11,13,11018,1181,3,128,69,29,1,4,231,0,0,231
11,13,11018,1182,3,365,237,151,27,9,789,4,19,812
11,13,11018,1183,3,699,270,158,42,12,1181,4,31,1216
11,13,11018,1184,3,389,187,92,40,10,718,1,20,739
11,13,11018,1185,3,352,177,125,54,10,718,1,17,736
11,13,11018,1186,3,358,169,81,26,3,637,2,14,653
11,13,11018,1187,3,249,107,110,45,5,516,0,6,522
11,13,11018,1188,3,445,240,121,26,6,838,1,24,863
11,13,11018,1189,3,236,100,45,12,3,396,0,0,396
11,13,11018,1190,3,170,80,53,3,2,308,0,0,308
11,13,11018,1191,3,515,155,49,9,5,733,0,12,745
11,13,11018,1192,3,403,168,152,46,8,777,0,25,802
11,13,11018,1193,3,310,67,28,9,1,415,0,16,431
11,13,11018,1194,3,338,118,71,8,1,536,1,12,549
11,13,11018,1195,3,447,58,85,13,5,608,0,13,621
11,13,11018,1196,3,418,106,85,23,2,634,4,9,647
11,13,11018,1197,3,256,134,82,12,5,489,3,27,519
11,13,11018,1198,3,201,147,36,5,1,390,2,13,405
11,13,11018,1199,3,119,101,91,9,3,323,2,13,338
11,13,11018,1200,3,127,104,50,2,3,286,0,15,301
11,13,11018,1201,3,180,60,63,7,6,316,0,9,325
11,13,11018,1202,3,144,63,47,6,0,260,0,6,266
11,13,11018,1203,3,158,32,11,4,0,205,0,5,210
11,13,11042,2816,3,670,213,441,132,33,1489,5,22,1516
11,13,11042,2817,3,329,60,224,42,18,673,1,23,697
11,13,11042,2818,3,430,93,189,34,12,758,1,16,775
11,13,11042,2819,3,297,108,185,45,10,645,0,12,657
11,13,11042,2820,3,293,108,144,22,8,575,0,20,595
11,13,11042,2821,3,288,114,198,29,12,641,0,15,656
11,13,11042,2822,3,233,91,162,27,9,522,1,21,544
11,13,11042,2823,3,406,139,313,71,20,949,4,21,974
11,13,11042,2824,3,422,175,251,63,27,938,4,34,976
11,13,11042,2825,3,416,104,239,57,25,841,4,29,874
11,13,11042,2826,3,318,129,177,49,7,680,0,25,705
11,13,11042,2827,3,258,45,177,27,9,516,4,20,540
11,13,11042,2828,3,357,106,229,41,10,743,5,23,771
11,13,11042,2829,3,349,127,215,51,21,763,0,37,800
11,13,11042,2830,3,413,79,182,33,9,716,0,16,732
11,13,11042,2831,3,351,110,219,51,17,748,8,20,776
11,13,11042,2832,3,354,92,265,46,14,771,1,36,808
11,13,11042,2833,3,371,138,219,55,10,793,3,11,807
11,13,11042,2834,3,274,92,250,39,6,661,2,21,684
11,13,11042,2835,3,172,80,187,21,9,469,2,8,479
11,13,11042,2836,3,225,41,135,16,6,423,1,10,434
11,13,11042,2837,3,296,72,210,52,11,641,1,27,669
11,13,11042,2838,3,322,96,250,57,14,739,0,34,773
11,13,11042,2839,3,388,93,235,45,21,782,4,25,811
11,13,11042,2840,3,260,67,211,23,9,570,1,21,592
11,13,11042,2841,3,327,117,340,23,17,824,5,32,861
11,13,11042,2842,3,274,136,289,23,14,736,3,31,770
11,13,11042,2843,3,339,138,273,34,25,809,0,42,851
11,13,11042,2844,3,299,104,323,36,9,771,4,20,795
11,13,11042,2845,3,226,70,185,26,7,514,3,17,534
11,13,11042,2846,3,117,30,148,15,6,316,1,8,325
11,13,11042,2847,3,310,131,338,40,19,838,5,34,877
11,13,11042,2848,3,177,66,295,10,5,553,0,39,592
11,13,11042,2849,3,141,43,318,7,13,522,1,25,548
11,13,11042,2850,3,264,56,304,20,9,653,2,15,670
11,13,11042,2851,3,240,101,137,9,10,497,1,25,523
11,13,11042,2852,3,306,96,199,21,13,635,4,26,665
11,13,11042,2853,3,219,61,154,13,8,455,1,9,465
11,13,11042,2854,3,69,8,137,1,1,216,0,7,223
11,13,11042,2855,3,283,118,239,33,13,686,22,10,718
11,13,11042,2856,3,177,94,271,19,17,578,3,21,602
11,13,11042,2857,3,220,23,182,18,2,445,0,21,466
11,13,11042,2858,3,145,39,126,9,4,323,0,6,329
11,13,11042,2859,3,164,36,123,17,2,342,0,11,353
11,13,11042,2860,3,416,72,329,37,15,869,7,37,913
11,13,11042,2861,3,235,128,111,6,9,489,7,30,526
11,13,11042,2862,3,340,77,184,8,9,618,0,36,654
11,13,11042,2863,3,248,97,225,13,6,589,6,11,606
11,13,11042,2864,3,234,68,329,28,2,661,2,26,689
11,13,11042,2865,3,262,98,96,6,3,465,1,11,477
11,13,11042,2866,3,271,43,102,11,1,428,0,13,441
11,13,11042,2867,3,339,86,237,15,2,679,6,50,735
11,13,11042,2868,3,329,94,234,26,19,702,5,20,727
11,13,11042,2869,3,265,78,278,20,9,650,0,4,654
11,13,11042,2870,3,433,51,183,14,5,686,2,38,726
11,13,11042,2871,3,232,93,330,18,5,678,1,38,717
11,13,11042,2872,3,254,111,414,39,13,831,1,34,866
11,13,11042,2873,3,158,17,646,15,10,846,2,24,872
11,13,11042,2874,3,184,22,375,10,3,594,1,22,617
11,13,11042,2875,3,469,66,333,16,9,893,3,15,911
11,13,11042,2876,3,290,88,188,10,4,580,2,36,618
11,13,11042,2877,3,313,190,190,40,15,748,0,22,770
11,13,11042,2878,3,240,149,151,11,3,554,1,38,593
11,13,11042,2879,3,248,65,155,11,15,494,0,12,506
11,13,11042,2880,3,176,24,258,14,4,476,1,18,495
11,13,11042,2881,3,177,22,211,13,8,431,0,21,452
11,13,11042,2882,3,216,82,117,21,7,443,2,16,461
11,13,11042,2883,3,232,46,270,12,6,566,0,19,585
11,13,11042,2884,3,111,41,230,17,14,413,0,16,429
11,13,11042,2885,3,204,26,225,2,4,461,0,13,474
11,13,11042,2886,3,219,45,127,14,4,409,0,12,421
11,13,11042,2887,3,248,88,119,2,6,463,2,15,480
11,13,11042,2888,3,249,100,428,19,8,804,1,42,847
11,13,11042,2889,3,118,63,158,3,2,344,0,14,358
11,13,11042,2890,3,190,20,173,4,3,390,1,6,397
11,14,11002,51,3,379,87,433,37,28,964,2,16,982
11,14,11002,52,3,139,45,193,16,9,402,2,10,414
11,14,11002,53,3,291,75,204,5,16,591,1,14,606
11,14,11002,54,3,268,75,211,35,11,600,1,10,611
11,14,11002,55,3,153,68,157,17,6,401,0,0,401
11,14,11002,56,3,277,84,295,31,12,699,4,30,733
11,14,11002,57,3,178,53,145,8,8,392,0,18,410
11,14,11002,58,3,222,47,192,22,13,496,1,18,515
11,14,11002,59,3,311,73,210,28,7,629,7,19,655
11,14,11002,60,3,285,109,191,23,14,622,1,17,640
11,14,11002,61,3,324,101,227,29,18,699,0,18,717
11,14,11002,62,3,329,62,199,41,13,644,3,12,659
11,14,11002,63,3,240,78,113,20,14,465,2,9,476
11,14,11002,64,3,206,75,176,14,14,485,1,15,501
11,14,11002,65,3,218,85,225,34,13,575,1,27,603
11,14,11002,66,3,251,78,193,18,13,553,0,18,571
11,14,11002,67,3,508,138,323,50,34,1053,6,27,1086
11,14,11002,68,3,279,89,163,21,5,557,1,10,568
11,14,11002,69,3,207,61,127,18,9,422,0,11,433
11,14,11002,70,3,230,84,200,24,9,547,1,20,568
11,14,11002,71,3,196,90,204,17,7,514,2,11,527
11,14,11002,72,3,255,64,252,25,13,609,1,15,625
11,14,11002,73,3,262,87,189,22,12,572,3,12,587
11,14,11002,74,3,486,180,301,67,28,1062,4,28,1094
11,14,11002,75,3,196,48,119,19,13,395,0,13,408
11,14,11002,76,3,258,61,162,26,10,517,0,18,535
11,14,11002,77,3,310,84,234,37,18,683,6,24,713
11,14,11002,78,3,266,61,261,17,10,615,2,23,640
11,14,11002,79,3,242,54,246,22,12,576,5,10,591
11,14,11002,80,3,210,101,240,20,13,584,0,29,613
11,14,11002,81,3,507,164,397,58,24,1150,10,20,1180
11,14,11002,82,3,211,55,154,19,10,449,0,12,461
11,14,11002,83,3,276,49,287,18,11,641,6,14,661
11,14,11002,84,3,208,82,258,17,8,573,1,6,580
11,14,11002,85,3,261,69,278,15,8,631,5,14,650
11,14,11002,86,3,387,135,587,37,29,1175,7,45,1227
11,14,11002,87,3,19,39,39,4,0,101,1,6,108
11,14,11002,88,3,12,30,32,0,1,75,0,0,75
11,14,11002,89,3,62,88,160,4,2,316,0,10,326
11,14,11002,90,3,60,13,59,2,0,134,0,5,139
11,14,11002,91,3,117,43,186,11,5,362,0,18,380
11,14,11002,92,3,109,21,77,2,1,210,0,6,216
11,14,11002,93,3,98,54,176,4,5,337,1,9,347
11,14,11002,94,3,196,76,107,9,5,393,1,6,400
11,14,11002,95,3,107,44,108,10,6,275,0,13,288
11,14,11002,96,3,139,55,158,12,8,372,0,6,378
11,14,11002,97,3,102,91,183,7,5,388,1,13,402
11,14,11002,98,3,49,35,69,6,1,160,1,17,178
11,14,11002,99,3,119,59,137,2,3,320,2,20,342
11,14,11002,100,3,209,53,102,8,12,384,3,19,406
11,14,11002,101,3,204,22,167,6,0,399,1,23,423
11,14,11002,102,3,172,43,194,16,8,433,3,12,448
11,14,11002,103,3,142,49,196,9,7,403,3,22,428
11,14,11002,104,3,113,65,216,19,2,415,1,20,436
11,14,11002,105,3,51,46,84,5,5,191,1,3,195
11,14,11002,106,3,62,81,170,8,2,323,0,7,330
11,14,11002,107,3,79,38,175,12,4,308,0,21,329
11,14,11002,108,3,124,25,120,6,4,279,2,17,298
11,14,11002,109,3,274,27,149,8,5,463,1,1,465
11,14,11002,110,3,143,13,65,5,2,228,0,4,232
11,14,11002,111,3,179,32,175,10,9,405,0,17,422
11,14,11002,112,3,40,56,228,10,1,335,2,4,341
11,14,11002,113,3,201,43,88,13,3,348,0,14,362
11,14,11002,114,3,186,60,340,13,8,607,4,25,636
11,14,11002,115,3,111,52,404,13,4,584,3,12,599
11,14,11002,116,3,198,65,198,6,5,472,2,11,485
11,14,11002,117,3,73,8,253,5,2,341,1,16,358
11,14,11002,118,3,146,65,266,4,19,500,0,11,511
11,14,11002,119,3,178,22,124,7,1,332,0,13,345
11,14,11002,120,3,146,34,141,5,5,331,0,21,352
11,14,11002,121,3,226,98,172,9,0,505,2,27,534
11,14,11002,122,3,108,55,167,4,1,335,1,18,354
11,14,11002,123,3,214,62,279,6,8,569,5,19,593
11,14,11002,124,3,49,25,93,1,1,169,0,5,174
11,14,11002,125,3,71,26,90,8,3,198,0,15,213
11,14,11002,126,3,74,77,175,5,6,337,0,14,351
11,14,11002,127,3,55,19,89,4,1,168,0,9,177
11,14,11002,128,3,258,37,221,10,6,532,1,19,552
11,14,11002,129,3,59,33,119,2,2,215,1,22,238
11,14,11002,130,3,41,44,181,5,2,273,3,22,298
11,14,11002,131,3,167,47,243,13,7,477,1,20,498
11,14,11002,132,3,102,51,168,7,7,335,3,17,355
11,14,11002,133,3,92,55,109,4,5,265,1,16,282
11,14,11002,134,3,51,11,137,3,1,203,3,8,214
11,14,11002,135,3,120,27,118,10,4,279,2,12,293
11,14,11002,136,3,428,60,226,12,8,734,0,27,761
11,14,11002,137,3,343,94,210,14,14,675,1,22,698
11,14,11002,138,3,340,32,312,21,10,715,1,30,746
11,14,11002,139,3,99,11,161,1,3,275,4,9,288
11,14,11002,140,3,69,53,208,5,4,339,1,8,348
11,14,11004,244,3,314,94,196,31,22,657,1,11,669
11,14,11004,245,3,352,163,165,25,17,722,0,16,738
11,14,11004,246,3,198,106,159,15,11,489,2,22,513
11,14,11004,247,3,310,156,149,19,17,651,3,30,684
11,14,11004,248,3,427,121,163,25,12,748,9,21,778
11,14,11004,249,3,331,109,147,23,17,627,0,19,646
11,14,11004,250,3,296,100,158,27,19,600,0,17,617
11,14,11004,251,3,388,128,231,27,18,792,2,47,841
11,14,11004,252,3,403,186,297,36,33,955,2,47,1004
11,14,11004,253,3,167,81,111,12,9,380,1,10,391
11,14,11004,254,3,286,106,99,24,17,532,0,3,535
11,14,11004,255,3,192,116,76,11,26,421,0,25,446
11,14,11004,256,3,272,196,101,17,18,604,0,14,618
11,14,11004,257,3,324,117,213,32,17,703,2,47,752
11,14,11004,258,3,272,110,170,9,17,578,1,18,597
11,14,11004,259,3,180,101,136,13,16,446,1,40,487
11,14,11004,260,3,235,24,52,9,3,323,0,2,325
11,14,11004,261,3,249,163,77,10,11,510,5,8,523
11,14,11004,262,3,162,100,73,21,3,359,4,8,371
11,14,11004,263,3,322,257,227,9,9,824,2,9,835
11,14,11004,264,3,224,176,208,19,6,633,3,17,653
11,14,11004,265,3,146,109,171,13,1,440,3,18,461
11,14,11004,266,3,31,77,73,1,2,184,1,8,193
11,14,11004,267,3,36,66,24,1,7,134,1,8,143
11,14,11004,268,3,113,85,27,5,10,240,2,15,257
11,14,11004,269,3,227,203,119,6,13,568,0,15,583
11,14,11004,270,3,33,94,97,5,7,236,2,7,245
11,14,11004,271,3,308,144,75,5,3,535,0,32,567
11,14,11004,272,3,90,136,45,8,2,281,0,46,327
11,14,11004,273,3,188,211,44,12,7,462,9,28,499
11,14,11004,274,3,92,53,89,0,3,237,2,18,257
11,14,11004,275,3,250,93,30,7,7,387,0,20,407
11,14,11004,276,3,137,104,77,5,7,330,7,41,378
11,14,11004,277,3,111,96,31,6,6,250,1,18,269
11,14,11004,278,3,114,79,45,2,8,248,1,9,258
11,14,11004,279,3,110,113,49,3,2,277,4,28,309
11,14,11004,280,3,87,81,160,12,10,350,4,18,372
11,14,11004,281,3,100,75,45,1,4,225,0,25,250
11,14,11004,282,3,56,87,58,1,3,205,0,11,216
11,14,11004,283,3,160,75,102,5,3,345,1,9,355
11,14,11004,284,3,124,39,46,1,4,214,3,12,229
11,14,11004,285,3,94,133,103,6,10,346,3,25,374
11,14,11004,286,3,114,200,182,15,4,515,1,25,541
11,14,11004,287,3,46,45,76,1,5,173,0,14,187
11,14,11005,288,3,532,113,205,39,19,908,6,49,963
11,14,11005,289,3,698,135,163,60,35,1091,1,17,1109
11,14,11005,290,3,568,118,169,43,22,920,4,30,954
11,14,11005,291,3,597,132,160,39,28,956,5,16,977
11,14,11005,292,3,505,144,162,42,20,873,2,19,894
11,14,11005,293,3,523,134,118,24,24,823,1,27,851
11,14,11005,294,3,895,219,282,50,39,1485,4,57,1546
11,14,11005,295,3,436,93,124,28,28,709,3,18,730
11,14,11005,296,3,535,130,131,33,11,840,0,23,863
11,14,11005,297,3,395,99,150,24,14,682,0,11,693
11,14,11005,298,3,20,43,160,1,1,225,1,20,246
11,14,11005,299,3,138,154,67,2,4,365,2,29,396
11,14,11005,300,3,117,157,139,7,17,437,53,79,569
11,14,11005,301,3,133,128,149,5,15,430,0,24,454
11,14,11005,302,3,434,144,129,17,20,744,10,36,790
11,14,11005,303,3,237,61,87,10,8,403,3,9,415
11,14,11005,304,3,427,224,141,19,7,818,11,37,866
11,14,11005,305,3,199,158,187,12,21,577,5,25,607
11,14,11005,306,3,90,51,27,3,3,174,3,4,181
11,14,11005,307,3,233,280,71,14,8,606,2,56,664
11,14,11005,308,3,94,49,56,5,4,208,4,27,239
11,14,11005,309,3,314,116,149,6,14,599,0,52,651
11,14,11005,310,3,115,227,51,17,10,420,0,30,450
11,14,11005,311,3,371,215,239,33,28,886,11,44,941
11,14,11005,312,3,122,77,84,14,9,306,5,13,324
11,14,11005,313,3,370,58,87,5,14,534,1,19,554
11,14,11005,314,3,264,224,84,13,10,595,3,31,629
11,14,11005,315,3,250,132,92,12,13,499,2,30,531
11,14,11005,316,3,161,156,78,16,13,424,2,24,450
11,14,11005,317,3,201,29,21,1,5,257,5,12,274
11,14,11005,318,3,179,51,55,4,6,295,2,16,313
11,14,11005,319,3,268,49,144,15,15,491,15,58,564
11,14,11005,320,3,450,115,88,22,7,682,3,9,694
11,14,11005,321,3,202,41,42,4,6,295,10,10,315
11,14,11005,322,3,367,126,198,23,18,732,6,18,756
11,14,11005,323,3,213,64,88,21,4,390,0,16,406
11,14,11005,324,3,255,113,240,12,12,632,2,26,660
11,14,11005,325,3,108,108,57,8,5,286,5,11,302
11,14,11005,326,3,256,191,159,24,21,651,3,29,683
11,14,11005,327,3,206,145,181,13,18,563,6,12,581
11,14,11005,328,3,340,182,110,20,17,669,3,18,690
11,14,11005,329,3,295,87,84,13,6,485,1,15,501
11,14,11005,330,3,272,91,97,11,9,480,6,13,499
11,14,11010,652,3,245,76,197,24,5,547,2,8,557
11,14,11010,653,3,210,87,120,24,6,447,0,19,466
11,14,11010,654,3,251,163,226,37,4,681,0,33,714
11,14,11010,655,3,275,85,129,16,3,508,2,11,521
11,14,11010,656,3,219,72,105,8,2,406,0,21,427
11,14,11010,657,3,170,45,120,15,9,359,0,16,375
11,14,11010,658,3,210,71,77,22,10,390,2,15,407
11,14,11010,659,3,123,43,133,5,1,305,1,9,315
11,14,11010,660,3,398,134,142,17,8,699,0,33,732
11,14,11010,661,3,155,73,154,3,8,393,0,15,408
11,14,11019,1204,3,176,137,109,35,7,464,0,30,494
11,14,11019,1205,3,210,197,161,73,12,653,1,58,712
11,14,11019,1206,3,173,163,135,72,8,551,1,25,577
11,14,11019,1207,3,149,133,97,45,6,430,0,24,454
11,14,11019,1208,3,235,196,180,67,9,687,0,34,721
11,14,11019,1209,3,69,203,69,7,2,350,1,65,416
11,14,11019,1210,3,307,143,70,20,9,549,2,29,580
11,14,11019,1211,3,53,106,28,5,4,196,3,2,201
11,14,11019,1212,3,33,166,29,0,1,229,4,12,245
11,14,11019,1213,3,83,27,18,3,1,132,0,0,132
11,14,11019,1214,3,207,100,38,6,3,354,0,23,377
11,14,11019,1215,3,118,108,40,6,7,279,3,33,315
11,14,11019,1216,3,44,79,9,1,5,138,0,3,141
11,14,11019,1217,3,118,37,14,2,1,172,1,13,186
11,14,11019,1218,3,179,209,54,5,7,454,0,41,495
11,14,11019,1219,3,145,33,22,6,4,210,0,0,210
11,14,11019,1220,3,88,116,24,9,3,240,0,54,294
11,14,11019,1221,3,65,80,12,1,7,165,1,18,184
11,14,11019,1222,3,88,85,45,9,7,234,0,21,255
11,14,11019,1223,3,62,125,65,5,5,262,0,25,287
11,14,11019,1224,3,93,65,45,4,8,215,1,45,261
11,14,11019,1225,3,154,143,55,9,9,370,0,25,395
11,14,11019,1226,3,126,180,32,7,7,352,3,66,421
11,14,11019,1227,3,156,55,54,4,7,276,0,26,302
11,14,11019,1228,3,49,48,27,5,2,131,0,32,163
11,14,11019,1229,3,94,147,85,11,7,344,1,52,397
11,14,11019,1230,3,61,139,71,19,10,300,0,39,339
11,14,11019,1231,3,3,14,19,2,3,41,2,4,47
11,14,11019,1232,3,36,74,20,27,2,159,0,21,180
11,14,11019,1233,3,59,100,44,7,2,212,0,16,228
11,14,11019,1234,3,30,58,52,2,3,145,1,9,155
11,14,11019,1235,3,71,198,78,20,6,373,0,50,423
11,14,11019,1236,3,43,118,15,15,3,194,0,45,239
11,14,11019,1237,3,48,15,25,1,1,90,0,17,107
11,14,11019,1238,3,18,33,12,1,1,65,0,8,73
11,14,11019,1239,3,28,62,33,4,7,134,0,13,147
11,14,11019,1240,3,25,12,16,3,2,58,0,7,65
11,14,11019,1241,3,99,203,81,11,6,400,6,61,467
11,14,11019,1242,3,31,107,29,0,1,168,0,24,192
11,14,11019,1243,3,47,98,47,11,11,214,0,39,253
11,14,11019,1244,3,101,130,151,12,3,397,4,34,435
11,14,11019,1245,3,77,50,22,0,0,149,0,0,149
11,14,11019,1246,3,65,89,94,7,8,263,4,49,316
11,14,11019,1247,3,116,58,92,15,4,285,1,13,299
11,14,11019,1248,3,84,73,81,11,3,252,0,30,282
11,14,11019,1249,3,61,92,26,16,4,199,0,24,223
11,14,11019,1250,3,83,90,88,8,8,277,19,43,339
11,14,11019,1251,3,36,55,68,3,6,168,20,26,214
11,14,11019,1252,3,52,67,27,20,3,169,2,4,175
11,14,11019,1253,3,4,15,5,1,0,25,0,2,27
11,14,11019,1254,3,318,184,50,40,9,601,6,41,648
11,14,11019,1255,3,219,89,46,24,2,380,4,22,406
11,14,11019,1256,3,76,54,26,5,4,165,0,18,183
11,14,11019,1257,3,198,125,35,21,7,386,3,8,397
11,14,11019,1258,3,100,151,38,4,4,297,0,35,332
11,14,11019,1259,3,124,126,33,9,6,298,5,70,373
11,14,11019,1260,3,51,54,19,3,2,129,0,3,132
11,14,11038,2732,3,224,166,62,13,6,471,0,12,483
11,14,11038,2733,3,202,81,51,11,3,348,0,7,355
11,14,11038,2734,3,170,64,21,13,6,274,0,9,283
11,14,11038,2735,3,167,179,27,2,2,377,0,19,396
11,14,11038,2736,3,290,188,50,11,9,548,0,14,562
11,14,11038,2737,3,259,111,61,9,8,448,3,18,469
11,14,11038,2738,3,517,186,115,22,8,848,3,29,880
11,14,11038,2739,3,151,51,20,1,2,225,0,22,247
11,14,11038,2740,3,146,50,24,6,1,227,0,6,233
11,14,11038,2741,3,240,194,27,8,3,472,1,2,475
11,14,11038,2742,3,153,99,58,10,2,322,0,26,348
11,14,11038,2743,3,125,63,71,3,1,263,1,11,275
12,1,12003,411,3,100,203,223,16,5,547,0,16,563
12,1,12003,412,3,17,65,117,4,0,203,0,5,208
12,1,12003,413,3,29,102,164,10,3,308,0,8,316
12,1,12003,414,3,72,250,598,18,6,944,1,11,956
12,1,12003,415,3,31,318,463,14,0,826,0,7,833
12,1,12003,416,3,25,141,150,4,0,320,0,2,322
12,1,12003,417,3,9,126,250,11,2,398,0,6,404
12,1,12003,418,3,34,282,270,15,3,604,0,8,612
12,1,12003,419,3,6,156,165,27,0,354,0,2,356
12,1,12003,420,3,7,72,144,2,1,226,0,2,228
12,1,12003,421,3,19,42,291,7,0,359,0,1,360
12,1,12003,422,3,35,179,207,4,2,427,1,3,431
12,1,12003,423,3,23,195,193,1,2,414,0,6,420
12,1,12003,424,3,21,73,126,1,0,221,0,2,223
12,1,12003,425,3,5,61,152,0,0,218,0,3,221
12,1,12003,426,3,22,93,125,1,0,241,0,1,242
12,1,12003,427,3,5,86,222,3,0,316,0,13,329
12,1,12003,428,3,17,115,101,1,0,234,0,0,234
12,1,12003,429,3,1,22,48,1,0,72,0,0,72
12,1,12003,430,3,4,10,91,0,0,105,0,2,107
12,1,12003,431,3,3,37,96,0,2,138,0,6,144
12,1,12003,432,3,25,78,141,0,2,246,0,1,247
12,1,12003,433,3,12,87,86,1,0,186,0,3,189
12,1,12003,434,3,48,165,318,5,1,537,0,3,540
12,1,12003,435,3,5,104,196,3,0,308,0,4,312
12,1,12003,436,3,6,39,97,0,0,142,0,0,142
12,1,12003,437,3,19,38,61,0,0,118,0,1,119
12,1,12003,438,3,70,88,161,3,2,324,0,5,329
12,1,12003,439,3,3,29,47,0,0,79,0,2,81
12,1,12003,440,3,38,26,65,1,5,135,0,3,138
12,1,12003,441,3,15,45,47,3,0,110,0,2,112
12,1,12003,442,3,13,115,118,0,1,247,0,0,247
12,1,12003,443,3,94,149,257,8,0,508,0,21,529
12,1,12003,444,3,21,8,62,0,0,91,0,0,91
12,1,12003,445,3,87,48,68,0,6,209,3,6,218
12,1,12003,446,3,37,39,145,1,3,225,0,2,227
12,1,12003,447,3,44,49,85,0,0,178,0,2,180
12,1,12003,448,3,9,1,99,0,1,110,0,1,111
12,1,12003,449,3,11,14,42,1,2,70,0,3,73
12,1,12003,450,3,22,12,67,0,1,102,0,1,103
12,1,12003,451,3,2,7,16,0,0,25,0,4,29
12,1,12003,452,3,7,9,22,0,0,38,0,0,38
12,1,12003,453,3,11,50,12,0,0,73,0,0,73
12,1,12003,454,3,28,44,26,1,1,100,1,1,102
12,1,12003,455,3,15,19,227,0,3,264,0,3,267
12,1,12006,479,3,48,110,130,9,4,301,0,8,309
12,1,12006,480,3,38,128,231,19,1,417,2,11,430
12,1,12006,481,3,72,143,251,10,3,479,0,28,507
12,1,12006,482,3,55,101,167,4,2,329,0,4,333
12,1,12006,483,3,73,188,290,17,1,569,0,18,587
12,1,12006,484,3,71,92,229,4,2,398,0,13,411
12,1,12006,485,3,1,7,31,0,2,41,0,0,41
12,1,12006,486,3,2,109,75,0,0,186,0,0,186
12,1,12006,487,3,2,13,33,0,0,48,0,0,48
12,1,12006,488,3,16,19,77,0,2,114,0,2,116
12,1,12006,489,3,4,99,82,0,0,185,0,1,186
12,1,12006,490,3,3,89,111,0,0,203,0,2,205
12,1,12006,491,3,11,40,14,0,0,65,0,2,67
12,1,12006,492,3,6,180,82,0,0,268,0,4,272
12,1,12006,493,3,12,83,71,4,0,170,0,4,174
12,1,12006,494,3,10,74,54,1,1,140,0,0,140
12,1,12006,495,3,6,14,29,0,0,49,0,4,53
12,1,12006,496,3,11,96,65,2,1,175,0,1,176
12,1,12006,497,3,2,29,7,1,0,39,0,1,40
12,1,12006,498,3,3,7,48,8,0,66,0,0,66
12,1,12006,499,3,4,23,29,1,0,57,0,5,62
12,1,12007,500,3,31,191,215,7,0,444,0,17,461
12,1,12007,501,3,33,271,288,13,8,613,5,15,633
12,1,12007,502,3,16,132,209,4,4,365,0,5,370
12,1,12007,503,3,23,223,249,10,4,509,0,8,517
12,1,12007,504,3,40,276,344,30,0,690,1,10,701
12,1,12007,505,3,38,276,327,38,4,683,0,16,699
12,1,12007,506,3,35,406,249,42,4,736,0,32,768
12,1,12007,507,3,16,180,246,11,5,458,0,13,471
12,1,12007,508,3,24,77,114,3,3,221,0,7,228
12,1,12007,509,3,12,75,160,1,2,250,0,21,271
12,1,12007,510,3,32,188,292,9,10,531,1,25,557
12,1,12007,511,3,44,229,229,7,7,516,2,15,533
12,1,12007,512,3,43,119,239,20,4,425,1,19,445
12,1,12007,513,3,20,109,144,5,0,278,0,8,286
12,1,12007,514,3,3,44,30,0,0,77,0,7,84
12,1,12007,515,3,2,30,36,0,0,68,0,2,70
12,1,12007,516,3,3,7,20,1,0,31,0,0,31
12,1,12007,517,3,7,35,70,0,1,113,0,0,113
12,1,12007,518,3,9,165,246,7,5,432,0,12,444
12,1,12007,519,3,2,29,49,1,1,82,1,7,90
12,1,12007,520,3,1,11,31,0,0,43,1,1,45
12,1,12007,521,3,8,29,83,1,1,122,0,2,124
12,1,12007,522,3,1,27,28,2,0,58,0,0,58
12,1,12007,523,3,2,12,34,0,0,48,0,1,49
12,1,12007,524,3,13,49,122,1,0,185,0,8,193
12,1,12007,525,3,5,1,37,0,0,43,0,1,44
12,1,12007,527,3,2,15,47,0,0,64,0,1,65
12,1,12007,528,3,5,11,72,2,0,90,0,0,90
12,1,12007,529,3,3,31,47,0,0,81,0,2,83
12,1,12007,530,3,7,11,25,1,0,44,1,0,45
12,1,12007,531,3,3,23,41,2,0,69,0,0,69
12,1,12007,532,3,2,10,54,1,0,67,0,1,68
12,1,12007,533,3,10,38,99,0,1,148,0,6,154
12,1,12007,534,3,2,11,68,0,1,82,0,1,83
12,1,12007,535,3,7,64,147,0,1,219,0,11,230
12,1,12007,536,3,0,5,49,1,0,55,0,2,57
12,1,12007,537,3,7,22,37,0,0,66,0,3,69
12,1,12007,538,3,25,129,221,3,0,378,1,5,384
12,1,12007,539,3,4,29,73,1,0,107,0,9,116
12,1,12007,540,3,7,31,62,1,2,103,0,4,107
12,1,12007,541,3,6,12,50,0,0,68,0,2,70
12,1,12007,542,3,9,19,46,0,1,75,0,0,75
12,1,12007,543,3,0,16,32,0,0,48,0,0,48
12,1,12007,544,3,3,17,38,0,0,58,0,0,58
12,1,12007,545,3,3,32,7,3,2,47,0,0,47
12,1,12007,546,3,6,20,57,0,0,83,0,4,87
12,1,12007,547,3,16,55,138,1,2,212,0,5,217
12,1,12007,548,3,0,43,25,1,0,69,0,1,70
12,1,12007,549,3,15,97,164,1,0,277,0,0,277
12,1,12007,550,3,4,67,98,1,0,170,0,3,173
12,1,12007,551,3,28,19,26,1,0,74,0,3,77
12,1,12007,552,3,1,88,144,0,0,233,0,7,240
12,1,12022,943,3,67,250,235,59,6,617,0,8,625
12,1,12022,944,3,40,78,52,46,4,220,0,8,228
12,1,12022,945,3,142,301,232,154,5,834,0,26,860
12,1,12022,946,3,121,289,265,128,8,811,0,27,838
12,1,12022,947,3,45,21,3,0,0,69,0,0,69
12,1,12022,948,3,3,17,5,0,0,25,0,0,25
12,1,12022,949,3,47,77,23,1,0,148,0,16,164
12,1,12022,950,3,10,56,62,0,0,128,0,2,130
12,1,12022,951,3,35,175,156,0,1,367,0,5,372
12,1,12022,952,3,25,43,25,0,0,93,0,2,95
12,1,12022,953,3,31,110,71,3,0,215,0,4,219
12,1,12022,954,3,20,167,209,5,0,401,0,5,406
12,1,12022,955,3,21,102,51,4,0,178,0,3,181
12,1,12022,956,3,9,63,68,4,2,146,0,7,153
12,1,12022,957,3,15,328,304,2,2,651,0,6,657
12,1,12022,958,3,22,103,56,1,0,182,0,12,194
12,1,12022,959,3,41,149,73,3,2,268,0,6,274
12,1,12022,960,3,23,53,198,2,2,278,0,3,281
12,1,12022,961,3,48,58,124,1,0,231,0,7,238
12,1,12022,962,3,13,87,79,9,0,188,1,1,190
12,1,12022,963,3,33,126,106,8,0,273,0,5,278
12,1,12022,964,3,26,160,93,3,4,286,0,4,290
12,1,12022,965,3,42,106,109,8,4,269,1,5,275
12,1,12022,966,3,40,48,47,0,1,136,0,0,136
12,1,12022,967,3,36,124,112,6,2,280,1,8,289
12,1,12022,968,3,34,93,97,6,2,232,0,3,235
12,1,12022,969,3,22,36,99,6,2,165,0,5,170
12,1,12022,970,3,71,120,163,9,1,364,0,15,379
12,1,12022,971,3,53,167,156,9,0,385,0,14,399
12,1,12022,972,3,64,8,10,8,1,91,1,6,98
12,1,12022,973,3,34,113,31,10,1,189,0,4,193
12,1,12022,974,3,29,47,59,10,0,145,0,2,147
12,1,12022,975,3,77,27,130,16,0,250,0,12,262
12,1,12022,976,3,12,102,110,16,0,240,0,9,249
12,1,12022,977,3,35,52,87,8,3,185,0,9,194
12,1,12022,978,3,7,20,34,2,0,63,0,0,63
12,1,12022,979,3,12,187,147,0,0,346,0,11,357
12,1,12022,980,3,9,60,33,1,1,104,0,7,111
12,1,12022,981,3,19,73,140,0,1,233,0,2,235
12,1,12022,982,3,10,58,76,3,2,149,0,1,150
12,1,12022,983,3,78,314,270,19,5,686,1,18,705
12,1,12022,984,3,13,1,1,1,0,16,0,0,16
12,1,12022,985,3,17,38,11,1,0,67,0,1,68
12,1,12022,986,3,7,29,51,0,0,87,0,3,90
12,1,12022,987,3,12,38,24,3,0,77,0,1,78
12,1,12022,988,3,66,232,236,7,4,545,0,19,564
12,1,12022,989,3,14,189,34,1,2,240,1,13,254
12,1,12022,990,3,1,65,114,1,2,183,0,1,184
12,1,12022,991,3,112,112,55,0,0,279,0,10,289
12,1,12022,992,3,43,38,5,1,0,87,0,0,87
12,1,12022,993,3,6,70,58,0,0,134,0,0,134
12,1,12022,994,3,90,131,79,2,3,305,1,11,317
12,1,12022,995,3,3,22,64,1,0,90,0,0,90
12,1,12022,996,3,28,118,54,0,1,201,0,4,205
12,1,12022,997,3,19,11,8,0,0,38,0,0,38
12,1,12022,998,3,10,147,28,1,0,186,0,2,188
12,1,12022,999,3,6,19,40,0,4,69,0,1,70
12,1,12022,1000,3,49,66,25,0,0,140,0,1,141
12,1,12027,1067,3,38,138,134,3,2,315,0,13,328
12,1,12027,1068,3,40,140,190,4,3,377,0,17,394
12,1,12027,1069,3,50,187,186,5,1,429,0,16,445
12,1,12027,1070,3,50,189,208,9,6,462,0,14,476
12,1,12027,1071,3,14,56,89,2,2,163,0,2,165
12,1,12027,1072,3,7,71,106,0,0,184,0,0,184
12,1,12027,1074,3,3,51,8,0,2,64,0,0,64
12,1,12027,1075,3,9,20,16,0,0,45,0,1,46
12,1,12027,1076,3,9,55,28,0,1,93,0,0,93
12,1,12027,1077,3,9,26,19,0,0,54,0,0,54
12,1,12027,1079,3,11,25,27,0,0,63,0,0,63
12,1,12027,1080,3,14,44,33,0,0,91,0,2,93
12,1,12027,1081,3,30,185,229,0,1,445,0,11,456
12,1,12027,1082,3,27,37,42,0,0,106,0,0,106
12,1,12027,1083,3,24,43,50,0,0,117,0,0,117
12,1,12027,1084,3,64,92,189,4,2,351,0,11,362
12,1,12027,1085,3,11,33,79,0,0,123,0,0,123
12,1,12027,1086,3,31,122,68,1,1,223,0,5,228
12,1,12027,1087,3,21,94,135,1,1,252,0,7,259
12,1,12027,1088,3,14,44,62,0,0,120,0,0,120
12,1,12027,1089,3,4,15,39,1,1,60,0,3,63
12,1,12027,1090,3,1,12,45,0,0,58,0,0,58
12,1,12027,1091,3,7,12,44,0,0,63,0,1,64
12,1,12027,1092,3,5,54,97,0,0,156,1,6,163
12,1,12027,1093,3,3,14,30,0,0,47,0,1,48
12,1,12027,1094,3,14,184,34,0,0,232,0,0,232
12,1,12027,1095,3,14,10,106,0,0,130,0,0,130
12,1,12027,1096,3,7,30,43,0,0,80,0,1,81
12,1,12027,1097,3,6,52,25,2,2,87,0,1,88
12,1,12027,1098,3,13,169,128,0,0,310,0,6,316
12,1,12027,1099,3,10,36,60,1,1,108,0,0,108
12,1,12027,1100,3,32,37,120,1,1,191,0,8,199
12,1,12027,1101,3,9,52,67,0,0,128,0,0,128
12,1,12027,1102,3,5,59,76,3,0,143,0,3,146
12,1,12027,1103,3,14,33,139,0,0,186,2,5,193
12,1,12027,1104,3,73,119,140,17,3,352,0,18,370
12,1,12027,1105,3,12,17,27,0,0,56,0,2,58
12,1,12027,1106,3,35,22,108,1,1,167,0,8,175
12,1,12027,1107,3,9,56,38,0,0,103,0,0,103
12,1,12027,1108,3,20,18,68,0,1,107,1,0,108
12,1,12027,1109,3,43,84,133,1,1,262,1,8,271
12,1,12027,1110,3,22,20,41,0,0,83,0,0,83
12,1,12027,1111,3,30,93,146,4,1,274,0,1,275
12,1,12033,1382,3,103,116,153,34,2,408,0,16,424
12,1,12033,1383,3,115,138,218,23,5,499,0,22,521
12,1,12033,1384,3,70,141,235,34,3,483,0,19,502
12,1,12033,1385,3,18,16,6,0,0,40,0,0,40
12,1,12033,1386,3,58,117,66,0,3,244,0,5,249
12,1,12033,1387,3,0,79,17,0,0,96,0,0,96
12,1,12033,1388,3,54,21,104,0,0,179,0,7,186
12,1,12033,1389,3,5,19,42,0,0,66,0,1,67
12,1,12033,1390,3,5,25,6,0,0,36,0,1,37
12,1,12033,1391,3,2,34,25,2,1,64,0,1,65
12,1,12033,1392,3,12,10,13,0,0,35,0,2,37
12,1,12033,1393,3,54,43,12,2,1,112,0,0,112
12,1,12033,1394,3,8,49,21,1,0,79,0,1,80
12,1,12033,1395,3,21,25,12,2,0,60,0,1,61
12,1,12033,1396,3,44,6,8,1,0,59,0,0,59
12,1,12033,1397,3,9,9,14,0,0,32,0,0,32
12,1,12033,1398,3,15,106,52,20,3,196,0,8,204
12,1,12033,1399,3,22,13,7,1,0,43,0,1,44
12,1,12033,1401,3,18,4,4,28,0,54,0,2,56
12,1,12033,1402,3,50,99,38,3,1,191,0,0,191
12,1,12033,1403,3,21,39,19,1,0,80,0,1,81
12,1,12033,1404,3,39,54,59,2,0,154,0,4,158
12,1,12033,1405,3,32,87,27,2,0,148,0,0,148
12,1,12033,1406,3,27,37,42,12,0,118,0,3,121
12,1,12033,1407,3,22,22,10,7,1,62,0,3,65
12,1,12033,1408,3,45,9,17,2,0,73,0,3,76
12,1,12033,1409,3,45,57,26,0,0,128,0,3,131
12,1,12033,1410,3,14,21,56,1,0,92,0,0,92
12,1,12033,1411,3,15,54,43,0,2,114,0,9,123
12,1,12033,1412,3,13,14,19,1,1,48,1,0,49
12,1,12033,1413,3,23,43,25,3,1,95,0,2,97
12,1,12033,1414,3,28,21,117,2,1,169,1,6,176
12,1,12033,1415,3,7,20,71,2,0,100,0,0,100
12,1,12033,1416,3,11,47,20,0,1,79,0,7,86
12,1,12033,1417,3,27,89,46,11,0,173,0,1,174
12,1,12033,1418,3,52,69,100,12,1,234,0,1,235
12,1,12033,1419,3,24,42,60,6,1,133,0,13,146
12,1,12033,1420,3,14,49,27,0,0,90,0,7,97
12,1,12033,1421,3,37,36,103,0,0,176,0,5,181
12,1,12033,1422,3,13,113,16,0,0,142,0,4,146
12,1,12033,1423,3,17,49,14,0,0,80,0,0,80
12,1,12033,1424,3,17,49,14,0,0,80,0,0,80
12,1,12033,1425,3,6,14,91,0,0,111,0,5,116
12,1,12033,1426,3,11,25,46,0,0,82,0,0,82
12,1,12033,1427,3,10,32,30,0,1,73,0,2,75
12,1,12033,1428,3,22,89,177,1,5,294,0,7,301
12,1,12033,1429,3,21,152,38,0,0,211,0,384,595
12,1,12033,1430,3,44,64,11,0,1,120,0,4,124
12,1,12033,1431,3,59,182,112,2,3,358,0,7,365
12,1,12041,1677,3,131,140,191,24,6,492,0,12,504
12,1,12041,1678,3,124,100,226,31,3,484,2,6,492
12,1,12041,1679,3,57,33,132,6,0,228,0,0,228
12,1,12041,1680,3,141,167,306,20,2,636,0,15,651
12,1,12041,1681,3,102,173,113,12,1,401,1,11,413
12,1,12041,1682,3,54,111,120,6,3,294,0,6,300
12,1,12041,1683,3,9,6,77,0,0,92,0,1,93
12,1,12041,1684,3,14,152,19,0,0,185,0,7,192
12,1,12041,1685,3,23,53,67,2,1,146,0,7,153
12,1,12041,1686,3,4,43,118,0,1,166,0,1,167
12,1,12041,1687,3,18,54,35,12,1,120,0,12,132
12,1,12041,1688,3,36,128,48,4,3,219,0,15,234
12,1,12041,1689,3,55,70,76,9,1,211,1,4,216
12,1,12041,1690,3,14,15,21,5,0,55,0,3,58
12,1,12041,1691,3,24,49,67,7,2,149,0,6,155
12,1,12041,1692,3,19,66,38,1,1,125,0,5,130
12,1,12041,1693,3,0,76,60,13,0,149,0,2,151
12,1,12041,1694,3,14,214,65,3,0,296,0,7,303
12,1,12041,1695,3,19,186,75,6,2,288,0,7,295
12,1,12041,1696,3,6,68,17,6,0,97,0,6,103
12,1,12041,1697,3,2,53,3,0,0,58,0,3,61
12,1,12041,1698,3,29,50,65,0,1,145,0,3,148
12,1,12051,1950,3,87,119,308,11,8,533,0,3,536
12,1,12051,1951,3,238,225,488,32,15,998,2,9,1009
12,1,12051,1952,3,94,169,377,23,6,669,1,13,683
12,1,12051,1953,3,109,128,367,15,13,632,0,12,644
12,1,12051,1954,3,197,295,496,36,8,1032,0,23,1055
12,1,12051,1955,3,76,118,421,25,11,651,2,20,673
12,1,12051,1956,3,115,195,363,20,9,702,1,8,711
12,1,12051,1957,3,207,267,462,53,14,1003,1,12,1016
12,1,12051,1958,3,130,177,300,17,7,631,0,11,642
12,1,12051,1959,3,107,212,375,34,14,742,0,12,754
12,1,12051,1960,3,117,247,483,40,5,892,0,24,916
12,1,12051,1961,3,60,140,312,24,14,550,0,16,566
12,1,12051,1962,3,12,87,68,10,2,179,0,3,182
12,1,12051,1963,3,19,24,66,2,0,111,0,7,118
12,1,12051,1964,3,51,85,135,4,0,275,0,9,284
12,1,12051,1965,3,33,55,95,3,2,188,0,3,191
12,1,12051,1966,3,22,19,67,5,4,117,0,1,118
12,1,12051,1967,3,31,96,51,3,1,182,0,2,184
12,1,12051,1968,3,53,158,321,9,1,542,0,9,551
12,1,12051,1969,3,81,63,181,3,1,329,0,0,329
12,1,12051,1970,3,16,70,109,2,1,198,0,1,199
12,1,12051,1971,3,70,466,467,35,2,1040,1,14,1055
12,1,12051,1972,3,40,178,242,31,5,496,0,3,499
12,1,12055,2092,3,19,96,121,5,4,245,0,10,255
12,1,12055,2093,3,22,257,251,13,4,547,0,19,566
12,1,12055,2094,3,16,267,302,30,4,619,0,27,646
12,1,12055,2095,3,9,151,149,9,1,319,0,0,319
12,1,12055,2096,3,6,90,123,5,0,224,0,3,227
12,1,12055,2097,3,5,153,258,0,0,416,0,15,431
12,1,12055,2098,3,5,44,39,1,0,89,0,3,92
12,1,12055,2099,3,8,95,62,1,0,166,0,3,169
12,1,12055,2100,3,5,125,130,3,1,264,0,9,273
12,1,12055,2101,3,12,170,268,3,0,453,1,9,463
12,1,12055,2102,3,2,114,156,2,0,274,0,8,282
12,1,12055,2103,3,2,68,77,2,1,150,0,9,159
12,1,12055,2104,3,3,73,236,0,1,313,0,13,326
12,1,12055,2105,3,8,58,56,0,1,123,0,8,131
12,1,12055,2106,3,0,20,85,2,0,107,0,0,107
12,1,12055,2107,3,5,72,72,3,0,152,0,7,159
12,1,12055,2108,3,4,13,65,0,0,82,0,0,82
12,1,12055,2109,3,21,34,23,1,1,80,0,2,82
12,1,12055,2110,3,2,13,106,2,0,123,1,0,124
12,1,12055,2111,3,5,7,69,0,1,82,0,1,83
12,1,12055,2112,3,3,11,36,10,0,60,0,2,62
12,1,12055,2113,3,1,5,58,7,3,74,0,0,74
12,1,12055,2114,3,11,22,82,2,0,117,0,4,121
12,1,12055,2115,3,13,44,80,2,0,139,0,6,145
12,1,12055,2116,3,18,83,69,7,0,177,0,17,194
12,1,12055,2117,3,43,33,84,4,0,164,0,7,171
12,1,12055,2118,3,12,33,106,1,0,152,0,3,155
12,1,12055,2119,3,3,57,55,1,0,116,0,2,118
12,1,12055,2120,3,9,10,38,0,0,57,0,1,58
12,1,12055,2121,3,6,16,55,0,0,77,0,2,79
12,1,12055,2122,3,5,20,159,0,0,184,0,1,185
12,1,12055,2123,3,9,31,97,0,0,137,0,5,142
12,1,12055,2124,3,3,25,54,0,0,82,0,1,83
12,1,12055,2125,3,9,24,50,6,3,92,0,6,98
12,1,12055,2126,3,0,39,4,0,0,43,0,0,43
12,1,12055,2127,3,1,0,123,0,0,124,0,0,124
12,1,12055,2128,3,7,50,43,0,0,100,0,1,101
12,1,12055,2129,3,5,85,110,2,2,204,1,7,212
12,1,12055,2130,3,5,119,109,0,0,233,0,7,240
12,1,12055,2131,3,2,100,152,0,0,254,0,4,258
12,1,12055,2132,3,3,94,59,1,0,157,0,0,157
12,1,12055,2133,3,5,151,267,3,0,426,0,19,445
12,1,12065,2533,3,74,62,125,16,0,277,0,1,278
12,1,12065,2534,3,161,124,228,11,2,526,1,0,527
12,1,12065,2535,3,208,73,186,11,5,483,0,15,498
12,1,12065,2536,3,111,37,105,12,0,265,0,6,271
12,1,12065,2537,3,110,29,155,3,0,297,0,7,304
12,1,12065,2538,3,19,3,34,0,0,56,0,0,56
12,1,12065,2539,3,4,9,17,0,0,30,0,0,30
12,1,12065,2540,3,53,4,24,1,0,82,0,0,82
12,1,12065,2541,3,90,1,61,0,0,152,0,5,157
12,1,12065,2542,3,205,93,371,9,1,679,0,9,688
12,1,12065,2543,3,10,5,31,0,1,47,0,1,48
12,1,12065,2544,3,20,9,77,0,2,108,0,1,109
12,1,12065,2545,3,55,43,38,3,0,139,0,0,139
12,1,12065,2546,3,35,60,60,0,0,155,0,4,159
12,1,12065,2547,3,22,39,41,0,0,102,0,4,106
12,1,12065,2548,3,25,42,42,0,0,109,0,4,113
12,1,12065,2549,3,4,28,22,1,0,55,0,6,61
12,1,12065,2550,3,32,155,208,2,0,397,1,10,408
12,1,12065,2551,3,53,211,229,2,1,496,0,13,509
12,1,12065,2552,3,9,33,11,0,1,54,0,2,56
12,1,12065,2553,3,52,148,228,3,0,431,0,3,434
12,1,12068,2600,3,80,393,371,115,8,967,0,13,980
12,1,12068,2601,3,40,181,309,45,4,579,0,4,583
12,1,12068,2602,3,80,167,309,45,6,607,0,15,622
12,1,12068,2603,3,11,40,29,3,0,83,0,0,83
12,1,12068,2604,3,51,154,283,26,0,514,0,7,521
12,1,12068,2605,3,26,78,187,30,1,322,0,2,324
12,1,12068,2606,3,18,83,110,15,2,228,0,4,232
12,1,12068,2607,3,59,141,222,31,0,453,0,19,472
12,1,12068,2608,3,8,54,56,2,0,120,0,1,121
12,1,12068,2609,3,5,52,65,8,1,131,0,1,132
12,1,12068,2610,3,37,137,184,4,0,362,0,6,368
12,1,12068,2611,3,41,283,308,36,1,669,0,8,677
12,1,12068,2612,3,47,199,287,4,1,538,0,8,546
12,1,12068,2613,3,10,111,102,3,0,226,0,6,232
12,1,12068,2614,3,42,301,177,25,0,545,0,14,559
12,1,12068,2615,3,35,198,305,11,1,550,4,4,558
12,1,12068,2616,3,23,93,214,15,1,346,0,7,353
12,1,12068,2617,3,13,67,54,8,0,142,0,6,148
12,1,12068,2618,3,2,43,77,2,1,125,0,3,128
12,1,12068,2619,3,8,29,47,5,0,89,0,0,89
12,1,12068,2620,3,12,51,28,5,0,96,0,2,98
12,1,12068,2621,3,2,36,41,2,0,81,0,0,81
12,1,12074,2725,3,73,113,308,16,1,511,0,8,519
12,1,12074,2726,3,105,204,493,35,8,845,0,18,863
12,1,12074,2727,3,9,23,555,1,1,589,1,6,596
12,1,12074,2728,3,18,31,66,2,0,117,1,2,120
12,1,12074,2729,3,25,34,113,0,0,172,0,0,172
12,1,12074,2730,3,25,157,227,1,0,410,0,3,413
12,1,12074,2731,3,28,88,477,22,1,616,0,9,625
12,1,12074,2732,3,32,89,234,7,0,362,0,6,368
12,1,12074,2733,3,9,17,96,0,0,122,0,0,122
12,1,12074,2734,3,8,33,179,1,0,221,0,0,221
12,1,12074,2735,3,16,130,258,0,0,404,0,3,407
12,1,12074,2736,3,24,31,174,2,2,233,0,8,241
12,1,12074,2737,3,7,67,85,4,0,163,0,0,163
12,1,12074,2738,3,6,38,109,5,0,158,0,3,161
12,1,12074,2739,3,6,13,45,1,1,66,0,2,68
12,1,12074,2740,3,76,30,92,4,0,202,0,0,202
12,1,12074,2741,3,69,166,306,5,5,551,0,14,565
12,1,12074,2742,3,4,7,16,1,0,28,0,0,28
12,1,12074,2743,3,0,12,15,0,0,27,0,0,27
12,1,12074,2744,3,60,40,61,2,4,167,0,8,175
12,1,12074,2746,3,18,44,104,1,0,167,0,0,167
12,1,12074,2748,3,62,101,186,1,0,350,0,6,356
12,1,12074,2749,3,4,3,93,4,0,104,0,4,108
12,1,12074,2751,3,9,22,117,1,0,149,0,2,151
12,2,12017,820,3,40,109,188,17,6,360,3,9,372
12,2,12017,821,3,61,163,187,24,4,439,0,13,452
12,2,12017,822,3,67,215,267,32,9,590,0,10,600
12,2,12017,823,3,119,97,113,0,1,330,0,7,337
12,2,12017,824,3,2,41,42,2,0,87,0,0,87
12,2,12017,825,3,34,96,131,1,3,265,0,7,272
12,2,12017,826,3,2,68,37,2,2,111,1,2,114
12,2,12017,827,3,14,40,124,3,3,184,0,3,187
12,2,12017,828,3,3,21,23,4,1,52,0,0,52
12,2,12017,829,3,12,63,94,5,0,174,0,4,178
12,2,12017,830,3,41,159,154,6,1,361,1,7,369
12,2,12017,831,3,47,114,185,6,1,353,0,2,355
12,2,12017,832,3,29,97,160,5,1,292,0,13,305
12,2,12017,833,3,16,146,132,3,3,300,5,10,315
12,2,12017,834,3,6,62,83,3,0,154,0,1,155
12,2,12017,835,3,18,100,80,1,1,200,0,2,202
12,2,12017,836,3,4,47,14,1,0,66,0,0,66
12,2,12017,837,3,4,67,48,1,0,120,0,7,127
12,2,12017,838,3,5,42,14,1,1,63,0,0,63
12,2,12017,839,3,20,104,112,2,0,238,0,9,247
12,2,12017,840,3,29,48,103,0,2,182,0,7,189
12,2,12017,841,3,3,15,39,1,0,58,0,1,59
12,2,12017,842,3,2,10,20,0,0,32,0,0,32
12,2,12017,843,3,12,91,61,1,1,166,0,3,169
12,2,12026,1050,3,26,126,104,4,2,262,2,5,269
12,2,12026,1051,3,12,72,76,2,0,162,0,2,164
12,2,12026,1052,3,7,127,96,5,0,235,0,3,238
12,2,12026,1053,3,6,192,141,2,0,341,0,3,344
12,2,12026,1054,3,2,64,193,3,0,262,1,9,272
12,2,12026,1055,3,4,131,125,5,0,265,0,15,280
12,2,12026,1056,3,4,123,65,1,0,193,1,10,204
12,2,12026,1057,3,2,57,157,0,0,216,0,4,220
12,2,12026,1058,3,20,205,170,1,1,397,0,5,402
12,2,12026,1059,3,23,86,310,4,1,424,0,9,433
12,2,12026,1060,3,3,57,41,0,0,101,0,0,101
12,2,12026,1061,3,1,56,45,0,0,102,0,0,102
12,2,12026,1062,3,25,65,138,0,0,228,0,5,233
12,2,12026,1063,3,5,65,47,0,0,117,0,4,121
12,2,12026,1064,3,3,51,5,1,0,60,0,1,61
12,2,12026,1065,3,10,42,19,1,0,72,0,1,73
12,2,12026,1066,3,3,8,26,0,0,37,0,0,37
12,2,12032,1358,3,34,178,213,19,3,447,0,9,456
12,2,12032,1359,3,13,105,65,4,0,187,1,0,188
12,2,12032,1360,3,3,9,24,1,0,37,0,0,37
12,2,12032,1361,3,1,130,164,0,1,296,1,5,302
12,2,12032,1362,3,5,91,57,0,0,153,0,6,159
12,2,12032,1363,3,1,30,15,2,0,48,2,1,51
12,2,12032,1364,3,4,38,40,0,0,82,0,1,83
12,2,12032,1365,3,0,6,16,0,0,22,0,0,22
12,2,12032,1366,3,1,24,16,1,0,42,0,0,42
12,2,12032,1367,3,3,66,10,0,0,79,0,0,79
12,2,12032,1369,3,2,46,23,0,2,73,0,0,73
12,2,12032,1370,3,1,60,34,1,0,96,0,2,98
12,2,12032,1371,3,2,22,17,0,0,41,0,1,42
12,2,12032,1372,3,3,74,72,0,1,150,0,0,150
12,2,12032,1373,3,2,25,12,0,0,39,0,3,42
12,2,12032,1374,3,4,31,20,0,0,55,0,0,55
12,2,12032,1375,3,4,59,36,0,0,99,1,3,103
12,2,12032,1376,3,4,42,37,3,1,87,0,3,90
12,2,12032,1377,3,8,61,45,1,2,117,0,2,119
12,2,12032,1378,3,2,12,8,0,1,23,0,2,25
12,2,12032,1379,3,1,24,10,1,1,37,0,1,38
12,2,12032,1380,3,1,20,52,0,0,73,0,0,73
12,2,12032,1381,3,8,15,18,0,0,41,0,0,41
12,2,12036,1480,3,125,240,473,25,18,881,1,30,912
12,2,12036,1481,3,40,121,135,10,1,307,0,5,312
12,2,12036,1482,3,65,134,170,15,3,387,0,9,396
12,2,12036,1483,3,97,140,163,39,13,452,0,12,464
12,2,12036,1484,3,141,238,484,57,20,940,5,31,976
12,2,12036,1485,3,199,202,459,34,20,914,7,27,948
12,2,12036,1486,3,107,229,307,39,17,699,5,13,717
12,2,12036,1487,3,270,351,357,75,31,1084,7,25,1116
12,2,12036,1488,3,84,161,220,29,7,501,4,10,515
12,2,12036,1489,3,84,217,237,46,6,590,0,14,604
12,2,12036,1490,3,135,269,278,42,25,749,4,10,763
12,2,12036,1491,3,123,230,253,39,22,667,0,11,678
12,2,12036,1492,3,161,304,379,41,26,911,7,14,932
12,2,12036,1493,3,126,191,294,49,24,684,2,18,704
12,2,12036,1494,3,110,191,241,26,13,581,0,14,595
12,2,12036,1495,3,233,412,450,61,34,1190,2,30,1222
12,2,12036,1496,3,40,90,80,15,3,228,4,4,236
12,2,12036,1497,3,126,196,297,48,14,681,1,18,700
12,2,12036,1498,3,114,208,181,42,11,556,0,13,569
12,2,12036,1499,3,128,189,211,39,24,591,1,13,605
12,2,12036,1500,3,253,412,475,93,39,1272,6,30,1308
12,2,12036,1501,3,137,270,239,39,19,704,5,21,730
12,2,12036,1502,3,93,306,229,22,11,661,0,13,674
12,2,12036,1503,3,70,264,211,27,8,580,1,11,592
12,2,12036,1504,3,123,183,218,25,16,565,3,16,584
12,2,12036,1505,3,144,214,175,42,13,588,0,12,600
12,2,12036,1506,3,80,118,142,33,15,388,0,8,396
12,2,12036,1507,3,97,170,176,31,9,483,1,18,502
12,2,12036,1508,3,62,161,236,24,6,489,6,9,504
12,2,12036,1509,3,47,108,245,15,6,421,0,13,434
12,2,12036,1510,3,113,185,310,36,9,653,2,13,668
12,2,12036,1511,3,135,200,361,37,17,750,0,28,778
12,2,12036,1512,3,169,274,276,67,21,807,0,25,832
12,2,12036,1513,3,233,287,289,39,18,866,2,20,888
12,2,12036,1514,3,135,166,184,31,11,527,1,5,533
12,2,12036,1515,3,164,217,279,32,15,707,4,7,718
12,2,12036,1516,3,196,266,341,55,13,871,3,31,905
12,2,12036,1517,3,83,95,78,21,4,281,0,14,295
12,2,12036,1518,3,76,131,143,15,5,370,2,8,380
12,2,12036,1519,3,40,109,72,8,4,233,2,0,235
12,2,12036,1520,3,97,101,171,20,14,403,0,1,404
12,2,12036,1521,3,88,146,248,25,7,514,1,0,515
12,2,12036,1522,3,131,195,253,17,9,605,1,15,621
12,2,12036,1523,3,68,132,193,25,6,424,1,12,437
12,2,12036,1524,3,78,188,286,28,17,597,1,16,614
12,2,12036,1525,3,50,109,177,18,5,359,1,11,371
12,2,12036,1526,3,129,180,242,40,23,614,2,10,626
12,2,12036,1527,3,114,273,294,38,24,743,3,24,770
12,2,12036,1528,3,105,208,246,38,21,618,2,26,646
12,2,12036,1529,3,68,127,147,33,10,385,0,16,401
12,2,12036,1530,3,50,113,194,16,6,379,3,9,391
12,2,12036,1531,3,100,144,260,34,18,556,1,15,572
12,2,12036,1532,3,107,169,297,53,11,637,2,9,648
12,2,12036,1533,3,85,172,326,32,4,619,0,25,644
12,2,12036,1534,3,160,226,298,34,17,735,0,19,754
12,2,12036,1535,3,91,182,227,30,12,542,2,19,563
12,2,12036,1536,3,135,176,271,48,12,642,2,15,659
12,2,12036,1537,3,90,197,306,21,16,630,1,6,637
12,2,12036,1538,3,63,169,262,20,10,524,3,8,535
12,2,12036,1539,3,128,227,533,78,15,981,3,28,1012
12,2,12036,1540,3,81,88,187,28,7,391,0,5,396
12,2,12036,1541,3,117,133,235,24,14,523,0,9,532
12,2,12036,1542,3,103,124,246,22,8,503,2,11,516
12,2,12036,1543,3,201,243,365,46,11,866,2,17,885
12,2,12036,1544,3,66,97,121,30,3,317,1,9,327
12,2,12036,1545,3,29,108,52,4,0,193,0,12,205
12,2,12036,1546,3,89,84,265,22,11,471,2,63,536
12,2,12036,1547,3,133,199,327,11,12,682,2,9,693
12,2,12036,1548,3,17,48,73,2,2,142,0,2,144
12,2,12036,1549,3,15,74,113,3,1,206,0,4,210
12,2,12036,1550,3,102,185,223,2,4,516,0,15,531
12,2,12036,1551,3,68,33,95,3,0,199,0,7,206
12,2,12036,1552,3,62,54,111,5,8,240,0,4,244
12,2,12036,1553,3,4,80,25,3,1,113,0,4,117
12,2,12036,1554,3,11,54,29,3,2,99,0,4,103
12,2,12036,1555,3,18,36,50,4,1,109,0,2,111
12,2,12036,1556,3,13,46,38,0,0,97,0,5,102
12,2,12036,1557,3,100,182,214,17,3,516,3,13,532
12,2,12036,1558,3,35,112,143,1,1,292,0,11,303
12,2,12036,1559,3,34,149,169,12,2,366,0,6,372
12,2,12036,1560,3,16,125,169,11,2,323,0,1,324
12,2,12036,1561,3,2,11,34,0,0,47,0,2,49
12,2,12036,1562,3,23,215,180,22,4,444,0,7,451
12,2,12036,1563,3,7,160,121,15,3,306,0,6,312
12,2,12036,1564,3,18,118,106,5,0,247,0,1,248
12,2,12038,1576,3,37,304,338,9,7,695,0,26,721
12,2,12038,1577,3,30,179,260,20,4,493,3,10,506
12,2,12038,1578,3,15,48,30,0,0,93,0,2,95
12,2,12038,1579,3,8,39,47,1,1,96,0,0,96
12,2,12038,1580,3,4,65,105,1,0,175,2,0,177
12,2,12038,1581,3,2,16,36,0,0,54,0,1,55
12,2,12038,1582,3,4,67,91,1,0,163,0,2,165
12,2,12038,1583,3,1,54,37,0,0,92,2,1,95
12,2,12038,1584,3,16,73,104,0,1,194,0,2,196
12,2,12038,1585,3,7,50,130,0,0,187,0,6,193
12,2,12038,1586,3,7,39,27,0,0,73,0,3,76
12,2,12038,1587,3,8,64,104,5,0,181,0,2,183
12,2,12038,1588,3,14,83,121,0,0,218,0,7,225
12,2,12048,1847,3,50,207,206,5,1,469,0,12,481
12,2,12048,1848,3,4,37,81,0,0,122,0,3,125
12,2,12048,1849,3,6,52,9,0,0,67,0,0,67
12,2,12048,1850,3,11,59,16,0,0,86,0,2,88
12,2,12048,1851,3,1,44,8,0,0,53,1,1,55
12,2,12048,1852,3,15,39,73,0,1,128,0,4,132
12,2,12048,1853,3,1,13,19,0,0,33,0,0,33
12,2,12048,1854,3,1,14,25,0,0,40,0,0,40
12,2,12048,1855,3,2,37,23,0,0,62,0,5,67
12,2,12048,1856,3,1,24,28,0,0,53,0,0,53
12,2,12048,1857,3,2,27,14,0,0,43,0,0,43
12,2,12048,1858,3,1,36,7,1,0,45,0,1,46
12,2,12048,1859,3,1,32,19,0,0,52,0,0,52
12,2,12048,1860,3,1,10,49,0,0,60,0,0,60
12,2,12048,1861,3,6,36,51,0,0,93,0,0,93
12,2,12048,1862,3,2,14,18,0,0,34,0,4,38
12,2,12048,1863,3,9,18,12,0,0,39,0,2,41
12,2,12048,1864,3,2,39,34,0,0,75,0,0,75
12,2,12048,1865,3,3,22,21,1,0,47,0,1,48
12,2,12048,1866,3,10,49,29,1,0,89,0,1,90
12,2,12048,1867,3,14,41,77,0,1,133,0,0,133
12,2,12048,1868,3,11,34,4,3,0,52,0,8,60
12,2,12048,1869,3,14,60,85,6,1,166,0,8,174
12,2,12048,1870,3,11,16,40,2,0,69,0,0,69
12,2,12048,1871,3,9,38,12,3,0,62,0,1,63
12,2,12048,1872,3,3,24,26,0,0,53,0,0,53
12,2,12048,1873,3,2,32,23,0,1,58,0,1,59
12,2,12048,1874,3,6,29,21,0,0,56,0,2,58
12,2,12050,1933,3,227,245,269,31,29,801,0,22,823
12,2,12050,1934,3,249,80,192,22,0,543,6,9,558
12,2,12050,1935,3,199,74,119,15,5,412,1,8,421
12,2,12050,1936,3,171,62,123,5,6,367,0,9,376
12,2,12050,1937,3,49,45,48,2,6,150,0,1,151
12,2,12050,1938,3,48,40,43,0,2,133,0,10,143
12,2,12050,1939,3,113,25,37,1,0,176,0,5,181
12,2,12050,1940,3,67,14,69,6,5,161,0,5,166
12,2,12050,1941,3,14,44,16,2,0,76,0,0,76
12,2,12050,1942,3,59,14,18,0,1,92,0,2,94
12,2,12050,1943,3,5,44,11,0,1,61,0,0,61
12,2,12050,1944,3,56,27,127,9,0,219,0,7,226
12,2,12050,1945,3,67,55,132,6,8,268,0,13,281
12,2,12050,1946,3,16,20,23,4,0,63,0,2,65
12,2,12050,1947,3,25,28,46,4,0,103,0,2,105
12,2,12050,1948,3,18,15,18,0,0,51,0,3,54
12,2,12050,1949,3,31,21,22,1,3,78,0,1,79
12,2,12056,2134,3,209,144,137,25,13,528,3,7,538
12,2,12056,2135,3,238,209,194,37,13,691,3,14,708
12,2,12056,2136,3,188,159,136,22,13,518,3,12,533
12,2,12056,2137,3,407,284,246,53,22,1012,19,22,1053
12,2,12056,2138,3,312,210,181,36,15,754,1,23,778
12,2,12056,2139,3,374,213,211,34,18,850,8,20,878
12,2,12056,2140,3,464,246,262,45,26,1043,3,19,1065
12,2,12056,2141,3,241,159,162,41,14,617,0,8,625
12,2,12056,2142,3,406,283,243,61,22,1015,2,19,1036
12,2,12056,2143,3,209,160,162,30,15,576,0,14,590
12,2,12056,2144,3,265,164,153,23,12,617,1,12,630
12,2,12056,2145,3,286,117,192,34,10,639,6,5,650
12,2,12056,2146,3,211,112,100,17,6,446,0,9,455
12,2,12056,2147,3,280,210,203,35,13,741,11,13,765
12,2,12056,2148,3,264,191,216,44,17,732,1,23,756
12,2,12056,2149,3,264,121,160,28,11,584,0,15,599
12,2,12056,2150,3,160,121,98,11,4,394,1,6,401
12,2,12056,2151,3,232,166,148,26,12,584,0,17,601
12,2,12056,2152,3,190,143,161,25,21,540,0,24,564
12,2,12056,2153,3,457,305,269,39,21,1091,4,30,1125
12,2,12056,2154,3,250,147,152,30,11,590,0,9,599
12,2,12056,2155,3,443,284,297,53,19,1096,3,21,1120
12,2,12056,2156,3,181,88,123,24,13,429,1,7,437
12,2,12056,2157,3,136,62,64,12,9,283,3,0,286
12,2,12056,2158,3,353,191,195,38,26,803,2,14,819
12,2,12056,2159,3,290,169,162,37,12,670,0,28,698
12,2,12056,2160,3,274,178,154,37,20,663,3,15,681
12,2,12056,2161,3,335,157,188,25,16,721,0,15,736
12,2,12056,2162,3,240,162,163,24,7,596,0,4,600
12,2,12056,2163,3,70,47,64,3,3,187,0,4,191
12,2,12056,2164,3,496,393,460,69,27,1445,5,27,1477
12,2,12056,2165,3,21,58,64,5,1,149,0,5,154
12,2,12056,2166,3,49,108,190,7,1,355,4,13,372
12,2,12056,2167,3,30,53,43,2,1,129,0,0,129
12,2,12056,2168,3,102,193,197,16,8,516,0,11,527
12,2,12056,2169,3,137,332,207,11,7,694,4,22,720
12,2,12056,2170,3,157,6,10,0,0,173,0,6,179
12,2,12056,2171,3,19,16,3,0,0,38,0,1,39
12,2,12056,2172,3,27,15,6,0,0,48,0,0,48
12,2,12056,2173,3,17,29,25,0,0,71,0,1,72
12,2,12056,2174,3,32,10,11,0,1,54,0,1,55
12,2,12056,2175,3,106,18,19,0,1,144,0,3,147
12,2,12056,2176,3,30,18,17,0,0,65,0,1,66
12,2,12056,2177,3,119,112,75,9,4,319,1,2,322
12,2,12056,2178,3,42,56,45,4,2,149,1,5,155
12,2,12056,2179,3,45,55,33,5,4,142,1,2,145
12,2,12056,2180,3,71,129,84,6,3,293,0,0,293
12,2,12056,2181,3,35,52,42,1,0,130,0,4,134
12,2,12056,2182,3,190,200,96,30,11,527,0,14,541
12,2,12056,2183,3,95,99,63,10,8,275,0,8,283
12,2,12056,2184,3,103,46,64,9,1,223,1,5,229
12,2,12056,2185,3,98,26,14,3,0,141,0,1,142
12,2,12056,2186,3,56,5,19,1,0,81,0,1,82
12,2,12056,2187,3,29,15,11,11,2,68,0,2,70
12,2,12056,2188,3,23,9,7,4,0,43,1,0,44
12,2,12056,2189,3,36,21,4,0,0,61,0,1,62
12,2,12056,2190,3,22,53,18,2,1,96,1,0,97
12,2,12056,2191,3,242,178,124,8,4,556,2,16,574
12,2,12056,2192,3,74,46,49,4,1,174,2,0,176
12,2,12056,2193,3,79,86,61,4,1,231,0,9,240
12,2,12056,2194,3,190,84,33,6,3,316,0,9,325
12,2,12056,2195,3,294,391,256,39,99,1079,2,12,1093
12,2,12056,2196,3,164,182,117,13,9,485,3,17,505
12,2,12056,2197,3,45,63,43,6,3,160,0,6,166
12,2,12056,2198,3,43,117,50,3,6,219,0,9,228
12,2,12056,2199,3,65,140,72,3,2,282,1,7,290
12,2,12056,2200,3,56,68,39,4,0,167,0,0,167
12,2,12056,2201,3,108,151,53,6,5,323,4,2,329
12,2,12056,2202,3,27,14,7,0,1,49,0,1,50
12,2,12056,2203,3,119,190,88,5,8,410,2,19,431
12,2,12056,2204,3,42,56,124,0,0,222,0,10,232
12,2,12056,2205,3,117,197,161,17,5,497,4,14,515
12,2,12056,2206,3,115,160,71,8,2,356,0,9,365
12,2,12056,2207,3,152,214,129,14,6,515,2,12,529
12,2,12056,2208,3,110,577,336,7,9,1039,12,85,1136
12,2,12056,2209,3,62,194,128,3,4,391,4,27,422
12,2,12056,2210,3,28,265,107,2,1,403,1,18,422
12,2,12056,2211,3,77,34,75,3,0,189,0,5,194
12,2,12056,2212,3,41,29,38,4,1,113,0,4,117
12,2,12056,2213,3,54,164,70,3,0,291,0,15,306
12,2,12056,2214,3,16,20,10,3,0,49,0,0,49
12,2,12056,2215,3,70,73,68,1,3,215,0,11,226
12,2,12056,2216,3,47,79,16,3,2,147,1,7,155
12,2,12056,2217,3,57,98,40,6,2,203,1,0,204
12,2,12056,2218,3,62,59,46,3,2,172,0,3,175
12,2,12056,2219,3,46,49,42,4,0,141,0,5,146
12,2,12056,2220,3,27,84,11,0,2,124,0,1,125
12,2,12056,2221,3,47,50,43,0,3,143,0,8,151
12,2,12056,2222,3,376,176,208,25,11,796,7,19,822
12,2,12059,2331,3,56,150,154,35,8,403,2,20,425
12,2,12059,2332,3,80,168,197,45,14,504,1,40,545
12,2,12059,2333,3,87,168,189,37,17,498,1,8,507
12,2,12059,2334,3,68,153,158,66,22,467,0,20,487
12,2,12059,2335,3,90,169,164,55,23,501,0,26,527
12,2,12059,2336,3,75,142,127,30,11,385,0,22,407
12,2,12059,2337,3,117,224,183,35,14,573,0,29,602
12,2,12059,2338,3,101,272,177,42,16,608,3,24,635
12,2,12059,2339,3,84,196,167,50,9,506,2,21,529
12,2,12059,2340,3,32,56,78,13,1,180,0,10,190
12,2,12059,2341,3,95,119,211,40,10,475,3,27,505
12,2,12059,2342,3,63,118,292,37,20,530,1,29,560
12,2,12059,2343,3,75,155,225,49,16,520,0,35,555
12,2,12059,2344,3,48,115,121,31,14,329,1,16,346
12,2,12059,2345,3,50,90,141,9,5,295,0,12,307
12,2,12059,2346,3,0,5,50,0,0,55,0,1,56
12,2,12059,2347,3,9,15,132,0,0,156,0,15,171
12,2,12059,2348,3,2,12,71,0,2,87,0,5,92
12,2,12059,2349,3,3,4,28,0,0,35,0,5,40
12,2,12059,2350,3,0,1,42,0,0,43,0,0,43
12,2,12059,2351,3,1,4,28,0,0,33,0,1,34
12,2,12059,2352,3,4,4,68,0,1,77,0,3,80
12,2,12059,2353,3,4,8,77,0,1,90,0,0,90
12,2,12059,2354,3,8,7,77,1,1,94,0,2,96
12,2,12059,2355,3,5,14,35,0,0,54,0,2,56
12,2,12059,2356,3,6,0,52,0,0,58,0,0,58
12,2,12059,2358,3,6,13,63,1,1,84,0,1,85
12,2,12059,2359,3,0,1,75,1,1,78,0,6,84
12,2,12059,2360,3,2,2,21,1,0,26,0,0,26
12,2,12059,2361,3,1,3,98,4,0,106,0,3,109
12,2,12059,2362,3,10,51,72,7,0,140,0,7,147
12,2,12059,2363,3,5,3,59,15,0,82,0,16,98
12,2,12059,2364,3,3,2,71,2,0,78,1,1,80
12,2,12059,2365,3,0,3,43,0,0,46,0,4,50
12,2,12059,2366,3,9,9,44,4,2,68,0,8,76
12,2,12059,2367,3,2,20,25,2,0,49,0,2,51
12,2,12059,2368,3,4,54,94,2,4,158,0,6,164
12,2,12059,2369,3,21,38,61,3,4,127,0,4,131
12,2,12059,2370,3,3,4,52,0,0,59,0,6,65
12,2,12059,2371,3,4,23,37,9,2,75,0,1,76
12,2,12059,2372,3,5,27,48,0,0,80,0,1,81
12,2,12059,2373,3,15,29,69,13,0,126,0,6,132
12,2,12059,2374,3,9,16,72,1,0,98,0,1,99
12,2,12059,2375,3,14,64,88,1,2,169,0,3,172
12,2,12059,2376,3,13,11,41,6,1,72,0,1,73
12,2,12059,2377,3,1,17,48,2,0,68,0,0,68
12,2,12059,2378,3,9,20,21,6,3,59,0,6,65
12,2,12059,2379,3,7,56,182,3,2,250,0,6,256
12,2,12059,2380,3,4,24,89,8,1,126,0,12,138
12,2,12059,2381,3,12,4,59,2,0,77,0,1,78
12,2,12059,2382,3,1,60,31,2,0,94,0,13,107
12,2,12059,2383,3,11,7,72,4,3,97,0,5,102
12,2,12059,2384,3,2,7,41,2,0,52,0,0,52
12,2,12059,2385,3,12,99,193,6,2,312,2,10,324
12,2,12059,2386,3,2,24,80,2,2,110,0,2,112
12,2,12059,2387,3,5,13,125,2,1,146,0,9,155
12,2,12059,2388,3,6,12,146,4,2,170,0,18,188
12,2,12059,2389,3,5,68,60,3,1,137,0,6,143
12,2,12059,2390,3,1,12,102,1,1,117,0,2,119
12,2,12059,2391,3,1,34,89,0,0,124,0,3,127
12,2,12059,2392,3,11,12,41,3,3,70,0,6,76
12,2,12059,2393,3,22,26,122,6,2,178,0,21,199
12,2,12059,2394,3,18,76,147,0,1,242,1,12,255
12,2,12059,2396,3,2,17,44,2,0,65,0,0,65
12,2,12059,2397,3,6,98,195,0,1,300,0,18,318
12,2,12059,2398,3,18,135,192,18,17,380,0,18,398
12,2,12059,2399,3,3,28,57,0,0,88,0,2,90
12,2,12059,2400,3,0,3,71,0,0,74,0,0,74
12,2,12059,2401,3,3,4,81,0,0,88,0,3,91
12,2,12059,2402,3,2,9,81,0,0,92,0,2,94
12,2,12059,2403,3,3,23,46,1,0,73,0,7,80
12,2,12059,2404,3,14,59,165,6,2,246,0,10,256
12,2,12059,2405,3,16,31,57,3,4,111,0,0,111
12,2,12059,2406,3,18,75,251,1,1,346,0,15,361
12,2,12059,2407,3,10,31,77,0,3,121,0,0,121
12,2,12059,2408,3,10,22,43,2,2,79,2,19,100
12,2,12059,2409,3,20,75,338,3,3,439,0,19,458
12,2,12059,2410,3,1,7,39,7,0,54,0,3,57
12,2,12059,2411,3,4,5,57,0,0,66,0,2,68
12,2,12059,2412,3,2,12,37,0,0,51,0,0,51
12,2,12059,2413,3,2,1,81,0,0,84,0,2,86
12,2,12059,2414,3,3,24,159,1,1,188,1,10,199
12,2,12059,2415,3,9,14,68,4,0,95,0,5,100
12,2,12059,2416,3,2,18,49,0,1,70,0,0,70
12,2,12059,2417,3,3,53,99,0,1,156,0,3,159
12,2,12059,2418,3,19,77,204,10,4,314,0,0,314
12,2,12059,2419,3,42,162,257,21,3,485,0,6,491
12,2,12061,2451,3,78,154,103,18,6,359,0,0,359
12,2,12061,2452,3,137,164,77,22,5,405,0,15,420
12,2,12061,2453,3,4,51,50,2,0,107,0,0,107
12,2,12061,2454,3,11,35,34,1,1,82,0,1,83
12,2,12061,2455,3,3,35,26,6,1,71,0,0,71
12,2,12061,2456,3,28,72,65,7,3,175,1,1,177
12,2,12061,2457,3,4,41,31,2,2,80,2,2,84
12,2,12061,2458,3,14,48,24,3,3,92,0,8,100
12,2,12061,2459,3,14,25,8,6,1,54,0,0,54
12,2,12061,2460,3,80,90,31,7,0,208,0,8,216
12,2,12061,2461,3,5,14,31,11,0,61,56,2,119
12,2,12061,2462,3,7,15,16,0,0,38,0,0,38
12,2,12061,2463,3,36,41,60,13,1,151,1,6,158
12,2,12061,2464,3,37,80,77,12,5,211,0,5,216
12,2,12061,2465,3,8,17,11,0,0,36,0,0,36
12,2,12061,2466,3,6,44,11,0,0,61,0,0,61
12,2,12061,2467,3,4,19,3,2,0,28,0,2,30
12,2,12061,2468,3,18,44,25,0,1,88,0,1,89
12,2,12061,2469,3,8,27,31,0,0,66,0,0,66
12,2,12061,2470,3,10,22,3,0,0,35,0,0,35
12,2,12061,2471,3,31,46,52,3,0,132,0,0,132
12,2,12061,2472,3,69,95,39,2,1,206,0,0,206
12,2,12061,2473,3,20,31,21,3,0,75,0,1,76
12,2,12061,2474,3,67,157,200,4,3,431,0,11,442
12,2,12061,2475,3,19,98,53,3,3,176,0,4,180
12,2,12061,2476,3,166,140,68,1,3,378,0,11,389
12,2,12061,2477,3,32,45,24,6,2,109,0,11,120
12,2,12061,2478,3,36,33,14,1,3,87,5,3,95
12,3,12011,596,3,18,84,142,20,12,276,0,12,288
12,3,12011,597,3,18,79,162,7,3,269,0,12,281
12,3,12011,598,3,16,55,162,16,5,254,0,13,267
12,3,12011,599,3,48,100,307,50,16,521,1,14,536
12,3,12011,600,3,20,56,122,9,17,224,0,9,233
12,3,12011,601,3,2,9,15,7,1,34,0,3,37
12,3,12011,602,3,50,132,227,43,14,466,0,8,474
12,3,12011,603,3,38,87,138,32,5,300,0,7,307
12,3,12011,604,3,28,126,281,48,12,495,2,18,515
12,3,12011,605,3,25,104,213,29,22,393,0,13,406
12,3,12011,606,3,27,97,224,40,11,399,1,16,416
12,3,12011,607,3,33,125,243,53,7,461,1,7,469
12,3,12011,608,3,41,99,255,36,5,436,1,12,449
12,3,12011,609,3,63,108,242,59,3,475,0,14,489
12,3,12011,610,3,39,79,220,35,12,385,0,7,392
12,3,12011,611,3,35,103,336,53,10,537,0,5,542
12,3,12011,612,3,38,36,83,10,1,168,0,8,176
12,3,12011,613,3,19,53,61,12,3,148,0,8,156
12,3,12011,614,3,16,39,10,0,3,68,0,0,68
12,3,12011,615,3,5,17,59,3,0,84,0,2,86
12,3,12011,616,3,2,20,46,10,0,78,1,5,84
12,3,12011,617,3,8,8,17,4,1,38,0,0,38
12,3,12011,618,3,1,8,19,6,0,34,0,3,37
12,3,12011,619,3,24,96,121,6,4,251,0,5,256
12,3,12011,620,3,4,20,42,4,2,72,0,3,75
12,3,12011,621,3,14,125,187,12,2,340,0,7,347
12,3,12011,622,3,21,110,291,6,1,429,1,13,443
12,3,12011,623,3,25,115,217,29,1,387,2,9,398
12,3,12011,624,3,33,150,187,9,2,381,1,15,397
12,3,12011,625,3,4,8,18,6,1,37,0,0,37
12,3,12011,626,3,3,55,45,0,1,104,0,2,106
12,3,12011,627,3,6,57,171,2,2,238,0,11,249
12,3,12011,628,3,3,45,36,3,3,90,0,0,90
12,3,12011,629,3,2,28,33,0,1,64,0,0,64
12,3,12011,630,3,13,49,103,16,0,181,0,13,194
12,3,12011,631,3,0,49,39,1,0,89,0,0,89
12,3,12011,632,3,18,94,66,7,5,190,0,3,193
12,3,12011,633,3,8,49,112,3,12,184,0,3,187
12,3,12011,634,3,2,17,77,2,4,102,0,0,102
12,3,12011,635,3,2,11,17,5,0,35,0,1,36
12,3,12011,636,3,1,18,41,2,0,62,0,1,63
12,3,12011,637,3,31,53,141,23,2,250,1,12,263
12,3,12011,638,3,0,10,109,4,1,124,0,2,126
12,3,12011,639,3,17,104,181,29,1,332,0,17,349
12,3,12011,640,3,16,55,100,4,0,175,0,4,179
12,3,12011,641,3,11,66,159,28,5,269,1,5,275
12,3,12011,642,3,3,11,44,2,2,62,0,1,63
12,3,12011,643,3,3,10,15,0,0,28,0,0,28
12,3,12011,644,3,5,31,45,5,2,88,0,3,91
12,3,12011,645,3,19,103,123,30,2,277,0,13,290
12,3,12011,646,3,15,81,136,71,1,304,0,10,314
12,3,12011,647,3,17,121,241,99,9,487,1,19,507
12,3,12011,649,3,3,20,25,7,1,56,0,0,56
12,3,12011,650,3,10,21,317,17,1,366,0,10,376
12,3,12011,651,3,0,15,27,2,1,45,0,3,48
12,3,12011,652,3,11,37,80,4,2,134,0,2,136
12,3,12011,653,3,6,43,88,34,4,175,0,9,184
12,3,12011,654,3,7,27,67,21,3,125,0,0,125
12,3,12011,655,3,4,15,54,6,8,87,0,4,91
12,3,12011,656,3,3,17,44,3,0,67,0,6,73
12,3,12011,657,3,11,165,308,166,9,659,2,27,688
12,3,12011,658,3,22,68,201,25,11,327,0,6,333
12,3,12011,659,3,29,150,303,73,6,561,0,30,591
12,3,12011,660,3,4,24,105,8,5,146,0,5,151
12,3,12011,661,3,27,93,212,44,15,391,0,8,399
12,3,12011,662,3,37,37,149,5,2,230,1,6,237
12,3,12011,663,3,29,87,253,40,20,429,0,19,448
12,3,12011,664,3,18,53,295,2,3,371,0,4,375
12,3,12011,665,3,26,80,238,18,17,379,1,14,394
12,3,12011,666,3,15,33,55,5,5,113,0,3,116
12,3,12011,667,3,10,63,89,16,1,179,0,4,183
12,3,12011,668,3,22,114,185,41,1,363,0,9,372
12,3,12011,669,3,29,197,273,47,6,552,0,24,576
12,3,12011,670,3,87,125,345,42,7,606,0,23,629
12,3,12014,763,3,35,107,342,180,2,666,0,24,690
12,3,12014,764,3,38,109,214,156,6,523,0,20,543
12,3,12014,765,3,51,155,195,163,1,565,1,11,577
12,3,12014,766,3,23,141,375,215,2,756,0,33,789
12,3,12014,767,3,59,80,281,51,0,471,1,6,478
12,3,12014,768,3,8,33,45,23,2,111,0,8,119
12,3,12014,769,3,15,21,38,16,1,91,0,4,95
12,3,12014,770,3,29,117,313,65,3,527,0,14,541
12,3,12014,771,3,4,22,48,15,1,90,0,6,96
12,3,12014,772,3,9,52,110,71,2,244,0,8,252
12,3,12014,773,3,31,172,200,138,6,547,0,31,578
12,3,12014,774,3,14,205,347,52,0,618,0,5,623
12,3,12014,775,3,10,142,211,31,0,394,1,17,412
12,3,12014,776,3,20,166,222,47,1,456,0,14,470
12,3,12014,777,3,14,58,64,11,0,147,1,6,154
12,3,12016,789,3,11,93,84,30,1,219,0,9,228
12,3,12016,790,3,15,115,114,7,0,251,0,4,255
12,3,12016,791,3,2,34,73,3,1,113,0,4,117
12,3,12016,792,3,16,94,168,0,0,278,0,6,284
12,3,12016,793,3,1,61,171,3,0,236,0,3,239
12,3,12016,794,3,5,81,90,30,1,207,0,12,219
12,3,12016,795,3,8,59,93,4,1,165,0,2,167
12,3,12016,796,3,5,63,66,1,0,135,0,3,138
12,3,12016,797,3,2,48,129,10,0,189,0,1,190
12,3,12016,798,3,0,13,51,1,0,65,0,6,71
12,3,12016,799,3,5,42,62,1,0,110,0,2,112
12,3,12016,800,3,10,39,164,4,1,218,0,7,225
12,3,12016,801,3,0,27,64,2,0,93,0,2,95
12,3,12016,802,3,4,33,73,4,0,114,0,5,119
12,3,12016,803,3,9,41,5,2,1,58,0,3,61
12,3,12016,804,3,4,24,42,19,0,89,0,0,89
12,3,12016,805,3,0,42,88,3,0,133,0,3,136
12,3,12016,806,3,0,28,28,0,0,56,0,1,57
12,3,12016,807,3,0,47,30,1,0,78,0,1,79
12,3,12016,808,3,0,136,33,4,0,173,0,1,174
12,3,12016,809,3,0,19,37,0,0,56,0,2,58
12,3,12016,810,3,3,22,53,0,0,78,0,0,78
12,3,12016,811,3,0,21,27,1,0,49,0,0,49
12,3,12016,812,3,2,16,12,13,0,43,0,0,43
12,3,12016,813,3,0,52,60,0,0,112,0,0,112
12,3,12016,814,3,1,52,54,0,0,107,0,1,108
12,3,12016,815,3,2,71,45,1,0,119,0,2,121
12,3,12016,816,3,0,8,11,0,0,19,0,0,19
12,3,12016,817,3,5,64,25,1,0,95,0,4,99
12,3,12016,818,3,6,5,38,0,0,49,0,0,49
12,3,12016,819,3,9,164,234,5,0,412,0,1,413
12,3,12039,1589,3,118,85,450,39,6,698,0,10,708
12,3,12039,1590,3,488,355,1334,214,50,2441,3,26,2470
12,3,12039,1591,3,43,27,128,8,2,208,0,2,210
12,3,12039,1592,3,91,113,307,18,11,540,2,14,556
12,3,12039,1593,3,82,101,413,20,5,621,1,10,632
12,3,12039,1594,3,123,118,509,27,16,793,3,10,806
12,3,12039,1595,3,145,117,426,29,16,733,0,20,753
12,3,12039,1596,3,82,73,145,21,14,335,0,6,341
12,3,12039,1597,3,46,60,142,14,9,271,0,5,276
12,3,12039,1598,3,76,81,264,32,12,465,0,5,470
12,3,12039,1599,3,103,77,285,20,5,490,0,5,495
12,3,12039,1600,3,62,48,251,32,6,399,0,5,404
12,3,12039,1601,3,64,52,191,24,4,335,0,12,347
12,3,12039,1602,3,71,49,148,29,8,305,0,5,310
12,3,12039,1603,3,134,116,281,26,12,569,3,7,579
12,3,12039,1604,3,53,49,148,32,8,290,0,6,296
12,3,12039,1605,3,59,53,205,26,7,350,0,0,350
12,3,12039,1606,3,136,106,275,26,10,553,1,9,563
12,3,12039,1607,3,137,94,317,33,13,594,2,13,609
12,3,12039,1608,3,73,93,253,21,8,448,1,9,458
12,3,12039,1609,3,143,157,574,38,16,928,1,25,954
12,3,12039,1610,3,109,116,311,43,10,589,2,14,605
12,3,12039,1611,3,142,112,470,33,23,780,4,22,806
12,3,12039,1612,3,86,74,324,36,11,531,3,16,550
12,3,12039,1613,3,113,130,367,31,16,657,0,21,678
12,3,12039,1614,3,97,129,380,21,9,636,3,10,649
12,3,12039,1615,3,85,91,320,41,7,544,0,16,560
12,3,12039,1616,3,135,161,682,64,8,1050,2,30,1082
12,3,12039,1617,3,118,131,491,39,8,787,2,15,804
12,3,12039,1618,3,32,27,155,14,8,236,0,18,254
12,3,12039,1619,3,124,141,446,45,19,775,0,15,790
12,3,12039,1620,3,65,60,294,17,3,439,2,6,447
12,3,12039,1621,3,41,43,171,5,4,264,0,5,269
12,3,12039,1622,3,46,49,97,7,2,201,0,4,205
12,3,12039,1623,3,16,9,44,4,0,73,0,1,74
12,3,12039,1624,3,27,60,154,9,4,254,0,6,260
12,3,12039,1625,3,68,140,172,17,7,404,0,7,411
12,3,12039,1626,3,33,14,95,6,3,151,0,5,156
12,3,12039,1627,3,11,47,34,16,0,108,1,0,109
12,3,12039,1628,3,61,142,289,17,2,511,1,23,535
12,3,12039,1629,3,42,79,158,1,0,280,1,12,293
12,3,12039,1630,3,8,22,43,0,0,73,0,0,73
12,3,12039,1631,3,12,34,79,1,0,126,0,1,127
12,3,12039,1632,3,63,74,176,10,4,327,1,5,333
12,3,12039,1633,3,26,43,77,0,2,148,0,17,165
12,3,12039,1634,3,17,14,7,1,0,39,0,2,41
12,3,12039,1635,3,102,132,279,27,2,542,1,20,563
12,3,12039,1636,3,71,157,272,24,4,528,2,11,541
12,3,12039,1637,3,4,28,60,0,1,93,0,2,95
12,3,12039,1638,3,161,110,426,27,13,737,1,26,764
12,3,12039,1639,3,50,82,209,17,2,360,2,14,376
12,3,12039,1640,3,123,106,304,28,11,572,0,16,588
12,3,12039,1641,3,145,130,384,24,15,698,1,17,716
12,3,12039,1642,3,88,46,47,1,1,183,0,6,189
12,3,12039,1643,3,368,193,799,96,38,1494,5,15,1514
12,3,12039,1644,3,234,91,235,34,13,607,0,7,614
12,3,12039,1645,3,63,50,194,18,5,330,0,10,340
12,3,12039,1646,3,125,124,443,24,10,726,0,15,741
12,3,12039,1647,3,176,168,488,34,7,873,2,45,920
12,3,12039,1648,3,108,165,381,13,10,677,0,13,690
12,3,12039,1649,3,71,87,221,7,0,386,0,14,400
12,3,12039,1650,3,39,89,142,5,3,278,0,7,285
12,3,12039,1651,3,92,100,190,17,9,408,0,6,414
12,3,12039,1652,3,78,86,219,20,12,415,0,9,424
12,3,12039,1653,3,95,91,305,15,5,511,0,23,534
12,3,12049,1875,3,57,118,357,60,5,597,2,11,610
12,3,12049,1876,3,33,107,83,10,2,235,3,3,241
12,3,12049,1877,3,48,53,333,14,3,451,1,10,462
12,3,12049,1878,3,42,79,181,8,3,313,2,1,316
12,3,12049,1879,3,67,143,200,22,1,433,0,6,439
12,3,12049,1880,3,45,117,289,20,4,475,0,7,482
12,3,12049,1881,3,55,113,196,32,4,400,1,17,418
12,3,12049,1882,3,59,75,158,26,2,320,0,7,327
12,3,12049,1883,3,51,118,231,35,5,440,2,13,455
12,3,12049,1884,3,38,76,210,9,2,335,0,7,342
12,3,12049,1885,3,38,94,194,26,3,355,1,10,366
12,3,12049,1886,3,44,94,192,30,2,362,0,13,375
12,3,12049,1887,3,119,303,492,53,10,977,2,14,993
12,3,12049,1888,3,62,126,275,36,1,500,1,6,507
12,3,12049,1889,3,47,130,159,26,1,363,0,24,387
12,3,12049,1890,3,0,2,58,0,0,60,0,1,61
12,3,12049,1891,3,1,12,5,0,0,18,0,1,19
12,3,12049,1892,3,1,2,49,0,0,52,0,2,54
12,3,12049,1893,3,7,20,39,0,1,67,0,0,67
12,3,12049,1894,3,25,5,186,0,0,216,0,3,219
12,3,12049,1895,3,3,11,62,0,0,76,0,0,76
12,3,12049,1896,3,0,1,84,0,0,85,0,0,85
12,3,12049,1897,3,10,86,12,1,0,109,0,2,111
12,3,12049,1898,3,26,6,96,1,1,130,0,0,130
12,3,12049,1899,3,2,5,41,0,0,48,0,0,48
12,3,12049,1900,3,20,52,27,0,0,99,0,2,101
12,3,12049,1901,3,12,19,34,1,0,66,0,3,69
12,3,12049,1902,3,0,1,227,0,0,228,0,1,229
12,3,12049,1903,3,12,29,91,5,0,137,0,4,141
12,3,12049,1904,3,1,0,71,3,0,75,0,0,75
12,3,12049,1905,3,19,23,6,0,0,48,0,0,48
12,3,12049,1906,3,6,45,21,0,1,73,0,0,73
12,3,12049,1907,3,14,43,204,2,1,264,0,3,267
12,3,12049,1908,3,15,37,64,4,0,120,0,4,124
12,3,12049,1909,3,66,103,323,24,9,525,0,13,538
12,3,12049,1910,3,58,79,231,17,1,386,1,7,394
12,3,12049,1911,3,50,126,197,30,5,408,0,13,421
12,3,12049,1912,3,61,148,279,22,3,513,0,19,532
12,3,12049,1913,3,37,72,161,7,5,282,1,5,288
12,3,12049,1914,3,27,41,74,4,2,148,1,6,155
12,3,12049,1915,3,7,13,132,2,0,154,0,4,158
12,3,12049,1916,3,15,26,36,3,0,80,1,1,82
12,3,12049,1917,3,65,28,138,10,1,242,0,7,249
12,3,12049,1918,3,14,6,47,7,0,74,0,0,74
12,3,12049,1919,3,4,1,22,0,0,27,0,0,27
12,3,12049,1920,3,3,27,97,6,0,133,0,12,145
12,3,12049,1921,3,7,21,57,9,1,95,0,0,95
12,3,12049,1922,3,3,5,28,0,0,36,0,1,37
12,3,12049,1923,3,0,7,12,0,0,19,0,1,20
12,3,12049,1924,3,12,13,49,2,0,76,0,3,79
12,3,12049,1925,3,17,34,132,33,0,216,0,15,231
12,3,12049,1926,3,11,31,110,10,1,163,0,11,174
12,3,12049,1927,3,7,14,78,3,1,103,0,2,105
12,3,12049,1928,3,7,27,99,8,0,141,0,5,146
12,3,12049,1929,3,38,120,371,62,8,599,2,23,624
12,3,12049,1930,3,25,31,54,9,0,119,0,3,122
12,3,12049,1931,3,18,85,88,18,1,210,2,13,225
12,3,12049,1932,3,0,1,174,0,0,175,0,0,175
12,3,12058,2262,3,51,97,334,42,10,534,2,17,553
12,3,12058,2263,3,55,179,335,55,1,625,0,21,646
12,3,12058,2264,3,71,154,400,61,2,688,0,8,696
12,3,12058,2265,3,45,123,517,63,5,753,0,19,772
12,3,12058,2266,3,66,162,396,40,4,668,0,18,686
12,3,12058,2267,3,24,152,320,36,5,537,2,24,563
12,3,12058,2268,3,85,193,383,85,4,750,0,23,773
12,3,12058,2269,3,49,249,441,114,1,854,1,38,893
12,3,12058,2270,3,99,279,526,64,8,976,4,31,1011
12,3,12058,2271,3,33,147,351,45,4,580,0,9,589
12,3,12058,2272,3,25,79,160,46,2,312,0,12,324
12,3,12058,2273,3,35,101,153,28,3,320,0,10,330
12,3,12058,2274,3,25,87,248,30,0,390,0,11,401
12,3,12058,2275,3,4,6,104,1,0,115,0,1,116
12,3,12058,2276,3,28,13,138,14,1,194,0,5,199
12,3,12058,2277,3,10,61,235,2,1,309,1,6,316
12,3,12058,2278,3,7,15,102,0,0,124,0,3,127
12,3,12058,2279,3,20,12,167,8,0,207,0,6,213
12,3,12058,2280,3,2,3,96,25,2,128,0,9,137
12,3,12058,2281,3,11,23,55,5,1,95,0,2,97
12,3,12058,2283,3,20,38,40,4,0,102,0,1,103
12,3,12058,2284,3,0,3,46,0,0,49,0,2,51
12,3,12058,2285,3,17,32,161,4,3,217,0,7,224
12,3,12058,2286,3,6,18,179,1,1,205,0,1,206
12,3,12058,2287,3,5,13,58,4,0,80,0,0,80
12,3,12058,2288,3,0,1,49,0,0,50,0,0,50
12,3,12058,2289,3,17,24,122,10,4,177,1,5,183
12,3,12058,2290,3,3,35,182,0,0,220,0,0,220
12,3,12058,2291,3,4,36,46,0,0,86,0,5,91
12,3,12058,2292,3,44,106,315,16,6,487,0,5,492
12,3,12058,2293,3,28,63,198,7,2,298,3,12,313
12,3,12058,2294,3,32,112,183,16,4,347,0,6,353
12,3,12058,2295,3,3,36,67,2,0,108,0,1,109
12,3,12058,2296,3,7,30,38,1,0,76,0,0,76
12,3,12058,2297,3,8,18,74,1,0,101,0,3,104
12,3,12058,2298,3,14,10,82,1,0,107,0,2,109
12,3,12058,2299,3,7,17,35,0,0,59,0,13,72
12,3,12058,2300,3,15,36,131,3,2,187,0,5,192
12,3,12058,2301,3,3,22,106,0,0,131,0,1,132
12,3,12058,2302,3,36,44,176,12,2,270,0,3,273
12,3,12058,2303,3,9,36,92,1,2,140,0,4,144
12,3,12058,2304,3,40,67,281,13,4,405,2,13,420
12,3,12058,2305,3,35,59,302,15,3,414,1,22,437
12,3,12058,2306,3,48,100,315,19,2,484,0,22,506
12,3,12058,2307,3,30,53,206,25,0,314,0,7,321
12,3,12058,2308,3,17,65,380,24,0,486,0,8,494
12,3,12058,2309,3,23,72,212,13,1,321,1,9,331
12,3,12058,2310,3,25,64,423,7,2,521,0,6,527
12,3,12058,2311,3,8,19,91,4,2,124,0,2,126
12,3,12058,2312,3,17,28,93,6,1,145,0,3,148
12,3,12058,2313,3,20,43,178,6,4,251,0,14,265
12,3,12058,2314,3,11,28,52,2,0,93,0,7,100
12,3,12058,2315,3,2,27,22,2,1,54,2,2,58
12,3,12058,2316,3,9,63,135,0,0,207,0,0,207
12,3,12058,2317,3,8,38,128,9,3,186,0,4,190
12,3,12058,2318,3,4,13,37,0,0,54,0,1,55
12,3,12058,2319,3,40,70,117,15,3,245,0,10,255
12,3,12058,2320,3,14,35,136,16,1,202,0,6,208
12,3,12058,2321,3,9,28,132,40,1,210,0,4,214
12,3,12058,2322,3,5,29,53,2,1,90,0,2,92
12,3,12058,2323,3,15,92,338,19,2,466,0,2,468
12,3,12058,2324,3,21,82,259,34,3,399,0,5,404
12,3,12058,2325,3,3,19,41,5,1,69,0,0,69
12,3,12058,2326,3,45,106,264,45,2,462,0,14,476
12,3,12058,2327,3,28,99,247,55,2,431,0,7,438
12,3,12058,2328,3,20,166,289,46,2,523,1,16,540
12,3,12058,2329,3,12,31,63,11,1,118,0,3,121
12,3,12058,2330,3,17,194,498,119,8,836,0,17,853
12,3,12069,2622,3,24,388,233,11,2,658,0,16,674
12,3,12069,2623,3,18,284,116,5,3,426,0,6,432
12,3,12069,2624,3,14,256,177,12,2,461,0,8,469
12,3,12069,2625,3,0,72,95,0,0,167,0,2,169
12,3,12069,2626,3,2,110,100,1,0,213,0,0,213
12,3,12069,2627,3,3,34,124,0,0,161,0,7,168
12,3,12069,2628,3,12,45,53,0,0,110,0,3,113
12,3,12069,2629,3,2,79,78,1,1,161,3,3,167
12,3,12069,2630,3,5,112,155,3,0,275,1,2,278
12,3,12069,2631,3,8,96,51,0,0,155,0,0,155
12,3,12069,2632,3,11,114,193,0,0,318,0,1,319
12,3,12069,2633,3,0,140,9,1,0,150,0,0,150
12,3,12069,2634,3,3,99,104,15,2,223,0,5,228
12,3,12069,2635,3,2,109,184,5,2,302,0,2,304
12,3,12069,2636,3,20,271,359,37,5,692,1,7,700
12,3,12069,2637,3,10,80,102,13,0,205,0,1,206
12,3,12069,2638,3,27,99,111,3,0,240,1,0,241
12,3,12069,2639,3,18,145,308,21,2,494,0,4,498
12,3,12069,2640,3,9,159,303,22,2,495,0,5,500
12,3,12069,2641,3,16,270,510,22,8,826,0,16,842
12,3,12069,2642,3,16,263,346,17,8,650,1,5,656
12,3,12069,2643,3,11,164,251,4,1,431,0,4,435
12,3,12069,2644,3,1,53,42,0,2,98,0,0,98
12,3,12069,2645,3,0,52,47,0,0,99,0,0,99
12,3,12069,2646,3,2,40,99,0,0,141,0,0,141
12,3,12069,2647,3,9,115,70,5,0,199,0,8,207
12,3,12069,2648,3,13,130,117,6,1,267,0,0,267
12,3,12069,2649,3,0,53,55,2,0,110,0,0,110
12,3,12069,2650,3,12,90,32,1,0,135,0,0,135
12,3,12069,2651,3,24,145,191,8,3,371,0,6,377
12,3,12069,2652,3,6,63,40,2,0,111,0,0,111
12,3,12069,2653,3,4,92,75,3,0,174,0,1,175
12,3,12069,2654,3,88,324,358,20,1,791,0,11,802
12,4,12001,1,3,101,137,481,47,15,781,6,13,800
12,4,12001,2,3,57,122,288,31,13,511,1,24,536
12,4,12001,3,3,88,206,416,37,26,773,5,30,808
12,4,12001,4,3,45,88,255,38,17,443,4,8,455
12,4,12001,5,3,47,55,225,23,11,361,1,12,374
12,4,12001,6,3,49,70,272,16,7,414,2,13,429
12,4,12001,7,3,89,149,333,42,15,628,2,15,645
12,4,12001,8,3,63,89,288,44,12,496,2,12,510
12,4,12001,9,3,58,77,219,33,10,397,1,17,415
12,4,12001,10,3,52,80,249,26,7,414,2,13,429
12,4,12001,11,3,41,78,209,20,10,358,6,5,369
12,4,12001,12,3,49,77,278,43,17,464,4,10,478
12,4,12001,13,3,96,168,387,40,12,703,3,9,715
12,4,12001,14,3,58,66,174,39,8,345,3,9,357
12,4,12001,15,3,48,137,258,54,14,511,0,19,530
12,4,12001,16,3,42,116,206,25,11,400,2,14,416
12,4,12001,17,3,67,94,260,27,9,457,0,22,479
12,4,12001,18,3,54,142,345,30,11,582,1,3,586
12,4,12001,19,3,98,123,471,39,19,750,4,20,774
12,4,12001,20,3,44,159,298,36,5,542,0,24,566
12,4,12001,21,3,82,129,360,42,52,665,3,25,693
12,4,12001,22,3,58,143,328,27,11,567,6,14,587
12,4,12001,23,3,119,179,496,67,22,883,6,8,897
12,4,12001,24,3,157,197,467,116,28,965,1,25,991
12,4,12001,25,3,173,234,435,179,17,1038,0,27,1065
12,4,12001,26,3,134,161,400,56,26,777,1,24,802
12,4,12001,27,3,95,125,462,73,24,779,3,16,798
12,4,12001,28,3,46,163,285,42,7,543,3,14,560
12,4,12001,29,3,125,206,455,80,21,887,6,25,918
12,4,12001,30,3,84,174,413,74,18,763,7,21,791
12,4,12001,31,3,222,293,540,72,22,1149,8,44,1201
12,4,12001,32,3,97,168,339,62,17,683,3,48,734
12,4,12001,33,3,140,157,515,212,25,1049,4,37,1090
12,4,12001,34,3,81,139,233,43,13,509,1,17,527
12,4,12001,35,3,91,112,248,37,16,504,0,14,518
12,4,12001,36,3,95,193,473,38,24,823,0,19,842
12,4,12001,37,3,72,149,327,43,20,611,1,24,636
12,4,12001,38,3,153,180,545,94,23,995,6,18,1019
12,4,12001,39,3,331,226,414,86,44,1101,8,26,1135
12,4,12001,40,3,141,151,265,44,22,623,2,17,642
12,4,12001,41,3,157,191,464,67,30,909,9,13,931
12,4,12001,42,3,160,199,491,73,34,957,5,13,975
12,4,12001,43,3,120,122,361,63,28,694,1,25,720
12,4,12001,44,3,126,151,356,52,18,703,1,16,720
12,4,12001,45,3,107,143,282,52,30,614,1,16,631
12,4,12001,46,3,132,121,262,39,25,579,0,10,589
12,4,12001,47,3,115,136,253,98,18,620,3,19,642
12,4,12001,48,3,243,205,453,115,42,1058,1,28,1087
12,4,12001,49,3,144,159,255,55,25,638,1,13,652
12,4,12001,50,3,136,176,347,68,28,755,0,19,774
12,4,12001,51,3,184,217,345,108,32,886,0,16,902
12,4,12001,52,3,110,107,221,43,11,492,4,12,508
12,4,12001,53,3,125,164,301,64,25,679,6,12,697
12,4,12001,54,3,115,156,344,65,30,710,7,14,731
12,4,12001,55,3,132,136,242,38,18,566,3,21,590
12,4,12001,56,3,169,175,381,56,32,813,4,15,832
12,4,12001,57,3,132,130,293,49,25,629,2,11,642
12,4,12001,58,3,51,88,121,22,8,290,0,12,302
12,4,12001,59,3,63,97,212,36,13,421,2,14,437
12,4,12001,60,3,90,118,295,63,13,579,1,19,599
12,4,12001,61,3,125,173,323,49,18,688,0,23,711
12,4,12001,62,3,44,68,168,19,13,312,1,4,317
12,4,12001,63,3,58,79,168,24,12,341,4,9,354
12,4,12001,64,3,49,117,212,29,10,417,17,20,454
12,4,12001,65,3,44,89,139,16,9,297,2,5,304
12,4,12001,66,3,78,106,186,38,16,424,3,8,435
12,4,12001,67,3,53,75,201,20,5,354,0,16,370
12,4,12001,68,3,101,95,278,47,27,548,3,4,555
12,4,12001,69,3,53,88,162,16,5,324,6,11,341
12,4,12001,70,3,106,129,322,20,16,593,5,18,616
12,4,12001,71,3,92,140,314,45,16,607,0,17,624
12,4,12001,72,3,101,169,297,39,20,626,1,17,644
12,4,12001,73,3,79,145,247,57,20,548,0,26,574
12,4,12001,74,3,80,177,248,33,21,559,1,18,578
12,4,12001,75,3,52,124,217,23,16,432,4,13,449
12,4,12001,76,3,57,88,190,27,13,375,4,5,384
12,4,12001,77,3,125,138,256,49,19,587,0,11,598
12,4,12001,78,3,34,30,64,14,5,147,0,3,150
12,4,12001,79,3,78,130,143,25,10,386,2,9,397
12,4,12001,80,3,202,181,355,69,25,832,7,8,847
12,4,12001,81,3,146,95,206,43,21,511,4,5,520
12,4,12001,82,3,29,73,126,22,9,259,0,9,268
12,4,12001,83,3,59,83,155,24,13,334,0,8,342
12,4,12001,84,3,94,57,126,31,11,319,0,5,324
12,4,12001,85,3,74,82,176,38,13,383,2,13,398
12,4,12001,86,3,109,142,264,47,23,585,2,14,601
12,4,12001,87,3,67,91,186,65,21,430,3,4,437
12,4,12001,88,3,58,72,140,21,28,319,5,0,324
12,4,12001,89,3,71,196,305,46,19,637,12,16,665
12,4,12001,90,3,100,145,177,39,15,476,4,8,488
12,4,12001,91,3,67,95,177,14,17,370,7,12,389
12,4,12001,92,3,39,78,123,15,8,263,0,10,273
12,4,12001,93,3,94,157,210,27,17,505,1,6,512
12,4,12001,94,3,86,142,159,33,26,446,3,13,462
12,4,12001,95,3,67,76,131,28,17,319,0,4,323
12,4,12001,96,3,4,10,19,3,1,37,0,0,37
12,4,12001,97,3,84,152,284,30,9,559,2,10,571
12,4,12001,98,3,145,86,223,29,13,496,4,10,510
12,4,12001,99,3,155,130,230,37,20,572,1,11,584
12,4,12001,100,3,192,176,311,44,24,747,2,11,760
12,4,12001,101,3,113,94,203,16,17,443,2,10,455
12,4,12001,102,3,143,149,246,29,24,591,6,16,613
12,4,12001,103,3,186,89,189,32,14,510,3,11,524
12,4,12001,104,3,216,161,343,40,26,786,0,32,818
12,4,12001,105,3,187,146,417,36,31,817,1,25,843
12,4,12001,106,3,243,155,329,49,16,792,0,7,799
12,4,12001,107,3,212,103,268,37,69,689,0,22,711
12,4,12001,108,3,250,157,256,44,31,738,0,27,765
12,4,12001,109,3,186,101,201,24,15,527,5,7,539
12,4,12001,110,3,139,213,584,104,19,1059,2,21,1082
12,4,12001,111,3,113,194,420,56,12,795,8,30,833
12,4,12001,112,3,85,150,430,39,11,715,7,18,740
12,4,12001,113,3,33,80,151,8,4,276,3,13,292
12,4,12001,114,3,217,273,742,125,25,1382,3,42,1427
12,4,12001,120,3,67,133,230,28,12,470,3,9,482
12,4,12001,121,3,90,177,401,56,17,741,6,23,770
12,4,12001,122,3,124,260,489,46,20,939,10,31,980
12,4,12001,123,3,114,135,437,40,11,737,4,16,757
12,4,12001,124,3,134,126,430,37,12,739,5,13,757
12,4,12001,125,3,100,200,337,48,13,698,3,17,718
12,4,12001,126,3,98,200,199,34,17,548,3,11,562
12,4,12001,127,3,68,135,339,27,10,579,0,33,612
12,4,12001,128,3,64,131,317,59,15,586,17,21,624
12,4,12001,143,3,74,175,398,27,12,686,5,20,711
12,4,12001,144,3,70,208,307,31,24,640,7,18,665
12,4,12001,163,3,23,39,117,5,3,187,2,6,195
12,4,12001,164,3,130,183,607,48,21,989,6,56,1051
12,4,12001,165,3,83,145,394,39,9,670,5,28,703
12,4,12001,166,3,125,122,399,32,21,699,5,32,736
12,4,12001,167,3,68,138,423,34,24,687,2,17,706
12,4,12001,168,3,68,107,255,30,19,479,0,12,491
12,4,12001,169,3,50,122,303,15,7,497,4,12,513
12,4,12001,170,3,36,57,201,19,5,318,1,13,332
12,4,12001,171,3,78,112,463,44,14,711,3,28,742
12,4,12001,187,3,69,72,220,15,9,385,2,16,403
12,4,12001,188,3,61,68,249,26,11,415,5,7,427
12,4,12001,189,3,29,43,125,11,2,210,0,4,214
12,4,12001,190,3,56,61,201,13,10,341,0,13,354
12,4,12001,191,3,84,115,242,19,9,469,0,23,492
12,4,12001,192,3,116,148,468,80,20,832,8,37,877
12,4,12001,193,3,52,167,425,28,9,681,3,25,709
12,4,12001,194,3,76,110,320,42,17,565,4,13,582
12,4,12001,195,3,36,81,204,20,8,349,3,10,362
12,4,12001,196,3,67,95,232,19,16,429,1,13,443
12,4,12001,197,3,53,111,352,35,17,568,7,10,585
12,4,12001,198,3,174,201,558,62,17,1012,5,28,1045
12,4,12001,199,3,63,82,255,28,12,440,2,12,454
12,4,12001,200,3,104,155,429,54,14,756,12,11,779
12,4,12001,218,3,83,131,263,42,14,533,5,22,560
12,4,12001,219,3,103,160,460,105,28,856,5,18,879
12,4,12001,220,3,82,170,415,48,14,729,0,8,737
12,4,12001,221,3,82,107,273,62,16,540,1,20,561
12,4,12001,222,3,44,64,212,64,3,387,7,9,403
12,4,12001,223,3,78,141,467,73,18,777,1,29,807
12,4,12001,224,3,98,192,485,66,18,859,3,31,893
12,4,12001,225,3,74,150,273,40,11,548,4,22,574
12,4,12001,226,3,45,156,397,32,5,635,0,27,662
12,4,12001,227,3,60,187,207,23,6,483,2,8,493
12,4,12001,228,3,76,195,392,69,23,755,7,19,781
12,4,12001,229,3,69,102,275,41,15,502,1,16,519
12,4,12001,230,3,72,149,430,31,18,700,8,24,732
12,4,12001,231,3,103,135,425,53,13,729,4,35,768
12,4,12001,232,3,134,203,539,44,20,940,6,11,957
12,4,12001,233,3,103,138,374,48,18,681,3,9,693
12,4,12001,234,3,66,123,178,37,12,416,2,9,427
12,4,12001,235,3,82,72,206,26,8,394,3,12,409
12,4,12001,236,3,79,150,218,28,12,487,1,5,493
12,4,12001,237,3,95,177,260,54,18,604,7,12,623
12,4,12001,238,3,62,82,229,47,13,433,16,26,475
12,4,12001,239,3,110,105,345,40,20,620,1,16,637
12,4,12001,240,3,140,145,297,35,18,635,1,4,640
12,4,12001,241,3,94,102,267,39,13,515,0,12,527
12,4,12001,242,3,85,105,263,49,18,520,3,11,534
12,4,12001,248,3,91,162,322,35,9,619,4,9,632
12,4,12001,249,3,75,104,243,36,16,474,1,15,490
12,4,12001,250,3,97,100,254,43,14,508,2,7,517
12,4,12001,251,3,122,126,324,51,28,651,8,10,669
12,4,12001,252,3,182,132,265,46,21,646,3,10,659
12,4,12001,253,3,128,125,256,44,18,571,1,8,580
12,4,12001,254,3,174,199,436,50,33,892,5,12,909
12,4,12001,255,3,330,165,266,58,34,853,7,13,873
12,4,12001,256,3,384,587,906,132,58,2067,9,48,2124
12,4,12001,257,3,108,227,424,61,26,846,3,21,870
12,4,12001,258,3,90,112,281,53,27,563,1,5,569
12,4,12001,259,3,95,148,304,33,18,598,2,16,616
12,4,12001,260,3,89,126,248,43,11,517,1,12,530
12,4,12001,261,3,153,176,422,54,29,834,1,29,864
12,4,12001,270,3,203,158,324,61,21,767,4,13,784
12,4,12001,271,3,145,109,261,49,26,590,3,5,598
12,4,12001,272,3,212,155,360,65,30,822,1,23,846
12,4,12001,273,3,64,135,327,20,17,563,1,13,577
12,4,12001,274,3,145,201,355,67,29,797,7,19,823
12,4,12001,275,3,151,94,176,23,15,459,0,8,467
12,4,12001,276,3,246,95,207,32,17,597,3,11,611
12,4,12001,277,3,234,193,370,60,28,885,3,30,918
12,4,12001,313,3,59,60,132,4,3,258,0,1,259
12,4,12001,314,3,17,46,93,9,3,168,0,2,170
12,4,12001,315,3,21,104,145,9,5,284,0,9,293
12,4,12001,316,3,66,76,143,4,7,296,0,11,307
12,4,12001,317,3,51,59,208,17,6,341,1,9,351
12,4,12001,318,3,62,113,209,23,2,409,1,7,417
12,4,12001,319,3,61,114,259,55,4,493,4,26,523
12,4,12001,320,3,92,135,280,88,3,598,2,20,620
12,4,12001,321,3,6,49,47,14,1,117,3,9,129
12,4,12001,322,3,39,93,109,6,3,250,1,9,260
12,4,12001,323,3,137,106,161,15,7,426,2,12,440
12,4,12001,324,3,30,48,143,2,3,226,0,0,226
12,4,12001,325,3,29,20,22,5,1,77,0,3,80
12,4,12001,332,3,18,47,46,3,1,115,1,4,120
12,4,12001,333,3,49,62,277,13,8,409,5,6,420
12,4,12001,334,3,103,152,353,27,9,644,8,34,686
12,4,12001,335,3,56,135,284,24,7,506,5,26,537
12,4,12001,336,3,44,149,330,29,13,565,2,18,585
12,4,12001,337,3,43,80,385,23,6,537,0,16,553
12,4,12001,338,3,28,79,299,22,7,435,3,14,452
12,4,12001,343,3,74,149,399,37,13,672,5,27,704
12,4,12001,344,3,49,144,325,25,8,551,7,22,580
12,4,12001,345,3,68,101,73,3,0,245,0,8,253
12,4,12001,346,3,54,42,101,1,1,199,0,8,207
12,4,12001,347,3,105,184,372,51,10,722,3,21,746
12,4,12001,353,3,19,56,40,7,1,123,1,7,131
12,5,12004,456,3,23,207,393,16,1,640,1,29,670
12,5,12004,457,3,3,131,146,1,0,281,0,8,289
12,5,12004,458,3,0,31,41,2,0,74,0,2,76
12,5,12004,459,3,5,130,180,3,4,322,1,18,341
12,5,12004,460,3,0,26,34,0,0,60,0,0,60
12,5,12004,461,3,3,93,75,0,0,171,0,6,177
12,5,12004,462,3,0,2,42,0,0,44,0,1,45
12,5,12004,463,3,7,72,89,0,0,168,0,7,175
12,5,12004,464,3,1,46,70,1,0,118,0,3,121
12,5,12004,465,3,16,214,183,1,2,416,0,15,431
12,5,12004,466,3,0,30,47,1,1,79,0,0,79
12,5,12004,467,3,4,157,138,1,1,301,0,14,315
12,5,12004,468,3,4,49,213,4,4,274,1,8,283
12,5,12004,469,3,9,54,127,1,1,192,0,4,196
12,5,12004,470,3,4,49,30,1,3,87,0,5,92
12,5,12004,471,3,8,161,60,0,0,229,0,14,243
12,5,12004,472,3,12,209,162,1,3,387,0,29,416
12,5,12004,473,3,22,167,42,1,7,239,0,29,268
12,5,12005,474,3,31,241,186,31,8,497,1,15,513
12,5,12005,475,3,16,149,159,12,1,337,3,10,350
12,5,12005,476,3,24,180,164,14,1,383,2,7,392
12,5,12005,477,3,2,42,47,9,1,101,0,3,104
12,5,12005,478,3,14,132,130,15,5,296,0,0,296
12,5,12009,564,3,16,150,90,1,0,257,0,18,275
12,5,12009,565,3,54,22,19,3,0,98,0,7,105
12,5,12009,566,3,1,29,60,3,0,93,0,3,96
12,5,12009,567,3,17,9,19,2,0,47,0,8,55
12,5,12009,568,3,4,14,31,0,0,49,0,4,53
12,5,12009,569,3,24,16,54,0,0,94,0,39,133
12,5,12009,570,3,23,45,74,2,1,145,0,7,152
12,5,12009,571,3,7,16,33,1,0,57,0,1,58
12,5,12009,572,3,19,17,90,0,1,127,0,14,141
12,5,12010,573,3,55,184,189,18,10,456,3,32,491
12,5,12010,574,3,0,26,7,0,0,33,0,0,33
12,5,12010,575,3,7,32,28,0,3,70,0,7,77
12,5,12010,576,3,4,55,13,2,1,75,0,3,78
12,5,12010,577,3,23,122,43,1,2,191,2,0,193
12,5,12010,578,3,7,33,17,0,1,58,0,3,61
12,5,12010,579,3,29,42,68,3,0,142,0,10,152
12,5,12010,580,3,7,78,70,2,2,159,0,10,169
12,5,12010,581,3,5,34,36,4,1,80,0,6,86
12,5,12010,582,3,14,143,154,9,3,323,2,11,336
12,5,12010,583,3,10,66,58,5,1,140,0,12,152
12,5,12010,584,3,7,49,144,15,0,215,1,22,238
12,5,12010,585,3,15,18,114,0,0,147,1,14,162
12,5,12010,586,3,2,75,116,4,0,197,0,11,208
12,5,12010,587,3,14,51,159,0,0,224,0,17,241
12,5,12010,588,3,4,35,52,0,0,91,0,9,100
12,5,12010,589,3,6,44,130,1,2,183,0,19,202
12,5,12010,590,3,1,4,184,0,1,190,0,29,219
12,5,12010,591,3,11,62,178,0,1,252,0,27,279
12,5,12010,592,3,12,48,259,3,3,325,0,0,325
12,5,12010,593,3,4,13,184,0,1,202,0,6,208
12,5,12010,594,3,3,32,268,0,3,306,0,20,326
12,5,12010,595,3,20,193,224,1,6,444,0,36,480
12,5,12020,868,3,61,234,321,28,1,645,0,29,674
12,5,12020,869,3,3,46,55,1,0,105,0,0,105
12,5,12020,870,3,20,41,92,5,1,159,0,16,175
12,5,12020,871,3,4,87,17,1,0,109,0,9,118
12,5,12020,872,3,12,105,106,3,0,226,0,17,243
12,5,12020,873,3,12,141,192,2,1,348,0,36,384
12,5,12020,874,3,14,137,104,2,2,259,0,13,272
12,5,12020,875,3,1,41,60,0,1,103,0,8,111
12,5,12020,876,3,1,24,51,0,0,76,0,7,83
12,5,12020,877,3,15,173,166,30,0,384,0,23,407
12,5,12020,878,3,14,98,99,1,2,214,0,2,216
12,5,12020,879,3,4,46,127,0,2,179,0,15,194
12,5,12020,880,3,7,9,32,2,0,50,0,1,51
12,5,12020,881,3,4,130,70,5,6,215,0,15,230
12,5,12020,882,3,2,11,43,1,1,58,0,5,63
12,5,12077,1185,3,21,179,238,1,5,444,1,49,494
12,5,12077,1190,3,14,102,202,2,4,324,0,24,348
12,5,12077,1191,3,24,88,102,3,3,220,0,32,252
12,5,12077,1192,3,1,136,104,1,1,243,0,7,250
12,5,12077,1195,3,56,289,440,9,9,803,3,54,860
12,5,12077,1196,3,8,105,160,0,1,274,0,76,350
12,5,12077,1198,3,31,89,155,0,1,276,0,46,322
12,5,12077,1199,3,14,214,144,0,7,379,0,32,411
12,5,12037,1565,3,62,94,147,53,2,358,1,23,382
12,5,12037,1566,3,27,94,92,23,3,239,0,8,247
12,5,12037,1567,3,39,111,125,25,1,301,0,16,317
12,5,12037,1568,3,36,77,126,38,9,286,0,27,313
12,5,12037,1569,3,3,142,177,2,1,325,0,3,328
12,5,12037,1570,3,19,42,124,13,1,199,0,6,205
12,5,12037,1571,3,8,33,67,16,2,126,0,1,127
12,5,12037,1572,3,6,43,126,5,1,181,0,4,185
12,5,12037,1573,3,23,57,63,7,0,150,0,7,157
12,5,12037,1574,3,6,47,45,7,0,105,0,2,107
12,5,12037,1575,3,34,100,169,32,2,337,0,4,341
12,5,12042,1699,3,20,133,429,11,1,594,1,19,614
12,5,12042,1700,3,18,140,371,5,3,537,1,20,558
12,5,12042,1701,3,6,22,213,0,0,241,0,6,247
12,5,12042,1702,3,11,96,275,5,0,387,1,10,398
12,5,12042,1703,3,4,362,129,1,0,496,0,10,506
12,5,12042,1704,3,8,213,534,0,0,755,1,16,772
12,5,12042,1705,3,4,11,129,1,0,145,0,6,151
12,5,12042,1706,3,9,129,282,4,2,426,0,18,444
12,5,12042,1707,3,11,38,517,4,4,574,1,9,584
12,5,12042,1708,3,10,80,92,0,9,191,0,7,198
12,5,12042,1709,3,2,119,222,2,3,348,0,11,359
12,5,12042,1710,3,31,126,612,8,4,781,0,40,821
12,5,12042,1711,3,17,135,255,3,4,414,0,17,431
12,5,12042,1712,3,5,230,267,1,1,504,0,15,519
12,5,12042,1713,3,13,412,363,8,2,798,0,22,820
12,5,12042,1714,3,0,99,138,0,2,239,0,6,245
12,5,12042,1715,3,1,37,142,0,2,182,0,7,189
12,5,12042,1716,3,19,83,413,0,4,519,0,31,550
12,5,12042,1717,3,20,167,314,11,1,513,0,16,529
12,5,12042,1718,3,9,64,135,2,1,211,0,6,217
12,5,12044,1735,3,18,127,175,4,3,327,3,11,341
12,5,12044,1736,3,42,250,198,4,1,495,0,18,513
12,5,12044,1737,3,1,8,147,1,1,158,1,7,166
12,5,12044,1738,3,0,2,181,0,0,183,0,3,186
12,5,12044,1739,3,7,7,136,0,0,150,0,0,150
12,5,12044,1740,3,6,50,59,1,2,118,0,2,120
12,5,12044,1741,3,13,18,192,0,0,223,0,20,243
12,5,12044,1742,3,4,3,74,1,0,82,0,6,88
12,5,12044,1743,3,0,7,47,0,0,54,0,3,57
12,5,12044,1744,3,6,16,203,0,0,225,0,12,237
12,5,12044,1745,3,7,14,127,1,0,149,0,6,155
12,5,12044,1746,3,6,44,176,2,3,231,0,40,271
12,5,12044,1747,3,2,9,56,0,1,68,0,1,69
12,5,12044,1748,3,6,78,184,1,0,269,0,20,289
12,5,12044,1749,3,4,44,89,0,0,137,1,0,138
12,5,12044,1750,3,12,23,151,0,2,188,0,10,198
12,5,12044,1751,3,38,321,422,3,2,786,0,51,837
12,5,12044,1752,3,11,6,154,0,1,172,1,6,179
12,5,12044,1753,3,5,128,323,0,6,462,0,12,474
12,5,12044,1754,3,32,65,187,2,1,287,0,19,306
12,5,12044,1755,3,2,1,128,0,0,131,1,0,132
12,5,12044,1756,3,3,27,394,0,0,424,0,1,425
12,5,12044,1757,3,7,10,69,0,0,86,0,12,98
12,5,12044,1758,3,5,166,325,1,2,499,0,0,499
12,5,12044,1759,3,3,0,913,0,0,916,0,12,928
12,5,12044,1760,3,28,389,122,13,37,589,0,10,599
12,5,12044,1761,3,55,75,323,19,17,489,0,9,498
12,5,12044,1762,3,1,33,445,0,0,479,1,13,493
12,5,12037,1763,3,75,76,37,3,0,191,0,16,207
12,5,12053,2015,3,186,191,313,27,7,724,0,23,747
12,5,12053,2016,3,154,194,233,27,6,614,3,21,638
12,5,12053,2017,3,211,185,221,16,9,642,3,24,669
12,5,12053,2018,3,20,48,257,0,6,331,0,21,352
12,5,12053,2019,3,7,74,132,0,2,215,0,8,223
12,5,12053,2020,3,4,4,258,4,0,270,0,30,300
12,5,12053,2021,3,19,44,89,5,1,158,0,0,158
12,5,12053,2022,3,29,23,59,0,3,114,0,7,121
12,5,12053,2023,3,19,27,76,12,0,134,0,5,139
12,5,12053,2024,3,15,82,239,3,3,342,2,38,382
12,5,12053,2025,3,7,17,154,1,3,182,1,18,201
12,5,12053,2026,3,36,108,245,7,3,399,2,19,420
12,5,12053,2027,3,5,13,66,1,1,86,0,0,86
12,5,12053,2028,3,36,67,112,5,2,222,0,9,231
12,5,12053,2029,3,6,25,100,0,4,135,0,3,138
12,5,12053,2030,3,17,91,340,4,7,459,0,24,483
12,5,12053,2031,3,28,98,83,1,3,213,0,14,227
12,5,12053,2032,3,27,37,38,2,0,104,0,4,108
12,5,12053,2033,3,20,65,26,1,2,114,0,4,118
12,5,12053,2034,3,10,22,23,0,0,55,0,2,57
12,5,12053,2035,3,58,124,425,1,2,610,1,25,636
12,5,12053,2036,3,40,27,26,0,1,94,0,6,100
12,5,12053,2037,3,23,14,40,0,0,77,0,4,81
12,5,12053,2038,3,10,20,33,0,1,64,0,1,65
12,5,12053,2039,3,11,112,144,0,0,267,0,19,286
12,5,12053,2040,3,14,46,46,0,0,106,0,8,114
12,5,12063,2509,3,174,121,235,41,6,577,2,32,611
12,5,12063,2510,3,215,196,224,18,2,655,2,36,693
12,5,12063,2511,3,44,35,132,1,1,213,0,26,239
12,5,12063,2512,3,83,134,61,3,6,287,0,40,327
12,5,12063,2513,3,7,28,58,0,0,93,0,8,101
12,5,12063,2514,3,70,88,124,1,2,285,3,15,303
12,5,12063,2515,3,22,42,30,3,0,97,0,12,109
12,5,12063,2516,3,26,49,121,3,1,200,0,37,237
12,5,12063,2517,3,22,93,65,3,2,185,0,11,196
12,5,12063,2518,3,265,313,333,13,2,926,0,24,950
12,5,12063,2519,3,90,24,85,1,3,203,0,25,228
12,5,12063,2520,3,34,16,49,0,0,99,0,0,99
12,5,12063,2521,3,50,96,116,5,1,268,0,3,271
12,5,12063,2522,3,58,58,266,3,1,386,2,39,427
12,5,12064,2523,3,37,460,288,22,1,808,3,36,847
12,5,12064,2524,3,13,76,128,1,1,219,0,5,224
12,5,12064,2525,3,1,41,47,1,0,90,0,3,93
12,5,12064,2526,3,7,71,47,1,1,127,0,6,133
12,5,12064,2527,3,18,83,135,3,0,239,0,19,258
12,5,12064,2528,3,7,192,147,2,3,351,0,26,377
12,5,12064,2529,3,5,17,30,0,0,52,0,2,54
12,5,12064,2530,3,5,41,69,1,1,117,0,10,127
12,5,12064,2531,3,22,37,289,8,1,357,0,23,380
12,5,12064,2532,3,0,54,30,0,0,84,0,3,87
12,5,12066,2554,3,31,122,149,8,2,312,0,4,316
12,5,12066,2555,3,54,178,143,9,3,387,1,17,405
12,5,12066,2556,3,13,81,33,8,3,138,0,0,138
12,5,12066,2557,3,10,78,17,2,0,107,0,2,109
12,5,12066,2558,3,4,106,17,1,1,129,0,6,135
12,5,12066,2559,3,2,33,69,1,0,105,0,3,108
12,5,12066,2560,3,2,150,148,6,0,306,0,2,308
12,5,12066,2561,3,6,415,26,4,3,454,0,24,478
12,5,12067,2562,3,77,291,296,105,23,792,0,25,817
12,5,12067,2563,3,102,190,259,135,13,699,4,24,727
12,5,12067,2564,3,119,563,625,142,20,1469,9,37,1515
12,5,12067,2565,3,50,241,334,49,3,677,2,26,705
12,5,12067,2566,3,71,235,433,72,15,826,0,22,848
12,5,12067,2567,3,55,254,456,125,5,895,7,38,940
12,5,12067,2568,3,48,187,288,48,3,574,3,12,589
12,5,12067,2569,3,51,230,441,40,10,772,5,21,798
12,5,12067,2570,3,63,216,622,50,5,956,4,24,984
12,5,12067,2571,3,48,215,390,56,11,720,2,26,748
12,5,12067,2572,3,47,280,486,63,14,890,0,36,926
12,5,12067,2573,3,9,72,82,21,4,188,3,10,201
12,5,12067,2574,3,2,15,61,2,0,80,0,12,92
12,5,12067,2575,3,9,126,66,12,1,214,0,14,228
12,5,12067,2576,3,3,3,32,3,0,41,0,2,43
12,5,12067,2577,3,12,87,98,7,2,206,0,30,236
12,5,12067,2578,3,4,167,77,2,0,250,0,7,257
12,5,12067,2579,3,3,62,37,3,1,106,0,10,116
12,5,12067,2580,3,1,18,127,1,1,148,0,6,154
12,5,12067,2581,3,0,8,12,4,0,24,0,0,24
12,5,12067,2582,3,11,117,84,14,3,229,1,5,235
12,5,12067,2583,3,5,91,4,2,1,103,0,11,114
12,5,12067,2584,3,1,86,68,4,1,160,0,4,164
12,5,12067,2585,3,10,130,143,24,3,310,1,5,316
12,5,12067,2586,3,14,265,265,20,4,568,2,41,611
12,5,12067,2587,3,6,66,55,0,2,129,0,9,138
12,5,12067,2588,3,12,69,61,1,1,144,0,5,149
12,5,12067,2589,3,6,23,74,7,0,110,2,5,117
12,5,12067,2590,3,13,68,102,3,0,186,0,12,198
12,5,12067,2591,3,2,6,27,0,0,35,0,3,38
12,5,12067,2592,3,9,60,55,5,0,129,0,3,132
12,5,12067,2593,3,19,267,183,6,4,479,0,38,517
12,5,12067,2594,3,9,15,49,1,2,76,0,12,88
12,5,12067,2595,3,21,242,207,19,7,496,5,35,536
12,5,12067,2596,3,0,3,100,0,0,103,0,1,104
12,5,12067,2597,3,0,39,32,0,0,71,0,4,75
12,5,12067,2598,3,16,19,27,0,0,62,0,9,71
12,5,12067,2599,3,1,1,39,0,0,41,0,0,41
12,5,12070,2655,3,272,489,355,15,5,1136,0,56,1192
12,5,12070,2656,3,3,4,45,0,1,53,0,0,53
12,5,12070,2657,3,0,9,123,0,0,132,0,9,141
12,5,12070,2658,3,1,21,64,5,0,91,0,2,93
12,5,12070,2659,3,8,20,108,0,3,139,0,45,184
12,5,12070,2660,3,48,31,106,0,0,185,0,11,196
12,5,12070,2661,3,3,127,85,0,1,216,0,11,227
12,5,12070,2662,3,16,69,176,0,2,263,0,17,280
12,5,12070,2663,3,0,33,225,2,0,260,0,21,281
12,5,12070,2664,3,0,12,186,0,0,198,0,0,198
12,5,12070,2665,3,0,2,46,0,0,48,0,1,49
12,5,12070,2666,3,0,1,38,1,0,40,0,4,44
12,5,12070,2667,3,0,7,76,2,3,88,0,14,102
12,5,12070,2668,3,4,12,148,2,2,168,0,5,173
12,5,12072,2678,3,110,291,416,21,9,847,1,22,870
12,5,12072,2679,3,106,253,379,16,2,756,0,44,800
12,5,12072,2680,3,4,57,35,0,0,96,1,2,99
12,5,12072,2681,3,9,91,149,0,2,251,0,16,267
12,5,12072,2682,3,27,140,131,0,0,298,0,16,314
12,5,12072,2683,3,10,110,92,0,1,213,0,3,216
12,5,12072,2684,3,10,139,137,0,0,286,0,5,291
12,5,12072,2685,3,49,266,269,1,1,586,0,18,604
12,5,12072,2686,3,44,279,104,2,0,429,0,8,437
12,5,12072,2687,3,37,229,240,2,3,511,0,11,522
12,5,12072,2688,3,62,309,234,5,3,613,0,9,622
12,5,12072,2689,3,29,250,132,0,2,413,0,35,448
12,5,12072,2690,3,40,352,205,0,4,601,0,16,617
12,5,12072,2691,3,160,1043,502,10,6,1721,0,46,1767
12,5,12072,2692,3,130,559,285,1,2,977,0,41,1018
12,5,12073,2693,3,19,114,40,21,2,196,0,13,209
12,5,12073,2694,3,35,213,154,13,1,416,3,14,433
12,5,12073,2695,3,3,93,33,8,0,137,0,14,151
12,5,12073,2696,3,4,51,83,5,2,145,1,8,154
12,5,12073,2697,3,3,43,79,0,0,125,0,5,130
12,5,12073,2698,3,12,49,47,15,0,123,0,0,123
12,5,12073,2699,3,12,117,80,0,5,214,0,4,218
12,5,12073,2700,3,14,218,89,5,2,328,0,9,337
12,5,12076,2701,3,6,43,125,2,1,177,0,19,196
12,5,12073,2702,3,2,60,58,1,1,122,0,0,122
12,5,12076,2703,3,5,13,279,0,2,299,0,15,314
12,5,12076,2705,3,35,100,43,0,1,179,0,8,187
12,5,12076,2706,3,8,64,65,0,0,137,0,15,152
12,5,12076,2707,3,3,11,125,0,0,139,0,3,142
12,5,12076,2708,3,4,80,49,2,1,136,0,0,136
12,5,12076,2709,3,22,313,127,4,5,471,0,0,471
12,5,12076,2710,3,2,24,84,0,1,111,0,4,115
12,5,12076,2711,3,6,8,176,0,0,190,0,0,190
12,5,12076,2712,3,1,58,190,1,2,252,0,15,267
12,5,12076,2713,3,13,56,239,0,1,309,0,17,326
12,5,12073,2714,3,1,3,24,0,0,28,0,2,30
12,5,12076,2715,3,5,44,128,0,1,178,0,4,182
12,5,12076,2716,3,16,62,199,2,7,286,0,35,321
12,5,12076,2717,3,7,4,89,0,0,100,0,5,105
12,5,12076,2718,3,2,36,146,0,0,184,0,6,190
12,5,12076,2719,3,1,10,175,0,0,186,0,27,213
12,5,12076,2720,3,3,26,52,0,0,81,0,1,82
12,5,12076,2721,3,10,110,119,0,0,239,1,35,275
12,5,12076,2723,3,6,189,13,0,0,208,0,5,213
12,5,12076,2724,3,2,60,131,1,1,195,0,12,207
12,5,12076,2772,3,49,197,256,14,8,524,1,29,554
12,5,12076,2773,3,33,117,254,1,3,408,0,41,449
12,5,12076,2774,3,23,115,121,0,0,259,0,15,274
12,5,12076,2775,3,6,59,227,2,0,294,1,21,316
12,5,12076,2776,3,6,5,242,2,0,255,0,4,259
12,5,12076,2777,3,4,30,14,0,0,48,0,1,49
12,5,12077,2783,3,15,30,93,0,2,140,0,7,147
12,5,12076,2786,3,5,18,339,0,2,364,0,33,397
12,6,12002,384,3,68,586,327,13,10,1004,3,53,1060
12,6,12002,385,3,9,154,51,0,0,214,0,14,228
12,6,12002,386,3,4,130,66,0,1,201,0,5,206
12,6,12002,387,3,11,80,42,1,0,134,0,0,134
12,6,12002,388,3,2,33,55,0,0,90,0,0,90
12,6,12002,389,3,6,133,83,0,0,222,1,13,236
12,6,12002,390,3,6,72,33,0,0,111,0,3,114
12,6,12002,391,3,13,180,142,1,3,339,0,3,342
12,6,12002,392,3,3,4,24,0,0,31,0,1,32
12,6,12002,393,3,2,189,41,0,1,233,0,14,247
12,6,12002,394,3,5,64,22,0,0,91,0,4,95
12,6,12002,395,3,2,64,69,0,0,135,0,1,136
12,6,12002,396,3,2,25,33,0,0,60,0,0,60
12,6,12002,397,3,9,109,78,0,0,196,0,5,201
12,6,12002,398,3,3,135,44,0,0,182,0,0,182
12,6,12002,399,3,7,110,23,0,0,140,0,2,142
12,6,12002,400,3,8,187,142,0,1,338,0,22,360
12,6,12002,401,3,12,119,29,0,0,160,0,2,162
12,6,12002,402,3,6,135,27,0,0,168,0,4,172
12,6,12002,403,3,8,296,159,2,0,465,0,7,472
12,6,12002,404,3,14,74,72,2,2,164,3,2,169
12,6,12002,405,3,7,196,139,0,7,349,1,9,359
12,6,12002,406,3,11,238,45,0,0,294,0,6,300
12,6,12002,407,3,3,36,17,1,1,58,0,2,60
12,6,12002,408,3,17,159,126,1,2,305,0,7,312
12,6,12002,409,3,10,261,243,0,6,520,0,6,526
12,6,12002,410,3,4,14,3,0,0,21,0,4,25
12,6,12008,553,3,56,125,226,24,7,438,1,24,463
12,6,12008,554,3,49,177,235,25,3,489,1,28,518
12,6,12008,555,3,7,164,18,0,0,189,0,1,190
12,6,12008,556,3,4,69,84,0,0,157,0,5,162
12,6,12008,557,3,21,83,78,18,2,202,1,12,215
12,6,12008,558,3,0,20,15,0,0,35,0,1,36
12,6,12008,559,3,11,44,75,0,0,130,0,2,132
12,6,12008,560,3,18,120,169,6,4,317,0,1,318
12,6,12008,561,3,8,93,182,0,4,287,0,19,306
12,6,12008,562,3,24,133,97,5,1,260,0,9,269
12,6,12008,563,3,26,90,111,4,2,233,0,9,242
12,6,12015,778,3,210,155,222,41,14,642,5,19,666
12,6,12015,779,3,290,160,191,17,6,664,0,9,673
12,6,12015,780,3,395,185,167,18,8,773,3,19,795
12,6,12015,781,3,340,260,312,48,12,972,1,18,991
12,6,12015,782,3,85,142,209,7,7,450,0,2,452
12,6,12015,783,3,112,118,83,7,1,321,0,5,326
12,6,12015,784,3,82,166,187,10,7,452,1,4,457
12,6,12015,785,3,77,100,114,2,0,293,2,16,311
12,6,12015,786,3,48,35,36,3,0,122,0,3,125
12,6,12015,787,3,10,62,41,2,0,115,0,7,122
12,6,12015,788,3,8,38,28,1,0,75,0,1,76
12,6,12019,858,3,19,217,395,8,2,641,5,11,657
12,6,12019,859,3,23,366,165,4,6,564,1,23,588
12,6,12019,860,3,4,73,45,0,0,122,0,3,125
12,6,12019,861,3,4,44,63,0,0,111,0,8,119
12,6,12019,862,3,15,286,114,0,0,415,0,36,451
12,6,12019,863,3,5,48,64,0,0,117,0,0,117
12,6,12019,864,3,4,94,25,0,1,124,0,3,127
12,6,12019,865,3,21,110,97,0,5,233,0,11,244
12,6,12019,866,3,22,12,62,0,2,98,0,0,98
12,6,12019,867,3,102,144,104,3,1,354,0,17,371
12,6,12024,1030,3,21,392,383,18,1,815,0,13,828
12,6,12024,1031,3,2,112,98,4,0,216,4,1,221
12,6,12024,1032,3,0,25,46,1,0,72,0,1,73
12,6,12024,1033,3,9,176,180,2,1,368,2,6,376
12,6,12024,1034,3,8,151,115,3,4,281,1,6,288
12,6,12024,1035,3,3,82,68,1,0,154,2,9,165
12,6,12024,1036,3,13,81,117,0,0,211,1,3,215
12,6,12028,1112,3,115,273,448,40,17,893,14,35,942
12,6,12028,1113,3,68,314,488,39,15,924,4,29,957
12,6,12028,1114,3,82,232,383,39,24,760,4,13,777
12,6,12028,1115,3,103,326,388,72,24,913,2,41,956
12,6,12028,1116,3,61,169,220,44,8,502,0,16,518
12,6,12028,1117,3,138,194,268,46,7,653,0,29,682
12,6,12028,1118,3,46,161,235,63,11,516,0,31,547
12,6,12028,1119,3,51,254,285,46,16,652,8,14,674
12,6,12028,1120,3,65,261,282,62,8,678,1,12,691
12,6,12028,1121,3,82,265,393,58,11,809,2,29,840
12,6,12028,1122,3,56,206,327,47,9,645,1,14,660
12,6,12028,1123,3,30,70,257,8,9,374,0,25,399
12,6,12028,1124,3,16,86,246,3,4,355,2,31,388
12,6,12028,1125,3,29,103,39,2,2,175,2,11,188
12,6,12028,1126,3,55,249,154,4,4,466,2,13,481
12,6,12028,1127,3,52,124,66,10,6,258,6,12,276
12,6,12028,1128,3,48,64,79,3,6,200,6,9,215
12,6,12028,1129,3,37,168,106,3,1,315,0,5,320
12,6,12028,1130,3,19,72,34,1,0,126,0,6,132
12,6,12028,1131,3,29,119,106,8,2,264,1,11,276
12,6,12028,1132,3,52,128,161,4,3,348,4,19,371
12,6,12028,1133,3,18,101,81,2,0,202,1,7,210
12,6,12028,1134,3,10,57,54,4,2,127,2,2,131
12,6,12028,1135,3,32,73,147,5,4,261,2,8,271
12,6,12028,1136,3,18,135,121,6,5,285,3,16,304
12,6,12028,1137,3,4,63,31,1,1,100,0,6,106
12,6,12028,1138,3,20,59,90,1,4,174,1,11,186
12,6,12028,1139,3,19,58,121,7,3,208,0,17,225
12,6,12028,1140,3,12,54,37,3,1,107,2,2,111
12,6,12028,1141,3,17,33,43,3,3,99,0,2,101
12,6,12028,1142,3,15,34,90,3,1,143,0,8,151
12,6,12028,1143,3,15,55,55,8,4,137,1,1,139
12,6,12028,1144,3,15,76,74,2,4,171,0,3,174
12,6,12028,1145,3,19,46,81,1,2,149,1,7,157
12,6,12028,1146,3,8,56,34,0,0,98,0,2,100
12,6,12028,1147,3,12,45,25,3,1,86,0,6,92
12,6,12028,1148,3,23,55,55,1,0,134,4,10,148
12,6,12028,1149,3,14,103,58,1,0,176,0,15,191
12,6,12028,1150,3,22,72,116,0,0,210,0,9,219
12,6,12028,1151,3,19,19,132,0,4,174,0,8,182
12,6,12028,1152,3,51,23,66,5,5,150,6,11,167
12,6,12028,1153,3,9,50,42,1,0,102,2,7,111
12,6,12028,1154,3,54,186,155,8,5,408,4,24,436
12,6,12028,1155,3,19,167,58,1,3,248,0,5,253
12,6,12028,1156,3,22,14,80,1,0,117,0,7,124
12,6,12028,1157,3,16,315,389,4,6,730,5,37,772
12,6,12028,1158,3,10,71,47,1,0,129,0,10,139
12,6,12028,1159,3,13,20,46,2,1,82,0,8,90
12,6,12028,1160,3,4,131,137,1,0,273,0,28,301
12,6,12028,1161,3,22,160,140,2,2,326,0,20,346
12,6,12028,1162,3,67,83,95,1,2,248,0,40,288
12,6,12028,1163,3,18,94,49,1,2,164,0,15,179
12,6,12028,1164,3,24,138,209,3,4,378,1,49,428
12,6,12028,1165,3,6,67,30,1,1,105,0,9,114
12,6,12028,1166,3,6,26,147,1,2,182,0,15,197
12,6,12028,1167,3,31,161,45,5,4,246,0,24,270
12,6,12028,1168,3,6,50,96,1,2,155,0,7,162
12,6,12028,1169,3,7,8,139,1,1,156,0,3,159
12,6,12028,1170,3,11,80,62,2,4,159,4,13,176
12,6,12028,1171,3,10,45,90,1,1,147,0,10,157
12,6,12028,1172,3,19,104,123,1,0,247,1,17,265
12,6,12028,1173,3,39,301,87,0,0,427,0,21,448
12,6,12028,1174,3,4,36,63,0,1,104,1,4,109
12,6,12028,1175,3,47,258,222,2,4,533,1,14,548
12,6,12028,1176,3,5,13,115,0,0,133,0,4,137
12,6,12028,1177,3,15,202,296,1,3,517,0,46,563
12,6,12028,1178,3,31,197,256,2,2,488,1,26,515
12,6,12028,1179,3,15,171,170,1,2,359,0,23,382
12,6,12028,1180,3,12,96,50,1,1,160,0,16,176
12,6,12028,1181,3,49,189,202,3,1,444,0,36,480
12,6,12028,1182,3,7,33,100,0,0,140,0,4,144
12,6,12028,1183,3,15,68,89,3,1,176,0,11,187
12,6,12028,1184,3,6,99,172,0,1,278,0,15,293
12,6,12028,1186,3,8,41,135,3,2,189,2,5,196
12,6,12028,1187,3,43,65,95,2,2,207,0,10,217
12,6,12028,1188,3,1,11,61,0,0,73,0,1,74
12,6,12028,1189,3,3,44,46,0,0,93,0,13,106
12,6,12028,1193,3,7,49,49,0,0,105,0,5,110
12,6,12028,1194,3,15,91,147,0,4,257,0,10,267
12,6,12028,1197,3,2,13,61,0,0,76,0,3,79
12,6,12028,1200,3,18,171,141,6,1,337,2,60,399
12,6,12028,1201,3,13,152,111,2,1,279,1,45,325
12,6,12028,1202,3,11,71,94,0,2,178,0,28,206
12,6,12028,1203,3,20,206,147,3,3,379,0,41,420
12,6,12030,1309,3,66,96,113,39,5,319,3,23,345
12,6,12030,1310,3,70,71,177,99,2,419,0,11,430
12,6,12030,1311,3,61,134,231,189,1,616,0,29,645
12,6,12030,1312,3,43,206,182,251,6,688,1,28,717
12,6,12030,1313,3,68,110,249,141,5,573,0,30,603
12,6,12030,1314,3,106,206,263,89,5,669,5,8,682
12,6,12030,1315,3,92,246,386,191,8,923,1,31,955
12,6,12030,1316,3,68,166,367,204,14,819,3,29,851
12,6,12030,1317,3,70,219,287,115,6,697,8,23,728
12,6,12030,1318,3,133,190,347,122,10,802,3,34,839
12,6,12030,1319,3,101,168,189,97,3,558,5,36,599
12,6,12030,1320,3,23,128,93,2,0,246,0,12,258
12,6,12030,1321,3,0,18,9,0,0,27,0,1,28
12,6,12030,1322,3,16,57,64,2,2,141,0,7,148
12,6,12030,1323,3,39,131,255,5,4,434,2,3,439
12,6,12030,1324,3,32,137,206,4,4,383,0,5,388
12,6,12030,1325,3,3,51,35,1,0,90,0,0,90
12,6,12030,1326,3,14,56,200,4,1,275,0,9,284
12,6,12030,1327,3,5,16,35,1,1,58,0,3,61
12,6,12030,1328,3,8,107,77,18,2,212,2,5,219
12,6,12030,1329,3,40,143,236,24,1,444,0,16,460
12,6,12030,1330,3,33,137,176,40,2,388,1,10,399
12,6,12030,1331,3,57,177,176,25,4,439,0,32,471
12,6,12030,1332,3,36,182,55,10,1,284,0,15,299
12,6,12030,1333,3,8,31,77,4,2,122,0,5,127
12,6,12030,1334,3,28,287,366,1,4,686,0,20,706
12,6,12030,1335,3,37,355,229,4,2,627,0,19,646
12,6,12030,1336,3,20,38,119,5,1,183,2,6,191
12,6,12030,1337,3,20,50,97,15,2,184,2,5,191
12,6,12030,1338,3,4,56,22,0,1,83,0,5,88
12,6,12034,1432,3,49,185,169,9,3,415,2,17,434
12,6,12034,1433,3,34,195,208,22,8,467,3,18,488
12,6,12034,1434,3,72,317,355,18,2,764,0,18,782
12,6,12034,1435,3,37,42,45,2,1,127,1,3,131
12,6,12034,1436,3,8,60,73,1,0,142,0,5,147
12,6,12034,1437,3,16,75,189,0,0,280,0,6,286
12,6,12034,1438,3,6,86,19,0,0,111,0,0,111
12,6,12034,1439,3,17,138,125,1,0,281,0,5,286
12,6,12034,1440,3,26,125,91,6,0,248,1,13,262
12,6,12034,1441,3,27,113,126,5,2,273,3,9,285
12,6,12034,1442,3,10,52,198,8,7,275,0,0,275
12,6,12034,1443,3,14,90,69,2,3,178,2,1,181
12,6,12035,1444,3,67,160,161,14,4,406,0,13,419
12,6,12035,1445,3,88,152,238,18,8,504,6,23,533
12,6,12035,1446,3,94,139,273,18,6,530,4,14,548
12,6,12035,1447,3,64,107,148,20,2,341,5,8,354
12,6,12035,1448,3,96,122,193,28,8,447,0,29,476
12,6,12035,1449,3,94,139,291,36,11,571,1,12,584
12,6,12035,1450,3,104,170,252,15,6,547,0,17,564
12,6,12035,1451,3,82,154,224,32,5,497,2,26,525
12,6,12035,1452,3,135,143,159,15,7,459,2,17,478
12,6,12035,1453,3,68,99,173,14,5,359,0,5,364
12,6,12035,1454,3,118,192,342,19,10,681,2,19,702
12,6,12035,1455,3,55,203,219,15,7,499,4,9,512
12,6,12035,1456,3,45,107,146,6,3,307,1,11,319
12,6,12035,1457,3,11,40,10,2,1,64,0,4,68
12,6,12035,1458,3,53,114,125,4,5,301,0,6,307
12,6,12035,1459,3,37,120,84,12,6,259,0,7,266
12,6,12035,1460,3,13,95,111,2,3,224,0,4,228
12,6,12035,1461,3,4,19,11,0,0,34,0,0,34
12,6,12035,1462,3,26,87,113,2,2,230,0,5,235
12,6,12035,1463,3,39,95,183,5,2,324,0,6,330
12,6,12035,1464,3,30,320,220,9,5,584,1,22,607
12,6,12035,1465,3,13,163,106,4,0,286,0,11,297
12,6,12035,1466,3,2,48,10,1,0,61,0,0,61
12,6,12035,1467,3,13,47,28,3,0,91,1,2,94
12,6,12035,1468,3,7,140,19,4,0,170,0,5,175
12,6,12035,1469,3,48,133,196,44,3,424,1,9,434
12,6,12035,1470,3,6,64,5,1,1,77,0,1,78
12,6,12035,1471,3,17,99,67,2,0,185,0,4,189
12,6,12035,1472,3,6,92,58,1,0,157,0,4,161
12,6,12035,1473,3,15,139,111,2,1,268,1,7,276
12,6,12035,1474,3,11,120,95,3,1,230,0,8,238
12,6,12035,1475,3,5,49,35,4,1,94,0,1,95
12,6,12035,1476,3,13,45,33,1,0,92,0,0,92
12,6,12035,1477,3,38,209,118,2,2,369,1,17,387
12,6,12035,1478,3,66,228,164,6,4,468,1,7,476
12,6,12035,1479,3,11,168,116,2,1,298,0,13,311
12,6,12043,1719,3,47,221,183,25,11,487,2,20,509
12,6,12043,1720,3,63,177,177,6,8,431,0,21,452
12,6,12043,1721,3,45,183,171,15,3,417,3,22,442
12,6,12043,1722,3,2,148,10,0,3,163,0,9,172
12,6,12043,1723,3,5,57,62,0,1,125,0,19,144
12,6,12043,1724,3,1,44,62,0,0,107,0,5,112
12,6,12043,1725,3,17,55,24,6,3,105,0,5,110
12,6,12043,1726,3,2,43,94,1,2,142,0,0,142
12,6,12043,1727,3,25,101,271,0,0,397,0,9,406
12,6,12043,1728,3,0,47,3,1,0,51,0,1,52
12,6,12043,1729,3,7,90,34,1,3,135,0,6,141
12,6,12043,1730,3,16,74,13,2,2,107,1,6,114
12,6,12043,1731,3,15,44,52,1,1,113,0,2,115
12,6,12043,1732,3,7,42,259,3,4,315,0,10,325
12,6,12043,1733,3,15,234,114,5,2,370,1,26,397
12,6,12043,1734,3,30,140,106,3,5,284,2,11,297
12,6,12046,1784,3,81,248,184,22,7,542,0,17,559
12,6,12046,1785,3,51,159,284,18,5,517,0,12,529
12,6,12046,1786,3,94,385,364,32,10,885,4,30,919
12,6,12046,1787,3,25,140,40,1,0,206,0,6,212
12,6,12046,1788,3,31,36,25,8,0,100,0,5,105
12,6,12046,1789,3,8,190,178,1,0,377,0,8,385
12,6,12046,1790,3,6,60,35,2,2,105,0,3,108
12,6,12046,1791,3,8,89,31,4,3,135,2,4,141
12,6,12046,1792,3,21,198,89,2,2,312,0,29,341
12,6,12046,1793,3,3,82,156,0,0,241,0,3,244
12,6,12046,1794,3,2,12,115,0,0,129,0,6,135
12,6,12046,1795,3,1,38,38,0,0,77,0,1,78
12,6,12046,1796,3,0,59,18,0,0,77,0,1,78
12,6,12046,1797,3,13,127,41,0,2,183,0,13,196
12,6,12046,1798,3,48,468,599,5,2,1122,0,31,1153
12,6,12046,1799,3,5,57,152,0,2,216,0,10,226
12,6,12046,1800,3,10,290,282,0,3,585,0,10,595
12,6,12046,1801,3,5,72,75,0,1,153,0,4,157
12,6,12046,1802,3,8,36,14,1,0,59,0,2,61
12,6,12046,1803,3,4,54,74,0,2,134,0,3,137
12,6,12046,1804,3,11,76,108,1,1,197,2,4,203
12,6,12046,1805,3,5,44,18,1,0,68,0,2,70
12,6,12046,1806,3,1,20,17,1,0,39,0,2,41
12,6,12046,1807,3,1,78,50,0,0,129,0,4,133
12,6,12046,1808,3,8,112,108,3,5,236,0,0,236
12,6,12060,2420,3,66,135,179,27,4,411,3,13,427
12,6,12060,2421,3,118,262,215,58,7,660,2,13,675
12,6,12060,2422,3,41,96,69,23,8,237,0,4,241
12,6,12060,2423,3,69,230,221,43,12,575,1,16,592
12,6,12060,2424,3,45,102,138,40,4,329,1,6,336
12,6,12060,2425,3,46,121,177,10,4,358,0,9,367
12,6,12060,2426,3,16,86,63,10,0,175,2,5,182
12,6,12060,2427,3,53,151,184,18,2,408,0,9,417
12,6,12060,2428,3,43,34,31,1,5,114,0,6,120
12,6,12060,2429,3,16,112,68,3,1,200,0,6,206
12,6,12060,2430,3,21,114,155,5,3,298,0,8,306
12,6,12060,2431,3,7,119,121,2,0,249,0,4,253
12,6,12060,2432,3,2,72,43,1,0,118,0,1,119
12,6,12060,2433,3,52,253,176,9,1,491,0,10,501
12,6,12060,2434,3,38,217,212,6,4,477,0,9,486
12,6,12060,2435,3,8,21,30,1,1,61,0,0,61
12,6,12060,2436,3,4,60,80,2,1,147,0,1,148
12,6,12060,2437,3,35,118,103,5,1,262,1,7,270
12,6,12060,2438,3,51,128,118,6,2,305,0,7,312
12,6,12060,2439,3,35,151,154,5,6,351,0,23,374
12,6,12060,2440,3,3,68,62,2,2,137,0,6,143
12,6,12060,2441,3,8,61,33,5,1,108,0,4,112
12,6,12060,2442,3,33,132,187,10,4,366,0,7,373
12,6,12060,2443,3,14,111,53,2,1,181,0,3,184
12,6,12060,2444,3,32,268,285,3,0,588,1,23,612
12,6,12060,2445,3,10,161,71,4,1,247,0,12,259
12,6,12060,2446,3,25,117,236,17,3,398,0,17,415
12,6,12060,2447,3,75,146,255,1,0,477,0,33,510
12,6,12060,2448,3,72,120,252,2,0,446,2,20,468
12,6,12060,2449,3,19,38,35,2,2,96,1,0,97
12,6,12060,2450,3,9,62,92,3,0,166,0,16,182
12,6,12071,2669,3,39,149,171,6,6,371,1,8,380
12,6,12071,2670,3,72,219,403,22,9,725,0,31,756
12,6,12071,2671,3,102,248,259,7,4,620,2,19,641
12,6,12071,2672,3,13,48,100,1,0,162,1,8,171
12,6,12071,2673,3,5,74,74,0,1,154,0,0,154
12,6,12071,2674,3,13,86,93,3,3,198,0,7,205
12,6,12071,2675,3,3,50,14,0,0,67,0,0,67
12,6,12071,2676,3,0,16,53,0,0,69,0,2,71
12,6,12071,2677,3,0,27,13,0,0,40,0,0,40
12,6,12075,2752,3,130,210,309,15,4,668,6,41,715
12,6,12075,2753,3,53,267,248,19,4,591,5,31,627
12,6,12075,2754,3,101,322,256,22,15,716,3,12,731
12,6,12075,2755,3,15,46,28,1,1,91,0,7,98
12,6,12075,2756,3,17,21,30,0,0,68,0,0,68
12,6,12075,2757,3,13,58,10,1,0,82,0,4,86
12,6,12075,2758,3,2,87,69,2,1,161,0,4,165
12,6,12075,2759,3,121,128,209,3,0,461,0,22,483
12,6,12075,2760,3,19,54,11,0,1,85,0,4,89
12,6,12075,2761,3,94,158,129,3,1,385,2,17,404
12,6,12075,2762,3,32,35,12,4,2,85,0,4,89
12,6,12075,2763,3,19,126,79,2,1,227,0,0,227
12,6,12075,2764,3,38,56,83,2,2,181,0,8,189
12,6,12075,2765,3,7,56,40,3,0,106,0,5,111
12,6,12075,2766,3,38,94,121,3,0,256,0,10,266
12,6,12075,2767,3,23,52,12,0,2,89,0,3,92
12,6,12075,2768,3,9,138,80,0,0,227,0,11,238
12,6,12075,2769,3,60,357,478,5,4,904,1,29,934
12,6,12075,2770,3,8,66,53,2,0,129,0,9,138
12,6,12075,2771,3,39,357,293,6,7,702,2,24,728
12,6,12028,2785,3,0,17,35,0,0,52,0,6,58
12,7,12021,883,3,44,123,222,43,3,435,5,23,463
12,7,12021,884,3,38,118,288,53,3,500,4,17,521
12,7,12021,885,3,50,141,246,137,2,576,0,29,605
12,7,12021,886,3,73,170,248,141,9,641,2,11,654
12,7,12021,887,3,76,146,140,175,1,538,0,17,555
12,7,12021,888,3,52,142,230,105,11,540,5,19,564
12,7,12021,889,3,75,214,250,255,8,802,1,24,827
12,7,12021,890,3,46,192,152,87,2,479,1,26,506
12,7,12021,891,3,6,14,56,0,0,76,0,3,79
12,7,12021,892,3,1,24,1,0,0,26,0,0,26
12,7,12021,893,3,13,39,104,0,0,156,0,0,156
12,7,12021,894,3,54,66,58,117,7,302,0,17,319
12,7,12021,895,3,41,321,171,18,9,560,0,40,600
12,7,12021,896,3,23,100,65,7,1,196,0,11,207
12,7,12021,897,3,35,28,57,2,0,122,0,3,125
12,7,12021,898,3,15,55,114,9,2,195,0,8,203
12,7,12021,899,3,78,44,38,9,2,171,0,8,179
12,7,12021,900,3,14,53,39,8,0,114,0,8,122
12,7,12021,901,3,14,17,47,1,0,79,0,1,80
12,7,12021,902,3,26,45,83,9,0,163,2,7,172
12,7,12021,903,3,98,99,250,28,1,476,0,11,487
12,7,12021,904,3,5,14,63,6,1,89,0,0,89
12,7,12021,905,3,13,69,65,15,0,162,1,0,163
12,7,12021,906,3,8,39,24,0,1,72,0,0,72
12,7,12021,907,3,68,120,195,12,4,399,2,9,410
12,7,12021,908,3,61,76,184,14,0,335,0,0,335
12,7,12021,909,3,47,128,222,22,2,421,0,9,430
12,7,12021,910,3,17,82,168,10,3,280,0,7,287
12,7,12021,911,3,4,45,52,1,2,104,0,1,105
12,7,12021,912,3,47,51,148,35,5,286,1,12,299
12,7,12021,913,3,59,64,252,69,8,452,0,25,477
12,7,12021,914,3,13,68,180,17,0,278,0,8,286
12,7,12021,915,3,43,76,210,33,1,363,0,15,378
12,7,12021,916,3,13,24,131,8,2,178,0,0,178
12,7,12021,917,3,40,252,288,72,14,666,2,22,690
12,7,12021,918,3,33,88,134,8,0,263,1,10,274
12,7,12021,919,3,54,50,118,20,0,242,0,7,249
12,7,12021,920,3,4,47,37,22,1,111,0,9,120
12,7,12021,921,3,24,68,45,5,1,143,1,3,147
12,7,12021,922,3,37,98,186,16,1,338,0,3,341
12,7,12021,923,3,22,79,109,27,2,239,0,7,246
12,7,12021,924,3,3,9,37,2,0,51,0,4,55
12,7,12021,925,3,28,211,372,33,3,647,0,27,674
12,7,12021,926,3,75,130,306,58,6,575,1,26,602
12,7,12021,927,3,2,21,37,40,0,100,0,3,103
12,7,12021,928,3,104,104,129,79,3,419,0,14,433
12,7,12021,929,3,40,232,218,127,1,618,0,24,642
12,7,12021,930,3,6,36,56,12,0,110,0,2,112
12,7,12021,931,3,78,212,379,103,11,783,9,28,820
12,7,12021,932,3,49,175,270,64,9,567,4,13,584
12,7,12021,933,3,38,144,248,87,0,517,2,35,554
12,7,12021,934,3,21,61,126,130,0,338,0,9,347
12,7,12021,935,3,21,99,134,39,0,293,0,9,302
12,7,12021,936,3,66,312,304,23,3,708,0,11,719
12,7,12021,937,3,19,160,164,78,1,422,1,21,444
12,7,12021,938,3,6,13,25,1,0,45,0,0,45
12,7,12021,939,3,88,93,209,16,6,412,3,10,425
12,7,12021,940,3,47,96,95,36,5,279,0,0,279
12,7,12021,941,3,25,94,95,55,9,278,1,7,286
12,7,12021,942,3,27,66,182,26,7,308,5,7,320
12,7,12029,1204,3,244,641,709,115,27,1736,1,29,1766
12,7,12029,1205,3,88,317,299,29,8,741,2,11,754
12,7,12029,1206,3,97,252,268,29,8,654,0,13,667
12,7,12029,1207,3,109,223,156,15,4,507,1,10,518
12,7,12029,1208,3,155,330,295,26,13,819,2,25,846
12,7,12029,1209,3,70,229,209,16,12,536,4,24,564
12,7,12029,1210,3,133,313,320,24,14,804,1,33,838
12,7,12029,1211,3,76,210,308,29,12,635,1,18,654
12,7,12029,1212,3,168,496,433,113,12,1222,0,19,1241
12,7,12029,1213,3,294,912,1123,153,34,2516,7,48,2571
12,7,12029,1214,3,131,405,332,56,22,946,0,14,960
12,7,12029,1215,3,107,437,296,59,7,906,0,17,923
12,7,12029,1216,3,150,525,423,52,22,1172,3,11,1186
12,7,12029,1217,3,117,358,409,51,16,951,4,26,981
12,7,12029,1218,3,66,240,171,21,9,507,0,11,518
12,7,12029,1219,3,115,287,293,36,9,740,1,18,759
12,7,12029,1220,3,121,358,283,32,9,803,0,12,815
12,7,12029,1221,3,125,345,272,56,7,805,4,16,825
12,7,12029,1222,3,123,291,254,56,8,732,0,19,751
12,7,12029,1223,3,89,293,295,57,14,748,0,9,757
12,7,12029,1224,3,70,189,213,27,10,509,2,5,516
12,7,12029,1225,3,108,253,270,35,17,683,0,14,697
12,7,12029,1226,3,132,417,402,64,25,1040,2,12,1054
12,7,12029,1227,3,133,437,456,49,21,1096,2,14,1112
12,7,12029,1228,3,108,312,238,27,10,695,7,19,721
12,7,12029,1229,3,99,317,259,40,15,730,0,9,739
12,7,12029,1230,3,163,288,268,15,18,752,5,5,762
12,7,12029,1231,3,90,293,160,17,13,573,0,3,576
12,7,12029,1232,3,135,392,405,48,13,993,1,21,1015
12,7,12029,1233,3,53,176,133,12,8,382,0,15,397
12,7,12029,1234,3,99,319,272,29,9,728,2,17,747
12,7,12029,1235,3,107,307,242,20,11,687,0,20,707
12,7,12029,1236,3,87,254,252,47,18,658,0,14,672
12,7,12029,1237,3,177,522,349,66,12,1126,1,33,1160
12,7,12029,1238,3,158,381,288,58,6,891,1,17,909
12,7,12029,1239,3,78,243,199,38,13,571,0,5,576
12,7,12029,1240,3,116,361,291,41,7,816,3,12,831
12,7,12029,1241,3,114,306,303,54,15,792,0,10,802
12,7,12029,1242,3,121,380,368,32,10,911,0,24,935
12,7,12029,1243,3,125,299,223,17,13,677,6,12,695
12,7,12029,1244,3,75,298,310,38,9,730,5,22,757
12,7,12029,1245,3,47,288,269,19,8,631,2,12,645
12,7,12029,1246,3,80,179,195,32,4,490,0,11,501
12,7,12029,1247,3,105,279,280,48,13,725,0,16,741
12,7,12029,1248,3,85,279,302,29,8,703,0,11,714
12,7,12029,1249,3,94,257,257,35,16,659,5,31,695
12,7,12029,1250,3,83,302,262,55,8,710,0,16,726
12,7,12029,1251,3,145,399,306,41,11,902,1,13,916
12,7,12029,1252,3,105,257,161,31,8,562,6,6,574
12,7,12029,1253,3,45,162,98,15,8,328,1,21,350
12,7,12029,1254,3,155,463,345,47,15,1025,5,16,1046
12,7,12029,1255,3,92,272,251,38,10,663,2,14,679
12,7,12029,1256,3,66,236,211,45,10,568,3,4,575
12,7,12029,1257,3,130,547,484,62,15,1238,6,19,1263
12,7,12029,1258,3,108,370,466,92,9,1045,3,21,1069
12,7,12029,1259,3,181,366,439,40,17,1043,3,34,1080
12,7,12029,1260,3,105,345,440,45,14,949,0,11,960
12,7,12029,1261,3,128,454,327,52,11,972,1,18,991
12,7,12029,1262,3,75,260,251,31,9,626,0,12,638
12,7,12029,1263,3,136,402,404,50,21,1013,2,9,1024
12,7,12029,1264,3,85,406,368,50,7,916,5,14,935
12,7,12029,1265,3,102,322,337,37,13,811,3,36,850
12,7,12029,1266,3,143,403,430,62,14,1052,4,21,1077
12,7,12029,1267,3,177,519,556,71,24,1347,8,15,1370
12,7,12029,1268,3,110,396,246,29,15,796,1,15,812
12,7,12029,1269,3,115,472,275,33,7,902,0,8,910
12,7,12029,1270,3,109,325,278,35,14,761,3,13,777
12,7,12029,1271,3,85,265,213,40,8,611,0,9,620
12,7,12029,1273,3,38,78,66,10,1,193,0,9,202
12,7,12029,1274,3,5,76,10,1,2,94,0,4,98
12,7,12029,1275,3,1,16,40,0,0,57,0,0,57
12,7,12029,1276,3,15,167,58,5,0,245,0,18,263
12,7,12029,1277,3,22,26,13,3,1,65,0,2,67
12,7,12029,1278,3,34,136,162,25,7,364,3,10,377
12,7,12029,1279,3,146,487,379,39,12,1063,7,21,1091
12,7,12029,1280,3,79,236,244,31,5,595,0,14,609
12,7,12029,1281,3,70,309,232,24,8,643,4,20,667
12,7,12029,1282,3,32,149,140,7,4,332,1,0,333
12,7,12029,1283,3,35,101,117,5,1,259,2,4,265
12,7,12029,1284,3,20,38,58,0,0,116,0,3,119
12,7,12029,1285,3,3,108,96,0,0,207,0,4,211
12,7,12029,1286,3,128,373,455,63,7,1026,4,32,1062
12,7,12029,1287,3,50,146,190,23,2,411,0,17,428
12,7,12029,1288,3,41,241,167,40,1,490,2,24,516
12,7,12029,1289,3,77,277,249,93,3,699,2,26,727
12,7,12029,1290,3,12,33,8,1,0,54,0,1,55
12,7,12029,1291,3,29,49,40,5,1,124,0,0,124
12,7,12029,1292,3,13,82,68,3,0,166,0,3,169
12,7,12029,1293,3,10,140,14,1,0,165,0,2,167
12,7,12029,1294,3,24,319,34,1,1,379,0,6,385
12,7,12029,1295,3,233,26,40,7,3,309,0,13,322
12,7,12029,1296,3,32,187,154,31,4,408,0,15,423
12,7,12029,1297,3,37,97,96,1,0,231,0,5,236
12,7,12029,1298,3,4,64,36,0,0,104,0,1,105
12,7,12029,1299,3,12,104,47,9,0,172,2,5,179
12,7,12029,1300,3,51,180,126,15,5,377,3,12,392
12,7,12029,1301,3,84,214,211,18,5,532,0,7,539
12,7,12029,1302,3,148,252,203,56,5,664,0,26,690
12,7,12029,1303,3,89,242,202,37,10,580,13,17,610
12,7,12029,1304,3,60,182,157,48,14,461,4,12,477
12,7,12029,1305,3,75,139,120,17,3,354,0,12,366
12,7,12029,1306,3,4,35,58,0,9,106,0,1,107
12,7,12029,1307,3,137,229,205,92,36,699,12,31,742
12,7,12029,1308,3,24,99,76,17,11,227,1,10,238
12,7,12045,1764,3,81,178,120,22,5,406,2,17,425
12,7,12045,1765,3,80,107,134,35,2,358,6,16,380
12,7,12045,1766,3,77,166,79,29,7,358,1,22,381
12,7,12045,1767,3,101,197,210,59,2,569,3,30,602
12,7,12045,1768,3,15,54,84,9,2,164,0,17,181
12,7,12045,1769,3,107,73,93,6,0,279,1,8,288
12,7,12045,1770,3,33,44,146,5,3,231,0,8,239
12,7,12045,1771,3,8,20,63,21,0,112,0,6,118
12,7,12045,1772,3,11,42,34,1,0,88,0,2,90
12,7,12045,1773,3,16,68,33,0,0,117,0,5,122
12,7,12045,1774,3,2,71,21,1,0,95,0,1,96
12,7,12045,1775,3,2,126,148,6,1,283,0,7,290
12,7,12045,1776,3,21,117,88,5,0,231,0,3,234
12,7,12045,1777,3,6,56,10,1,0,73,0,2,75
12,7,12045,1778,3,3,16,6,1,0,26,0,2,28
12,7,12045,1780,3,4,11,21,0,0,36,0,2,38
12,7,12045,1781,3,8,25,10,0,0,43,0,2,45
12,7,12045,1783,3,1,16,15,0,0,32,0,0,32
12,7,12052,1973,3,59,127,148,24,4,362,0,8,370
12,7,12052,1974,3,42,128,126,9,0,305,1,8,314
12,7,12052,1975,3,70,205,122,17,3,417,1,13,431
12,7,12052,1976,3,110,201,200,28,5,544,1,19,564
12,7,12052,1977,3,0,5,159,0,1,165,1,0,166
12,7,12052,1978,3,21,46,182,1,3,253,0,16,269
12,7,12052,1979,3,33,98,83,0,6,220,0,13,233
12,7,12052,1980,3,48,109,108,11,2,278,0,1,279
12,7,12052,1981,3,43,26,27,1,2,99,0,6,105
12,7,12052,1982,3,6,36,91,2,2,137,0,1,138
12,7,12052,1983,3,60,34,105,1,0,200,1,6,207
12,7,12052,1984,3,93,118,249,28,5,493,2,22,517
12,7,12052,1985,3,93,70,170,12,6,351,5,16,372
12,7,12052,1986,3,45,92,75,4,18,234,1,25,260
12,7,12052,1987,3,12,17,19,2,0,50,0,0,50
12,7,12052,1988,3,40,14,75,1,0,130,0,8,138
12,7,12052,1989,3,42,32,82,2,1,159,0,7,166
12,7,12052,1990,3,5,15,76,2,0,98,0,4,102
12,7,12052,1991,3,47,84,313,3,4,451,0,11,462
12,7,12052,1992,3,10,1,21,1,1,34,0,8,42
12,7,12052,1993,3,44,23,92,0,3,162,1,11,174
12,7,12052,1994,3,14,32,28,1,1,76,0,5,81
12,7,12052,1995,3,37,128,129,1,1,296,0,4,300
12,7,12052,1996,3,93,15,29,0,1,138,1,3,142
12,7,12052,1997,3,5,6,115,2,1,129,0,3,132
12,7,12052,1998,3,8,18,85,0,1,112,0,5,117
12,7,12052,1999,3,6,38,95,2,3,144,0,3,147
12,7,12052,2000,3,14,44,110,7,2,177,0,0,177
12,7,12052,2001,3,17,35,102,2,1,157,0,5,162
12,7,12052,2002,3,9,101,68,7,0,185,0,0,185
12,7,12052,2003,3,4,21,138,4,1,168,0,8,176
12,7,12052,2004,3,20,5,27,0,0,52,0,4,56
12,7,12052,2005,3,3,3,71,0,0,77,0,3,80
12,7,12052,2006,3,9,12,58,0,0,79,0,7,86
12,7,12052,2007,3,15,11,114,0,0,140,0,6,146
12,7,12052,2008,3,15,11,105,0,0,131,0,5,136
12,7,12052,2009,3,2,10,58,1,0,71,0,1,72
12,7,12052,2010,3,4,3,93,3,0,103,0,4,107
12,7,12052,2011,3,1,7,83,0,0,91,0,0,91
12,7,12052,2012,3,16,87,66,1,1,171,0,4,175
12,7,12052,2013,3,9,26,98,0,0,133,0,6,139
12,7,12052,2014,3,12,34,123,1,1,171,0,16,187
12,7,12062,2479,3,48,136,219,110,6,519,0,15,534
12,7,12062,2480,3,58,210,283,119,13,683,1,18,702
12,7,12062,2481,3,75,220,457,117,15,884,4,20,908
12,7,12062,2482,3,37,94,157,79,7,374,0,12,386
12,7,12062,2483,3,51,179,236,82,4,552,3,20,575
12,7,12062,2484,3,58,156,201,112,8,535,3,14,552
12,7,12062,2485,3,66,166,281,152,10,675,5,21,701
12,7,12062,2486,3,50,156,214,114,7,541,1,13,555
12,7,12062,2487,3,23,150,199,83,3,458,0,9,467
12,7,12062,2488,3,33,96,191,68,7,395,2,5,402
12,7,12062,2489,3,51,102,296,82,6,537,4,4,545
12,7,12062,2490,3,46,110,232,88,8,484,0,14,498
12,7,12062,2491,3,44,141,151,62,7,405,0,18,423
12,7,12062,2492,3,55,258,169,29,3,514,2,21,537
12,7,12062,2493,3,37,127,171,20,6,361,3,31,395
12,7,12062,2494,3,37,96,234,19,0,386,4,44,434
12,7,12062,2495,3,40,42,48,12,1,143,1,13,157
12,7,12062,2496,3,47,68,45,13,1,174,1,10,185
12,7,12062,2497,3,47,133,60,74,2,316,1,15,332
12,7,12062,2499,3,19,34,84,7,0,144,0,7,151
12,7,12062,2500,3,18,21,25,7,1,72,0,2,74
12,7,12062,2501,3,4,30,30,1,0,65,0,0,65
12,7,12062,2502,3,23,44,33,31,4,135,0,8,143
12,7,12062,2503,3,7,36,18,3,0,64,2,0,66
12,7,12062,2504,3,47,37,102,13,3,202,7,17,226
12,7,12062,2505,3,44,43,83,5,1,176,0,46,222
12,7,12062,2506,3,7,40,44,2,0,93,0,7,100
12,7,12062,2507,3,9,20,52,8,0,89,0,10,99
12,7,12062,2508,3,7,38,58,3,0,106,0,9,115
12,8,12012,671,3,29,130,553,49,6,767,1,36,804
12,8,12012,672,3,14,42,310,51,1,418,0,22,440
12,8,12012,673,3,13,89,193,37,1,333,2,5,340
12,8,12012,674,3,48,207,736,86,10,1087,0,54,1141
12,8,12012,675,3,36,55,419,36,3,549,0,17,566
12,8,12012,676,3,2,46,22,0,0,70,0,2,72
12,8,12012,677,3,2,38,19,0,0,59,0,6,65
12,8,12012,678,3,0,14,72,1,0,87,0,4,91
12,8,12012,679,3,7,87,117,2,1,214,0,6,220
12,8,12012,680,3,1,90,82,1,1,175,0,31,206
12,8,12012,681,3,7,82,57,4,1,151,0,20,171
12,8,12012,682,3,3,19,68,1,0,91,0,5,96
12,8,12012,683,3,11,115,102,10,2,240,0,30,270
12,8,12012,684,3,11,83,336,12,0,442,0,22,464
12,8,12012,685,3,5,39,37,0,0,81,0,5,86
12,8,12012,686,3,0,62,32,2,1,97,0,2,99
12,8,12012,687,3,4,73,26,10,3,116,0,9,125
12,8,12012,688,3,5,31,38,2,0,76,0,3,79
12,8,12012,689,3,2,42,82,3,0,129,0,5,134
12,8,12012,690,3,1,9,28,3,1,42,0,3,45
12,8,12012,691,3,0,11,53,0,0,64,0,4,68
12,8,12012,692,3,17,36,228,18,2,301,0,24,325
12,8,12012,693,3,10,25,68,1,2,106,0,9,115
12,8,12012,694,3,26,60,152,17,2,257,0,14,271
12,8,12012,695,3,4,10,105,0,1,120,0,8,128
12,8,12012,696,3,3,51,23,1,1,79,0,5,84
12,8,12012,697,3,7,12,116,1,0,136,0,4,140
12,8,12012,698,3,0,1,34,0,1,36,0,2,38
12,8,12012,699,3,1,11,74,0,0,86,0,10,96
12,8,12012,700,3,1,7,85,0,0,93,0,14,107
12,8,12012,701,3,6,18,89,6,0,119,0,7,126
12,8,12012,702,3,2,59,38,2,2,103,2,4,109
12,8,12012,703,3,5,66,132,6,2,211,0,6,217
12,8,12012,704,3,2,29,24,2,0,57,0,6,63
12,8,12012,705,3,8,26,128,4,1,167,0,15,182
12,8,12012,706,3,3,5,85,0,1,94,0,9,103
12,8,12012,707,3,8,25,197,0,3,233,0,19,252
12,8,12012,708,3,4,22,32,0,1,59,0,9,68
12,8,12012,709,3,2,2,124,0,0,128,0,8,136
12,8,12012,710,3,8,22,120,5,1,156,0,9,165
12,8,12012,711,3,15,27,220,93,1,356,0,49,405
12,8,12012,712,3,4,17,145,3,0,169,0,0,169
12,8,12012,713,3,2,37,55,10,1,105,0,10,115
12,8,12012,714,3,7,59,177,15,1,259,0,9,268
12,8,12012,715,3,3,20,71,3,0,97,0,1,98
12,8,12012,716,3,0,16,33,0,0,49,0,2,51
12,8,12012,717,3,3,27,107,3,1,141,0,6,147
12,8,12012,718,3,5,7,182,3,1,198,2,7,207
12,8,12012,719,3,11,89,154,56,2,312,0,13,325
12,8,12012,720,3,7,67,199,7,2,282,1,15,298
12,8,12012,721,3,9,27,60,0,0,96,0,3,99
12,8,12012,722,3,2,17,52,1,0,72,0,3,75
12,8,12012,723,3,0,2,67,2,2,73,0,4,77
12,8,12012,724,3,5,34,28,39,1,107,0,10,117
12,8,12013,725,3,13,189,177,27,5,411,0,12,423
12,8,12013,726,3,19,218,357,37,6,637,1,26,664
12,8,12013,727,3,6,199,305,34,3,547,1,15,563
12,8,12013,728,3,7,221,344,4,0,576,0,11,587
12,8,12013,729,3,2,25,152,4,0,183,0,7,190
12,8,12013,730,3,19,163,268,25,3,478,0,23,501
12,8,12013,731,3,8,85,118,1,0,212,0,11,223
12,8,12013,732,3,53,152,228,3,6,442,1,4,447
12,8,12013,733,3,5,34,100,2,0,141,2,0,143
12,8,12013,734,3,5,84,93,2,0,184,0,7,191
12,8,12013,735,3,0,30,60,9,1,100,0,0,100
12,8,12013,736,3,10,43,56,3,1,113,0,10,123
12,8,12013,737,3,3,93,136,2,1,235,1,8,244
12,8,12013,738,3,8,63,68,10,6,155,2,6,163
12,8,12013,739,3,1,32,32,0,1,66,0,2,68
12,8,12013,740,3,4,39,89,3,0,135,0,5,140
12,8,12013,741,3,16,282,139,8,3,448,1,48,497
12,8,12013,742,3,16,160,178,16,3,373,0,36,409
12,8,12013,743,3,9,55,216,16,0,296,1,24,321
12,8,12013,744,3,13,90,160,15,2,280,0,27,307
12,8,12013,745,3,17,72,128,3,2,222,0,19,241
12,8,12013,746,3,9,74,200,41,3,327,0,29,356
12,8,12013,747,3,8,56,123,5,1,193,0,0,193
12,8,12013,748,3,10,27,125,2,4,168,1,9,178
12,8,12013,749,3,0,9,45,0,1,55,0,0,55
12,8,12013,750,3,5,25,44,0,0,74,0,4,78
12,8,12013,751,3,4,55,31,1,1,92,0,4,96
12,8,12013,752,3,23,135,353,31,3,545,1,13,559
12,8,12013,753,3,23,102,313,33,0,471,3,19,493
12,8,12013,754,3,18,158,236,53,2,467,0,16,483
12,8,12013,755,3,24,78,176,32,3,313,0,18,331
12,8,12013,756,3,18,105,188,19,1,331,0,7,338
12,8,12013,758,3,5,32,53,5,1,96,0,0,96
12,8,12013,759,3,10,48,38,21,1,118,0,9,127
12,8,12013,760,3,3,28,26,1,0,58,0,0,58
12,8,12013,761,3,3,44,18,1,1,67,0,6,73
12,8,12013,762,3,13,61,119,21,0,214,0,0,214
12,8,12018,844,3,25,170,221,48,3,467,1,17,485
12,8,12018,845,3,11,95,109,20,1,236,3,9,248
12,8,12018,846,3,14,126,181,32,3,356,1,26,383
12,8,12018,847,3,66,138,173,22,4,403,0,15,418
12,8,12018,848,3,25,82,55,8,3,173,1,13,187
12,8,12018,849,3,12,58,113,6,1,190,2,6,198
12,8,12018,850,3,8,47,169,16,1,241,0,17,258
12,8,12018,851,3,9,25,53,0,0,87,0,1,88
12,8,12018,852,3,7,25,36,1,2,71,0,4,75
12,8,12018,853,3,12,38,91,19,1,161,0,12,173
12,8,12018,854,3,8,41,58,0,0,107,1,1,109
12,8,12018,855,3,20,67,83,8,0,178,0,0,178
12,8,12018,856,3,37,104,272,19,7,439,0,22,461
12,8,12018,857,3,20,67,83,8,0,178,1,5,184
12,8,12023,1001,3,30,103,194,14,4,345,1,9,355
12,8,12023,1002,3,23,110,232,18,7,390,2,6,398
12,8,12023,1003,3,26,99,171,22,4,322,2,18,342
12,8,12023,1004,3,29,79,192,32,2,334,0,8,342
12,8,12023,1005,3,15,120,115,12,1,263,0,6,269
12,8,12023,1006,3,78,196,410,50,13,747,1,8,756
12,8,12023,1007,3,20,86,194,36,1,337,0,11,348
12,8,12023,1008,3,18,24,134,7,2,185,2,2,189
12,8,12023,1009,3,2,17,36,5,1,61,0,2,63
12,8,12023,1010,3,16,66,94,14,0,190,1,7,198
12,8,12023,1011,3,7,27,31,2,2,69,0,3,72
12,8,12023,1012,3,1,106,88,13,0,208,0,14,222
12,8,12023,1013,3,24,100,207,8,2,341,0,18,359
12,8,12023,1014,3,20,147,227,3,4,401,0,11,412
12,8,12023,1015,3,3,50,105,21,2,181,0,9,190
12,8,12023,1016,3,17,91,124,0,1,233,0,7,240
12,8,12023,1017,3,3,112,92,0,0,207,1,7,215
12,8,12023,1018,3,6,13,93,5,2,119,1,7,127
12,8,12023,1019,3,16,71,72,2,1,162,0,11,173
12,8,12023,1020,3,18,113,112,5,1,249,0,6,255
12,8,12023,1021,3,2,14,17,0,0,33,0,1,34
12,8,12023,1022,3,14,111,54,17,3,199,0,13,212
12,8,12023,1023,3,23,85,133,4,0,245,0,2,247
12,8,12023,1024,3,18,51,92,5,2,168,0,2,170
12,8,12023,1025,3,16,61,117,0,0,194,0,11,205
12,8,12023,1026,3,35,17,89,0,0,141,0,2,143
12,8,12023,1027,3,6,168,87,5,1,267,0,0,267
12,8,12023,1028,3,6,24,50,0,0,80,0,3,83
12,8,12023,1029,3,15,115,74,7,1,212,4,5,221
12,8,12025,1037,3,55,201,228,25,1,510,0,9,519
12,8,12025,1038,3,17,288,296,32,3,636,0,18,654
12,8,12025,1039,3,22,122,245,7,7,403,0,11,414
12,8,12025,1040,3,6,208,131,2,0,347,0,6,353
12,8,12025,1041,3,3,42,123,3,0,171,0,2,173
12,8,12025,1042,3,7,77,186,1,3,274,0,7,281
12,8,12025,1043,3,3,19,89,3,1,115,0,6,121
12,8,12025,1044,3,4,125,135,2,2,268,0,10,278
12,8,12025,1045,3,6,202,222,24,2,456,0,17,473
12,8,12025,1046,3,4,77,90,1,2,174,0,0,174
12,8,12025,1047,3,13,84,145,2,1,245,0,1,246
12,8,12025,1048,3,7,174,220,16,3,420,0,13,433
12,8,12025,1049,3,8,91,120,6,2,227,0,8,235
12,8,12031,1339,3,67,199,358,143,2,769,0,18,787
12,8,12031,1340,3,9,55,96,59,0,219,0,6,225
12,8,12031,1341,3,26,136,171,61,2,396,0,4,400
12,8,12031,1342,3,78,272,481,275,10,1116,0,52,1168
12,8,12031,1343,3,4,43,17,9,0,73,0,0,73
12,8,12031,1344,3,24,83,128,77,0,312,1,19,332
12,8,12031,1345,3,11,73,91,19,0,194,0,5,199
12,8,12031,1346,3,21,114,54,16,1,206,0,3,209
12,8,12031,1347,3,15,66,155,27,1,264,2,0,266
12,8,12031,1348,3,0,52,30,13,0,95,0,0,95
12,8,12031,1349,3,10,29,76,24,0,139,0,5,144
12,8,12031,1350,3,2,24,28,23,0,77,0,0,77
12,8,12031,1351,3,0,39,25,12,0,76,0,5,81
12,8,12031,1352,3,3,70,110,4,0,187,0,4,191
12,8,12031,1353,3,0,59,103,13,0,175,0,2,177
12,8,12031,1354,3,6,17,51,1,0,75,1,2,78
12,8,12031,1355,3,5,58,110,28,0,201,0,1,202
12,8,12031,1356,3,12,60,75,73,0,220,0,6,226
12,8,12031,1357,3,7,44,97,6,0,154,0,0,154
12,8,12040,1654,3,48,150,230,21,5,454,4,13,471
12,8,12040,1655,3,40,79,203,22,4,348,2,20,370
12,8,12040,1656,3,91,220,464,39,6,820,7,20,847
12,8,12040,1657,3,35,132,276,11,4,458,1,11,470
12,8,12040,1658,3,34,87,138,11,4,274,0,9,283
12,8,12040,1659,3,38,119,199,19,4,379,1,9,389
12,8,12040,1660,3,28,101,157,25,2,313,1,16,330
12,8,12040,1661,3,48,102,238,16,4,408,0,14,422
12,8,12040,1662,3,16,70,107,1,1,195,0,5,200
12,8,12040,1663,3,17,102,93,1,1,214,0,4,218
12,8,12040,1664,3,6,84,64,0,1,155,1,7,163
12,8,12040,1665,3,46,101,142,7,6,302,2,15,319
12,8,12040,1666,3,13,150,120,1,0,284,1,1,286
12,8,12040,1667,3,7,172,167,10,1,357,0,4,361
12,8,12040,1668,3,5,40,94,7,0,146,3,5,154
12,8,12040,1669,3,18,30,65,0,0,113,0,6,119
12,8,12040,1670,3,12,62,88,5,2,169,0,6,175
12,8,12040,1671,3,3,24,31,1,0,59,0,2,61
12,8,12040,1672,3,14,22,49,5,2,92,0,3,95
12,8,12040,1673,3,14,11,38,2,0,65,0,2,67
12,8,12040,1674,3,46,180,287,16,0,529,1,17,547
12,8,12040,1675,3,6,56,50,2,0,114,0,1,115
12,8,12040,1676,3,42,246,261,4,6,559,0,20,579
12,8,12047,1809,3,83,499,690,62,18,1352,1,50,1403
12,8,12047,1810,3,31,251,359,19,6,666,0,48,714
12,8,12047,1811,3,76,378,451,43,10,958,6,34,998
12,8,12047,1812,3,37,220,346,30,4,637,3,20,660
12,8,12047,1813,3,49,455,463,47,14,1028,5,25,1058
12,8,12047,1814,3,35,292,244,14,5,590,2,26,618
12,8,12047,1815,3,36,174,173,20,5,408,2,13,423
12,8,12047,1816,3,35,226,287,24,4,576,5,0,581
12,8,12047,1817,3,10,310,448,7,0,775,0,25,800
12,8,12047,1818,3,26,322,151,4,0,503,0,28,531
12,8,12047,1819,3,21,424,363,3,2,813,0,55,868
12,8,12047,1820,3,17,283,141,3,6,450,0,24,474
12,8,12047,1821,3,43,402,442,12,1,900,2,23,925
12,8,12047,1822,3,14,119,162,8,0,303,2,12,317
12,8,12047,1823,3,9,69,122,8,3,211,0,4,215
12,8,12047,1824,3,38,485,628,39,3,1193,13,43,1249
12,8,12047,1825,3,3,33,69,1,2,108,0,3,111
12,8,12047,1826,3,6,170,110,0,0,286,0,13,299
12,8,12047,1827,3,12,45,42,3,0,102,0,7,109
12,8,12047,1828,3,11,90,193,3,2,299,0,6,305
12,8,12047,1829,3,5,139,54,0,3,201,1,8,210
12,8,12047,1830,3,35,423,356,5,3,822,2,42,866
12,8,12047,1831,3,1,54,6,1,1,63,0,1,64
12,8,12047,1832,3,5,80,70,0,1,156,0,6,162
12,8,12047,1833,3,15,112,179,0,0,306,0,7,313
12,8,12047,1834,3,10,63,22,3,0,98,0,3,101
12,8,12047,1835,3,9,22,15,0,0,46,0,1,47
12,8,12047,1836,3,4,53,30,0,1,88,0,4,92
12,8,12047,1837,3,11,87,82,1,1,182,0,6,188
12,8,12047,1838,3,7,93,120,2,3,225,0,6,231
12,8,12047,1839,3,8,131,153,0,0,292,0,14,306
12,8,12047,1840,3,10,391,469,6,2,878,0,3,881
12,8,12047,1841,3,8,61,53,1,0,123,0,4,127
12,8,12047,1842,3,5,47,55,0,0,107,0,2,109
12,8,12047,1843,3,9,59,82,1,1,152,2,2,156
12,8,12047,1844,3,1,31,24,0,1,57,0,0,57
12,8,12047,1845,3,5,67,89,3,2,166,0,7,173
12,8,12047,1846,3,6,73,54,2,0,135,0,7,142
12,8,12054,2041,3,85,116,69,8,5,283,0,14,297
12,8,12054,2042,3,66,62,77,10,1,216,0,4,220
12,8,12054,2043,3,36,82,136,10,3,267,0,16,283
12,8,12054,2044,3,62,171,119,15,0,367,0,19,386
12,8,12054,2045,3,99,112,118,32,1,362,0,10,372
12,8,12054,2046,3,125,175,117,19,2,438,1,19,458
12,8,12054,2047,3,133,99,119,17,2,370,0,11,381
12,8,12054,2048,3,142,91,123,28,0,384,0,10,394
12,8,12054,2049,3,112,72,155,21,2,362,0,14,376
12,8,12054,2050,3,91,127,136,26,3,383,0,11,394
12,8,12054,2051,3,2,30,3,0,0,35,0,1,36
12,8,12054,2052,3,60,189,404,13,5,671,2,15,688
12,8,12054,2053,3,46,63,63,1,2,175,0,5,180
12,8,12054,2054,3,16,73,179,1,1,270,0,12,282
12,8,12054,2055,3,5,16,69,2,7,99,0,5,104
12,8,12054,2056,3,2,82,88,0,2,174,0,6,180
12,8,12054,2057,3,29,130,197,6,1,363,0,17,380
12,8,12054,2058,3,11,23,103,0,0,137,2,5,144
12,8,12054,2059,3,62,97,87,1,4,251,0,11,262
12,8,12054,2060,3,32,71,93,5,4,205,0,8,213
12,8,12054,2061,3,32,198,75,5,0,310,0,5,315
12,8,12054,2062,3,4,60,32,2,0,98,0,2,100
12,8,12054,2063,3,5,80,72,0,0,157,0,0,157
12,8,12054,2064,3,2,49,20,5,0,76,0,1,77
12,8,12054,2065,3,29,84,59,0,0,172,0,31,203
12,8,12054,2066,3,13,35,10,2,0,60,0,3,63
12,8,12054,2067,3,12,85,72,3,0,172,0,10,182
12,8,12054,2068,3,22,52,113,0,1,188,0,11,199
12,8,12054,2069,3,3,96,113,2,1,215,2,17,234
12,8,12054,2070,3,6,47,84,8,2,147,0,4,151
12,8,12054,2071,3,36,132,198,8,3,377,1,9,387
12,8,12054,2072,3,25,66,66,3,4,164,1,5,170
12,8,12054,2073,3,28,127,149,12,3,319,1,10,330
12,8,12054,2074,3,32,139,217,26,5,419,1,8,428
12,8,12054,2075,3,15,79,199,24,2,319,0,12,331
12,8,12054,2076,3,39,145,340,12,1,537,1,11,549
12,8,12054,2077,3,22,42,102,1,2,169,1,2,172
12,8,12054,2078,3,21,61,60,5,1,148,0,5,153
12,8,12054,2079,3,11,34,46,9,2,102,1,3,106
12,8,12054,2080,3,42,106,218,5,1,372,0,21,393
12,8,12054,2082,3,7,18,11,2,0,38,0,4,42
12,8,12054,2083,3,18,106,144,0,3,271,0,0,271
12,8,12054,2084,3,19,72,166,1,0,258,0,25,283
12,8,12054,2085,3,2,16,11,0,0,29,1,0,30
12,8,12054,2086,3,25,78,29,2,1,135,0,3,138
12,8,12054,2087,3,4,47,25,0,0,76,0,2,78
12,8,12054,2088,3,4,57,16,2,0,79,0,1,80
12,8,12054,2089,3,10,58,90,19,5,182,0,14,196
12,8,12054,2090,3,6,51,149,9,0,215,0,11,226
12,8,12054,2091,3,10,102,66,0,0,178,0,3,181
12,8,12057,2223,3,57,175,292,98,11,633,0,18,651
12,8,12057,2224,3,31,95,346,96,8,576,1,15,592
12,8,12057,2225,3,9,10,55,9,3,86,2,2,90
12,8,12057,2226,3,25,70,74,2,1,172,0,6,178
12,8,12057,2227,3,20,60,77,15,4,176,0,6,182
12,8,12057,2228,3,18,65,50,3,3,139,0,11,150
12,8,12057,2229,3,17,18,98,4,0,137,0,3,140
12,8,12057,2230,3,7,16,68,2,1,94,0,3,97
12,8,12057,2231,3,15,37,133,9,2,196,0,11,207
12,8,12057,2232,3,11,47,178,19,4,259,3,8,270
12,8,12057,2233,3,97,85,143,18,3,346,1,23,370
12,8,12057,2234,3,13,16,216,3,5,253,0,12,265
12,8,12057,2235,3,22,86,151,5,2,266,0,9,275
12,8,12057,2236,3,16,43,110,23,2,194,0,14,208
12,8,12057,2237,3,14,160,236,5,2,417,1,16,434
12,8,12057,2238,3,69,48,411,19,6,553,0,17,570
12,8,12057,2239,3,19,49,258,21,2,349,0,17,366
12,8,12057,2240,3,35,131,126,19,7,318,0,20,338
12,8,12057,2241,3,12,128,189,15,0,344,1,20,365
12,8,12057,2242,3,15,109,152,18,3,297,0,18,315
12,8,12057,2243,3,2,13,140,30,2,187,0,8,195
12,8,12057,2244,3,49,85,291,13,2,440,10,3,453
12,8,12057,2245,3,11,64,49,34,1,159,0,10,169
12,8,12057,2246,3,4,20,100,20,0,144,0,7,151
12,8,12057,2247,3,29,69,125,6,1,230,0,15,245
12,8,12057,2248,3,29,35,169,2,3,238,1,14,253
12,8,12057,2249,3,64,62,54,1,1,182,0,10,192
12,8,12057,2250,3,10,68,115,10,2,205,0,8,213
12,8,12057,2251,3,3,15,80,1,0,99,0,4,103
12,8,12057,2252,3,8,34,119,4,1,166,0,0,166
12,8,12057,2253,3,3,21,68,1,11,104,0,8,112
12,8,12057,2254,3,14,19,104,0,1,138,0,12,150
12,8,12057,2255,3,9,27,76,11,11,134,0,4,138
12,8,12057,2256,3,4,20,68,9,1,102,0,1,103
12,8,12057,2257,3,19,46,125,6,2,198,0,0,198
12,8,12057,2258,3,8,29,61,2,0,100,0,2,102
12,8,12057,2259,3,7,24,85,4,2,122,0,4,126
12,8,12057,2260,3,15,26,67,9,0,117,0,7,124
12,8,12057,2261,3,0,16,20,1,0,37,0,3,40
12,8,12040,2784,3,8,73,241,1,1,324,1,4,329
12,9,12001,115,3,60,137,236,13,2,448,2,10,460
12,9,12001,116,3,122,154,325,31,9,641,4,31,676
12,9,12001,117,3,154,150,411,41,8,764,4,29,797
12,9,12001,118,3,123,130,386,59,14,712,8,31,751
12,9,12001,119,3,145,143,436,51,8,783,6,19,808
12,9,12001,129,3,75,134,337,22,8,576,2,16,594
12,9,12001,130,3,119,152,302,33,10,616,4,9,629
12,9,12001,131,3,101,95,244,39,7,486,8,4,498
12,9,12001,132,3,133,175,351,51,15,725,3,23,751
12,9,12001,133,3,110,131,355,32,15,643,2,13,658
12,9,12001,134,3,179,252,518,70,29,1048,10,31,1089
12,9,12001,135,3,87,132,273,47,6,545,4,40,589
12,9,12001,136,3,123,213,508,82,19,945,8,32,985
12,9,12001,137,3,85,138,268,44,11,546,1,24,571
12,9,12001,138,3,273,250,666,88,21,1298,8,36,1342
12,9,12001,139,3,110,170,300,50,16,646,3,19,668
12,9,12001,140,3,70,157,236,25,15,503,6,14,523
12,9,12001,141,3,115,218,381,54,20,788,18,24,830
12,9,12001,142,3,87,167,368,72,11,705,2,26,733
12,9,12001,145,3,60,77,295,48,5,485,2,27,514
12,9,12001,146,3,135,147,417,32,9,740,7,26,773
12,9,12001,147,3,128,186,413,29,15,771,9,24,804
12,9,12001,148,3,134,199,424,55,13,825,10,32,867
12,9,12001,149,3,154,215,474,72,10,925,5,36,966
12,9,12001,150,3,138,136,308,59,19,660,11,15,686
12,9,12001,151,3,102,106,332,47,10,597,4,15,616
12,9,12001,152,3,79,116,315,27,14,551,5,19,575
12,9,12001,153,3,75,124,414,31,14,658,10,20,688
12,9,12001,154,3,91,135,323,31,20,600,4,26,630
12,9,12001,155,3,76,124,351,45,21,617,12,25,654
12,9,12001,156,3,128,135,342,46,13,664,8,16,688
12,9,12001,157,3,115,123,392,41,30,701,9,16,726
12,9,12001,158,3,97,115,310,92,16,630,3,44,677
12,9,12001,159,3,98,124,352,53,8,635,6,21,662
12,9,12001,160,3,204,256,579,120,23,1182,7,31,1220
12,9,12001,161,3,107,144,365,50,15,681,10,36,727
12,9,12001,162,3,91,116,352,21,15,595,4,29,628
12,9,12001,172,3,90,97,312,36,19,554,8,9,571
12,9,12001,173,3,96,127,340,59,14,636,7,13,656
12,9,12001,174,3,114,135,339,48,16,652,3,31,686
12,9,12001,175,3,110,145,290,53,17,615,6,19,640
12,9,12001,176,3,139,129,359,72,17,716,9,20,745
12,9,12001,177,3,126,151,348,67,19,711,11,24,746
12,9,12001,178,3,115,157,346,49,15,682,9,32,723
12,9,12001,179,3,96,195,458,44,21,814,7,50,871
12,9,12001,180,3,155,260,631,121,22,1189,5,46,1240
12,9,12001,181,3,93,101,278,26,19,517,3,6,526
12,9,12001,182,3,61,144,308,35,14,562,4,21,587
12,9,12001,183,3,93,146,297,52,20,608,0,33,641
12,9,12001,184,3,107,144,335,42,13,641,4,25,670
12,9,12001,185,3,164,183,406,57,18,828,4,36,868
12,9,12001,186,3,82,97,284,67,18,548,4,9,561
12,9,12001,201,3,77,93,248,47,10,475,3,9,487
12,9,12001,202,3,109,140,373,105,11,738,1,35,774
12,9,12001,203,3,82,89,277,116,11,575,2,16,593
12,9,12001,204,3,84,184,457,69,17,811,3,21,835
12,9,12001,205,3,73,111,249,39,9,481,5,17,503
12,9,12001,206,3,72,154,235,25,16,502,4,18,524
12,9,12001,207,3,69,169,244,23,2,507,4,15,526
12,9,12001,208,3,55,484,306,61,12,918,7,34,959
12,9,12001,209,3,77,297,284,31,7,696,2,22,720
12,9,12001,210,3,67,215,480,40,14,816,4,37,857
12,9,12001,211,3,45,85,205,15,6,356,0,13,369
12,9,12001,212,3,91,155,421,28,11,706,7,20,733
12,9,12001,213,3,51,94,188,21,115,469,7,14,490
12,9,12001,214,3,81,127,349,46,10,613,1,19,633
12,9,12001,215,3,128,148,361,67,18,722,5,27,754
12,9,12001,216,3,135,137,474,53,15,814,2,25,841
12,9,12001,217,3,175,219,521,88,30,1033,12,20,1065
12,9,12001,243,3,163,211,625,95,32,1126,2,35,1163
12,9,12001,244,3,145,176,462,63,19,865,3,30,898
12,9,12001,245,3,116,206,558,37,16,933,8,27,968
12,9,12001,246,3,63,191,326,33,7,620,5,24,649
12,9,12001,247,3,82,148,325,25,12,592,6,42,640
12,9,12001,262,3,244,232,552,117,40,1185,4,40,1229
12,9,12001,263,3,171,189,352,74,17,803,5,29,837
12,9,12001,264,3,74,143,269,20,13,519,1,14,534
12,9,12001,265,3,134,178,408,42,15,777,2,31,810
12,9,12001,266,3,97,206,444,43,13,803,5,35,843
12,9,12001,267,3,85,144,353,30,12,624,3,28,655
12,9,12001,268,3,143,131,263,39,11,587,0,14,601
12,9,12001,269,3,211,101,204,47,32,595,1,23,619
12,9,12001,278,3,315,162,414,81,29,1001,5,37,1043
12,9,12001,279,3,346,437,668,188,22,1661,9,44,1714
12,9,12001,280,3,109,144,260,26,11,550,4,17,571
12,9,12001,281,3,68,140,199,23,10,440,5,21,466
12,9,12001,282,3,105,113,227,44,16,505,0,0,505
12,9,12001,283,3,86,64,125,32,9,316,2,6,324
12,9,12001,284,3,128,194,465,70,35,892,18,12,922
12,9,12001,285,3,167,102,359,50,16,694,9,18,721
12,9,12001,286,3,367,171,229,77,32,876,1,18,895
12,9,12001,287,3,317,113,164,41,15,650,3,10,663
12,9,12001,288,3,199,104,111,41,19,474,1,9,484
12,9,12001,289,3,319,119,132,73,17,660,3,9,672
12,9,12001,290,3,80,100,218,46,19,463,4,20,487
12,9,12001,291,3,132,163,234,40,21,590,3,17,610
12,9,12001,292,3,141,173,270,61,16,661,1,9,671
12,9,12001,293,3,151,133,258,53,20,615,2,13,630
12,9,12001,294,3,119,231,451,53,11,865,1,28,894
12,9,12001,295,3,278,243,684,117,43,1365,8,44,1417
12,9,12001,296,3,152,140,371,49,25,737,6,23,766
12,9,12001,297,3,206,256,681,61,45,1249,9,16,1274
12,9,12001,298,3,287,233,397,81,26,1024,10,27,1061
12,9,12001,299,3,216,218,364,73,21,892,2,35,929
12,9,12001,300,3,264,302,568,104,22,1260,1,45,1306
12,9,12001,301,3,395,428,1128,161,65,2177,12,42,2231
12,9,12001,302,3,232,107,148,31,15,533,1,19,553
12,9,12001,304,3,202,334,380,83,22,1021,9,27,1057
12,9,12001,305,3,140,122,356,37,9,664,14,23,701
12,9,12001,306,3,245,195,541,57,30,1068,6,27,1101
12,9,12001,307,3,289,211,974,94,29,1597,14,45,1656
12,9,12001,308,3,193,230,254,30,42,749,5,26,780
12,9,12001,309,3,38,24,71,11,4,148,0,9,157
12,9,12001,310,3,1182,732,1783,300,146,4143,16,95,4254
12,9,12001,311,3,160,87,249,80,18,594,2,14,610
12,9,12001,312,3,160,251,462,29,20,922,4,33,959
12,9,12001,326,3,24,66,39,1,1,131,0,7,138
12,9,12001,327,3,67,45,70,0,0,182,0,19,201
12,9,12001,328,3,88,132,186,10,7,423,3,18,444
12,9,12001,329,3,19,67,83,8,0,177,0,13,190
12,9,12001,330,3,30,99,83,13,2,227,1,20,248
12,9,12001,331,3,49,144,191,7,5,396,1,67,464
12,9,12001,339,3,111,128,397,16,6,658,3,28,689
12,9,12001,340,3,30,24,66,2,0,122,0,8,130
12,9,12001,341,3,8,35,97,24,3,167,1,16,184
12,9,12001,342,3,2,16,42,2,3,65,0,0,65
12,9,12001,348,3,0,0,0,0,0,0,0,0,0
12,9,12001,349,3,0,0,0,0,0,0,0,0,0
12,9,12001,350,3,52,27,172,0,3,254,0,20,274
12,9,12001,351,3,2,31,47,7,0,87,0,13,100
12,9,12001,352,3,3,29,70,27,0,129,0,22,151
12,9,12001,354,3,15,74,161,6,0,256,2,9,267
12,9,12001,355,3,42,100,181,10,3,336,9,18,363
12,9,12001,356,3,28,281,336,4,2,651,2,10,663
12,9,12001,357,3,36,88,52,3,2,181,0,2,183
12,9,12001,358,3,20,53,52,16,1,142,0,9,151
12,9,12001,359,3,12,31,60,0,0,103,0,10,113
12,9,12001,360,3,6,60,35,24,0,125,0,8,133
12,9,12001,361,3,15,18,10,4,1,48,0,3,51
12,9,12001,362,3,77,141,306,15,11,550,7,19,576
12,9,12001,363,3,39,156,139,9,8,351,3,18,372
12,9,12001,364,3,40,122,163,15,10,350,0,34,384
12,9,12001,365,3,6,23,22,0,1,52,0,1,53
12,9,12001,366,3,32,39,112,0,1,184,3,11,198
12,9,12001,367,3,19,23,46,3,0,91,0,7,98
12,9,12001,368,3,64,153,295,7,7,526,3,21,550
12,9,12001,369,3,27,116,99,10,7,259,0,4,263
12,9,12001,370,3,41,124,277,12,5,459,0,22,481
12,9,12001,371,3,62,178,217,22,13,492,5,25,522
12,9,12001,372,3,61,156,127,8,4,356,2,15,373
12,9,12001,373,3,51,226,357,50,11,695,2,35,732
12,9,12001,374,3,78,147,375,36,4,640,1,48,689
12,9,12001,375,3,17,139,106,3,0,265,0,8,273
12,9,12001,376,3,35,75,52,3,8,173,0,9,182
12,9,12001,377,3,49,171,189,10,46,465,2,41,508
12,9,12001,378,3,62,122,81,5,5,275,1,18,294
12,9,12001,379,3,123,243,213,23,6,608,2,14,624
12,9,12001,380,3,162,183,322,24,6,697,3,31,731
12,9,12001,381,3,84,49,156,23,3,315,4,9,328
12,9,12001,382,3,72,70,144,16,6,308,2,6,316
12,9,12001,383,3,82,86,231,35,18,452,8,18,478
13,1,13010,162,3,127,386,327,132,9,981,1,42,1024
13,1,13010,163,3,12,257,206,10,4,489,1,34,524
13,1,13010,164,3,12,90,49,12,1,164,0,34,198
13,1,13010,165,3,20,165,333,95,4,617,0,46,663
13,1,13010,166,3,61,125,250,16,1,453,0,25,478
13,1,13010,167,3,35,63,108,4,4,214,0,26,240
13,1,13010,168,3,95,64,118,11,1,289,0,29,318
13,1,13010,169,3,78,260,359,7,2,706,2,34,742
13,1,13010,170,3,66,260,133,6,2,467,1,30,498
13,1,13010,171,3,35,193,391,62,7,688,0,41,729
13,1,13010,172,3,18,98,133,9,0,258,0,17,275
13,1,13010,173,3,6,38,171,9,1,225,1,15,241
13,1,13010,174,3,27,92,73,10,1,203,0,11,214
13,1,13010,175,3,22,119,117,15,0,273,0,28,301
13,1,13010,176,3,46,152,184,30,3,415,0,45,460
13,1,13010,177,3,48,343,179,37,7,614,0,38,652
13,1,13013,224,3,321,401,201,102,9,1034,0,55,1089
13,1,13013,225,3,144,253,141,43,4,585,0,33,618
13,1,13013,226,3,55,106,22,9,3,195,1,16,212
13,1,13013,227,3,73,167,14,1,3,258,0,12,270
13,1,13013,228,3,248,225,128,11,3,615,3,43,661
13,1,13013,229,3,78,123,62,10,5,278,0,10,288
13,1,13013,230,3,104,129,125,18,0,376,0,13,389
13,1,13013,231,3,63,102,77,45,3,290,2,19,311
13,1,13013,232,3,254,376,271,29,2,932,11,82,1025
13,1,13013,233,3,107,139,30,8,3,287,0,11,298
13,1,13013,234,3,99,127,55,4,0,285,0,12,297
13,1,13013,235,3,138,137,57,8,2,342,0,19,361
13,1,13013,236,3,42,310,93,6,3,454,2,23,479
13,1,13013,237,3,25,99,36,3,1,164,0,7,171
13,1,13013,238,3,61,171,89,25,1,347,0,31,378
13,1,13013,239,3,8,39,2,11,0,60,0,2,62
13,1,13025,405,3,125,314,320,105,5,869,1,35,905
13,1,13025,406,3,83,277,228,105,5,698,3,23,724
13,1,13025,407,3,9,23,37,1,0,70,0,5,75
13,1,13025,408,3,6,137,125,9,0,277,0,5,282
13,1,13025,409,3,26,133,183,9,0,351,0,17,368
13,1,13025,410,3,8,75,100,0,0,183,0,11,194
13,1,13025,411,3,7,57,155,12,1,232,0,24,256
13,1,13025,412,3,2,7,106,1,0,116,0,8,124
13,1,13025,413,3,22,70,158,32,2,284,1,23,308
13,1,13025,414,3,28,76,106,4,0,214,0,16,230
13,1,13025,415,3,16,72,117,15,0,220,1,12,233
13,1,13025,416,3,13,123,103,3,0,242,2,8,252
13,1,13025,417,3,50,309,369,33,8,769,1,24,794
13,1,13025,418,3,15,141,131,6,1,294,0,11,305
13,1,13025,419,3,35,196,298,11,3,543,0,44,587
13,1,13025,420,3,14,73,108,15,6,216,0,16,232
13,1,13025,421,3,3,67,45,3,4,122,0,4,126
13,1,13025,422,3,32,191,262,50,8,543,0,40,583
13,1,13025,423,3,14,33,27,7,0,81,0,2,83
13,1,13025,424,3,30,57,125,9,3,224,0,10,234
13,1,13025,425,3,53,96,119,49,2,319,0,27,346
13,1,13025,426,3,9,65,196,0,2,272,2,20,294
13,1,13025,427,3,58,68,91,3,4,224,0,15,239
13,1,13025,428,3,38,109,132,13,4,296,3,28,327
13,1,13025,429,3,33,356,168,14,8,579,1,11,591
13,1,13025,430,3,29,89,176,29,1,324,0,23,347
13,1,13026,431,3,124,249,231,62,8,674,3,62,739
13,1,13026,432,3,17,116,146,4,0,283,0,13,296
13,1,13026,433,3,19,156,138,8,5,326,0,21,347
13,1,13026,434,3,51,232,455,18,17,773,2,41,816
13,1,13026,435,3,60,206,255,31,13,565,4,60,629
13,1,13026,436,3,25,42,96,8,3,174,2,14,190
13,1,13026,437,3,20,85,137,2,3,247,0,21,268
13,1,13026,438,3,16,136,180,66,7,405,0,25,430
13,1,13026,439,3,23,87,134,16,3,263,1,29,293
13,1,13026,440,3,70,116,137,63,10,396,1,45,442
13,1,13028,457,3,368,536,739,194,23,1860,7,65,1932
13,1,13028,458,3,176,317,303,123,16,935,4,18,957
13,1,13028,459,3,196,382,385,220,18,1201,1,17,1219
13,1,13028,460,3,295,643,660,352,38,1988,4,54,2046
13,1,13028,461,3,203,346,271,180,13,1013,3,21,1037
13,1,13028,462,3,157,309,195,115,6,782,0,22,804
13,1,13028,463,3,117,313,241,113,15,799,1,19,819
13,1,13028,464,3,137,362,394,214,12,1119,6,28,1153
13,1,13028,465,3,89,217,128,63,3,500,0,8,508
13,1,13028,466,3,55,238,168,62,5,528,1,9,538
13,1,13028,467,3,180,356,508,163,18,1225,4,53,1282
13,1,13028,468,3,153,300,469,231,11,1164,3,35,1202
13,1,13028,469,3,163,265,386,133,11,958,5,27,990
13,1,13028,470,3,191,439,643,184,18,1475,7,38,1520
13,1,13028,471,3,95,212,314,10,5,636,3,98,737
13,1,13028,472,3,59,29,162,6,1,257,0,32,289
13,1,13028,473,3,109,223,465,42,10,849,2,28,879
13,1,13028,474,3,41,208,183,11,0,443,0,21,464
13,1,13028,475,3,28,135,125,6,0,294,0,26,320
13,1,13028,476,3,93,217,215,24,0,549,0,74,623
13,1,13028,477,3,60,162,158,10,4,394,0,13,407
13,1,13028,478,3,54,172,241,56,4,527,0,16,543
13,1,13028,479,3,49,335,145,33,5,567,0,32,599
13,1,13028,480,3,83,240,196,16,6,541,0,28,569
13,1,13028,481,3,50,126,230,7,1,414,1,39,454
13,1,13028,482,3,106,238,465,32,4,845,0,38,883
13,1,13028,483,3,71,201,186,18,4,480,0,52,532
13,1,13028,484,3,20,273,140,7,5,445,0,47,492
13,1,13028,485,3,81,90,169,22,3,365,3,24,392
13,1,13028,486,3,120,230,323,75,7,755,0,91,846
13,1,13028,487,3,93,211,288,18,10,620,0,83,703
13,1,13028,488,3,24,82,343,10,8,467,0,36,503
13,1,13028,489,3,33,248,178,13,3,475,2,38,515
13,1,13028,490,3,39,352,216,32,6,645,1,21,667
13,1,13028,491,3,62,333,258,36,3,692,0,44,736
13,1,13028,492,3,28,130,94,2,4,258,4,31,293
13,1,13028,493,3,38,176,76,6,0,296,0,24,320
13,1,13028,494,3,59,101,181,28,0,369,2,43,414
13,1,13028,495,3,148,186,416,23,3,776,4,69,849
13,1,13028,496,3,25,32,86,26,0,169,0,11,180
13,1,13028,497,3,76,66,156,11,3,312,0,33,345
13,1,13028,498,3,4,5,45,2,0,56,0,0,56
13,1,13028,499,3,50,233,480,58,6,827,0,71,898
13,1,13028,500,3,141,278,279,15,2,715,1,58,774
13,1,13028,501,3,51,133,211,14,1,410,0,44,454
13,1,13028,502,3,172,290,295,25,22,804,7,53,864
13,1,13028,503,3,47,103,196,4,3,353,1,42,396
13,1,13028,504,3,95,419,261,10,1,786,0,56,842
13,1,13028,505,3,204,261,173,7,1,646,0,38,684
13,1,13028,506,3,33,273,46,9,3,364,0,32,396
13,1,13028,507,3,256,231,109,58,6,660,2,26,688
13,1,13028,508,3,297,415,241,79,7,1039,2,45,1086
13,1,13028,509,3,98,89,134,16,3,340,3,28,371
13,1,13032,630,3,76,101,179,8,1,365,1,28,394
13,1,13032,631,3,121,375,396,84,12,988,0,47,1035
13,1,13032,632,3,217,316,388,37,5,963,0,30,993
13,1,13032,633,3,44,61,105,3,1,214,1,22,237
13,1,13032,634,3,11,105,100,6,1,223,0,2,225
13,1,13032,635,3,10,52,34,5,3,104,2,8,114
13,1,13032,636,3,32,36,53,23,1,145,0,5,150
13,1,13032,637,3,37,31,36,25,0,129,0,8,137
13,1,13032,638,3,32,52,71,7,1,163,0,0,163
13,1,13032,639,3,8,31,172,5,1,217,0,11,228
13,1,13032,640,3,41,161,160,18,1,381,0,14,395
13,1,13032,641,3,47,132,100,7,0,286,0,0,286
13,1,13035,657,3,107,129,72,67,2,377,4,15,396
13,1,13035,658,3,23,134,57,11,1,226,0,12,238
13,1,13035,659,3,210,168,163,6,3,550,3,37,590
13,1,13035,660,3,210,214,77,7,1,509,0,18,527
13,1,13035,661,3,31,143,237,23,3,437,3,35,475
13,1,13035,662,3,51,154,126,25,3,359,1,36,396
13,1,13035,663,3,86,150,146,87,6,475,3,20,498
13,1,13035,664,3,67,169,79,30,3,348,2,21,371
13,1,13053,1043,3,162,179,92,71,2,506,0,16,522
13,1,13053,1044,3,511,410,151,172,5,1249,1,30,1280
13,1,13053,1045,3,363,458,181,107,4,1113,0,37,1150
13,1,13053,1046,3,150,175,94,63,1,483,0,14,497
13,1,13053,1047,3,152,177,22,8,1,360,1,12,373
13,1,13053,1048,3,245,289,226,2,0,762,0,36,798
13,1,13053,1049,3,101,157,151,8,2,419,0,24,443
13,1,13053,1050,3,287,119,143,5,0,554,0,25,579
13,1,13053,1051,3,128,139,56,6,3,332,0,18,350
13,1,13053,1052,3,127,96,78,0,2,303,0,15,318
13,1,13053,1053,3,229,130,64,2,5,430,0,31,461
13,1,13053,1054,3,117,83,20,4,0,224,0,13,237
13,1,13053,1055,3,174,143,93,4,1,415,0,28,443
13,1,13053,1056,3,177,152,135,16,2,482,0,33,515
13,1,13053,1057,3,199,167,126,6,5,503,0,22,525
13,1,13053,1058,3,100,114,63,5,1,283,0,12,295
13,1,13053,1059,3,163,298,217,18,2,698,0,29,727
13,1,13053,1060,3,203,408,374,16,3,1004,0,14,1018
13,1,13053,1061,3,681,665,99,31,8,1484,0,53,1537
13,1,13053,1062,3,243,366,280,23,10,922,0,59,981
13,1,13053,1063,3,210,166,145,5,1,527,0,44,571
13,1,13053,1064,3,17,104,51,2,2,176,2,9,187
13,1,13053,1065,3,41,134,67,33,2,277,0,16,293
13,1,13053,1066,3,71,307,35,7,1,421,0,12,433
13,1,13062,1229,3,39,180,158,24,7,408,2,17,427
13,1,13062,1230,3,66,161,62,3,1,293,0,10,303
13,1,13062,1231,3,4,83,22,1,0,110,0,1,111
13,1,13062,1232,3,45,244,206,0,2,497,1,15,513
13,1,13062,1233,3,12,114,92,0,0,218,0,5,223
13,1,13062,1234,3,63,66,24,0,0,153,0,8,161
13,1,13062,1235,3,59,82,38,2,3,184,1,5,190
13,1,13062,1236,3,169,246,51,1,3,470,1,34,505
13,1,13062,1237,3,30,346,327,4,5,712,1,32,745
13,1,13062,1238,3,5,24,51,1,0,81,0,2,83
13,1,13062,1239,3,8,54,16,0,0,78,0,7,85
13,1,13062,1240,3,198,218,56,1,7,480,0,104,584
13,1,13062,1241,3,9,109,50,2,1,171,0,11,182
13,1,13062,1242,3,12,128,48,4,3,195,0,20,215
13,1,13062,1243,3,25,161,132,2,1,321,0,16,337
13,1,13062,1244,3,23,138,92,4,1,258,0,10,268
13,1,13062,1245,3,28,97,128,5,4,262,0,26,288
13,1,13062,1246,3,27,151,155,1,0,334,0,13,347
13,1,13062,1247,3,18,89,28,4,1,140,0,2,142
13,1,13062,1248,3,28,106,49,2,1,186,1,6,193
13,1,13062,1249,3,78,276,96,14,3,467,4,24,495
13,1,13062,1250,3,11,165,135,6,0,317,0,5,322
13,1,13062,1251,3,17,86,123,7,1,234,0,13,247
13,1,13062,1252,3,3,48,101,16,2,170,0,5,175
13,1,13062,1253,3,22,143,200,12,1,378,2,15,395
13,1,13062,1254,3,39,124,109,5,5,282,2,18,302
13,1,13062,1255,3,2,57,49,4,0,112,0,3,115
13,1,13062,1256,3,2,20,38,1,0,61,0,6,67
13,1,13062,1257,3,4,94,13,4,0,115,0,5,120
13,1,13062,1258,3,41,142,69,8,2,262,0,2,264
13,1,13062,1259,3,8,109,76,19,1,213,0,13,226
13,1,13062,1260,3,54,113,165,18,4,354,2,15,371
13,1,13062,1261,3,51,35,16,5,1,108,0,1,109
13,1,13067,1333,3,85,121,121,90,7,424,0,15,439
13,1,13067,1334,3,61,137,118,103,4,423,2,12,437
13,1,13067,1335,3,31,38,23,15,1,108,0,1,109
13,1,13067,1336,3,18,110,65,66,5,264,0,20,284
13,1,13067,1337,3,50,111,58,13,0,232,0,14,246
13,1,13067,1338,3,46,71,42,14,1,174,0,23,197
13,1,13067,1339,3,21,30,47,5,5,108,0,5,113
13,1,13067,1340,3,21,109,67,5,2,204,0,21,225
13,1,13067,1341,3,32,40,82,27,2,183,0,20,203
13,1,13067,1342,3,42,67,81,9,2,201,1,52,254
13,1,13067,1343,3,20,35,49,6,4,114,0,18,132
13,1,13067,1344,3,57,45,24,7,5,138,0,16,154
13,1,13067,1345,3,61,57,21,8,4,151,0,11,162
13,1,13067,1346,3,87,103,92,23,0,305,1,17,323
13,1,13067,1347,3,51,124,154,24,3,356,0,16,372
13,1,13067,1348,3,79,98,48,5,0,230,0,8,238
13,1,13072,1403,3,224,172,342,125,14,877,3,24,904
13,1,13072,1404,3,28,57,114,9,5,213,3,5,221
13,1,13072,1405,3,36,69,93,2,5,205,1,27,233
13,1,13072,1406,3,26,210,140,13,4,393,0,19,412
13,1,13072,1407,3,30,275,170,0,2,477,2,11,490
13,1,13072,1408,3,50,196,166,0,2,414,2,19,435
13,1,13072,1409,3,83,134,121,38,3,379,0,11,390
13,1,13072,1410,3,244,275,160,11,1,691,1,43,735
13,1,13072,1411,3,56,218,88,1,0,363,2,14,379
13,1,13072,1412,3,130,225,18,2,2,377,5,19,401
13,1,13072,1413,3,78,121,93,23,2,317,1,21,339
13,1,13072,1414,3,86,237,135,2,8,468,1,43,512
13,1,13072,1415,3,63,206,309,15,5,598,0,52,650
13,1,13072,1416,3,35,76,70,1,1,183,0,4,187
13,1,13072,1417,3,94,249,40,2,3,388,3,32,423
13,1,13072,1418,3,25,59,71,0,0,155,1,22,178
13,1,13072,1419,3,117,102,142,36,5,402,2,68,472
13,1,13072,1420,3,19,74,90,3,2,188,0,11,199
13,1,13072,1421,3,39,106,64,5,0,214,1,20,235
13,1,13072,1422,3,41,237,228,11,4,521,5,40,566
13,1,13072,1423,3,99,215,188,35,9,546,0,36,582
13,1,13072,1424,3,74,122,39,16,1,252,0,14,266
13,1,13072,1425,3,33,154,92,5,2,286,0,30,316
13,1,13072,1426,3,13,139,143,1,2,298,0,46,344
13,1,13072,1427,3,29,115,152,0,1,297,1,22,320
13,1,13072,1428,3,234,250,355,126,7,972,1,23,996
13,1,13078,1563,3,346,344,377,23,3,1093,4,29,1126
13,1,13078,1564,3,118,128,129,17,4,396,5,29,430
13,1,13078,1565,3,150,93,117,12,3,375,5,53,433
13,1,13078,1566,3,81,67,85,1,2,236,0,32,268
13,1,13078,1567,3,200,270,231,5,1,707,1,39,747
13,1,13078,1568,3,214,246,163,27,2,652,0,17,669
13,1,13078,1569,3,75,160,178,11,0,424,0,15,439
13,1,13078,1570,3,128,249,208,13,8,606,3,32,641
13,1,13078,1571,3,183,238,79,3,4,507,0,34,541
13,1,13078,1572,3,149,141,188,6,1,485,0,76,561
13,1,13078,1573,3,74,30,74,10,1,189,1,10,200
13,1,13078,1574,3,143,90,44,10,1,288,1,11,300
13,1,13078,1575,3,159,94,118,23,1,395,2,23,420
13,1,13080,1585,3,300,353,365,69,16,1103,0,75,1178
13,1,13080,1586,3,272,346,201,38,4,861,0,59,920
13,1,13080,1587,3,185,163,409,24,14,795,16,27,838
13,1,13080,1588,3,160,153,162,12,4,491,0,24,515
13,1,13080,1589,3,52,69,135,10,0,266,0,28,294
13,1,13080,1590,3,220,127,133,8,5,493,0,36,529
13,1,13080,1591,3,38,61,41,20,0,160,0,13,173
13,1,13080,1592,3,35,142,139,16,2,334,5,23,362
13,1,13080,1593,3,58,218,334,32,4,646,0,53,699
13,1,13080,1594,3,45,49,86,2,4,186,1,29,216
13,1,13080,1595,3,45,80,99,0,4,228,1,9,238
13,1,13080,1596,3,73,20,92,2,1,188,0,10,198
13,1,13080,1597,3,31,47,112,7,8,205,0,14,219
13,1,13080,1598,3,124,581,636,9,10,1360,0,85,1445
13,1,13080,1599,3,120,265,170,5,5,565,3,20,588
13,2,13006,92,3,208,367,205,49,16,845,1,22,868
13,2,13006,93,3,60,116,107,15,4,302,1,8,311
13,2,13006,94,3,13,62,56,8,4,143,3,9,155
13,2,13006,95,3,58,183,180,7,13,441,0,10,451
13,2,13006,96,3,28,105,122,11,0,266,0,14,280
13,2,13006,97,3,65,107,164,15,6,357,4,25,386
13,2,13006,98,3,40,80,66,11,1,198,0,3,201
13,2,13006,99,3,44,118,285,10,6,463,0,11,474
13,2,13006,100,3,89,112,85,8,9,303,4,24,331
13,2,13006,101,3,43,145,215,48,8,459,2,7,468
13,2,13006,102,3,25,81,38,2,1,147,0,8,155
13,2,13006,103,3,92,263,169,25,15,564,0,32,596
13,2,13006,104,3,53,120,87,8,13,281,4,18,303
13,2,13006,105,3,24,126,100,13,6,269,0,5,274
13,2,13006,106,3,54,131,178,14,1,378,1,15,394
13,2,13006,107,3,36,93,116,10,7,262,2,8,272
13,2,13006,108,3,34,90,72,11,3,210,0,9,219
13,2,13006,109,3,50,106,36,10,1,203,1,8,212
13,2,13006,110,3,9,64,70,2,0,145,2,1,148
13,2,13006,111,3,88,178,130,5,5,406,2,10,418
13,2,13006,112,3,10,41,41,7,1,100,0,1,101
13,2,13006,113,3,11,109,38,2,0,160,2,2,164
13,2,13014,240,3,99,222,115,56,5,497,4,11,512
13,2,13014,241,3,67,194,147,39,3,450,7,22,479
13,2,13014,242,3,8,76,50,3,0,137,0,8,145
13,2,13014,243,3,46,131,72,25,3,277,3,13,293
13,2,13014,244,3,11,81,48,5,2,147,0,5,152
13,2,13014,245,3,70,207,109,22,7,415,1,23,439
13,2,13014,246,3,60,309,246,62,5,682,1,30,713
13,2,13014,247,3,14,136,92,19,4,265,0,12,277
13,2,13014,248,3,19,121,100,11,1,252,3,12,267
13,2,13014,249,3,59,187,236,110,12,604,2,17,623
13,2,13014,250,3,57,247,366,20,4,694,2,22,718
13,2,13014,251,3,55,83,111,4,3,256,2,20,278
13,2,13014,252,3,25,95,79,12,0,211,3,13,227
13,2,13014,253,3,14,69,166,1,1,251,0,11,262
13,2,13014,254,3,34,51,63,7,0,155,0,4,159
13,2,13014,255,3,105,178,101,10,1,395,1,9,405
13,2,13014,256,3,33,161,143,8,4,349,0,7,356
13,2,13017,291,3,118,350,361,25,9,863,9,30,902
13,2,13017,292,3,110,271,317,24,7,729,1,19,749
13,2,13017,293,3,3,86,70,3,0,162,0,7,169
13,2,13017,294,3,20,107,98,5,1,231,1,3,235
13,2,13017,295,3,5,94,27,3,0,129,0,4,133
13,2,13017,296,3,30,117,143,0,0,290,0,18,308
13,2,13017,297,3,20,141,115,2,0,278,0,20,298
13,2,13017,298,3,28,180,129,6,2,345,0,26,371
13,2,13017,299,3,7,60,44,2,0,113,0,4,117
13,2,13017,300,3,14,70,59,1,2,146,0,5,151
13,2,13017,301,3,11,112,51,4,1,179,2,7,188
13,2,13017,302,3,35,123,137,3,3,301,0,7,308
13,2,13017,303,3,4,74,47,3,0,128,1,6,135
13,2,13017,304,3,15,85,77,4,0,181,0,9,190
13,2,13017,305,3,22,121,105,3,2,253,0,6,259
13,2,13017,306,3,4,74,36,1,0,115,0,6,121
13,2,13017,307,3,69,167,42,9,2,289,0,16,305
13,2,13017,308,3,27,142,196,17,2,384,0,9,393
13,2,13017,309,3,98,258,231,37,13,637,3,40,680
13,2,13017,310,3,23,179,126,20,2,350,0,16,366
13,2,13017,311,3,39,193,77,29,0,338,0,9,347
13,2,13017,312,3,33,250,201,9,0,493,0,6,499
13,2,13017,313,3,21,85,35,6,0,147,0,8,155
13,2,13017,314,3,13,102,63,5,1,184,0,13,197
13,2,13017,315,3,24,276,132,10,1,443,0,26,469
13,2,13018,316,3,125,340,421,76,14,976,3,18,997
13,2,13018,317,3,26,102,55,2,2,187,0,25,212
13,2,13018,318,3,16,168,78,20,2,284,0,7,291
13,2,13018,319,3,18,100,77,36,4,235,0,8,243
13,2,13018,320,3,41,219,163,22,7,452,0,16,468
13,2,13018,321,3,13,169,31,7,3,223,0,16,239
13,2,13018,322,3,34,197,90,77,5,403,0,27,430
13,2,13018,323,3,55,245,297,23,4,624,1,13,638
13,2,13018,324,3,17,106,42,15,3,183,2,10,195
13,2,13018,325,3,12,77,48,10,1,148,0,9,157
13,2,13018,326,3,1,56,8,2,1,68,0,2,70
13,2,13018,327,3,50,223,353,22,11,659,0,13,672
13,2,13018,328,3,38,263,217,11,8,537,3,10,550
13,2,13018,329,3,50,341,495,20,10,916,2,12,930
13,2,13018,330,3,4,36,5,2,0,47,1,4,52
13,2,13030,547,3,85,211,344,51,6,697,4,19,720
13,2,13030,548,3,75,209,266,20,10,580,7,25,612
13,2,13030,549,3,107,265,251,36,6,665,2,17,684
13,2,13030,550,3,195,435,484,98,18,1230,6,30,1266
13,2,13030,551,3,251,389,303,69,15,1027,4,18,1049
13,2,13030,552,3,217,498,372,66,22,1175,2,22,1199
13,2,13030,553,3,187,560,420,46,15,1228,2,32,1262
13,2,13030,554,3,64,208,116,26,8,422,0,9,431
13,2,13030,555,3,110,422,228,47,10,817,3,17,837
13,2,13030,556,3,151,317,225,39,9,741,3,13,757
13,2,13030,557,3,111,197,238,46,11,603,0,16,619
13,2,13030,558,3,95,147,133,18,4,397,0,2,399
13,2,13030,559,3,89,233,226,40,7,595,0,18,613
13,2,13030,560,3,115,421,299,45,11,891,0,17,908
13,2,13030,561,3,88,259,212,14,12,585,0,14,599
13,2,13030,562,3,138,268,253,39,17,715,1,19,735
13,2,13030,563,3,136,243,272,42,9,702,0,10,712
13,2,13030,564,3,32,48,62,11,2,155,0,4,159
13,2,13030,565,3,17,31,81,6,4,139,0,10,149
13,2,13030,566,3,6,59,44,3,2,114,1,4,119
13,2,13030,567,3,2,30,23,2,0,57,0,3,60
13,2,13030,568,3,71,32,220,9,4,336,0,5,341
13,2,13030,569,3,33,49,145,12,0,239,1,15,255
13,2,13030,570,3,71,11,14,1,1,98,0,0,98
13,2,13030,571,3,5,84,9,3,0,101,0,3,104
13,2,13030,572,3,11,77,76,2,2,168,2,1,171
13,2,13030,573,3,6,23,19,1,1,50,0,6,56
13,2,13030,574,3,55,122,78,10,3,268,0,10,278
13,2,13030,575,3,78,345,336,42,16,817,3,22,842
13,2,13030,576,3,43,80,22,13,3,161,3,9,173
13,2,13030,577,3,88,57,117,4,6,272,0,13,285
13,2,13030,578,3,64,46,43,13,5,171,1,7,179
13,2,13030,579,3,35,118,125,7,9,294,2,11,307
13,2,13030,580,3,94,146,209,42,4,495,0,14,509
13,2,13030,581,3,66,311,314,36,11,738,5,44,787
13,2,13030,582,3,19,54,158,5,2,238,0,7,245
13,2,13030,583,3,41,85,170,8,0,304,1,10,315
13,2,13030,584,3,10,89,26,10,5,140,0,3,143
13,2,13030,585,3,5,115,112,0,0,232,1,7,240
13,2,13030,586,3,23,86,205,8,2,324,0,16,340
13,2,13030,587,3,10,115,144,7,1,277,0,7,284
13,2,13030,588,3,15,85,163,1,1,265,0,2,267
13,2,13030,589,3,7,18,84,4,0,113,0,5,118
13,2,13030,590,3,24,135,114,7,2,282,0,4,286
13,2,13030,591,3,21,118,80,6,5,230,0,9,239
13,2,13030,592,3,28,50,96,7,2,183,0,5,188
13,2,13030,593,3,141,269,420,40,10,880,1,18,899
13,2,13030,594,3,92,348,377,23,8,848,5,22,875
13,2,13030,595,3,43,329,593,19,4,988,0,30,1018
13,2,13030,596,3,118,206,270,31,6,631,4,14,649
13,2,13030,597,3,48,492,344,42,6,932,2,17,951
13,2,13030,598,3,39,124,71,6,0,240,3,20,263
13,2,13030,599,3,11,49,41,8,2,111,0,2,113
13,2,13030,600,3,81,118,88,27,6,320,1,11,332
13,2,13030,601,3,51,358,618,35,5,1067,0,24,1091
13,2,13030,602,3,54,90,137,7,1,289,3,6,298
13,2,13030,603,3,35,183,145,29,1,393,0,11,404
13,2,13030,604,3,27,25,14,0,1,67,0,3,70
13,2,13030,605,3,27,37,218,16,1,299,0,14,313
13,2,13030,606,3,27,31,77,3,1,139,0,12,151
13,2,13030,607,3,84,228,580,43,12,947,0,29,976
13,2,13031,608,3,119,204,444,54,9,830,1,31,862
13,2,13031,609,3,98,206,289,31,5,629,4,28,661
13,2,13031,610,3,52,92,47,6,1,198,0,13,211
13,2,13031,611,3,23,94,80,4,8,209,0,8,217
13,2,13031,612,3,13,66,81,4,3,167,0,0,167
13,2,13031,613,3,87,137,64,13,1,302,0,0,302
13,2,13031,614,3,101,95,92,24,2,314,0,20,334
13,2,13031,615,3,5,13,31,0,0,49,1,5,55
13,2,13031,616,3,10,8,75,4,0,97,0,4,101
13,2,13031,617,3,5,4,38,4,1,52,0,1,53
13,2,13031,618,3,21,78,46,4,1,150,0,9,159
13,2,13031,619,3,2,42,7,2,0,53,0,1,54
13,2,13031,620,3,44,146,151,30,2,373,0,25,398
13,2,13031,621,3,9,18,38,3,1,69,0,0,69
13,2,13031,622,3,3,80,67,15,0,165,0,5,170
13,2,13031,623,3,5,20,10,2,0,37,0,4,41
13,2,13031,624,3,7,12,22,3,2,46,0,2,48
13,2,13031,625,3,7,53,6,5,1,72,0,2,74
13,2,13031,626,3,5,13,55,3,0,76,0,3,79
13,2,13031,627,3,17,82,74,15,1,189,0,10,199
13,2,13031,628,3,8,54,56,7,2,127,0,6,133
13,2,13031,629,3,21,110,111,9,1,252,0,11,263
13,2,13034,646,3,34,168,259,5,3,469,0,20,489
13,2,13034,647,3,29,130,200,1,2,362,2,13,377
13,2,13034,648,3,19,111,104,3,1,238,1,16,255
13,2,13034,649,3,38,130,152,4,1,325,4,16,345
13,2,13034,650,3,60,229,284,6,3,582,5,26,613
13,2,13034,651,3,25,121,40,2,1,189,0,5,194
13,2,13034,652,3,15,84,91,6,1,197,0,12,209
13,2,13034,653,3,35,63,127,0,1,226,0,14,240
13,2,13034,654,3,40,123,282,9,1,455,0,12,467
13,2,13034,655,3,39,179,270,9,1,498,3,18,519
13,2,13034,656,3,14,86,103,1,1,205,0,0,205
13,2,13043,780,3,24,213,106,16,3,362,1,8,371
13,2,13043,781,3,23,71,22,1,0,117,1,7,125
13,2,13043,782,3,10,22,100,0,1,133,0,5,138
13,2,13043,783,3,9,36,27,1,0,73,0,1,74
13,2,13043,784,3,35,118,11,1,1,166,0,0,166
13,2,13043,785,3,6,51,29,1,1,88,0,3,91
13,2,13043,786,3,13,24,25,7,3,72,0,0,72
13,2,13043,787,3,17,16,12,2,1,48,0,2,50
13,2,13043,788,3,6,109,46,0,0,161,0,10,171
13,2,13043,789,3,6,32,36,0,0,74,0,9,83
13,2,13043,790,3,7,61,28,3,0,99,0,7,106
13,2,13043,791,3,13,51,17,2,0,83,0,3,86
13,2,13043,792,3,6,22,22,1,0,51,0,2,53
13,2,13043,793,3,27,46,48,4,8,133,2,4,139
13,2,13043,794,3,2,48,3,3,0,56,0,1,57
13,2,13043,795,3,8,113,71,12,0,204,0,4,208
13,2,13043,796,3,3,104,40,9,0,156,0,4,160
13,2,13043,797,3,4,52,45,2,1,104,0,4,108
13,2,13043,798,3,10,31,22,6,0,69,0,4,73
13,2,13043,799,3,41,99,29,4,0,173,0,11,184
13,2,13043,800,3,10,48,60,5,2,125,0,6,131
13,2,13043,801,3,2,23,30,0,1,56,0,8,64
13,2,13046,822,3,150,70,38,14,3,275,1,10,286
13,2,13046,823,3,91,103,35,14,1,244,0,7,251
13,2,13046,824,3,300,156,27,8,1,492,1,13,506
13,2,13046,825,3,130,37,17,4,2,190,0,3,193
13,2,13046,826,3,49,79,4,2,0,134,0,1,135
13,2,13046,827,3,73,63,4,0,0,140,0,1,141
13,2,13046,828,3,86,68,7,3,2,166,0,3,169
13,2,13046,829,3,110,116,6,4,1,237,0,4,241
13,2,13046,830,3,51,47,4,1,1,104,2,6,112
13,2,13046,831,3,27,133,6,1,0,167,0,6,173
13,2,13048,962,3,248,489,240,56,10,1043,1,31,1075
13,2,13048,963,3,37,158,26,32,0,253,0,24,277
13,2,13048,964,3,71,84,16,2,0,173,2,11,186
13,2,13048,965,3,69,76,11,1,1,158,0,5,163
13,2,13048,966,3,55,86,15,6,0,162,0,21,183
13,2,13048,967,3,67,288,66,20,2,443,0,28,471
13,2,13048,968,3,40,10,14,4,0,68,0,9,77
13,2,13048,969,3,46,92,3,3,1,145,1,5,151
13,2,13048,970,3,78,339,18,8,0,443,0,20,463
13,2,13048,971,3,103,82,10,11,1,207,0,1,208
13,2,13048,972,3,194,318,86,34,0,632,3,29,664
13,2,13048,973,3,11,136,22,2,2,173,0,5,178
13,2,13048,974,3,25,57,19,6,0,107,0,11,118
13,2,13048,975,3,76,61,37,7,0,181,2,6,189
13,2,13048,976,3,30,101,36,7,0,174,0,11,185
13,2,13048,977,3,64,47,12,2,0,125,0,6,131
13,2,13048,978,3,91,163,20,11,2,287,1,9,297
13,2,13048,979,3,25,64,27,3,0,119,0,3,122
13,2,13048,980,3,31,69,7,0,0,107,0,6,113
13,2,13048,981,3,43,84,46,4,3,180,0,7,187
13,2,13054,1067,3,91,205,356,108,5,765,0,18,783
13,2,13054,1068,3,100,222,278,11,5,616,0,31,647
13,2,13054,1069,3,23,38,151,2,4,218,2,11,231
13,2,13054,1070,3,105,266,280,34,15,700,0,19,719
13,2,13054,1071,3,9,103,142,8,1,263,0,5,268
13,2,13054,1072,3,47,175,236,31,5,494,1,14,509
13,2,13054,1073,3,66,178,258,26,8,536,0,3,539
13,2,13054,1074,3,86,124,143,24,8,385,4,10,399
13,2,13054,1075,3,11,28,196,25,2,262,0,4,266
13,2,13054,1076,3,27,129,170,41,6,373,3,9,385
13,2,13054,1077,3,35,71,68,22,0,196,0,8,204
13,2,13054,1078,3,70,213,189,49,5,526,0,21,547
13,2,13054,1079,3,186,254,347,125,21,933,2,25,960
13,2,13054,1080,3,21,122,175,68,5,391,0,12,403
13,2,13054,1081,3,34,75,129,25,4,267,5,6,278
13,2,13054,1082,3,19,85,82,17,4,207,1,7,215
13,2,13054,1083,3,22,56,57,5,2,142,1,4,147
13,2,13054,1084,3,39,122,316,65,5,547,0,19,566
13,2,13054,1085,3,128,228,609,111,19,1095,8,20,1123
13,2,13054,1086,3,18,63,93,2,4,180,0,4,184
13,2,13054,1087,3,96,370,412,62,20,960,1,13,974
13,2,13054,1088,3,42,207,232,16,3,500,0,23,523
13,2,13054,1089,3,17,161,90,25,4,297,0,2,299
13,2,13054,1090,3,33,229,180,13,2,457,1,10,468
13,2,13055,1091,3,128,300,219,89,15,751,3,26,780
13,2,13055,1092,3,6,37,18,5,0,66,0,4,70
13,2,13055,1093,3,11,34,14,3,0,62,0,3,65
13,2,13055,1094,3,7,44,37,1,1,90,2,3,95
13,2,13055,1095,3,10,43,8,0,0,61,0,3,64
13,2,13055,1096,3,56,150,112,16,10,344,5,13,362
13,2,13055,1097,3,33,76,48,21,2,180,1,14,195
13,2,13055,1098,3,19,132,44,10,4,209,4,2,215
13,2,13055,1099,3,55,204,527,38,15,839,1,9,849
13,2,13055,1100,3,72,167,180,51,4,474,0,10,484
13,2,13055,1101,3,31,89,95,5,2,222,0,10,232
13,2,13055,1102,3,16,63,93,8,2,182,0,7,189
13,2,13055,1103,3,10,43,43,7,2,105,0,3,108
13,2,13055,1104,3,8,56,53,3,1,121,2,1,124
13,2,13055,1105,3,46,99,124,8,4,281,0,12,293
13,2,13055,1106,3,29,114,79,11,6,239,0,11,250
13,2,13055,1107,3,23,95,92,9,1,220,2,4,226
13,2,13055,1108,3,49,84,75,11,1,220,1,12,233
13,2,13055,1109,3,72,205,120,21,4,422,2,8,432
13,2,13058,1132,3,63,119,114,27,7,330,0,9,339
13,2,13058,1133,3,134,175,221,67,7,604,0,23,627
13,2,13058,1134,3,128,293,283,90,10,804,0,12,816
13,2,13058,1135,3,29,101,49,3,3,185,5,11,201
13,2,13058,1136,3,12,23,30,1,0,66,0,5,71
13,2,13058,1137,3,24,133,93,24,2,276,2,8,286
13,2,13058,1138,3,41,84,186,24,8,343,0,9,352
13,2,13058,1139,3,32,58,99,11,2,202,0,5,207
13,2,13058,1140,3,4,8,19,3,0,34,0,11,45
13,2,13058,1141,3,22,47,35,3,2,109,2,11,122
13,2,13058,1142,3,30,73,163,28,5,299,1,10,310
13,2,13058,1143,3,14,61,46,4,3,128,1,1,130
13,2,13058,1144,3,5,32,124,2,2,165,1,3,169
13,2,13058,1145,3,24,49,93,11,2,179,0,6,185
13,2,13058,1146,3,63,58,153,3,4,281,2,11,294
13,2,13058,1147,3,14,39,118,1,4,176,0,6,182
13,2,13058,1148,3,18,62,141,6,0,227,0,6,233
13,2,13058,1149,3,29,53,129,4,2,217,0,5,222
13,2,13058,1150,3,40,215,111,11,5,382,2,13,397
13,2,13058,1151,3,75,268,251,20,4,618,2,24,644
13,2,13059,1152,3,414,213,409,97,36,1169,3,25,1197
13,2,13059,1153,3,369,190,521,122,27,1229,1,40,1270
13,2,13059,1154,3,87,75,78,6,6,252,0,4,256
13,2,13059,1155,3,86,68,70,6,2,232,0,13,245
13,2,13059,1156,3,94,55,82,31,4,266,0,6,272
13,2,13059,1157,3,189,257,252,37,5,740,2,23,765
13,2,13059,1158,3,65,39,260,12,7,383,2,11,396
13,2,13059,1159,3,308,116,234,52,16,726,2,35,763
13,2,13059,1160,3,76,124,168,18,5,391,1,19,411
13,2,13059,1161,3,81,202,278,28,12,601,3,22,626
13,2,13059,1162,3,128,368,238,29,14,777,4,28,809
13,2,13059,1163,3,75,155,125,23,4,382,0,25,407
13,2,13059,1164,3,51,85,55,14,2,207,5,6,218
13,2,13059,1165,3,71,38,131,7,4,251,2,12,265
13,2,13059,1166,3,37,47,58,12,2,156,1,13,170
13,2,13059,1167,3,29,47,24,13,1,114,0,8,122
13,2,13059,1168,3,87,41,102,17,3,250,1,10,261
13,2,13059,1169,3,42,78,23,4,2,149,0,6,155
13,2,13059,1170,3,196,95,128,56,4,479,1,12,492
13,2,13059,1171,3,196,152,85,14,6,453,1,10,464
13,2,13059,1172,3,49,92,32,12,1,186,0,5,191
13,2,13059,1173,3,86,257,79,38,4,464,0,9,473
13,2,13059,1174,3,238,285,228,31,7,789,2,35,826
13,2,13059,1175,3,145,138,90,20,4,397,1,11,409
13,2,13059,1176,3,29,54,31,25,3,142,2,3,147
13,2,13084,1644,3,189,328,250,57,13,837,1,35,873
13,2,13084,1645,3,151,194,206,32,8,591,0,16,607
13,2,13084,1646,3,86,124,131,26,5,372,4,3,379
13,2,13084,1647,3,103,131,174,25,7,440,1,15,456
13,2,13084,1648,3,97,121,106,36,6,366,0,16,382
13,2,13084,1649,3,147,163,213,39,8,570,3,22,595
13,2,13084,1650,3,135,261,257,53,15,721,1,29,751
13,2,13084,1651,3,8,27,7,0,1,43,0,1,44
13,2,13084,1652,3,3,22,29,0,0,54,0,10,64
13,2,13084,1653,3,57,67,82,6,7,219,2,7,228
13,2,13084,1654,3,2,58,16,11,1,88,1,10,99
13,2,13084,1655,3,18,30,28,3,1,80,2,3,85
13,2,13084,1656,3,7,72,9,1,1,90,0,6,96
13,2,13084,1657,3,18,37,12,3,0,70,2,8,80
13,2,13084,1659,3,11,34,16,14,1,76,0,0,76
13,2,13084,1660,3,33,67,26,18,1,145,0,13,158
13,2,13084,1661,3,12,30,32,0,2,76,0,1,77
13,2,13084,1662,3,35,106,53,4,0,198,0,8,206
13,2,13084,1663,3,14,71,37,2,2,126,0,4,130
13,2,13084,1664,3,27,69,19,1,2,118,4,3,125
13,2,13084,1665,3,11,23,25,2,2,63,0,0,63
13,2,13084,1666,3,2,22,20,1,0,45,0,0,45
13,2,13084,1667,3,7,11,39,1,0,58,1,3,62
13,2,13084,1668,3,43,158,105,12,4,322,1,12,335
13,2,13084,1669,3,10,33,43,1,0,87,1,3,91
13,2,13084,1670,3,5,59,27,2,0,93,0,6,99
13,2,13084,1671,3,9,20,22,2,0,53,0,4,57
13,2,13084,1672,3,6,29,12,3,0,50,0,0,50
13,2,13084,1673,3,8,39,2,0,1,50,0,5,55
13,2,13084,1674,3,6,20,8,2,0,36,0,5,41
13,2,13084,1675,3,43,82,180,19,6,330,1,13,344
13,2,13084,1676,3,63,77,149,17,4,310,5,3,318
13,2,13084,1677,3,12,14,9,0,0,35,0,0,35
13,2,13084,1678,3,91,132,243,18,8,492,1,37,530
13,2,13084,1679,3,96,215,222,29,11,573,9,18,600
13,2,13084,1680,3,73,165,236,51,10,535,5,15,555
13,2,13084,1681,3,24,46,27,3,2,102,1,0,103
13,2,13084,1682,3,69,155,96,16,4,340,5,12,357
13,2,13084,1683,3,106,158,185,27,11,487,4,11,502
13,2,13084,1684,3,86,145,125,15,3,374,3,8,385
13,2,13084,1685,3,12,5,22,4,0,43,0,2,45
13,2,13084,1686,3,16,42,25,1,0,84,0,9,93
13,2,13084,1687,3,18,94,47,31,1,191,0,6,197
13,2,13084,1688,3,10,93,37,3,0,143,0,13,156
13,2,13084,1689,3,10,12,14,1,1,38,0,2,40
13,2,13084,1690,3,2,10,6,2,0,20,0,0,20
13,2,13084,1691,3,11,25,24,4,0,64,0,2,66
13,2,13084,1692,3,32,48,51,13,4,148,1,3,152
13,2,13084,1693,3,16,37,53,4,1,111,1,5,117
13,2,13084,1694,3,145,261,388,79,15,888,2,39,929
13,2,13084,1695,3,31,25,19,3,2,80,0,1,81
13,2,13084,1696,3,9,130,14,4,2,159,1,2,162
13,2,13084,1697,3,4,31,32,3,1,71,1,4,76
13,2,13084,1698,3,17,37,36,0,0,90,1,2,93
13,2,13084,1699,3,35,65,51,8,1,160,1,13,174
13,2,13084,1700,3,24,49,74,10,0,157,0,11,168
13,2,13084,1701,3,20,48,23,12,1,104,0,15,119
13,2,13084,1702,3,39,168,37,7,2,253,0,7,260
13,2,13084,1703,3,27,188,36,4,0,255,0,7,262
13,2,13084,1704,3,6,36,80,6,1,129,0,2,131
13,2,13084,1705,3,6,14,6,0,0,26,0,0,26
13,2,13084,1706,3,20,67,60,3,2,152,0,6,158
13,2,13084,1707,3,1,36,32,1,0,70,0,0,70
13,3,13003,34,3,270,417,594,106,27,1414,1,30,1445
13,3,13003,35,3,118,269,316,31,10,744,5,20,769
13,3,13003,36,3,93,195,196,35,8,527,0,4,531
13,3,13003,37,3,157,274,409,42,19,901,4,12,917
13,3,13003,38,3,123,269,261,55,13,721,0,16,737
13,3,13003,39,3,205,312,433,64,16,1030,8,17,1055
13,3,13003,40,3,233,350,422,61,18,1084,2,27,1113
13,3,13003,41,3,90,166,239,28,9,532,4,16,552
13,3,13003,42,3,102,185,191,22,3,503,4,11,518
13,3,13003,43,3,153,249,260,81,13,756,1,17,774
13,3,13003,44,3,258,388,384,54,14,1098,1,28,1127
13,3,13003,45,3,161,301,259,39,25,785,2,24,811
13,3,13003,46,3,163,264,350,67,11,855,4,21,880
13,3,13003,47,3,121,192,239,51,22,625,0,9,634
13,3,13003,48,3,5,99,40,0,0,144,0,7,151
13,3,13003,49,3,4,78,47,0,0,129,0,5,134
13,3,13003,50,3,9,33,2,0,0,44,0,2,46
13,3,13003,51,3,4,88,21,7,2,122,0,5,127
13,3,13003,52,3,50,133,149,8,1,341,0,4,345
13,3,13003,53,3,12,97,100,18,3,230,0,2,232
13,3,13003,54,3,76,121,214,11,2,424,2,5,431
13,3,13003,55,3,97,283,201,18,7,606,1,11,618
13,3,13003,56,3,30,77,81,0,0,188,0,5,193
13,3,13003,57,3,26,157,101,4,1,289,0,12,301
13,3,13003,58,3,14,117,116,4,0,251,1,4,256
13,3,13003,59,3,60,129,63,7,6,265,1,3,269
13,3,13003,60,3,159,212,426,35,15,847,5,29,881
13,3,13003,61,3,60,102,80,17,3,262,6,13,281
13,3,13003,62,3,116,254,371,23,7,771,0,19,790
13,3,13003,63,3,36,78,84,6,1,205,1,6,212
13,3,13003,64,3,17,85,221,13,3,339,0,7,346
13,3,13003,65,3,74,282,384,14,3,757,3,19,779
13,3,13003,66,3,75,234,210,9,6,534,2,13,549
13,3,13003,67,3,60,284,342,25,1,712,0,14,726
13,3,13003,68,3,69,264,307,31,10,681,1,7,689
13,3,13005,81,3,106,328,199,48,13,694,0,13,707
13,3,13005,82,3,149,277,227,52,14,719,3,30,752
13,3,13005,83,3,75,313,197,23,12,620,0,20,640
13,3,13005,84,3,110,367,186,17,12,692,0,3,695
13,3,13005,85,3,88,180,327,24,5,624,0,18,642
13,3,13005,86,3,190,215,345,35,18,803,4,28,835
13,3,13005,87,3,19,32,63,4,3,121,0,2,123
13,3,13005,88,3,104,231,470,31,11,847,0,15,862
13,3,13005,89,3,76,140,276,15,6,513,1,14,528
13,3,13005,90,3,49,51,66,3,0,169,1,2,172
13,3,13005,91,3,9,67,26,4,0,106,2,4,112
13,3,13011,178,3,252,213,194,128,9,796,0,31,827
13,3,13011,179,3,306,282,156,141,13,898,1,19,918
13,3,13011,180,3,184,202,136,152,18,692,2,18,712
13,3,13011,181,3,159,152,138,107,9,565,0,15,580
13,3,13011,182,3,78,11,6,2,1,98,1,3,102
13,3,13011,183,3,31,78,6,4,2,121,0,8,129
13,3,13011,184,3,96,62,24,4,1,187,1,9,197
13,3,13011,185,3,34,30,20,3,0,87,0,3,90
13,3,13011,186,3,99,60,49,30,1,239,2,10,251
13,3,13011,187,3,174,154,121,53,5,507,0,19,526
13,3,13011,188,3,110,43,29,24,3,209,0,20,229
13,3,13011,189,3,57,65,24,8,1,155,1,12,168
13,3,13011,190,3,57,65,27,49,4,202,0,10,212
13,3,13011,191,3,131,82,69,33,4,319,0,24,343
13,3,13011,192,3,81,41,42,10,2,176,0,20,196
13,3,13011,193,3,82,85,55,21,2,245,0,11,256
13,3,13011,194,3,149,129,63,35,3,379,0,17,396
13,3,13011,195,3,111,70,107,40,8,336,0,9,345
13,3,13011,196,3,60,69,94,17,2,242,1,7,250
13,3,13011,197,3,121,202,113,29,7,472,0,26,498
13,3,13011,198,3,39,40,10,4,0,93,0,2,95
13,3,13011,199,3,41,94,36,13,0,184,4,6,194
13,3,13011,200,3,124,42,20,29,9,224,0,13,237
13,3,13011,201,3,104,89,104,39,6,342,2,14,358
13,3,13011,202,3,55,107,15,4,0,181,1,7,189
13,3,13011,203,3,150,73,96,68,9,396,0,9,405
13,3,13011,204,3,129,151,136,35,6,457,2,14,473
13,3,13011,205,3,26,42,16,3,1,88,0,1,89
13,3,13019,331,3,228,315,303,99,8,953,3,24,980
13,3,13019,332,3,118,231,143,13,2,507,0,8,515
13,3,13019,333,3,68,253,95,11,5,432,1,8,441
13,3,13019,334,3,12,117,21,2,1,153,1,5,159
13,3,13019,335,3,140,162,66,13,2,383,0,8,391
13,3,13019,336,3,192,330,233,36,8,799,0,17,816
13,3,13019,337,3,53,136,60,1,2,252,7,7,266
13,3,13019,338,3,31,118,60,15,2,226,0,11,237
13,3,13019,339,3,49,224,27,4,8,312,4,11,327
13,3,13019,340,3,195,567,471,34,15,1282,2,28,1312
13,3,13019,341,3,110,200,214,26,3,553,1,11,565
13,3,13020,342,3,34,135,137,10,2,318,0,15,333
13,3,13020,343,3,2,53,35,2,0,92,0,1,93
13,3,13020,344,3,0,34,28,2,0,64,0,0,64
13,3,13020,345,3,14,97,257,9,3,380,8,8,396
13,3,13020,346,3,6,78,37,0,0,121,0,6,127
13,3,13020,347,3,5,23,31,0,0,59,0,4,63
13,3,13020,348,3,6,51,75,1,0,133,0,2,135
13,3,13020,349,3,4,43,56,2,1,106,0,6,112
13,3,13023,369,3,79,258,434,242,14,1027,3,35,1065
13,3,13023,370,3,80,284,340,171,7,882,0,23,905
13,3,13023,371,3,112,280,628,196,22,1238,0,18,1256
13,3,13023,372,3,67,162,291,67,5,592,1,7,600
13,3,13023,373,3,99,294,430,178,10,1011,1,12,1024
13,3,13023,374,3,82,168,384,122,14,770,1,14,785
13,3,13023,375,3,50,200,207,13,4,474,1,16,491
13,3,13023,376,3,56,91,130,35,3,315,0,10,325
13,3,13023,377,3,33,112,107,26,6,284,1,8,293
13,3,13023,378,3,94,262,305,69,5,735,2,12,749
13,3,13023,379,3,94,188,323,71,14,690,0,12,702
13,3,13023,380,3,100,157,162,39,2,460,1,14,475
13,3,13023,381,3,44,254,269,64,6,637,3,15,655
13,3,13023,382,3,30,230,180,23,4,467,2,10,479
13,3,13023,383,3,60,260,589,78,9,996,1,5,1002
13,3,13023,384,3,50,419,415,127,10,1021,0,17,1038
13,3,13023,385,3,59,398,574,116,15,1162,4,32,1198
13,3,13033,642,3,9,195,167,4,0,375,0,9,384
13,3,13033,643,3,6,124,75,0,1,206,0,7,213
13,3,13033,644,3,6,187,118,8,0,319,0,14,333
13,3,13033,645,3,22,253,179,8,1,463,2,16,481
13,3,13037,674,3,56,149,244,52,3,504,0,9,513
13,3,13037,675,3,72,245,211,65,3,596,4,24,624
13,3,13037,676,3,15,105,87,7,1,215,0,4,219
13,3,13037,677,3,19,64,55,6,2,146,0,7,153
13,3,13037,678,3,35,253,42,6,5,341,0,11,352
13,3,13037,679,3,14,228,48,3,4,297,1,12,310
13,3,13037,680,3,27,222,170,47,0,466,8,15,489
13,3,13037,681,3,31,265,238,22,5,561,4,17,582
13,3,13037,682,3,0,0,0,0,0,0,0,0,0
13,3,13037,683,3,15,72,25,1,1,114,0,5,119
13,3,13037,684,3,26,140,61,2,0,229,0,9,238
13,3,13037,685,3,11,82,42,6,1,142,0,4,146
13,3,13037,686,3,21,47,121,14,0,203,0,3,206
13,3,13037,687,3,10,124,36,1,0,171,0,8,179
13,3,13037,688,3,24,73,64,4,0,165,0,6,171
13,3,13037,689,3,21,88,134,5,2,250,2,8,260
13,3,13037,690,3,8,70,51,6,1,136,0,1,137
13,3,13037,691,3,2,84,117,2,0,205,5,10,220
13,3,13037,692,3,7,159,2,0,1,169,0,4,173
13,3,13037,693,3,21,152,88,20,0,281,1,9,291
13,3,13037,694,3,44,113,79,22,1,259,0,4,263
13,3,13037,695,3,15,146,33,6,1,201,0,22,223
13,3,13037,696,3,6,79,1,1,1,88,0,2,90
13,3,13037,697,3,49,145,109,67,3,373,8,12,393
13,3,13037,698,3,23,83,84,73,0,263,1,11,275
13,3,13037,699,3,6,75,3,0,0,84,0,9,93
13,3,13038,700,3,72,139,127,27,5,370,0,6,376
13,3,13038,701,3,3,14,15,10,0,42,0,0,42
13,3,13038,702,3,10,39,70,9,3,131,3,7,141
13,3,13038,703,3,4,21,15,3,0,43,1,0,44
13,3,13038,704,3,62,245,244,47,3,601,9,20,630
13,3,13038,705,3,2,31,17,2,0,52,0,3,55
13,3,13038,706,3,1,13,24,5,0,43,0,0,43
13,3,13038,707,3,8,34,37,17,1,97,0,6,103
13,3,13038,708,3,13,89,115,14,4,235,1,6,242
13,3,13038,709,3,3,28,45,2,0,78,0,0,78
13,3,13038,710,3,145,211,214,53,19,642,11,21,674
13,3,13038,711,3,3,39,38,3,2,85,0,2,87
13,3,13038,712,3,78,161,184,22,10,455,0,9,464
13,3,13041,743,3,264,367,284,81,28,1024,3,15,1042
13,3,13041,744,3,188,314,245,79,33,859,0,22,881
13,3,13041,745,3,199,239,214,72,22,746,1,25,772
13,3,13041,746,3,164,323,198,64,26,775,2,16,793
13,3,13041,747,3,108,207,175,58,12,560,0,20,580
13,3,13041,748,3,196,261,278,82,21,838,3,20,861
13,3,13041,749,3,205,326,247,71,24,873,0,19,892
13,3,13041,750,3,271,366,276,100,37,1050,1,27,1078
13,3,13041,751,3,235,369,233,49,23,909,4,20,933
13,3,13041,752,3,134,208,173,58,22,595,2,9,606
13,3,13041,753,3,176,266,237,100,28,807,7,12,826
13,3,13041,754,3,29,108,118,15,6,276,0,10,286
13,3,13041,755,3,38,146,92,24,3,303,1,0,304
13,3,13041,756,3,258,149,203,74,10,694,0,19,713
13,3,13041,757,3,117,133,169,31,10,460,4,27,491
13,3,13041,758,3,151,151,114,39,12,467,11,14,492
13,3,13041,759,3,92,241,266,42,17,658,1,25,684
13,3,13041,760,3,47,74,72,17,6,216,2,6,224
13,3,13041,761,3,174,236,352,62,10,834,5,17,856
13,3,13041,762,3,53,140,168,27,5,393,0,9,402
13,3,13041,763,3,44,96,227,33,5,405,3,13,421
13,3,13041,764,3,17,86,76,1,0,180,1,4,185
13,3,13042,765,3,127,244,323,109,11,814,2,24,840
13,3,13042,766,3,70,336,249,119,9,783,2,30,815
13,3,13042,767,3,13,72,80,4,2,171,0,0,171
13,3,13042,768,3,15,61,85,19,3,183,0,17,200
13,3,13042,769,3,17,139,96,4,4,260,1,15,276
13,3,13042,770,3,18,23,30,10,2,83,0,6,89
13,3,13042,771,3,7,74,61,7,0,149,0,12,161
13,3,13042,772,3,12,79,86,8,3,188,1,16,205
13,3,13042,773,3,9,64,156,7,1,237,0,3,240
13,3,13042,774,3,7,41,39,5,2,94,0,8,102
13,3,13042,775,3,16,53,68,10,0,147,0,9,156
13,3,13042,776,3,6,45,36,21,0,108,1,8,117
13,3,13042,777,3,3,31,57,15,1,107,0,14,121
13,3,13042,778,3,8,53,62,5,0,128,0,4,132
13,3,13042,779,3,50,81,74,58,2,265,0,9,274
13,3,13049,982,3,200,253,243,102,19,817,4,22,843
13,3,13049,983,3,296,377,352,137,11,1173,1,30,1204
13,3,13049,984,3,156,229,233,82,6,706,0,15,721
13,3,13049,985,3,171,244,202,67,9,693,2,10,705
13,3,13049,986,3,223,262,269,102,11,867,0,7,874
13,3,13049,987,3,276,318,306,118,22,1040,1,25,1066
13,3,13049,988,3,252,302,351,94,14,1013,3,22,1038
13,3,13049,989,3,16,41,14,2,1,74,0,4,78
13,3,13049,990,3,49,71,67,9,3,199,7,3,209
13,3,13049,991,3,177,206,405,50,16,854,4,12,870
13,3,13049,992,3,167,161,249,93,7,677,0,18,695
13,3,13049,993,3,64,149,112,55,8,388,0,11,399
13,3,13050,994,3,245,417,190,194,15,1061,4,30,1095
13,3,13050,995,3,11,39,79,6,0,135,0,7,142
13,3,13050,996,3,94,238,153,25,6,516,4,19,539
13,3,13050,997,3,105,130,85,7,1,328,1,9,338
13,3,13050,998,3,16,31,44,14,2,107,0,2,109
13,3,13050,999,3,38,64,61,4,4,171,2,16,189
13,3,13050,1000,3,82,33,119,19,3,256,0,11,267
13,3,13050,1001,3,87,84,36,65,3,275,4,6,285
13,3,13050,1002,3,80,77,189,21,3,370,0,4,374
13,3,13050,1003,3,13,23,11,6,0,53,0,3,56
13,3,13050,1004,3,12,22,18,28,2,82,0,1,83
13,3,13050,1005,3,40,32,70,17,3,162,1,17,180
13,3,13050,1006,3,33,26,51,17,1,128,0,0,128
13,3,13050,1007,3,10,19,64,3,0,96,0,4,100
13,3,13051,1008,3,197,274,415,46,36,968,3,20,991
13,3,13051,1009,3,241,260,267,36,21,825,3,16,844
13,3,13051,1010,3,228,265,412,40,21,966,3,23,992
13,3,13051,1011,3,198,246,350,42,25,861,0,11,872
13,3,13051,1012,3,60,141,92,13,8,314,1,0,315
13,3,13051,1013,3,209,239,320,42,21,831,3,8,842
13,3,13051,1014,3,214,209,182,29,20,654,5,18,677
13,3,13051,1015,3,190,146,151,14,22,523,1,19,543
13,3,13051,1016,3,278,267,204,37,39,825,4,27,856
13,3,13051,1017,3,98,105,68,12,9,292,0,0,292
13,3,13051,1018,3,63,28,63,1,3,158,0,1,159
13,3,13051,1019,3,45,68,92,10,7,222,2,7,231
13,3,13051,1020,3,127,230,186,38,17,598,1,13,612
13,3,13051,1021,3,190,149,106,26,16,487,0,13,500
13,3,13051,1022,3,70,116,98,3,6,293,1,10,304
13,3,13051,1023,3,44,81,106,10,11,252,2,26,280
13,3,13051,1024,3,34,42,81,3,0,160,0,3,163
13,3,13051,1025,3,69,55,103,12,14,253,1,9,263
13,3,13065,1303,3,22,195,457,12,8,694,2,6,702
13,3,13065,1304,3,41,210,357,26,15,649,0,9,658
13,3,13065,1305,3,46,275,282,19,11,633,0,13,646
13,3,13065,1306,3,46,216,345,43,9,659,2,14,675
13,3,13065,1307,3,50,155,298,33,9,545,5,12,562
13,3,13065,1308,3,24,92,276,19,10,421,2,6,429
13,3,13065,1309,3,35,128,387,14,3,567,1,15,583
13,3,13069,1369,3,82,173,189,20,10,474,0,4,478
13,3,13069,1370,3,140,269,265,38,10,722,0,9,731
13,3,13069,1371,3,42,129,126,12,2,311,0,2,313
13,3,13069,1372,3,57,144,144,16,5,366,0,5,371
13,3,13069,1373,3,116,199,339,32,5,691,0,17,708
13,3,13069,1374,3,150,308,418,54,20,950,3,18,971
13,3,13069,1375,3,76,216,275,37,19,623,0,10,633
13,3,13069,1376,3,185,336,426,55,11,1013,4,25,1042
13,3,13069,1377,3,41,351,326,81,7,806,3,9,818
13,3,13070,1378,3,49,120,165,11,2,347,0,13,360
13,3,13070,1379,3,33,148,54,17,2,254,0,7,261
13,3,13070,1380,3,13,263,86,7,0,369,0,8,377
13,3,13070,1381,3,70,110,77,2,0,259,0,4,263
13,3,13070,1382,3,22,76,57,7,1,163,0,6,169
13,3,13070,1383,3,36,77,61,3,2,179,0,9,188
13,3,13070,1384,3,4,28,55,2,0,89,0,2,91
13,3,13070,1385,3,7,106,46,2,1,162,0,14,176
13,3,13070,1386,3,21,96,122,21,1,261,1,13,275
13,3,13070,1387,3,0,32,12,9,1,54,0,2,56
13,3,13070,1388,3,15,182,111,70,1,379,0,23,402
13,3,13070,1389,3,14,48,65,4,0,131,1,5,137
13,3,13070,1390,3,13,35,99,4,0,151,0,0,151
13,3,13070,1391,3,13,87,175,3,3,281,0,18,299
13,3,13070,1392,3,17,60,112,3,1,193,1,6,200
13,3,13070,1393,3,4,65,98,5,0,172,0,6,178
13,3,13070,1394,3,12,24,52,0,0,88,1,3,92
13,3,13079,1576,3,93,148,76,61,1,379,2,16,397
13,3,13079,1577,3,87,101,164,61,6,419,0,36,455
13,3,13079,1578,3,74,152,78,12,2,318,0,0,318
13,3,13079,1579,3,156,120,106,15,0,397,0,32,429
13,3,13079,1580,3,14,52,24,9,1,100,2,7,109
13,3,13079,1581,3,51,113,95,9,5,273,0,23,296
13,3,13079,1582,3,69,82,78,11,4,244,0,8,252
13,3,13079,1583,3,86,202,115,49,3,455,6,43,504
13,3,13079,1584,3,70,141,95,13,5,324,1,10,335
13,3,13081,1600,3,175,372,311,88,11,957,4,45,1006
13,3,13081,1601,3,141,262,215,44,10,672,4,15,691
13,3,13081,1602,3,179,260,243,90,14,786,2,31,819
13,3,13081,1603,3,193,237,136,99,8,673,0,27,700
13,3,13081,1604,3,152,206,161,53,7,579,1,28,608
13,3,13081,1605,3,192,191,255,71,6,715,0,25,740
13,3,13081,1606,3,220,260,232,51,4,767,2,27,796
13,3,13081,1607,3,158,166,145,92,12,573,2,17,592
13,3,13081,1608,3,128,218,155,46,8,555,0,12,567
13,3,13081,1609,3,34,75,49,1,2,161,0,4,165
13,3,13081,1610,3,31,60,70,3,1,165,1,13,179
13,3,13081,1611,3,27,115,76,4,2,224,0,9,233
13,3,13081,1612,3,30,51,35,3,2,121,0,6,127
13,3,13081,1613,3,70,55,134,22,0,281,0,11,292
13,3,13081,1614,3,122,156,84,18,3,383,0,15,398
13,3,13081,1615,3,105,73,80,8,4,270,4,19,293
13,3,13081,1616,3,120,39,71,18,5,253,0,4,257
13,3,13081,1617,3,27,92,54,17,2,192,2,15,209
13,3,13081,1618,3,67,160,65,9,6,307,1,12,320
13,4,13001,1,3,201,269,104,18,16,608,1,20,629
13,4,13001,2,3,123,95,80,22,2,322,3,10,335
13,4,13001,3,3,12,65,25,2,1,105,0,6,111
13,4,13001,4,3,13,54,22,11,0,100,0,9,109
13,4,13001,5,3,96,177,96,17,6,392,2,32,426
13,4,13001,6,3,106,209,145,11,6,477,7,27,511
13,4,13001,7,3,103,208,142,11,5,469,2,17,488
13,4,13001,8,3,172,264,104,21,4,565,12,21,598
13,4,13001,9,3,299,257,228,40,12,836,1,24,861
13,4,13001,10,3,205,284,153,22,9,673,0,14,687
13,4,13001,11,3,298,282,156,14,13,763,0,35,798
13,4,13001,12,3,112,207,73,17,3,412,4,10,426
13,4,13002,13,3,263,331,207,46,8,855,3,13,871
13,4,13002,14,3,186,280,199,39,5,709,4,15,728
13,4,13002,15,3,34,54,55,3,5,151,3,10,164
13,4,13002,16,3,79,160,34,7,4,284,9,19,312
13,4,13002,17,3,7,123,41,7,0,178,0,21,199
13,4,13002,18,3,16,31,20,5,0,72,0,7,79
13,4,13002,19,3,38,72,73,0,1,184,0,5,189
13,4,13002,20,3,114,115,107,11,4,351,23,39,413
13,4,13002,21,3,113,120,82,10,4,329,18,26,373
13,4,13002,22,3,140,206,258,14,17,635,7,24,666
13,4,13002,23,3,175,385,149,21,11,741,7,31,779
13,4,13002,24,3,179,376,260,45,11,871,6,21,898
13,4,13002,25,3,193,201,159,49,6,608,0,2,610
13,4,13002,26,3,87,145,75,10,4,321,1,8,330
13,4,13002,27,3,345,366,262,29,5,1007,4,45,1056
13,4,13002,28,3,47,107,162,17,10,343,3,21,367
13,4,13002,29,3,108,111,493,26,10,748,1,29,778
13,4,13002,30,3,173,133,170,10,2,488,10,33,531
13,4,13002,31,3,87,94,67,7,1,256,0,29,285
13,4,13002,32,3,191,168,199,13,13,584,10,16,610
13,4,13002,33,3,86,154,81,6,3,330,0,17,347
13,4,13004,69,3,405,384,151,61,5,1006,5,32,1043
13,4,13004,70,3,31,57,72,8,1,169,0,8,177
13,4,13004,71,3,30,26,20,0,0,76,0,1,77
13,4,13004,72,3,27,127,58,4,2,218,1,10,229
13,4,13004,73,3,36,39,76,2,1,154,0,6,160
13,4,13004,74,3,82,79,29,8,2,200,1,3,204
13,4,13004,75,3,47,30,17,1,0,95,0,2,97
13,4,13004,76,3,24,48,5,3,1,81,0,2,83
13,4,13004,77,3,131,226,48,7,0,412,2,21,435
13,4,13004,78,3,137,101,111,19,2,370,0,9,379
13,4,13004,79,3,114,61,93,20,7,295,0,6,301
13,4,13004,80,3,108,69,57,12,0,246,2,6,254
13,4,13024,386,3,170,159,189,42,9,569,3,10,582
13,4,13024,387,3,100,104,135,23,7,369,0,6,375
13,4,13024,388,3,21,66,14,3,0,104,0,1,105
13,4,13024,389,3,27,38,21,7,0,93,0,2,95
13,4,13024,390,3,35,43,7,2,0,87,0,2,89
13,4,13024,391,3,75,54,57,19,1,206,0,15,221
13,4,13024,392,3,134,139,128,14,5,420,6,2,428
13,4,13024,393,3,32,69,28,13,0,142,0,1,143
13,4,13024,394,3,10,33,58,7,1,109,0,5,114
13,4,13024,395,3,62,142,142,27,8,381,1,23,405
13,4,13024,396,3,36,123,55,18,1,233,1,4,238
13,4,13024,397,3,114,153,104,20,6,397,1,2,400
13,4,13024,398,3,92,159,97,26,3,377,0,20,397
13,4,13024,399,3,173,122,132,41,6,474,7,14,495
13,4,13024,400,3,133,166,207,35,3,544,3,11,558
13,4,13024,401,3,26,33,63,11,1,134,0,5,139
13,4,13024,402,3,42,41,77,7,3,170,0,1,171
13,4,13024,403,3,26,80,106,16,2,230,0,8,238
13,4,13024,404,3,20,45,46,13,2,126,1,3,130
13,4,13027,441,3,57,532,516,61,8,1174,0,63,1237
13,4,13027,442,3,4,63,79,0,2,148,0,9,157
13,4,13027,443,3,14,240,189,6,1,450,0,0,450
13,4,13027,444,3,13,231,279,14,1,538,0,10,548
13,4,13027,445,3,3,87,41,1,1,133,0,3,136
13,4,13027,446,3,1,246,146,7,0,400,0,21,421
13,4,13027,447,3,62,465,294,41,4,866,6,80,952
13,4,13027,448,3,8,220,76,9,5,318,0,26,344
13,4,13027,449,3,65,255,74,5,2,401,1,27,429
13,4,13027,450,3,25,181,142,3,0,351,0,16,367
13,4,13027,451,3,171,400,124,29,6,730,2,26,758
13,4,13027,452,3,24,240,248,10,0,522,1,25,548
13,4,13027,453,3,92,318,158,16,6,590,2,22,614
13,4,13027,454,3,69,201,265,20,6,561,0,24,585
13,4,13027,455,3,14,116,146,2,2,280,1,11,292
13,4,13027,456,3,28,201,103,10,0,342,2,20,364
13,4,13036,665,3,222,391,256,41,12,922,6,16,944
13,4,13036,666,3,20,43,27,9,2,101,0,4,105
13,4,13036,667,3,166,121,232,37,3,559,3,27,589
13,4,13036,668,3,345,224,342,48,22,981,6,26,1013
13,4,13036,669,3,33,44,76,2,0,155,0,3,158
13,4,13036,670,3,69,109,91,16,6,291,4,10,305
13,4,13036,671,3,94,189,65,13,6,367,3,14,384
13,4,13036,672,3,19,53,38,8,0,118,0,2,120
13,4,13036,673,3,41,118,60,11,3,233,0,7,240
13,4,13039,713,3,87,204,113,52,11,467,10,17,494
13,4,13039,714,3,107,143,184,48,22,504,1,10,515
13,4,13039,715,3,102,242,132,69,25,570,3,14,587
13,4,13039,716,3,145,250,134,72,39,640,3,21,664
13,4,13039,717,3,77,203,126,69,26,501,2,8,511
13,4,13039,718,3,94,191,146,53,22,506,5,11,522
13,4,13039,719,3,112,181,117,60,15,485,3,10,498
13,4,13039,720,3,147,313,211,118,37,826,2,27,855
13,4,13039,721,3,50,76,121,8,11,266,0,11,277
13,4,13039,722,3,14,54,49,9,0,126,0,3,129
13,4,13039,723,3,78,192,54,30,2,356,3,19,378
13,4,13039,724,3,47,22,30,4,0,103,0,5,108
13,4,13045,812,3,266,262,230,63,9,830,3,16,849
13,4,13045,813,3,177,125,153,19,6,480,1,16,497
13,4,13045,814,3,51,58,51,3,5,168,2,1,171
13,4,13045,815,3,89,62,60,6,0,217,1,11,229
13,4,13045,816,3,68,79,123,21,4,295,0,3,298
13,4,13045,817,3,69,107,34,9,1,220,1,15,236
13,4,13045,818,3,88,122,55,22,1,288,0,16,304
13,4,13045,819,3,54,68,89,12,3,226,0,15,241
13,4,13045,820,3,44,71,45,17,3,180,0,0,180
13,4,13045,821,3,37,32,30,3,0,102,0,2,104
13,4,13052,1026,3,93,393,209,73,5,773,2,31,806
13,4,13052,1027,3,189,481,436,97,9,1212,2,38,1252
13,4,13052,1028,3,7,51,75,1,1,135,0,2,137
13,4,13052,1029,3,19,70,37,1,0,127,1,0,128
13,4,13052,1030,3,107,179,171,13,3,473,1,32,506
13,4,13052,1031,3,13,157,165,3,4,342,0,26,368
13,4,13052,1032,3,12,184,153,4,2,355,2,33,390
13,4,13052,1033,3,2,52,42,1,0,97,0,8,105
13,4,13052,1034,3,24,163,147,11,4,349,2,8,359
13,4,13052,1035,3,7,62,102,3,0,174,0,15,189
13,4,13052,1036,3,12,130,286,37,2,467,4,33,504
13,4,13052,1037,3,24,109,143,6,1,283,0,16,299
13,4,13052,1038,3,31,37,61,4,4,137,0,15,152
13,4,13052,1039,3,118,270,184,8,1,581,1,48,630
13,4,13052,1040,3,6,26,79,1,0,112,0,36,148
13,4,13052,1041,3,12,89,30,4,0,135,1,5,141
13,4,13052,1042,3,14,69,44,2,0,129,2,2,133
13,4,13060,1177,3,61,132,245,34,1,473,4,19,496
13,4,13060,1178,3,84,417,457,76,6,1040,3,38,1081
13,4,13060,1179,3,11,82,99,2,0,194,0,8,202
13,4,13060,1180,3,56,323,349,30,4,762,1,28,791
13,4,13060,1181,3,15,150,230,3,2,400,0,23,423
13,4,13060,1182,3,27,102,120,2,0,251,0,12,263
13,4,13060,1183,3,7,145,181,3,0,336,0,23,359
13,4,13060,1184,3,9,81,81,2,0,173,0,5,178
13,4,13060,1185,3,25,111,133,2,1,272,1,14,287
13,4,13060,1186,3,16,95,132,1,2,246,0,12,258
13,4,13060,1187,3,11,81,117,2,2,213,0,11,224
13,4,13060,1188,3,20,299,218,3,1,541,0,25,566
13,4,13060,1189,3,108,181,101,5,2,397,0,29,426
13,4,13060,1190,3,54,195,120,2,2,373,2,13,388
13,4,13076,1502,3,442,808,741,104,47,2142,7,30,2179
13,4,13076,1503,3,335,403,500,58,18,1314,9,52,1375
13,4,13076,1504,3,446,590,695,144,43,1918,12,46,1976
13,4,13076,1505,3,433,523,532,77,29,1594,1,20,1615
13,4,13076,1506,3,380,489,443,76,30,1418,1,12,1431
13,4,13076,1507,3,367,371,400,56,28,1222,0,18,1240
13,4,13076,1508,3,282,279,295,50,20,926,0,17,943
13,4,13076,1509,3,372,296,324,47,27,1066,6,22,1094
13,4,13076,1510,3,381,341,490,71,24,1307,2,34,1343
13,4,13076,1511,3,409,463,737,83,27,1719,12,49,1780
13,4,13076,1512,3,204,228,357,47,15,851,1,24,876
13,4,13076,1513,3,252,281,443,48,20,1044,1,29,1074
13,4,13076,1514,3,277,295,359,56,19,1006,1,39,1046
13,4,13076,1515,3,254,283,352,46,25,960,2,26,988
13,4,13076,1516,3,234,255,330,55,19,893,1,19,913
13,4,13076,1517,3,242,274,321,54,18,909,2,16,927
13,4,13076,1518,3,254,266,253,38,12,823,0,15,838
13,4,13076,1519,3,175,198,219,22,7,621,7,6,634
13,4,13076,1520,3,348,318,397,60,16,1139,3,15,1157
13,4,13076,1521,3,149,168,176,25,9,527,2,7,536
13,4,13076,1522,3,235,266,276,27,15,819,1,18,838
13,4,13076,1523,3,172,197,211,41,9,630,0,6,636
13,4,13076,1524,3,211,227,301,39,17,795,0,20,815
13,4,13076,1525,3,257,272,313,35,20,897,1,25,923
13,4,13076,1526,3,328,351,395,61,27,1162,0,20,1182
13,4,13076,1527,3,113,139,158,20,21,451,5,14,470
13,4,13076,1528,3,363,375,445,49,22,1254,1,21,1276
13,4,13076,1529,3,328,398,423,80,40,1269,4,21,1294
13,4,13076,1530,3,303,343,364,64,35,1109,3,22,1134
13,4,13076,1531,3,150,209,195,36,12,602,1,12,615
13,4,13076,1532,3,243,258,243,40,14,798,6,14,818
13,4,13076,1533,3,216,259,253,51,10,789,1,22,812
13,4,13076,1534,3,280,322,317,46,16,981,1,17,999
13,4,13076,1535,3,293,304,381,63,15,1056,1,13,1070
13,4,13076,1536,3,427,486,491,169,18,1591,1,24,1616
13,4,13076,1537,3,338,461,426,100,23,1348,5,11,1364
13,4,13076,1538,3,328,420,354,56,17,1175,4,23,1202
13,4,13076,1539,3,275,362,375,37,22,1071,0,39,1110
13,4,13076,1540,3,140,132,103,29,9,413,2,6,421
13,4,13076,1541,3,58,51,46,4,1,160,3,10,173
13,4,13076,1542,3,81,120,115,7,2,325,0,11,336
13,4,13076,1543,3,76,122,275,13,5,491,1,19,511
13,4,13076,1544,3,126,256,534,12,7,935,3,46,984
13,4,13076,1545,3,194,409,339,21,6,969,0,35,1004
13,4,13076,1546,3,56,114,87,14,7,278,3,5,286
13,4,13076,1547,3,11,44,44,0,1,100,0,3,103
13,4,13076,1548,3,275,341,474,56,19,1165,1,27,1193
13,4,13076,1549,3,118,189,202,12,12,533,10,21,564
13,4,13076,1550,3,76,149,101,7,5,338,3,13,354
13,4,13076,1551,3,160,195,275,13,10,653,1,14,668
13,4,13076,1552,3,36,37,63,7,2,145,0,7,152
13,4,13076,1553,3,118,218,137,6,9,488,4,19,511
13,4,13076,1554,3,504,451,756,129,41,1881,8,51,1940
13,4,13076,1555,3,126,170,173,32,5,506,0,10,516
13,5,13009,152,3,346,370,341,56,28,1141,1,16,1158
13,5,13009,153,3,514,298,433,39,28,1312,3,27,1342
13,5,13009,154,3,515,126,215,45,9,910,0,14,924
13,5,13009,155,3,205,255,223,26,6,715,3,13,731
13,5,13009,156,3,330,378,218,42,15,983,1,19,1003
13,5,13009,157,3,414,385,488,45,27,1359,0,20,1379
13,5,13009,158,3,346,453,199,26,19,1043,5,13,1061
13,5,13009,159,3,103,301,208,28,19,659,2,3,664
13,5,13009,160,3,89,203,198,28,17,535,1,9,545
13,5,13009,161,3,335,301,556,39,30,1261,3,19,1283
13,5,13012,206,3,253,261,396,48,40,998,0,10,1008
13,5,13012,207,3,214,196,332,47,20,809,1,9,819
13,5,13012,208,3,218,245,408,54,22,947,5,19,971
13,5,13012,209,3,228,274,660,55,22,1239,1,12,1252
13,5,13012,210,3,90,100,125,14,10,339,0,3,342
13,5,13012,211,3,176,249,169,36,11,641,7,9,657
13,5,13012,212,3,47,142,282,12,10,493,2,6,501
13,5,13012,213,3,104,143,199,10,6,462,0,9,471
13,5,13012,214,3,134,136,355,22,16,663,0,24,687
13,5,13012,215,3,210,288,362,49,16,925,14,5,944
13,5,13012,216,3,472,434,655,68,13,1642,3,26,1671
13,5,13012,217,3,37,124,55,5,2,223,1,2,226
13,5,13012,218,3,36,130,60,7,4,237,0,10,247
13,5,13012,219,3,25,68,51,3,2,149,1,2,152
13,5,13012,220,3,45,159,39,13,3,259,1,4,264
13,5,13012,221,3,51,41,92,14,7,205,0,5,210
13,5,13012,222,3,232,136,260,72,16,716,2,5,723
13,5,13012,223,3,151,143,212,59,14,579,1,14,594
13,5,13016,281,3,192,282,223,40,15,752,5,16,773
13,5,13016,282,3,198,259,123,42,8,630,2,16,648
13,5,13016,283,3,48,136,88,9,7,288,1,8,297
13,5,13016,284,3,71,102,59,21,1,254,0,17,271
13,5,13016,285,3,28,116,119,12,2,277,1,5,283
13,5,13016,286,3,79,201,130,14,8,432,1,33,466
13,5,13016,287,3,71,100,66,10,1,248,3,13,264
13,5,13016,288,3,96,137,266,26,11,536,3,9,548
13,5,13016,289,3,69,273,293,33,4,672,4,44,720
13,5,13016,290,3,67,168,124,8,2,369,0,13,382
13,5,13029,510,3,429,255,208,96,18,1006,0,21,1027
13,5,13029,511,3,342,274,194,67,29,906,0,25,931
13,5,13029,512,3,203,210,131,48,18,610,5,8,623
13,5,13029,513,3,331,307,162,63,14,877,6,9,892
13,5,13029,514,3,15,132,22,3,0,172,0,8,180
13,5,13029,515,3,13,78,21,4,1,117,0,5,122
13,5,13029,516,3,29,101,13,5,0,148,0,12,160
13,5,13029,517,3,133,147,132,11,8,431,1,22,454
13,5,13029,518,3,132,217,124,21,7,501,2,24,527
13,5,13029,519,3,65,217,64,15,4,365,5,20,390
13,5,13029,520,3,106,475,68,17,5,671,2,20,693
13,5,13029,521,3,60,169,45,13,4,291,0,7,298
13,5,13029,522,3,98,153,56,21,12,340,3,14,357
13,5,13029,523,3,221,267,175,46,22,731,1,37,769
13,5,13029,524,3,56,104,13,11,2,186,0,3,189
13,5,13029,525,3,111,100,45,8,2,266,0,6,272
13,5,13029,526,3,22,115,61,6,6,210,2,7,219
13,5,13029,527,3,89,93,51,16,7,256,0,3,259
13,5,13029,528,3,289,250,159,34,21,753,2,31,786
13,5,13029,529,3,22,52,14,4,0,92,0,5,97
13,5,13029,530,3,66,188,78,29,5,366,0,17,383
13,5,13029,531,3,104,115,64,18,3,304,0,7,311
13,5,13029,532,3,76,145,27,5,2,255,0,8,263
13,5,13029,533,3,85,160,61,12,8,326,0,8,334
13,5,13029,534,3,240,208,175,69,13,705,1,17,723
13,5,13029,535,3,243,161,164,49,14,631,0,22,653
13,5,13029,536,3,78,124,74,22,4,302,0,7,309
13,5,13029,537,3,72,298,95,42,6,513,1,7,521
13,5,13029,538,3,52,103,25,7,3,190,0,5,195
13,5,13029,539,3,89,238,33,9,2,371,0,18,389
13,5,13029,540,3,170,354,58,125,6,713,3,13,729
13,5,13029,541,3,21,80,15,21,2,139,0,6,145
13,5,13029,542,3,17,130,11,16,1,175,0,7,182
13,5,13029,543,3,123,148,36,15,3,325,0,10,335
13,5,13029,544,3,273,213,94,15,7,602,5,18,625
13,5,13029,545,3,61,201,121,80,6,469,0,8,477
13,5,13029,546,3,48,44,19,1,0,112,0,2,114
13,5,13044,802,3,406,552,235,46,16,1255,1,58,1314
13,5,13044,803,3,277,304,251,36,15,883,0,27,910
13,5,13044,804,3,121,261,53,11,3,449,3,11,463
13,5,13044,805,3,156,136,109,8,3,412,3,16,431
13,5,13044,806,3,168,206,292,11,10,687,0,15,702
13,5,13044,807,3,258,297,287,46,7,895,2,21,918
13,5,13044,808,3,82,110,77,7,4,280,3,5,288
13,5,13044,809,3,121,132,36,7,4,300,0,15,315
13,5,13044,810,3,148,159,62,6,3,378,0,5,383
13,5,13044,811,3,126,121,60,4,1,312,4,6,322
13,5,13063,1262,3,158,176,331,85,24,774,7,19,800
13,5,13063,1263,3,349,306,399,127,25,1206,8,11,1225
13,5,13063,1264,3,166,154,282,53,18,673,1,12,686
13,5,13063,1265,3,151,127,201,44,20,543,5,14,562
13,5,13063,1266,3,248,129,284,55,13,729,0,26,755
13,5,13063,1267,3,244,252,414,95,32,1037,4,25,1066
13,5,13063,1268,3,173,191,222,49,18,653,10,9,672
13,5,13063,1269,3,274,277,426,86,28,1091,4,10,1105
13,5,13063,1270,3,418,388,512,126,32,1476,3,21,1500
13,5,13063,1271,3,283,286,351,89,30,1039,4,22,1065
13,5,13063,1272,3,324,524,616,126,31,1621,20,20,1661
13,5,13063,1273,3,249,255,260,65,26,855,0,24,879
13,5,13063,1274,3,325,256,384,80,23,1068,8,18,1094
13,5,13063,1275,3,201,220,409,66,26,922,2,22,946
13,5,13063,1276,3,406,302,383,95,34,1220,4,21,1245
13,5,13063,1277,3,108,113,139,27,11,398,0,15,413
13,5,13063,1278,3,231,317,661,52,20,1281,8,35,1324
13,5,13063,1279,3,253,165,277,31,12,738,0,22,760
13,5,13063,1280,3,404,183,133,20,15,755,1,18,774
13,5,13063,1281,3,213,271,222,41,17,764,8,26,798
13,5,13063,1282,3,303,130,338,36,17,824,1,17,842
13,5,13063,1283,3,178,190,154,16,7,545,1,6,552
13,5,13063,1284,3,218,453,375,28,12,1086,4,12,1102
13,5,13063,1285,3,84,107,88,43,9,331,2,5,338
13,5,13063,1286,3,100,208,236,24,14,582,0,5,587
13,5,13063,1287,3,411,245,519,103,36,1314,1,26,1341
13,5,13063,1288,3,26,128,74,1,4,233,0,10,243
13,5,13063,1289,3,174,214,226,26,11,651,0,9,660
13,5,13063,1290,3,140,87,198,19,5,449,7,11,467
13,5,13063,1291,3,123,180,214,29,10,556,0,35,591
13,5,13063,1292,3,110,220,196,26,7,559,11,22,592
13,5,13063,1293,3,138,227,279,49,15,708,2,30,740
13,5,13063,1294,3,42,178,141,25,5,391,1,11,403
13,5,13064,1295,3,287,324,187,25,11,834,1,22,857
13,5,13064,1296,3,128,82,193,9,4,416,0,15,431
13,5,13064,1297,3,36,49,18,1,2,106,0,5,111
13,5,13064,1298,3,46,45,24,6,3,124,0,6,130
13,5,13064,1299,3,151,214,223,14,6,608,0,15,623
13,5,13064,1300,3,155,144,96,2,4,401,0,9,410
13,5,13064,1301,3,224,312,248,33,19,836,1,13,850
13,5,13064,1302,3,226,146,162,14,2,550,2,8,560
13,5,13066,1310,3,160,347,681,66,48,1302,7,12,1321
13,5,13066,1311,3,115,420,542,27,20,1124,0,16,1140
13,5,13066,1312,3,66,196,171,36,8,477,0,11,488
13,5,13066,1313,3,121,298,571,65,47,1102,2,19,1123
13,5,13066,1314,3,122,224,527,39,63,975,1,19,995
13,5,13066,1315,3,38,61,168,9,4,280,1,4,285
13,5,13066,1316,3,196,577,268,35,20,1096,5,18,1119
13,5,13066,1317,3,126,353,475,63,23,1040,7,20,1067
13,5,13066,1318,3,98,263,273,25,18,677,1,7,685
13,5,13066,1319,3,195,588,244,33,21,1081,0,24,1105
13,5,13066,1320,3,105,359,114,26,11,615,1,15,631
13,5,13066,1321,3,66,215,151,8,32,472,6,0,478
13,5,13066,1322,3,99,224,301,22,30,676,3,8,687
13,5,13066,1323,3,22,123,127,6,15,293,0,6,299
13,5,13066,1324,3,91,195,195,6,21,508,3,14,525
13,5,13066,1325,3,94,117,155,8,288,662,0,30,692
13,5,13066,1326,3,22,55,71,6,384,538,5,21,564
13,5,13066,1327,3,29,78,113,5,377,602,2,25,629
13,5,13066,1328,3,56,172,351,11,189,779,0,22,801
13,5,13066,1329,3,68,262,177,24,18,549,1,10,560
13,5,13066,1330,3,53,75,89,5,4,226,0,2,228
13,5,13066,1331,3,27,141,81,26,1,276,0,6,282
13,5,13066,1332,3,52,188,411,19,13,683,2,6,691
13,5,13073,1429,3,225,319,265,76,18,903,5,15,923
13,5,13073,1430,3,323,389,470,123,36,1341,2,28,1371
13,5,13073,1431,3,154,205,340,56,15,770,4,19,793
13,5,13073,1432,3,171,253,246,64,12,746,4,14,764
13,5,13073,1433,3,168,231,282,49,14,744,3,8,755
13,5,13073,1434,3,228,223,303,79,23,856,0,23,879
13,5,13073,1435,3,77,165,302,22,9,575,2,9,586
13,5,13073,1436,3,82,223,299,42,9,655,1,10,666
13,5,13073,1437,3,172,307,291,45,10,825,8,8,841
13,5,13073,1438,3,244,335,376,56,9,1020,0,17,1037
13,5,13073,1439,3,188,189,261,28,6,672,0,5,677
13,5,13073,1440,3,58,169,190,15,6,438,0,5,443
13,5,13075,1449,3,124,279,317,45,18,783,1,23,807
13,5,13075,1450,3,99,278,258,40,4,679,1,26,706
13,5,13075,1451,3,96,428,263,39,17,843,0,10,853
13,5,13075,1452,3,177,588,330,57,25,1177,1,15,1193
13,5,13075,1453,3,249,543,322,52,18,1184,0,11,1195
13,5,13075,1454,3,128,332,188,44,16,708,0,0,708
13,5,13075,1455,3,145,255,179,39,8,626,0,12,638
13,5,13075,1456,3,217,620,385,40,17,1279,4,20,1303
13,5,13075,1457,3,210,532,271,59,10,1082,2,17,1101
13,5,13075,1458,3,161,409,381,39,13,1003,7,17,1027
13,5,13075,1459,3,170,365,349,35,13,932,3,24,959
13,5,13075,1460,3,243,410,311,67,22,1053,3,12,1068
13,5,13075,1461,3,131,315,276,41,8,771,1,9,781
13,5,13075,1462,3,231,308,298,26,7,870,4,26,900
13,5,13075,1463,3,130,84,25,9,0,248,1,13,262
13,5,13075,1464,3,209,252,279,18,6,764,2,29,795
13,5,13075,1465,3,5,37,42,1,2,87,0,1,88
13,5,13075,1466,3,480,272,295,13,17,1077,0,31,1108
13,5,13075,1467,3,8,32,98,14,2,154,0,4,158
13,5,13075,1468,3,37,217,81,12,5,352,0,8,360
13,5,13075,1469,3,28,106,136,6,5,281,0,6,287
13,5,13075,1470,3,31,83,47,7,2,170,0,4,174
13,5,13075,1471,3,6,29,15,1,0,51,0,1,52
13,5,13075,1472,3,65,213,277,12,10,577,0,18,595
13,5,13075,1473,3,37,163,109,9,2,320,0,9,329
13,5,13075,1474,3,231,329,347,30,5,942,1,9,952
13,5,13075,1475,3,65,106,60,10,0,241,0,3,244
13,5,13075,1476,3,199,433,373,79,27,1111,9,27,1147
13,5,13075,1477,3,139,275,381,41,7,843,3,11,857
13,5,13075,1478,3,255,417,334,54,21,1081,1,19,1101
13,5,13075,1479,3,141,311,202,143,11,808,2,12,822
13,5,13075,1480,3,343,624,480,44,12,1503,6,26,1535
13,5,13075,1481,3,124,233,263,24,12,656,0,11,667
13,5,13075,1482,3,103,293,103,8,4,511,1,11,523
13,5,13075,1483,3,72,179,146,16,3,416,1,20,437
13,5,13075,1484,3,270,205,165,25,5,670,0,16,686
13,5,13075,1485,3,344,367,368,36,14,1129,5,14,1148
13,5,13075,1486,3,200,321,180,36,17,754,3,12,769
13,5,13075,1487,3,231,361,238,49,10,889,0,10,899
13,5,13075,1488,3,424,359,278,58,38,1157,3,7,1167
13,5,13075,1489,3,84,145,216,18,3,466,0,5,471
13,5,13075,1490,3,62,61,37,7,5,172,0,7,179
13,5,13075,1491,3,131,279,302,10,4,726,0,14,740
13,5,13075,1492,3,487,384,320,34,21,1246,8,9,1263
13,5,13075,1493,3,113,534,955,26,11,1639,0,26,1665
13,5,13075,1494,3,620,418,197,43,14,1292,1,10,1303
13,5,13075,1495,3,383,271,243,34,4,935,3,15,953
13,5,13075,1496,3,366,189,106,13,8,682,0,8,690
13,5,13075,1497,3,459,287,264,13,4,1027,2,22,1051
13,5,13075,1498,3,504,459,366,47,14,1390,4,26,1420
13,5,13075,1499,3,48,168,164,8,5,393,5,5,403
13,5,13075,1500,3,349,192,220,18,9,788,2,16,806
13,5,13075,1501,3,17,63,17,4,0,101,0,3,104
13,6,13040,725,3,1323,1038,978,195,107,3641,15,77,3733
13,6,13040,726,3,419,243,261,37,18,978,1,19,998
13,6,13040,727,3,456,418,305,68,27,1274,8,41,1323
13,6,13040,728,3,403,364,310,93,34,1204,2,31,1237
13,6,13040,729,3,379,305,313,71,32,1100,3,30,1133
13,6,13040,730,3,213,214,151,31,17,626,1,18,645
13,6,13040,731,3,1578,989,808,292,112,3779,9,46,3834
13,6,13040,732,3,407,348,200,76,22,1053,2,23,1078
13,6,13040,733,3,206,161,110,53,25,555,2,7,564
13,6,13040,734,3,879,450,416,135,78,1958,4,29,1991
13,6,13040,735,3,264,193,120,33,17,627,3,6,636
13,6,13040,736,3,347,257,169,90,21,884,2,11,897
13,6,13040,737,3,431,379,368,67,34,1279,11,22,1312
13,6,13040,738,3,173,157,127,60,19,536,0,13,549
13,6,13040,739,3,2095,1458,1272,507,180,5512,15,55,5582
13,6,13040,740,3,242,228,155,26,8,659,0,23,682
13,6,13040,741,3,232,159,82,14,6,493,2,12,507
13,6,13040,742,3,327,251,254,50,21,903,4,28,935
13,6,13047,832,3,118,193,126,34,15,486,1,22,509
13,6,13047,833,3,170,194,166,27,17,574,5,24,603
13,6,13047,834,3,100,69,60,8,5,242,2,4,248
13,6,13047,835,3,116,117,86,14,12,345,3,6,354
13,6,13047,836,3,86,104,75,9,14,288,2,0,290
13,6,13047,837,3,173,131,99,23,7,433,1,16,450
13,6,13047,838,3,74,54,60,6,3,197,0,9,206
13,6,13047,839,3,151,110,64,25,10,360,0,13,373
13,6,13047,840,3,181,200,130,23,11,545,3,12,560
13,6,13047,841,3,129,130,74,18,4,355,0,4,359
13,6,13047,842,3,233,146,107,25,9,520,2,9,531
13,6,13047,843,3,236,139,107,28,9,519,3,16,538
13,6,13047,844,3,190,176,154,26,20,566,1,9,576
13,6,13047,845,3,134,90,68,22,13,327,2,9,338
13,6,13047,846,3,216,185,101,37,14,553,1,16,570
13,6,13047,847,3,187,163,129,37,9,525,0,20,545
13,6,13047,848,3,302,293,242,45,28,910,2,40,952
13,6,13047,849,3,99,170,74,27,10,380,4,8,392
13,6,13047,850,3,562,309,169,53,31,1124,2,18,1144
13,6,13047,851,3,411,301,174,84,27,997,4,15,1016
13,6,13047,852,3,426,603,676,88,44,1837,13,40,1890
13,6,13047,853,3,295,217,186,52,21,771,2,20,793
13,6,13047,854,3,426,287,250,83,22,1068,5,12,1085
13,6,13047,855,3,393,284,266,64,22,1029,1,18,1048
13,6,13047,856,3,374,289,270,71,20,1024,6,14,1044
13,6,13047,857,3,243,249,170,57,22,741,0,22,763
13,6,13047,858,3,182,133,99,31,12,457,1,11,469
13,6,13047,859,3,183,103,99,38,17,440,0,8,448
13,6,13047,860,3,264,165,137,39,18,623,2,23,648
13,6,13047,861,3,244,118,87,32,9,490,1,7,498
13,6,13047,862,3,202,126,92,25,6,451,1,12,464
13,6,13047,863,3,316,248,268,34,26,892,6,24,922
13,6,13047,864,3,107,108,122,17,17,371,3,18,392
13,6,13047,865,3,198,175,171,44,18,606,3,14,623
13,6,13047,866,3,238,189,158,52,22,659,5,19,683
13,6,13047,867,3,270,198,139,50,12,669,1,26,696
13,6,13047,868,3,243,207,164,28,11,653,2,18,673
13,6,13047,869,3,169,80,120,22,19,410,0,14,424
13,6,13047,870,3,158,121,83,14,9,385,0,15,400
13,6,13047,871,3,265,220,100,40,21,646,3,14,663
13,6,13047,872,3,233,141,76,18,6,474,0,14,488
13,6,13047,873,3,399,220,135,54,10,818,1,22,841
13,6,13047,874,3,250,185,112,28,12,587,2,8,597
13,6,13047,875,3,240,209,115,62,10,636,1,15,652
13,6,13047,876,3,425,238,259,41,25,988,8,13,1009
13,6,13047,877,3,248,196,235,45,27,751,6,12,769
13,6,13047,878,3,511,381,280,74,48,1294,5,19,1318
13,6,13047,879,3,602,556,494,138,41,1831,6,33,1870
13,6,13047,880,3,1432,1104,932,291,123,3882,14,71,3967
13,6,13047,881,3,273,200,188,49,20,730,4,11,745
13,6,13047,882,3,302,223,182,60,32,799,2,12,813
13,6,13047,883,3,220,148,91,25,16,500,6,10,516
13,6,13047,884,3,279,186,112,56,6,639,2,5,646
13,6,13047,885,3,380,243,149,58,23,853,9,25,887
13,6,13047,886,3,222,171,94,42,15,544,2,16,562
13,6,13047,887,3,407,269,178,48,17,919,3,20,942
13,6,13047,888,3,340,187,175,68,20,790,2,24,816
13,6,13047,889,3,268,143,129,42,14,596,0,8,604
13,6,13047,890,3,326,188,127,27,12,680,4,13,697
13,6,13047,891,3,323,188,115,32,13,671,1,9,681
13,6,13047,892,3,231,148,44,26,13,462,2,12,476
13,6,13047,893,3,152,107,43,31,8,341,0,6,347
13,6,13047,894,3,278,193,100,31,25,627,2,13,642
13,6,13047,895,3,235,194,145,42,14,630,1,16,647
13,6,13047,896,3,334,179,143,48,21,725,1,17,743
13,6,13047,897,3,306,201,225,75,20,827,10,22,859
13,6,13047,898,3,422,239,184,57,22,924,1,25,950
13,6,13047,899,3,257,131,166,30,16,600,2,18,620
13,6,13047,900,3,466,249,262,59,39,1075,4,19,1098
13,6,13047,901,3,320,212,158,51,15,756,1,23,780
13,6,13047,902,3,503,341,224,68,12,1148,0,23,1171
13,6,13047,903,3,368,213,134,53,11,779,0,22,801
13,6,13047,904,3,452,274,121,56,19,922,0,18,940
13,6,13047,905,3,204,152,88,35,21,500,0,17,517
13,6,13047,906,3,259,141,76,28,5,509,1,6,516
13,6,13047,907,3,307,189,125,37,13,671,2,9,682
13,6,13047,908,3,282,195,96,31,10,614,0,10,624
13,6,13047,909,3,592,388,141,54,17,1192,0,20,1212
13,6,13047,910,3,456,240,262,73,25,1056,2,25,1083
13,6,13047,911,3,423,327,328,69,32,1179,8,29,1216
13,6,13047,912,3,370,246,243,79,26,964,3,11,978
13,6,13047,913,3,357,202,242,59,17,877,3,20,900
13,6,13047,914,3,364,302,266,80,35,1047,1,42,1090
13,6,13047,915,3,359,275,213,55,28,930,3,19,952
13,6,13047,916,3,423,327,206,77,24,1057,2,11,1070
13,6,13047,917,3,1074,1001,1068,202,116,3461,11,61,3533
13,6,13047,918,3,468,290,343,92,36,1229,8,31,1268
13,6,13047,919,3,398,275,278,76,23,1050,3,18,1071
13,6,13047,920,3,423,261,200,45,22,951,3,22,976
13,6,13047,921,3,389,222,116,39,16,782,2,15,799
13,6,13047,922,3,455,294,185,77,20,1031,1,11,1043
13,6,13047,923,3,376,282,171,61,21,911,2,5,918
13,6,13047,924,3,244,195,159,45,16,659,0,16,675
13,6,13047,925,3,349,176,197,67,15,804,2,14,820
13,6,13047,926,3,325,181,135,33,18,692,1,11,704
13,6,13047,927,3,187,121,67,41,9,425,0,9,434
13,6,13047,928,3,1120,589,378,129,50,2266,1,37,2304
13,6,13047,929,3,283,241,182,49,17,772,0,17,789
13,6,13047,930,3,245,297,236,50,28,856,12,42,910
13,6,13047,931,3,172,178,175,35,19,579,0,33,612
13,6,13047,932,3,477,350,292,83,49,1251,12,31,1294
13,6,13047,933,3,839,494,181,76,34,1624,0,31,1655
13,6,13047,934,3,1667,954,770,203,104,3698,7,50,3755
13,6,13047,935,3,489,451,469,63,34,1506,6,53,1565
13,6,13047,936,3,297,223,215,57,29,821,1,24,846
13,6,13047,937,3,312,215,156,38,8,729,8,0,737
13,6,13047,938,3,513,418,379,94,47,1451,1,19,1471
13,6,13047,939,3,578,372,328,113,37,1428,1,22,1451
13,6,13047,940,3,345,365,252,83,27,1072,9,32,1113
13,6,13047,941,3,301,247,163,54,20,785,1,21,807
13,6,13047,942,3,352,213,177,38,33,813,6,12,831
13,6,13047,943,3,444,283,185,90,19,1021,2,16,1039
13,6,13047,944,3,359,303,240,57,21,980,0,22,1002
13,6,13047,945,3,209,135,96,29,19,488,0,8,496
13,6,13047,946,3,218,179,111,36,19,563,3,7,573
13,6,13047,947,3,218,160,100,39,21,538,3,6,547
13,6,13047,948,3,520,470,263,238,33,1524,3,15,1542
13,6,13047,949,3,295,221,129,67,18,730,3,13,746
13,6,13047,950,3,252,231,125,76,21,705,1,12,718
13,6,13047,951,3,548,385,315,138,44,1430,3,16,1449
13,6,13047,952,3,615,434,412,132,61,1654,1,13,1668
13,6,13047,953,3,785,566,532,230,61,2174,2,18,2194
13,6,13047,954,3,892,536,551,141,72,2192,3,25,2220
13,6,13047,955,3,691,559,520,146,54,1970,3,33,2006
13,6,13047,956,3,486,337,275,54,18,1170,6,42,1218
13,6,13047,957,3,652,409,395,62,20,1538,20,34,1592
13,6,13047,958,3,242,101,147,24,11,525,0,5,530
13,6,13047,959,3,380,319,436,100,31,1266,9,29,1304
13,6,13047,960,3,324,317,361,68,25,1095,11,25,1131
13,6,13047,961,3,379,244,152,68,26,869,0,18,887
13,7,13007,114,3,340,387,183,43,32,985,3,29,1017
13,7,13007,115,3,201,274,74,20,13,582,1,7,590
13,7,13007,116,3,27,48,17,5,2,99,0,6,105
13,7,13007,117,3,75,87,28,4,2,196,0,9,205
13,7,13007,118,3,36,75,17,5,3,136,1,2,139
13,7,13007,119,3,106,74,39,9,4,232,2,5,239
13,7,13007,120,3,46,32,5,1,1,85,1,3,89
13,7,13007,121,3,149,141,70,10,3,373,5,8,386
13,7,13007,122,3,78,133,98,9,4,322,3,6,331
13,7,13007,123,3,43,79,29,6,3,160,2,8,170
13,7,13007,124,3,76,51,26,4,3,160,2,6,168
13,7,13007,125,3,47,84,72,8,1,212,0,1,213
13,7,13007,126,3,73,201,63,7,10,354,0,9,363
13,7,13008,127,3,245,470,360,56,22,1153,2,36,1191
13,7,13008,128,3,276,547,398,83,28,1332,3,37,1372
13,7,13008,129,3,264,516,348,80,27,1235,8,11,1254
13,7,13008,130,3,302,390,327,68,21,1108,2,25,1135
13,7,13008,131,3,180,293,136,37,8,654,2,20,676
13,7,13008,132,3,162,294,131,29,6,622,2,15,639
13,7,13008,133,3,185,315,95,23,9,627,1,14,642
13,7,13008,134,3,328,493,283,58,22,1184,4,28,1216
13,7,13008,135,3,175,339,204,52,20,790,6,25,821
13,7,13008,136,3,239,422,246,70,14,991,1,17,1009
13,7,13008,137,3,169,296,311,74,11,861,4,30,895
13,7,13008,138,3,130,200,86,28,3,447,3,9,459
13,7,13008,139,3,26,158,60,1,3,248,1,14,263
13,7,13008,140,3,13,107,43,1,0,164,0,7,171
13,7,13008,141,3,21,64,53,0,0,138,1,4,143
13,7,13008,142,3,28,93,84,8,3,216,3,12,231
13,7,13008,143,3,135,320,359,25,9,848,5,17,870
13,7,13008,144,3,68,121,132,42,3,366,0,7,373
13,7,13008,145,3,120,133,154,44,5,456,1,14,471
13,7,13008,146,3,202,245,168,37,13,665,5,22,692
13,7,13008,147,3,92,181,150,37,2,462,1,20,483
13,7,13008,148,3,90,168,144,9,3,414,0,24,438
13,7,13008,149,3,17,107,16,2,0,142,0,4,146
13,7,13008,150,3,55,129,104,11,3,302,0,9,311
13,7,13008,151,3,125,89,135,13,6,368,0,11,379
13,7,13015,257,3,420,177,258,37,20,912,4,29,945
13,7,13015,258,3,565,335,238,68,26,1232,2,29,1263
13,7,13015,259,3,359,277,180,53,18,887,3,16,906
13,7,13015,260,3,178,106,106,19,9,418,0,4,422
13,7,13015,261,3,288,208,168,35,11,710,2,17,729
13,7,13015,262,3,451,239,157,32,16,895,12,21,928
13,7,13015,263,3,245,159,118,19,10,551,1,9,561
13,7,13015,264,3,451,333,166,38,9,997,13,21,1031
13,7,13015,265,3,430,266,222,48,21,987,6,25,1018
13,7,13015,266,3,120,118,137,12,5,392,6,10,408
13,7,13015,267,3,124,84,91,10,1,310,4,17,331
13,7,13015,268,3,28,93,46,7,1,175,1,7,183
13,7,13015,269,3,340,401,286,56,19,1102,26,26,1154
13,7,13015,270,3,411,187,111,36,42,787,4,20,811
13,7,13015,271,3,399,299,231,50,11,990,0,31,1021
13,7,13015,272,3,62,116,50,37,2,267,2,20,289
13,7,13015,273,3,631,374,207,33,18,1263,12,50,1325
13,7,13015,274,3,396,379,624,85,42,1526,9,43,1578
13,7,13015,275,3,134,94,72,14,2,316,1,11,328
13,7,13015,276,3,138,65,71,8,4,286,3,15,304
13,7,13015,277,3,137,98,70,5,3,313,0,22,335
13,7,13015,278,3,118,112,100,11,7,348,2,9,359
13,7,13015,279,3,85,101,71,4,5,266,0,16,282
13,7,13015,280,3,302,120,132,51,7,612,12,15,639
13,7,13021,350,3,89,204,255,25,7,580,0,12,592
13,7,13021,351,3,121,261,283,37,7,709,1,18,728
13,7,13021,352,3,140,228,348,37,12,765,0,4,769
13,7,13021,353,3,130,210,368,49,19,776,3,14,793
13,7,13021,354,3,136,264,340,40,20,800,0,20,820
13,7,13021,355,3,109,256,233,65,13,676,3,16,695
13,7,13021,356,3,40,211,200,28,7,486,0,14,500
13,7,13021,357,3,63,227,292,33,6,621,2,23,646
13,7,13022,358,3,277,168,187,68,13,713,3,24,740
13,7,13022,359,3,229,120,138,76,13,576,5,15,596
13,7,13022,360,3,255,136,125,36,14,566,6,10,582
13,7,13022,361,3,165,73,79,20,1,338,3,11,352
13,7,13022,362,3,48,34,50,25,6,163,3,4,170
13,7,13022,363,3,314,196,268,54,10,842,5,19,866
13,7,13022,364,3,35,68,38,19,5,165,4,3,172
13,7,13022,365,3,45,91,64,27,1,228,1,11,240
13,7,13022,366,3,19,19,22,3,1,64,0,3,67
13,7,13022,367,3,133,119,81,29,7,369,1,16,386
13,7,13022,368,3,273,158,273,62,20,786,2,23,811
13,7,13056,1110,3,401,350,286,56,12,1105,6,15,1126
13,7,13056,1111,3,506,392,212,106,24,1240,3,18,1261
13,7,13056,1112,3,424,285,189,71,14,983,3,20,1006
13,7,13056,1113,3,282,307,211,62,19,881,1,21,903
13,7,13056,1114,3,478,582,395,87,36,1578,9,44,1631
13,7,13056,1115,3,20,79,49,26,6,180,2,8,190
13,7,13056,1116,3,560,353,418,114,40,1485,11,28,1524
13,7,13056,1117,3,137,162,128,40,12,479,5,13,497
13,7,13056,1118,3,298,361,275,40,23,997,8,31,1036
13,7,13056,1119,3,22,82,23,4,0,131,1,4,136
13,7,13056,1120,3,147,182,99,25,9,462,1,13,476
13,7,13057,1121,3,404,331,384,86,26,1231,3,34,1268
13,7,13057,1122,3,200,175,218,40,14,647,4,27,678
13,7,13057,1123,3,184,185,270,32,17,688,5,28,721
13,7,13057,1124,3,100,107,72,25,4,308,0,29,337
13,7,13057,1125,3,98,160,187,31,9,485,11,13,509
13,7,13057,1126,3,52,58,74,13,7,204,1,8,213
13,7,13057,1127,3,41,94,66,10,2,213,0,3,216
13,7,13057,1128,3,77,98,54,14,3,246,0,7,253
13,7,13057,1129,3,34,105,52,7,0,198,0,11,209
13,7,13057,1130,3,51,116,139,15,8,329,12,19,360
13,7,13057,1131,3,48,86,130,7,5,276,0,5,281
13,7,13061,1191,3,204,266,419,50,17,956,1,18,975
13,7,13061,1192,3,151,220,347,53,10,781,7,26,814
13,7,13061,1193,3,179,248,308,60,12,807,4,12,823
13,7,13061,1194,3,61,105,126,21,9,322,0,3,325
13,7,13061,1195,3,93,156,263,32,9,553,0,8,561
13,7,13061,1196,3,156,170,343,61,16,746,0,35,781
13,7,13061,1197,3,205,389,439,52,20,1105,0,27,1132
13,7,13061,1198,3,73,144,235,28,6,486,0,15,501
13,7,13061,1199,3,152,218,336,65,4,775,0,16,791
13,7,13061,1200,3,31,52,51,6,2,142,1,3,146
13,7,13061,1201,3,38,104,86,11,1,240,0,11,251
13,7,13061,1202,3,59,135,80,21,8,303,0,14,317
13,7,13061,1203,3,3,40,18,1,0,62,0,4,66
13,7,13061,1204,3,31,107,59,17,3,217,0,13,230
13,7,13061,1205,3,82,187,115,26,1,411,0,8,419
13,7,13061,1206,3,69,71,179,21,10,350,0,7,357
13,7,13061,1207,3,74,59,146,40,6,325,1,5,331
13,7,13061,1208,3,108,122,246,34,13,523,1,13,537
13,7,13061,1209,3,146,176,337,50,12,721,2,16,739
13,7,13061,1210,3,115,136,269,29,16,565,1,13,579
13,7,13061,1211,3,134,127,231,47,16,555,1,9,565
13,7,13061,1212,3,311,228,377,58,30,1004,1,16,1021
13,7,13061,1213,3,175,167,288,34,9,673,1,16,690
13,7,13061,1214,3,119,108,235,30,15,507,0,11,518
13,7,13061,1215,3,275,194,392,59,29,949,1,23,973
13,7,13061,1216,3,145,128,243,45,11,572,1,8,581
13,7,13061,1217,3,177,193,312,53,14,749,0,10,759
13,7,13061,1218,3,220,203,228,50,19,720,2,9,731
13,7,13061,1219,3,121,99,217,21,12,470,2,4,476
13,7,13061,1220,3,337,239,315,60,30,981,0,15,996
13,7,13061,1221,3,219,159,304,63,19,764,0,10,774
13,7,13061,1222,3,201,210,335,73,24,843,3,9,855
13,7,13061,1223,3,152,138,233,48,13,584,2,10,596
13,7,13061,1224,3,280,302,506,87,29,1204,0,26,1230
13,7,13061,1225,3,109,150,251,46,15,571,2,3,576
13,7,13061,1226,3,84,151,118,22,4,379,0,27,406
13,7,13061,1227,3,109,134,174,17,6,440,0,12,452
13,7,13061,1228,3,76,229,366,80,10,761,2,11,774
13,7,13068,1349,3,305,563,578,107,43,1596,9,39,1644
13,7,13068,1350,3,295,336,482,81,40,1234,3,24,1261
13,7,13068,1351,3,267,437,352,87,33,1176,1,18,1195
13,7,13068,1352,3,341,458,452,101,47,1399,6,42,1447
13,7,13068,1353,3,363,389,373,55,42,1222,3,21,1246
13,7,13068,1354,3,211,205,275,52,23,766,0,32,798
13,7,13068,1355,3,284,330,318,89,31,1052,2,17,1071
13,7,13068,1356,3,219,312,257,79,28,895,3,13,911
13,7,13068,1357,3,252,224,222,48,24,770,0,26,796
13,7,13068,1358,3,414,377,593,100,58,1542,2,19,1563
13,7,13068,1359,3,261,161,244,45,21,732,1,18,751
13,7,13068,1360,3,210,198,281,66,35,790,2,18,810
13,7,13068,1361,3,196,154,231,51,16,648,0,8,656
13,7,13068,1362,3,609,477,858,168,80,2192,0,36,2228
13,7,13068,1363,3,412,345,651,115,52,1575,5,27,1607
13,7,13068,1364,3,98,78,170,32,15,393,0,7,400
13,7,13068,1365,3,192,185,273,52,12,714,2,23,739
13,7,13068,1366,3,250,216,290,54,21,831,4,17,852
13,7,13068,1367,3,419,401,603,101,63,1587,6,41,1634
13,7,13068,1368,3,416,442,544,140,50,1592,5,23,1620
13,7,13071,1395,3,88,178,297,113,10,686,2,16,704
13,7,13071,1396,3,91,171,273,91,8,634,4,15,653
13,7,13071,1397,3,102,215,283,82,8,690,1,8,699
13,7,13071,1398,3,85,185,433,90,8,801,3,10,814
13,7,13071,1399,3,116,175,440,61,20,812,3,22,837
13,7,13071,1400,3,16,57,78,22,1,174,1,8,183
13,7,13071,1401,3,51,89,158,22,3,323,0,12,335
13,7,13071,1402,3,165,140,171,85,15,576,0,12,588
13,7,13074,1441,3,189,112,199,59,8,567,0,8,575
13,7,13074,1442,3,393,203,185,96,11,888,1,18,907
13,7,13074,1443,3,156,104,80,48,7,395,0,2,397
13,7,13074,1444,3,233,265,231,89,14,832,0,15,847
13,7,13074,1445,3,64,111,87,55,8,325,2,0,327
13,7,13074,1446,3,84,167,123,66,9,449,3,0,452
13,7,13074,1447,3,216,220,307,337,29,1109,13,34,1156
13,7,13074,1448,3,58,41,41,18,4,162,0,4,166
13,7,13077,1556,3,216,165,150,227,18,776,5,31,812
13,7,13077,1557,3,179,159,124,107,17,586,3,13,602
13,7,13077,1558,3,167,112,126,94,20,519,1,13,533
13,7,13077,1559,3,164,143,144,107,5,563,4,12,579
13,7,13077,1560,3,140,126,98,69,5,438,0,19,457
13,7,13077,1561,3,240,175,214,138,7,774,6,25,805
13,7,13077,1562,3,28,23,32,18,1,102,1,6,109
13,7,13082,1619,3,421,370,260,71,29,1151,3,16,1170
13,7,13082,1620,3,451,285,212,69,26,1043,6,17,1066
13,7,13082,1621,3,304,301,262,37,29,933,3,25,961
13,7,13082,1622,3,207,180,191,49,17,644,6,14,664
13,7,13082,1623,3,272,187,189,33,18,699,0,7,706
13,7,13082,1624,3,136,148,140,22,16,462,3,19,484
13,7,13082,1625,3,343,318,248,84,23,1016,1,26,1043
13,7,13082,1626,3,209,186,195,23,12,625,4,9,638
13,7,13083,1627,3,158,188,242,39,13,640,1,21,662
13,7,13083,1628,3,223,271,386,62,24,966,3,21,990
13,7,13083,1629,3,255,299,464,57,24,1099,4,25,1128
13,7,13083,1630,3,160,153,230,69,20,632,3,16,651
13,7,13083,1631,3,317,391,265,178,23,1174,2,37,1213
13,7,13083,1632,3,191,203,228,38,7,667,2,27,696
13,7,13083,1633,3,154,232,276,42,11,715,7,21,743
13,7,13083,1634,3,75,78,136,23,8,320,0,10,330
13,7,13083,1635,3,112,226,161,58,7,564,1,18,583
13,7,13083,1636,3,65,125,111,21,11,333,1,9,343
13,7,13083,1637,3,345,374,300,70,12,1101,0,32,1133
13,7,13083,1638,3,69,326,224,30,8,657,2,18,677
13,7,13083,1639,3,81,169,164,25,13,452,2,21,475
13,7,13083,1640,3,42,62,59,12,4,179,2,11,192
13,7,13083,1641,3,86,137,265,27,4,519,0,21,540
13,7,13083,1642,3,254,178,265,50,11,758,1,19,778
13,7,13083,1643,3,106,85,94,20,6,311,1,3,315
14,1,14003,24,3,300,350,192,41,10,893,0,26,919
14,1,14003,25,3,242,321,162,30,13,768,1,22,791
14,1,14003,26,3,185,269,120,26,6,606,2,14,622
14,1,14003,27,3,250,336,210,39,9,844,5,18,867
14,1,14003,28,3,231,324,154,38,4,751,1,26,778
14,1,14003,29,3,435,509,185,79,19,1227,2,44,1273
14,1,14003,30,3,231,236,116,20,12,615,2,13,630
14,1,14003,31,3,367,432,274,57,31,1161,8,46,1215
14,1,14003,32,3,34,66,83,0,1,184,0,12,196
14,1,14003,33,3,216,370,106,34,16,742,5,35,782
14,1,14003,34,3,366,364,181,35,11,957,1,51,1009
14,1,14003,35,3,189,260,256,14,11,730,0,48,778
14,1,14005,40,3,334,445,205,158,13,1155,0,34,1189
14,1,14005,41,3,327,343,196,124,6,996,1,38,1035
14,1,14005,42,3,287,404,246,163,2,1102,0,49,1151
14,1,14005,43,3,408,440,258,142,12,1260,1,40,1301
14,1,14005,44,3,109,101,88,14,2,314,0,8,322
14,1,14005,45,3,33,161,81,19,0,294,2,3,299
14,1,14005,46,3,20,98,105,0,2,225,0,11,236
14,1,14005,47,3,135,282,77,49,4,547,0,9,556
14,1,14007,94,3,394,293,194,32,23,936,0,31,967
14,1,14007,95,3,357,221,136,20,30,764,0,26,790
14,1,14007,96,3,264,204,75,11,41,595,2,19,616
14,1,14007,97,3,150,189,64,7,9,419,3,18,440
14,1,14007,98,3,82,115,71,21,9,298,0,20,318
14,1,14007,99,3,49,80,28,1,5,163,0,3,166
14,1,14007,100,3,131,120,37,10,7,305,0,3,308
14,1,14007,101,3,147,79,83,8,4,321,0,9,330
14,1,14009,139,3,764,562,174,67,12,1579,1,52,1632
14,1,14009,140,3,608,524,129,98,21,1380,1,41,1422
14,1,14009,141,3,728,696,143,54,19,1640,0,56,1696
14,1,14009,142,3,430,564,84,49,23,1150,0,49,1199
14,1,14009,143,3,683,283,69,68,14,1117,6,36,1159
14,1,14019,292,3,366,255,36,6,2,665,0,2,667
14,1,14019,293,3,155,148,18,2,1,324,0,15,339
14,1,14019,294,3,771,937,86,5,5,1804,2,60,1866
14,1,14019,295,3,128,151,4,7,3,293,0,10,303
14,1,14026,411,3,383,212,53,13,2,663,3,25,691
14,1,14026,412,3,128,131,19,1,3,282,0,12,294
14,1,14026,413,3,272,233,59,15,3,582,0,19,601
14,1,14026,414,3,312,286,66,21,4,689,3,31,723
14,1,14026,415,3,356,267,69,20,8,720,0,14,734
14,1,14026,416,3,273,232,60,13,7,585,1,19,605
14,1,14026,417,3,244,191,33,9,4,481,1,23,505
14,1,14026,418,3,257,184,39,12,3,495,3,9,507
14,1,14026,419,3,275,320,68,20,7,690,5,27,722
14,1,14026,420,3,446,361,101,33,9,950,2,22,974
14,1,14026,421,3,137,66,15,3,0,221,0,9,230
14,1,14026,422,3,33,10,26,1,1,71,0,3,74
14,1,14026,423,3,38,46,15,1,0,100,0,5,105
14,1,14026,424,3,92,53,5,1,2,153,1,1,155
14,1,14026,425,3,326,68,51,2,4,451,1,19,471
14,1,14026,426,3,160,63,7,2,1,233,0,5,238
14,1,14030,445,3,359,258,163,138,10,928,2,10,940
14,1,14030,446,3,366,195,183,160,15,919,0,23,942
14,1,14030,447,3,187,186,132,91,16,612,0,14,626
14,1,14030,448,3,203,203,135,134,7,682,0,0,682
14,1,14030,449,3,197,118,76,47,14,452,13,22,487
14,1,14030,450,3,106,178,202,147,7,640,7,24,671
14,1,14030,451,3,137,171,64,80,12,464,0,21,485
14,1,14030,452,3,125,61,82,37,4,309,0,19,328
14,1,14030,453,3,223,158,166,76,7,630,0,37,667
14,1,14030,454,3,120,95,182,103,5,505,1,22,528
14,1,14030,455,3,121,145,147,111,4,528,0,0,528
14,1,14030,456,3,148,145,67,54,5,419,0,24,443
14,1,14032,476,3,246,327,30,4,1,608,1,27,636
14,1,14032,477,3,156,314,16,4,6,496,1,26,523
14,1,14032,478,3,85,107,7,1,1,201,1,8,210
14,1,14037,530,3,371,307,113,46,15,852,1,90,943
14,1,14037,531,3,594,300,156,47,14,1111,2,27,1140
14,1,14037,532,3,425,359,107,57,15,963,3,24,990
14,1,14037,533,3,376,270,77,37,7,767,5,7,779
14,1,14037,534,3,192,165,55,26,7,445,0,4,449
14,1,14037,535,3,271,293,75,21,9,669,0,22,691
14,1,14037,536,3,356,324,132,59,14,885,3,16,904
14,1,14037,537,3,130,182,40,8,6,366,0,7,373
14,1,14037,538,3,270,208,113,24,1,616,0,22,638
14,1,14037,539,3,386,299,66,26,5,782,1,30,813
14,1,14037,540,3,44,63,15,1,4,127,2,1,130
14,1,14042,1549,3,235,185,46,9,1,476,3,39,518
14,1,14042,1550,3,95,100,27,3,2,227,0,13,240
14,1,14042,1551,3,93,102,29,0,1,225,0,14,239
14,1,14042,1552,3,247,190,35,10,5,487,0,15,502
14,1,14042,1553,3,335,303,102,4,3,747,1,19,767
14,1,14042,1554,3,61,99,9,4,4,177,0,10,187
14,1,14042,1555,3,8,29,19,1,0,57,0,2,59
14,1,14042,1556,3,11,109,7,0,0,127,0,6,133
14,1,14042,1557,3,62,39,9,0,0,110,0,6,116
14,1,14042,1558,3,157,169,36,0,2,364,0,15,379
14,1,14042,1559,3,47,115,14,0,0,176,0,9,185
14,1,14042,1560,3,180,178,14,4,2,378,3,17,398
14,1,14043,1561,3,242,182,171,7,5,607,0,21,628
14,1,14043,1562,3,364,285,159,20,5,833,1,15,849
14,1,14043,1563,3,204,172,147,5,9,537,2,21,560
14,1,14043,1564,3,312,102,67,3,6,490,0,11,501
14,1,14043,1565,3,195,227,52,1,3,478,0,19,497
14,1,14044,1566,3,357,301,92,5,3,758,0,22,780
14,1,14044,1567,3,476,223,150,4,0,853,0,27,880
14,1,14044,1568,3,385,170,116,2,3,676,0,32,708
14,1,14044,1569,3,187,120,57,2,3,369,1,17,387
14,1,14044,1570,3,105,37,18,1,1,162,0,7,169
14,1,14044,1571,3,31,49,11,1,2,94,0,4,98
14,1,14044,1572,3,174,247,114,3,0,538,0,14,552
14,1,14047,1602,3,274,404,156,53,21,908,1,24,933
14,1,14047,1603,3,224,235,65,21,6,551,4,23,578
14,1,14047,1604,3,364,382,107,41,16,910,0,45,955
14,1,14047,1605,3,387,427,119,34,12,979,0,44,1023
14,1,14047,1606,3,129,193,98,11,17,448,2,34,484
14,1,14047,1607,3,179,323,65,23,18,608,0,19,627
14,1,14047,1608,3,147,261,87,29,11,535,2,10,547
14,1,14047,1609,3,422,359,208,43,21,1053,3,51,1107
14,1,14047,1610,3,250,136,123,17,5,531,0,20,551
14,1,14047,1611,3,117,183,82,11,8,401,3,13,417
14,1,14047,1612,3,154,89,136,13,60,452,0,5,457
14,1,14057,1782,3,392,291,47,3,4,737,0,20,757
14,1,14057,1783,3,450,414,97,12,6,979,0,29,1008
14,1,14057,1784,3,677,689,185,23,14,1588,1,33,1622
14,1,14057,1785,3,361,324,95,6,1,787,0,22,809
14,1,14057,1786,3,293,324,54,6,5,682,0,5,687
14,1,14057,1787,3,334,474,57,11,6,882,0,25,907
14,1,14057,1788,3,206,217,45,3,2,473,0,9,482
14,1,14057,1789,3,261,142,46,10,4,463,0,15,478
14,1,14057,1790,3,103,289,32,4,1,429,2,16,447
14,1,14057,1791,3,283,389,16,1,2,691,3,8,702
14,1,14063,1831,3,393,213,29,17,4,656,0,35,691
14,1,14063,1832,3,266,171,30,20,1,488,0,14,502
14,1,14063,1833,3,61,33,4,4,0,102,0,3,105
14,1,14063,1834,3,162,136,2,1,1,302,0,5,307
14,1,14063,1835,3,166,85,5,1,1,258,0,6,264
14,1,14063,1837,3,534,438,187,6,6,1171,11,115,1297
14,1,14063,1838,3,341,256,158,0,8,763,0,62,825
14,1,14063,1839,3,579,513,637,14,8,1751,3,77,1831
14,1,14073,2050,3,232,285,28,22,4,571,0,27,598
14,1,14073,2051,3,87,85,9,11,1,193,0,4,197
14,1,14073,2052,3,191,209,14,24,0,438,1,15,454
14,1,14073,2053,3,62,57,12,7,1,139,0,3,142
14,1,14073,2054,3,68,11,2,5,2,88,0,15,103
14,1,14077,2107,3,216,312,202,52,8,790,1,26,817
14,1,14077,2108,3,289,330,174,40,9,842,2,16,860
14,1,14077,2109,3,12,31,11,1,0,55,0,3,58
14,1,14078,2110,3,155,87,11,2,0,255,0,2,257
14,1,14078,2111,3,298,304,10,5,1,618,0,22,640
14,1,14078,2112,3,75,106,1,0,0,182,0,3,185
14,1,14078,2113,3,39,46,1,1,0,87,0,7,94
14,1,14078,2114,3,15,57,1,0,0,73,0,2,75
14,1,14082,2157,3,119,56,74,3,4,256,0,8,264
14,1,14082,2158,3,247,131,66,8,11,463,0,14,477
14,1,14082,2159,3,113,82,21,5,3,224,0,7,231
14,1,14082,2160,3,260,165,112,8,2,547,1,13,561
14,1,14082,2161,3,186,47,74,1,0,308,0,10,318
14,1,14084,2181,3,309,227,157,86,97,876,0,31,907
14,1,14084,2182,3,429,452,288,153,85,1407,3,54,1464
14,1,14084,2183,3,170,158,84,47,21,480,1,11,492
14,1,14084,2184,3,272,215,161,42,20,710,0,16,726
14,1,14084,2185,3,287,238,188,63,21,797,0,26,823
14,1,14084,2186,3,203,189,250,69,24,735,2,19,756
14,1,14084,2187,3,213,244,258,73,27,815,2,18,835
14,1,14084,2188,3,285,186,218,49,30,768,0,23,791
14,1,14084,2189,3,275,220,251,114,49,909,1,28,938
14,1,14084,2190,3,196,216,244,57,24,737,3,30,770
14,1,14084,2191,3,312,214,195,61,18,800,0,16,816
14,1,14084,2192,3,163,193,92,30,13,491,0,9,500
14,1,14084,2193,3,376,250,134,51,14,825,0,33,858
14,1,14084,2194,3,279,216,141,78,14,728,1,17,746
14,1,14084,2195,3,265,177,74,38,8,562,0,8,570
14,1,14084,2196,3,356,190,130,33,19,728,0,21,749
14,1,14084,2197,3,184,210,135,45,19,593,1,5,599
14,1,14084,2198,3,231,412,258,142,56,1099,0,43,1142
14,1,14084,2199,3,91,240,152,55,29,567,0,19,586
14,1,14084,2200,3,86,189,133,37,17,462,4,9,475
14,1,14084,2201,3,95,209,214,29,7,554,0,25,579
14,1,14084,2202,3,61,128,144,18,5,356,0,12,368
14,1,14084,2203,3,70,56,47,14,10,197,2,9,208
14,1,14084,2204,3,169,318,132,44,20,683,1,31,715
14,1,14084,2205,3,244,307,213,46,37,847,0,29,876
14,1,14084,2206,3,279,325,106,33,63,806,1,56,863
14,1,14084,2207,3,273,249,137,51,29,739,0,25,764
14,1,14084,2208,3,177,238,141,29,10,595,4,18,617
14,1,14084,2209,3,118,192,121,15,6,452,5,20,477
14,1,14084,2210,3,605,527,314,114,32,1592,2,49,1643
14,1,14084,2211,3,41,114,41,10,3,209,2,12,223
14,1,14095,2396,3,644,294,189,15,10,1152,1,36,1189
14,1,14095,2397,3,334,139,94,15,3,585,1,19,605
14,1,14095,2398,3,375,154,82,12,3,626,1,11,638
14,1,14095,2399,3,283,164,72,4,3,526,0,9,535
14,1,14095,2400,3,818,271,204,11,10,1314,1,33,1348
14,1,14095,2401,3,485,240,115,19,9,868,2,20,890
14,1,14095,2402,3,338,174,141,14,7,674,1,16,691
14,1,14095,2403,3,322,191,101,11,2,627,1,14,642
14,1,14095,2404,3,429,226,142,19,3,819,0,19,838
14,1,14095,2405,3,498,266,120,23,8,915,0,13,928
14,1,14095,2406,3,481,225,271,20,6,1003,0,19,1022
14,1,14095,2407,3,623,288,243,26,11,1191,5,35,1231
14,1,14095,2408,3,403,174,213,15,6,811,4,13,828
14,1,14095,2409,3,143,11,3,2,0,159,0,1,160
14,1,14095,2410,3,121,31,11,1,1,165,1,6,172
14,1,14095,2411,3,63,48,5,1,0,117,0,1,118
14,1,14095,2412,3,443,97,38,6,4,588,0,15,603
14,1,14095,2413,3,501,180,52,7,5,745,0,21,766
14,1,14095,2414,3,120,30,37,4,0,191,0,7,198
14,1,14095,2415,3,87,156,100,4,2,349,0,22,371
14,1,14095,2416,3,81,31,32,1,0,145,1,13,159
14,1,14095,2417,3,252,115,129,10,4,510,0,31,541
14,1,14096,2418,3,231,440,449,13,9,1142,0,44,1186
14,1,14096,2419,3,182,284,222,7,6,701,1,29,731
14,1,14096,2420,3,115,126,121,10,0,372,0,11,383
14,1,14096,2421,3,49,127,94,1,2,273,0,10,283
14,1,14096,2422,3,240,404,181,8,4,837,0,27,864
14,1,14096,2423,3,334,371,318,9,2,1034,1,16,1051
14,1,14105,2742,3,291,164,134,1,4,594,0,19,613
14,1,14105,2743,3,252,141,97,5,7,502,0,17,519
14,1,14105,2744,3,74,57,44,0,0,175,0,7,182
14,1,14105,2745,3,81,19,14,0,0,114,0,2,116
14,1,14105,2746,3,113,75,60,1,1,250,0,5,255
14,1,14105,2747,3,349,233,177,6,5,770,0,25,795
14,1,14115,2839,3,210,279,71,6,10,576,0,14,590
14,1,14115,2840,3,229,167,52,4,2,454,0,11,465
14,1,14115,2841,3,257,199,119,7,4,586,0,9,595
14,1,14115,2842,3,264,228,73,6,3,574,0,6,580
14,1,14115,2843,3,38,62,19,0,0,119,0,2,121
14,1,14115,2844,3,57,74,93,0,1,225,0,5,230
14,1,14115,2845,3,20,46,30,0,0,96,0,2,98
14,1,14115,2846,3,28,17,17,0,0,62,0,3,65
14,2,14036,501,3,432,663,80,40,10,1225,2,29,1256
14,2,14036,502,3,348,356,28,28,3,763,0,27,790
14,2,14036,503,3,442,415,38,41,10,946,1,18,965
14,2,14036,504,3,418,386,28,42,6,880,4,28,912
14,2,14036,505,3,827,631,60,47,13,1578,0,35,1613
14,2,14036,506,3,592,380,48,40,13,1073,5,14,1092
14,2,14036,507,3,366,216,28,27,3,640,0,7,647
14,2,14036,508,3,258,258,31,17,1,565,0,13,578
14,2,14036,509,3,556,571,41,58,12,1238,1,44,1283
14,2,14036,510,3,360,292,34,31,6,723,0,16,739
14,2,14036,511,3,345,46,16,6,3,416,0,23,439
14,2,14036,512,3,482,305,144,17,6,954,0,30,984
14,2,14036,513,3,117,97,3,2,2,221,0,9,230
14,2,14036,514,3,69,37,9,4,1,120,0,6,126
14,2,14036,515,3,1356,250,56,41,12,1715,4,35,1754
14,2,14036,517,3,33,14,2,1,2,52,0,2,54
14,2,14036,518,3,224,26,4,9,5,268,0,7,275
14,2,14036,519,3,127,83,5,5,3,223,0,6,229
14,2,14036,520,3,682,464,43,40,11,1240,0,50,1290
14,2,14036,521,3,461,226,20,22,4,733,0,26,759
14,2,14036,522,3,86,77,1,3,0,167,0,6,173
14,2,14036,523,3,31,106,8,2,2,149,0,0,149
14,2,14036,524,3,34,32,5,5,0,76,0,2,78
14,2,14036,525,3,496,366,35,12,2,911,0,24,935
14,2,14036,526,3,452,182,22,27,2,685,0,19,704
14,2,14036,527,3,498,337,31,25,11,902,0,55,957
14,2,14036,528,3,97,66,2,3,0,168,0,15,183
14,2,14036,529,3,73,45,3,9,1,131,0,6,137
14,2,14055,1702,3,1307,623,182,87,29,2228,3,25,2256
14,2,14055,1703,3,709,248,100,42,20,1119,3,15,1137
14,2,14055,1704,3,609,311,90,33,13,1056,3,24,1083
14,2,14055,1705,3,320,188,44,10,10,572,3,12,587
14,2,14055,1706,3,849,443,112,66,21,1491,5,38,1534
14,2,14055,1707,3,970,436,117,52,25,1600,5,27,1632
14,2,14055,1708,3,750,365,139,48,10,1312,2,33,1347
14,2,14055,1709,3,607,291,115,35,11,1059,4,25,1088
14,2,14055,1710,3,501,164,49,28,11,753,3,25,781
14,2,14055,1711,3,1276,522,170,102,35,2105,3,48,2156
14,2,14055,1712,3,419,168,29,27,11,654,1,15,670
14,2,14055,1713,3,1175,576,141,66,30,1988,5,48,2041
14,2,14055,1714,3,816,325,153,39,11,1344,4,36,1384
14,2,14055,1715,3,1174,464,114,57,25,1834,5,46,1885
14,2,14055,1716,3,284,48,21,0,5,358,0,1,359
14,2,14055,1717,3,306,150,45,11,8,520,0,9,529
14,2,14055,1718,3,177,96,26,9,8,316,0,5,321
14,2,14055,1719,3,549,335,52,24,16,976,0,20,996
14,2,14055,1720,3,322,113,41,19,3,498,1,5,504
14,2,14055,1721,3,423,183,47,13,14,680,0,11,691
14,2,14055,1722,3,433,176,47,9,6,671,0,11,682
14,2,14055,1723,3,428,169,24,17,6,644,1,9,654
14,2,14055,1724,3,254,187,26,11,10,488,0,3,491
14,2,14055,1725,3,108,38,17,4,3,170,0,2,172
14,2,14055,1726,3,332,130,27,9,11,509,4,6,519
14,2,14055,1727,3,55,35,2,2,0,94,0,0,94
14,2,14055,1728,3,198,125,20,6,7,356,1,7,364
14,2,14055,1729,3,688,343,83,25,13,1152,1,13,1166
14,2,14055,1730,3,562,264,64,29,12,931,1,16,948
14,2,14055,1731,3,1137,475,120,46,24,1802,3,24,1829
14,2,14055,1732,3,536,297,93,31,9,966,1,22,989
14,2,14055,1733,3,505,249,60,22,12,848,1,12,861
14,2,14055,1734,3,760,344,111,69,19,1303,0,26,1329
14,2,14055,1735,3,900,418,81,50,20,1469,1,18,1488
14,2,14055,1736,3,584,215,56,24,11,890,2,20,912
14,2,14055,1737,3,192,193,17,7,2,411,1,12,424
14,2,14055,1738,3,107,163,107,9,7,393,0,15,408
14,2,14055,1739,3,248,195,91,14,7,555,1,22,578
14,2,14055,1740,3,259,104,49,11,4,427,0,21,448
14,2,14055,1741,3,263,126,16,6,5,416,0,27,443
14,2,14055,1742,3,162,126,20,9,1,318,1,2,321
14,2,14055,1743,3,198,119,30,16,1,364,7,17,388
14,2,14055,1744,3,22,41,4,0,0,67,0,8,75
14,2,14055,1745,3,174,71,9,1,2,257,2,8,267
14,2,14055,1746,3,122,66,7,4,3,202,0,6,208
14,2,14055,1747,3,156,176,54,11,7,404,0,29,433
14,2,14055,1748,3,925,385,79,46,25,1460,1,25,1486
14,2,14055,1749,3,611,335,108,40,19,1113,3,43,1159
14,2,14055,1750,3,82,44,4,1,1,132,1,1,134
14,2,14055,1751,3,98,24,5,3,0,130,0,0,130
14,2,14055,1752,3,99,68,8,3,6,184,0,0,184
14,2,14055,1753,3,67,68,8,2,1,146,1,6,153
14,2,14055,1754,3,272,447,82,27,10,838,8,36,882
14,2,14055,1755,3,197,64,13,2,2,278,0,11,289
14,2,14055,1756,3,32,14,2,2,0,50,0,0,50
14,2,14055,1757,3,397,231,35,11,7,681,3,14,698
14,2,14055,1758,3,22,68,1,2,0,93,1,4,98
14,2,14055,1759,3,289,72,30,7,3,401,0,8,409
14,2,14055,1760,3,297,240,36,12,6,591,5,9,605
14,2,14055,1761,3,314,161,25,5,3,508,2,12,522
14,2,14055,1762,3,88,214,13,8,5,328,1,18,347
14,2,14055,1763,3,1057,744,138,41,20,2000,7,62,2069
14,2,14055,1764,3,134,59,20,3,1,217,0,0,217
14,2,14055,1765,3,133,165,10,3,2,313,0,17,330
14,2,14055,1766,3,101,34,2,2,2,141,0,2,143
14,2,14055,1767,3,461,156,33,6,7,663,8,23,694
14,2,14055,1768,3,229,114,35,2,1,381,1,13,395
14,2,14055,1769,3,315,150,32,13,3,513,1,9,523
14,2,14055,1770,3,36,98,12,1,2,149,1,13,163
14,2,14055,1771,3,1074,571,119,55,26,1845,4,56,1905
14,2,14055,1772,3,300,241,43,10,8,602,1,23,626
14,2,14055,1773,3,94,265,35,7,4,405,4,22,431
14,2,14055,1774,3,83,120,17,2,5,227,0,12,239
14,2,14055,1775,3,42,11,1,0,0,54,0,3,57
14,2,14066,1886,3,404,264,366,37,19,1090,4,27,1121
14,2,14066,1887,3,298,168,280,41,22,809,1,37,847
14,2,14066,1888,3,284,225,259,41,27,836,3,26,865
14,2,14066,1889,3,357,325,416,97,36,1231,0,53,1284
14,2,14066,1890,3,71,136,244,6,28,485,0,11,496
14,2,14066,1891,3,120,49,106,10,23,308,0,0,308
14,2,14066,1892,3,367,263,311,39,77,1057,4,94,1155
14,2,14066,1893,3,116,109,75,8,17,325,4,20,349
14,2,14066,1894,3,30,179,82,17,12,320,0,14,334
14,2,14066,1895,3,166,109,365,28,21,689,0,25,714
14,2,14066,1896,3,175,236,377,23,15,826,4,44,874
14,2,14066,1897,3,134,188,149,14,14,499,4,22,525
14,2,14066,1898,3,67,48,41,8,5,169,0,8,177
14,2,14066,1899,3,112,145,166,10,19,452,1,26,479
14,2,14066,1900,3,455,91,59,10,10,625,0,18,643
14,2,14075,2063,3,1346,460,38,54,20,1918,18,32,1968
14,2,14075,2064,3,688,273,33,32,12,1038,9,30,1077
14,2,14075,2065,3,604,184,15,10,4,817,0,7,824
14,2,14075,2066,3,958,461,73,58,27,1577,6,51,1634
14,2,14075,2067,3,855,302,22,35,7,1221,1,34,1256
14,2,14075,2068,3,1022,365,229,54,12,1682,5,68,1755
14,2,14075,2069,3,682,182,19,33,7,923,3,19,945
14,2,14075,2070,3,346,80,10,6,1,443,1,5,449
14,2,14075,2071,3,229,54,6,2,1,292,0,4,296
14,2,14075,2072,3,364,86,13,10,2,475,0,10,485
14,2,14075,2073,3,483,100,9,8,6,606,0,25,631
14,2,14075,2074,3,811,252,37,45,9,1154,5,17,1176
14,2,14075,2075,3,504,165,29,14,12,724,2,26,752
14,2,14075,2076,3,670,246,27,47,8,998,3,37,1038
14,2,14075,2077,3,595,159,28,18,3,803,1,12,816
14,2,14075,2078,3,708,194,19,26,7,954,2,13,969
14,2,14075,2079,3,956,270,61,41,7,1335,0,47,1382
14,2,14075,2080,3,184,27,7,1,0,219,0,11,230
14,2,14075,2081,3,613,148,19,20,2,802,0,27,829
14,2,14075,2082,3,341,82,19,5,4,451,2,4,457
14,2,14075,2083,3,186,185,18,8,3,400,0,14,414
14,2,14075,2084,3,648,117,38,13,8,824,3,18,845
14,2,14075,2085,3,147,103,16,7,1,274,3,10,287
14,2,14075,2086,3,183,74,6,9,3,275,1,16,292
14,2,14075,2087,3,176,80,35,6,2,299,0,5,304
14,2,14075,2088,3,144,48,3,12,1,208,0,7,215
14,2,14075,2089,3,121,75,4,5,1,206,0,12,218
14,2,14075,2090,3,136,41,6,5,2,190,2,5,197
14,2,14075,2091,3,89,50,4,6,0,149,0,7,156
14,2,14075,2092,3,183,73,8,7,2,273,1,7,281
14,2,14075,2093,3,738,231,41,44,16,1070,1,23,1094
14,2,14075,2094,3,525,255,18,32,6,836,0,25,861
14,2,14075,2095,3,104,16,2,4,1,127,0,1,128
14,2,14075,2096,3,86,20,3,3,0,112,0,2,114
14,2,14092,2307,3,480,332,196,83,17,1108,2,24,1134
14,2,14092,2308,3,688,374,186,96,15,1359,0,52,1411
14,2,14092,2309,3,209,136,120,45,4,514,1,23,538
14,2,14092,2310,3,185,127,60,46,6,424,2,16,442
14,2,14092,2311,3,277,137,75,52,7,548,1,26,575
14,2,14092,2312,3,98,69,60,21,1,249,0,11,260
14,2,14092,2313,3,390,182,162,30,14,778,7,14,799
14,2,14092,2314,3,110,69,34,26,2,241,1,0,242
14,2,14092,2315,3,272,148,94,67,11,592,0,14,606
14,2,14092,2316,3,354,308,227,88,7,984,1,78,1063
14,2,14092,2317,3,195,123,66,52,2,438,0,18,456
14,2,14092,2318,3,698,526,235,162,18,1639,2,87,1728
14,2,14092,2319,3,363,407,185,37,13,1005,1,39,1045
14,2,14092,2320,3,295,295,201,35,6,832,0,43,875
14,2,14092,2321,3,120,97,56,4,7,284,4,21,309
14,2,14092,2322,3,228,126,45,15,10,424,0,33,457
14,2,14092,2323,3,250,256,62,28,8,604,4,39,647
14,2,14092,2324,3,285,250,55,40,8,638,1,24,663
14,2,14092,2325,3,106,139,73,5,2,325,2,8,335
14,2,14092,2326,3,214,147,51,21,6,439,0,24,463
14,2,14092,2327,3,72,118,16,5,1,212,2,15,229
14,2,14092,2328,3,172,165,88,23,4,452,1,29,482
14,2,14092,2329,3,41,49,18,2,0,110,0,14,124
14,2,14110,2794,3,743,611,59,28,15,1456,1,39,1496
14,2,14110,2795,3,268,186,26,7,4,491,0,13,504
14,2,14110,2796,3,781,380,53,6,14,1234,1,46,1281
14,2,14110,2797,3,455,167,75,7,6,710,0,35,745
14,2,14110,2798,3,231,114,8,3,2,358,0,15,373
14,2,14110,2799,3,95,109,31,0,5,240,0,15,255
14,2,14110,2800,3,140,647,71,6,7,871,0,49,920
14,2,14110,2801,3,138,162,42,2,7,351,3,29,383
14,2,14110,2802,3,86,29,3,1,1,120,1,6,127
14,2,14110,2803,3,355,368,44,14,14,795,1,41,837
14,2,14116,2847,3,682,567,95,26,20,1390,1,41,1432
14,2,14116,2848,3,648,382,75,37,17,1159,0,22,1181
14,2,14116,2849,3,734,319,64,29,25,1171,0,26,1197
14,2,14116,2850,3,525,309,29,21,3,887,1,7,895
14,2,14116,2851,3,375,225,29,13,9,651,0,12,663
14,2,14116,2852,3,121,79,15,9,6,230,0,9,239
14,2,14116,2853,3,127,104,10,0,1,242,1,8,251
14,2,14116,2854,3,531,268,52,18,15,884,0,25,909
14,3,14001,1,3,288,215,58,24,9,594,0,18,612
14,3,14001,2,3,277,173,64,23,10,547,0,17,564
14,3,14001,3,3,645,239,158,40,25,1107,1,40,1148
14,3,14001,4,3,630,138,138,24,15,945,2,23,970
14,3,14001,5,3,645,329,104,34,15,1127,3,26,1156
14,3,14001,6,3,378,202,93,28,10,711,2,6,719
14,3,14001,7,3,349,343,112,13,13,830,0,37,867
14,3,14001,8,3,61,79,11,2,4,157,1,6,164
14,3,14001,9,3,32,8,6,0,0,46,0,1,47
14,3,14001,10,3,649,310,78,30,16,1083,0,30,1113
14,3,14001,11,3,373,138,35,11,10,567,4,14,585
14,3,14001,12,3,182,176,26,4,1,389,0,12,401
14,3,14008,102,3,557,474,35,24,7,1097,1,31,1129
14,3,14008,103,3,570,578,27,22,6,1203,0,31,1234
14,3,14008,104,3,333,442,28,15,3,821,1,10,832
14,3,14008,105,3,477,549,30,25,6,1087,0,29,1116
14,3,14008,106,3,701,771,62,45,19,1598,5,50,1653
14,3,14008,107,3,890,994,69,41,12,2006,2,80,2088
14,3,14008,108,3,506,542,19,25,5,1097,0,33,1130
14,3,14008,109,3,289,449,17,15,6,776,0,13,789
14,3,14008,110,3,396,450,25,12,1,884,0,15,899
14,3,14008,111,3,551,446,39,13,8,1057,3,36,1096
14,3,14008,112,3,593,709,33,26,8,1369,0,30,1399
14,3,14008,113,3,480,512,28,20,3,1043,1,44,1088
14,3,14008,114,3,559,651,34,38,4,1286,3,27,1316
14,3,14008,115,3,627,831,54,33,10,1555,6,21,1582
14,3,14008,116,3,644,629,33,30,14,1350,6,35,1391
14,3,14008,117,3,625,948,64,23,13,1673,0,33,1706
14,3,14008,118,3,433,207,48,14,10,712,0,24,736
14,3,14008,119,3,444,304,29,13,11,801,0,28,829
14,3,14008,120,3,384,218,26,17,147,792,0,39,831
14,3,14008,121,3,361,154,30,9,143,697,1,35,733
14,3,14008,122,3,646,301,47,16,257,1267,3,46,1316
14,3,14008,123,3,583,305,45,19,258,1210,5,53,1268
14,3,14008,124,3,266,173,17,4,1,461,0,14,475
14,3,14008,125,3,287,87,5,1,0,380,0,12,392
14,3,14008,126,3,133,65,3,4,0,205,0,10,215
14,3,14008,127,3,321,431,13,28,5,798,0,30,828
14,3,14008,128,3,115,97,8,2,4,226,0,5,231
14,3,14008,129,3,90,29,0,1,2,122,6,6,134
14,3,14008,130,3,89,22,7,1,1,120,0,5,125
14,3,14008,131,3,142,102,12,5,1,262,0,10,272
14,3,14008,132,3,400,79,16,2,6,503,0,26,529
14,3,14008,133,3,485,86,16,4,2,593,4,27,624
14,3,14008,134,3,419,210,17,3,4,653,4,22,679
14,3,14008,135,3,240,71,9,2,26,348,0,15,363
14,3,14008,136,3,749,229,23,7,46,1054,1,35,1090
14,3,14008,137,3,498,144,9,6,20,677,0,9,686
14,3,14008,138,3,457,213,4,12,57,743,0,35,778
14,3,14048,1613,3,455,222,26,26,4,733,0,12,745
14,3,14048,1614,3,432,215,30,16,6,699,1,17,717
14,3,14048,1615,3,613,268,30,34,14,959,0,19,978
14,3,14048,1616,3,444,166,22,9,6,647,0,14,661
14,3,14048,1617,3,323,219,20,11,12,585,0,11,596
14,3,14048,1618,3,225,234,18,12,5,494,1,11,506
14,3,14048,1619,3,448,205,24,16,10,703,0,9,712
14,3,14048,1620,3,765,306,44,30,7,1152,1,32,1185
14,3,14048,1621,3,338,197,17,14,4,570,0,12,582
14,3,14048,1622,3,564,349,38,22,9,982,0,20,1002
14,3,14048,1623,3,372,168,29,19,6,594,0,10,604
14,3,14048,1624,3,680,213,28,15,6,942,3,10,955
14,3,14048,1625,3,56,40,6,6,0,108,0,1,109
14,3,14048,1626,3,188,214,21,10,15,448,2,15,465
14,3,14048,1627,3,33,19,2,1,0,55,1,3,59
14,3,14048,1628,3,172,46,11,4,4,237,1,6,244
14,3,14048,1629,3,79,28,2,1,0,110,0,1,111
14,3,14048,1630,3,64,16,4,4,1,89,0,1,90
14,3,14048,1631,3,184,83,9,9,2,287,0,11,298
14,3,14048,1632,3,73,44,2,1,1,121,0,1,122
14,3,14048,1633,3,346,76,8,5,2,437,3,6,446
14,3,14048,1634,3,60,18,2,1,1,82,0,1,83
14,3,14062,1824,3,383,346,51,13,5,798,0,15,813
14,3,14062,1825,3,190,148,46,9,1,394,0,8,402
14,3,14062,1826,3,206,58,31,5,2,302,0,8,310
14,3,14062,1827,3,210,112,29,8,1,360,0,11,371
14,3,14062,1828,3,331,43,19,1,2,396,0,9,405
14,3,14062,1829,3,200,142,20,3,0,365,0,13,378
14,3,14062,1830,3,68,31,11,3,0,113,0,1,114
14,3,14074,2055,3,607,427,56,12,10,1112,0,18,1130
14,3,14074,2056,3,532,308,36,9,13,898,1,17,916
14,3,14074,2057,3,127,103,24,7,1,262,0,6,268
14,3,14074,2058,3,133,42,9,3,0,187,0,0,187
14,3,14074,2059,3,43,23,3,0,0,69,0,1,70
14,3,14074,2060,3,55,26,9,4,0,94,0,1,95
14,3,14074,2061,3,46,45,5,0,0,96,0,5,101
14,3,14074,2062,3,56,50,26,0,0,132,1,4,137
14,3,14076,2097,3,228,92,4,4,0,328,0,4,332
14,3,14076,2098,3,857,456,36,15,8,1372,3,18,1393
14,3,14076,2099,3,905,297,26,20,6,1254,1,24,1279
14,3,14076,2100,3,552,220,11,12,14,809,0,19,828
14,3,14076,2101,3,665,293,14,6,6,984,0,16,1000
14,3,14076,2102,3,663,285,21,15,7,991,0,9,1000
14,3,14076,2103,3,528,214,10,7,6,765,1,21,787
14,3,14076,2104,3,119,20,0,1,0,140,0,1,141
14,3,14076,2105,3,183,63,3,1,1,251,0,0,251
14,3,14076,2106,3,64,28,1,0,0,93,0,2,95
14,3,14080,2132,3,338,276,30,17,8,669,4,20,693
14,3,14080,2133,3,860,521,75,50,27,1533,8,18,1559
14,3,14080,2134,3,491,291,40,27,14,863,0,21,884
14,3,14080,2135,3,475,325,56,26,17,899,0,22,921
14,3,14080,2136,3,747,415,47,34,16,1259,1,33,1293
14,3,14080,2137,3,574,264,36,18,19,911,0,10,921
14,3,14080,2138,3,605,318,62,19,16,1020,3,30,1053
14,3,14080,2139,3,621,264,69,28,14,996,1,31,1028
14,3,14080,2140,3,984,443,62,46,23,1558,0,24,1582
14,3,14080,2141,3,74,21,2,2,0,99,0,4,103
14,3,14080,2142,3,471,85,6,8,6,576,1,9,586
14,3,14080,2143,3,19,7,2,0,0,28,0,2,30
14,3,14080,2144,3,197,56,10,5,1,269,0,6,275
14,3,14080,2145,3,118,22,6,6,1,153,0,7,160
14,3,14080,2146,3,87,23,4,2,2,118,0,3,121
14,3,14080,2147,3,215,140,7,3,10,375,0,5,380
14,3,14080,2148,3,61,50,0,1,1,113,0,8,121
14,3,14080,2149,3,323,151,26,7,4,511,0,26,537
14,3,14094,2340,3,892,239,65,62,22,1280,2,33,1315
14,3,14094,2341,3,726,270,57,118,12,1183,2,31,1216
14,3,14094,2342,3,815,293,61,109,22,1300,0,43,1343
14,3,14094,2343,3,651,409,57,62,22,1201,6,31,1238
14,3,14094,2344,3,908,522,105,79,19,1633,1,41,1675
14,3,14094,2345,3,630,282,53,36,9,1010,2,16,1028
14,3,14094,2346,3,835,397,56,65,21,1374,1,23,1398
14,3,14094,2347,3,713,272,39,39,17,1080,1,34,1115
14,3,14094,2348,3,858,318,45,60,14,1295,1,33,1329
14,3,14094,2349,3,541,243,28,29,7,848,0,17,865
14,3,14094,2350,3,560,288,35,43,15,941,2,11,954
14,3,14094,2351,3,549,274,29,31,11,894,1,18,913
14,3,14094,2352,3,883,571,116,60,20,1650,5,36,1691
14,3,14094,2353,3,654,305,26,37,19,1041,3,29,1073
14,3,14094,2354,3,952,438,64,42,14,1510,2,37,1549
14,3,14094,2355,3,623,352,49,46,18,1088,3,21,1112
14,3,14094,2356,3,469,401,46,37,8,961,0,29,990
14,3,14094,2357,3,1192,670,118,75,24,2079,8,52,2139
14,3,14094,2358,3,697,378,41,44,22,1182,0,27,1209
14,3,14094,2359,3,708,377,52,48,27,1212,7,34,1253
14,3,14094,2360,3,1142,464,132,85,36,1859,10,44,1913
14,3,14094,2361,3,1719,851,199,122,48,2939,5,38,2982
14,3,14094,2362,3,1029,461,104,79,21,1694,1,50,1745
14,3,14094,2363,3,847,403,94,73,22,1439,2,37,1478
14,3,14094,2364,3,1362,608,109,127,28,2234,12,57,2303
14,3,14094,2365,3,518,215,35,31,14,813,2,43,858
14,3,14094,2366,3,539,239,38,36,21,873,0,41,914
14,3,14094,2367,3,382,159,18,23,12,594,0,20,614
14,3,14094,2368,3,204,75,11,8,4,302,0,20,322
14,3,14094,2369,3,765,421,27,23,8,1244,0,19,1263
14,3,14094,2370,3,790,354,29,19,17,1209,2,39,1250
14,3,14094,2371,3,1326,436,32,43,24,1861,2,46,1909
14,3,14094,2372,3,979,451,29,25,17,1501,2,38,1541
14,3,14094,2373,3,316,119,111,145,7,698,3,37,738
14,3,14094,2374,3,302,129,87,137,9,664,5,34,703
14,3,14094,2375,3,255,154,58,163,6,636,0,33,669
14,3,14094,2377,3,79,42,5,3,0,129,0,0,129
14,3,14094,2378,3,230,86,30,8,1,355,1,16,372
14,3,14094,2379,3,48,17,2,3,1,71,0,1,72
14,3,14094,2380,3,92,23,4,1,1,121,1,4,126
14,3,14094,2381,3,561,132,14,20,7,734,0,20,754
14,3,14094,2382,3,312,46,7,5,5,375,0,9,384
14,3,14094,2383,3,211,142,59,25,8,445,2,12,459
14,3,14094,2384,3,90,26,10,5,4,135,1,6,142
14,3,14094,2385,3,131,55,4,2,1,193,0,0,193
14,3,14094,2386,3,477,41,5,5,14,542,0,8,550
14,3,14094,2387,3,143,44,24,21,2,234,0,16,250
14,3,14094,2388,3,105,31,11,1,2,150,0,2,152
14,3,14094,2389,3,455,434,64,35,12,1000,0,20,1020
14,3,14094,2390,3,152,26,12,4,5,199,0,15,214
14,3,14094,2391,3,36,5,33,2,0,76,0,1,77
14,3,14094,2392,3,625,137,49,16,9,836,0,29,865
14,3,14094,2393,3,112,43,49,5,2,211,0,7,218
14,3,14094,2394,3,140,68,94,8,5,315,0,31,346
14,3,14094,2395,3,288,127,25,13,5,458,1,6,465
14,3,14112,2816,3,707,340,29,47,7,1130,2,21,1153
14,3,14112,2817,3,294,275,9,30,3,611,0,14,625
14,3,14112,2818,3,389,235,17,29,7,677,0,8,685
14,3,14112,2819,3,46,10,4,6,3,69,0,2,71
14,3,14112,2820,3,132,56,3,8,0,199,0,10,209
14,3,14112,2821,3,95,34,7,8,1,145,0,4,149
14,3,14112,2822,3,45,4,0,0,0,49,0,0,49
14,3,14112,2823,3,79,20,2,2,0,103,0,8,111
14,3,14117,2855,3,161,150,8,2,0,321,0,8,329
14,3,14117,2856,3,315,173,6,8,3,505,0,16,521
14,3,14117,2857,3,202,96,10,7,0,315,0,17,332
14,3,14117,2858,3,170,176,12,8,1,367,1,20,388
14,3,14117,2859,3,76,29,4,0,1,110,0,7,117
14,3,14117,2860,3,30,58,4,1,0,93,0,8,101
14,3,14117,2861,3,66,45,4,0,0,115,0,2,117
14,3,14118,2862,3,376,183,37,17,4,617,1,23,641
14,3,14118,2863,3,266,124,41,10,4,445,2,11,458
14,3,14118,2864,3,253,194,30,16,5,498,0,17,515
14,3,14118,2865,3,345,290,48,20,3,706,0,22,728
14,3,14118,2866,3,239,164,24,1,4,432,0,4,436
14,3,14118,2867,3,467,309,52,19,14,861,0,17,878
14,3,14118,2868,3,482,306,67,19,7,881,0,19,900
14,3,14118,2869,3,467,199,57,11,9,743,1,5,749
14,3,14118,2870,3,444,320,36,14,9,823,0,11,834
14,3,14118,2871,3,784,351,47,15,11,1208,0,29,1237
14,3,14118,2872,3,27,8,5,2,1,43,0,1,44
14,3,14118,2873,3,161,35,4,2,1,203,0,6,209
14,3,14118,2874,3,78,71,3,6,1,159,0,15,174
14,3,14118,2875,3,260,206,30,6,5,507,0,17,524
14,3,14118,2876,3,97,27,10,2,0,136,0,3,139
14,3,14118,2877,3,98,30,8,0,1,137,0,2,139
14,3,14118,2878,3,363,296,27,24,11,721,1,19,741
14,3,14118,2879,3,242,117,10,3,1,373,2,4,379
14,3,14118,2880,3,44,21,1,1,0,67,0,0,67
14,3,14118,2881,3,181,150,16,1,2,350,0,6,356
14,3,14118,2882,3,110,38,4,4,1,157,0,5,162
14,3,14118,2883,3,116,67,9,1,2,195,1,8,204
14,4,14120,2909,3,298,306,71,45,23,743,2,17,762
14,4,14120,2910,3,390,338,114,49,41,932,4,15,951
14,4,14120,2915,3,987,431,218,94,64,1794,6,19,1819
14,4,14120,2916,3,368,251,74,41,17,751,0,15,766
14,4,14120,2917,3,667,395,149,59,44,1314,3,19,1336
14,4,14120,2918,3,821,283,120,50,24,1298,1,10,1309
14,4,14120,2919,3,383,300,97,49,21,850,3,9,862
14,4,14120,2920,3,362,359,75,53,10,859,3,24,886
14,4,14120,2921,3,428,325,120,41,35,949,1,18,968
14,4,14120,2922,3,449,362,98,56,21,986,5,23,1014
14,4,14120,2923,3,440,345,124,40,29,978,6,25,1009
14,4,14120,2924,3,465,339,126,72,28,1030,1,18,1049
14,4,14120,2925,3,461,290,124,47,18,940,0,14,954
14,4,14120,2926,3,373,302,157,45,27,904,0,17,921
14,4,14120,2927,3,373,124,115,38,19,669,1,11,681
14,4,14120,2928,3,564,235,128,60,24,1011,1,14,1026
14,4,14120,2929,3,490,289,137,58,26,1000,0,11,1011
14,4,14120,2930,3,732,480,166,92,40,1510,1,32,1543
14,4,14120,2931,3,576,509,175,96,48,1404,5,25,1434
14,4,14120,2932,3,441,423,137,55,31,1087,2,26,1115
14,4,14120,2933,3,692,491,200,83,47,1513,7,30,1550
14,4,14120,2934,3,632,401,156,64,42,1295,5,13,1313
14,4,14120,2935,3,673,307,185,57,39,1261,2,13,1276
14,4,14120,2936,3,428,232,99,42,17,818,2,15,835
14,4,14120,2937,3,361,252,109,58,16,796,3,18,817
14,4,14120,2938,3,529,354,146,85,32,1146,4,34,1184
14,4,14120,2939,3,418,418,106,67,19,1028,4,23,1055
14,4,14120,2940,3,427,322,93,67,20,929,2,20,951
14,4,14120,2941,3,401,372,109,71,26,979,3,18,1000
14,4,14120,2942,3,557,399,111,93,16,1176,1,27,1204
14,4,14120,2943,3,451,424,131,63,21,1090,1,18,1109
14,4,14120,2944,3,259,147,97,44,16,563,0,9,572
14,4,14120,2945,3,546,396,118,78,22,1160,2,27,1189
14,4,14120,2946,3,534,484,140,77,14,1249,8,20,1277
14,4,14120,2947,3,459,327,73,32,14,905,4,24,933
14,4,14120,2948,3,624,459,236,84,35,1438,4,30,1472
14,4,14120,2949,3,661,449,172,83,44,1409,1,31,1441
14,4,14120,2950,3,613,440,168,96,39,1356,9,27,1392
14,4,14120,2951,3,444,315,98,72,17,946,2,23,971
14,4,14120,2952,3,386,259,81,56,20,802,3,16,821
14,4,14120,2953,3,559,410,141,78,23,1211,3,29,1243
14,4,14120,2954,3,545,408,167,77,36,1233,3,33,1269
14,4,14120,2955,3,472,455,113,83,15,1138,4,29,1171
14,4,14120,2956,3,550,343,121,64,24,1102,3,29,1134
14,4,14120,2957,3,345,218,79,45,20,707,1,15,723
14,4,14120,2958,3,301,226,97,42,14,680,8,18,706
14,4,14120,2959,3,321,265,90,49,16,741,0,18,759
14,4,14120,2960,3,480,387,156,73,29,1125,8,30,1163
14,4,14120,2961,3,509,435,162,85,26,1217,6,27,1250
14,4,14120,2962,3,470,380,110,51,37,1048,1,23,1072
14,4,14120,2963,3,188,127,60,30,16,421,3,3,427
14,4,14120,2964,3,1197,547,301,124,77,2246,2,21,2269
14,4,14120,2965,3,509,432,136,79,30,1186,3,25,1214
14,4,14120,2966,3,1039,742,270,182,90,2323,5,34,2362
14,4,14120,2967,3,523,314,124,92,41,1094,1,17,1112
14,4,14120,2968,3,826,440,179,93,42,1580,3,19,1602
14,4,14120,2969,3,2511,1367,663,381,207,5129,8,44,5181
14,4,14120,2970,3,621,381,156,75,38,1271,1,14,1286
14,4,14120,2971,3,330,300,134,62,30,856,2,8,866
14,4,14120,2972,3,630,474,152,95,66,1417,2,24,1443
14,4,14120,2973,3,438,246,127,61,27,899,2,8,909
14,4,14120,2974,3,531,351,165,62,34,1143,5,14,1162
14,4,14120,2975,3,540,327,129,86,29,1111,1,7,1119
14,4,14120,2976,3,3094,1627,750,402,165,6038,6,66,6110
14,4,14120,2977,3,299,238,106,43,28,714,1,15,730
14,4,14120,2978,3,307,241,66,53,19,686,3,10,699
14,4,14120,2979,3,1009,559,236,106,41,1951,1,35,1987
14,4,14120,2980,3,684,376,154,65,81,1360,0,25,1385
14,4,14120,2981,3,886,459,187,92,31,1655,5,12,1672
14,4,14120,2982,3,685,353,123,73,26,1260,2,21,1283
14,4,14120,2983,3,940,542,241,105,53,1881,2,35,1918
14,4,14120,2984,3,617,469,181,115,43,1425,1,37,1463
14,4,14120,2985,3,834,718,215,135,42,1944,3,28,1975
14,4,14120,2986,3,888,527,257,133,63,1868,0,24,1892
14,4,14120,2987,3,772,559,246,92,49,1718,1,34,1753
14,4,14120,2988,3,637,399,175,81,29,1321,0,25,1346
14,4,14120,2989,3,736,615,255,120,45,1771,8,31,1810
14,4,14120,2990,3,473,378,165,76,28,1120,6,26,1152
14,4,14120,2991,3,323,539,131,61,25,1079,3,28,1110
14,4,14120,2992,3,374,398,125,59,17,973,1,22,996
14,4,14120,2993,3,905,979,276,116,47,2323,9,58,2390
14,4,14120,2994,3,594,479,153,91,23,1340,6,20,1366
14,4,14120,2995,3,628,411,166,64,28,1297,5,23,1325
14,4,14120,2996,3,540,453,279,77,24,1373,0,29,1402
14,4,14120,2997,3,397,350,97,28,8,880,0,11,891
14,4,14120,2998,3,516,468,101,41,21,1147,7,18,1172
14,4,14120,2999,3,549,496,169,69,31,1314,1,12,1327
14,4,14120,3000,3,667,601,160,82,36,1546,23,33,1602
14,4,14120,3001,3,692,811,233,135,56,1927,13,47,1987
14,4,14120,3002,3,818,783,224,107,42,1974,12,48,2034
14,4,14120,3003,3,597,649,142,104,32,1524,6,39,1569
14,4,14120,3004,3,759,752,199,136,33,1879,30,54,1963
14,4,14120,3005,3,796,673,224,132,45,1870,1,49,1920
14,4,14120,3006,3,1097,1122,323,204,54,2800,9,63,2872
14,4,14120,3007,3,818,1129,254,150,51,2402,6,69,2477
14,4,14120,3008,3,553,774,166,85,36,1614,13,20,1647
14,4,14120,3009,3,338,527,111,61,20,1057,1,28,1086
14,4,14120,3010,3,429,423,132,70,16,1070,1,39,1110
14,4,14120,3011,3,574,592,127,52,20,1365,2,28,1395
14,4,14120,3012,3,401,497,128,68,14,1108,4,28,1140
14,4,14120,3013,3,958,882,316,146,37,2339,18,62,2419
14,4,14120,3014,3,526,628,150,94,25,1423,24,51,1498
14,4,14120,3015,3,639,709,179,80,28,1635,7,41,1683
14,4,14120,3016,3,583,517,154,94,36,1384,3,50,1437
14,4,14120,3017,3,573,656,200,84,26,1539,6,48,1593
14,4,14120,3027,3,224,249,23,31,3,530,0,26,556
14,4,14120,3028,3,459,917,78,47,16,1517,3,51,1571
14,5,14011,149,3,319,222,11,15,4,571,2,9,582
14,5,14011,150,3,261,142,9,14,2,428,0,3,431
14,5,14011,151,3,114,93,2,0,0,209,0,3,212
14,5,14011,152,3,112,158,2,0,1,273,0,4,277
14,5,14011,153,3,447,592,9,7,2,1057,0,18,1075
14,5,14011,154,3,133,110,4,7,0,254,0,3,257
14,5,14012,155,3,248,182,19,5,2,456,0,16,472
14,5,14012,156,3,213,224,24,5,5,471,1,6,478
14,5,14012,157,3,35,32,1,0,0,68,0,1,69
14,5,14012,158,3,69,45,2,2,1,119,0,1,120
14,5,14012,159,3,427,298,20,10,4,759,0,35,794
14,5,14012,160,3,57,111,0,1,0,169,0,2,171
14,5,14017,244,3,727,216,28,30,8,1009,1,32,1042
14,5,14017,245,3,461,113,26,6,4,610,0,16,626
14,5,14017,246,3,382,95,16,15,2,510,0,11,521
14,5,14017,247,3,338,92,31,10,2,473,0,6,479
14,5,14017,248,3,435,125,17,19,3,599,2,13,614
14,5,14017,249,3,218,69,7,4,3,301,0,8,309
14,5,14017,250,3,241,114,8,5,0,368,0,0,368
14,5,14017,251,3,258,137,6,6,2,409,2,6,417
14,5,14017,252,3,194,52,4,0,1,251,0,4,255
14,5,14017,253,3,310,27,0,4,1,342,0,6,348
14,5,14017,254,3,224,90,3,0,0,317,0,9,326
14,5,14017,255,3,238,90,8,1,0,337,0,7,344
14,5,14020,296,3,333,402,192,7,3,937,0,30,967
14,5,14020,297,3,333,496,268,25,2,1124,1,50,1175
14,5,14020,298,3,176,233,154,1,1,565,0,27,592
14,5,14020,299,3,198,187,83,8,3,479,0,13,492
14,5,14020,300,3,406,572,140,7,5,1130,0,30,1160
14,5,14020,301,3,111,278,30,5,0,424,0,19,443
14,5,14029,441,3,293,274,4,1,2,574,0,14,588
14,5,14029,442,3,143,143,8,0,0,294,0,1,295
14,5,14029,443,3,45,44,1,0,1,91,0,2,93
14,5,14029,444,3,97,86,6,1,0,190,0,0,190
14,5,14040,561,3,225,196,50,5,3,479,2,28,509
14,5,14040,562,3,166,203,23,7,5,404,0,22,426
14,5,14040,563,3,101,177,26,2,0,306,1,11,318
14,5,14040,564,3,47,28,4,0,0,79,0,0,79
14,5,14040,565,3,52,126,10,2,0,190,0,9,199
14,5,14040,566,3,22,51,2,1,0,76,0,5,81
14,5,14040,567,3,64,75,4,0,0,143,1,13,157
14,5,14040,568,3,15,20,16,0,0,51,0,2,53
14,5,14040,569,3,59,114,7,2,0,182,0,9,191
14,5,14045,1573,3,186,302,130,13,16,647,0,21,668
14,5,14045,1574,3,245,304,127,26,12,714,0,29,743
14,5,14045,1575,3,221,200,90,25,7,543,0,13,556
14,5,14045,1576,3,63,126,49,9,10,257,2,10,269
14,5,14045,1577,3,129,171,50,16,2,368,0,12,380
14,5,14045,1578,3,211,326,95,32,6,670,1,14,685
14,5,14045,1579,3,50,85,50,11,3,199,0,15,214
14,5,14045,1580,3,54,129,44,1,9,237,0,10,247
14,5,14045,1581,3,65,124,46,7,3,245,0,7,252
14,5,14045,1582,3,266,352,110,33,23,784,0,57,841
14,5,14045,1583,3,64,33,14,6,4,121,0,8,129
14,5,14045,1584,3,102,176,32,10,8,328,1,14,343
14,5,14045,1585,3,329,243,96,20,11,699,0,23,722
14,5,14045,1586,3,98,129,104,9,4,344,0,12,356
14,5,14045,1587,3,359,205,379,24,16,983,0,36,1019
14,5,14045,1588,3,111,152,324,10,17,614,0,29,643
14,5,14045,1589,3,171,175,210,19,14,589,0,18,607
14,5,14045,1590,3,144,240,121,15,6,526,0,7,533
14,5,14060,1802,3,410,336,121,47,7,921,0,38,959
14,5,14060,1803,3,303,255,118,37,9,722,0,34,756
14,5,14060,1804,3,235,236,65,49,10,595,0,29,624
14,5,14060,1805,3,394,392,132,40,12,970,0,39,1009
14,5,14060,1806,3,413,382,125,51,10,981,0,27,1008
14,5,14060,1807,3,82,58,20,8,3,171,0,7,178
14,5,14060,1808,3,180,120,22,9,4,335,0,14,349
14,5,14060,1809,3,218,186,56,13,13,486,0,20,506
14,5,14060,1810,3,132,52,27,9,6,226,0,9,235
14,5,14060,1811,3,35,29,17,1,1,83,0,4,87
14,5,14060,1812,3,43,37,8,1,9,98,0,10,108
14,5,14060,1813,3,87,37,8,7,1,140,0,11,151
14,5,14060,1814,3,136,145,47,12,13,353,0,30,383
14,5,14064,1840,3,219,122,31,7,0,379,1,16,396
14,5,14064,1841,3,242,210,20,10,1,483,1,15,499
14,5,14064,1842,3,266,309,109,14,9,707,3,20,730
14,5,14064,1843,3,77,83,6,0,0,166,0,1,167
14,5,14069,1934,3,289,160,95,23,18,585,0,13,598
14,5,14069,1935,3,1220,861,736,126,54,2997,4,60,3061
14,5,14069,1937,3,307,283,151,44,17,802,0,29,831
14,5,14069,1938,3,485,398,247,70,29,1229,0,25,1254
14,5,14069,1939,3,280,240,135,29,18,702,1,9,712
14,5,14069,1940,3,105,62,63,16,5,251,2,4,257
14,5,14069,1941,3,1039,843,752,139,47,2820,3,450,3273
14,5,14069,1942,3,511,486,317,47,25,1386,3,36,1425
14,5,14069,1943,3,933,533,473,130,66,2135,0,26,2161
14,5,14069,1944,3,311,383,163,32,13,902,1,21,924
14,5,14069,1945,3,434,378,267,46,17,1142,2,10,1154
14,5,14069,1946,3,641,457,375,72,25,1570,2,16,1588
14,5,14069,1947,3,436,309,205,38,16,1004,2,11,1017
14,5,14069,1948,3,1307,873,742,138,54,3114,12,79,3205
14,5,14069,1949,3,348,227,115,36,11,737,1,11,749
14,5,14069,1950,3,703,566,352,64,26,1711,1,48,1760
14,5,14069,1951,3,449,327,256,53,17,1102,0,11,1113
14,5,14069,1952,3,276,314,168,37,8,803,3,12,818
14,5,14069,1953,3,301,252,107,27,8,695,2,13,710
14,5,14069,1954,3,407,320,161,46,23,957,0,7,964
14,5,14069,1955,3,675,337,200,67,29,1308,2,13,1323
14,5,14069,1956,3,574,343,213,72,28,1230,0,18,1248
14,5,14069,1957,3,565,451,259,81,30,1386,1,23,1410
14,5,14069,1958,3,834,850,445,92,36,2257,0,47,2304
14,5,14069,1959,3,817,488,377,86,54,1822,3,19,1844
14,5,14069,1960,3,522,382,210,53,31,1198,0,15,1213
14,5,14069,1961,3,208,177,93,23,10,511,1,3,515
14,5,14069,1962,3,363,317,169,41,12,902,2,14,918
14,5,14069,1963,3,310,260,115,32,15,732,0,13,745
14,5,14069,1964,3,427,417,166,45,32,1087,2,19,1108
14,5,14069,1965,3,466,219,216,53,27,981,3,8,992
14,5,14069,1966,3,193,184,74,29,13,493,1,7,501
14,5,14069,1967,3,948,832,456,87,36,2359,4,71,2434
14,5,14069,1968,3,359,432,230,42,11,1074,0,41,1115
14,5,14069,1969,3,402,436,265,53,24,1180,1,29,1210
14,5,14069,1970,3,259,246,118,27,11,661,0,18,679
14,5,14069,1971,3,422,358,185,44,16,1025,2,15,1042
14,5,14069,1972,3,362,399,143,43,12,959,0,14,973
14,5,14069,1973,3,424,454,232,52,23,1185,1,18,1204
14,5,14069,1974,3,201,221,99,19,9,549,1,10,560
14,5,14069,1975,3,312,209,154,22,22,719,2,13,734
14,5,14069,1976,3,205,198,103,28,8,542,0,9,551
14,5,14069,1977,3,195,204,104,35,8,546,0,12,558
14,5,14069,1978,3,286,260,142,19,11,718,2,15,735
14,5,14069,1979,3,220,137,73,28,9,467,1,5,473
14,5,14069,1980,3,238,204,94,32,9,577,2,11,590
14,5,14069,1981,3,251,333,113,31,8,736,1,9,746
14,5,14069,1982,3,236,267,83,17,8,611,0,7,618
14,5,14069,1983,3,572,438,217,49,23,1299,1,46,1346
14,5,14069,1984,3,303,237,102,17,6,665,0,3,668
14,5,14069,1985,3,358,375,143,41,15,932,4,24,960
14,5,14069,1986,3,543,495,181,40,28,1287,1,17,1305
14,5,14069,1987,3,180,130,82,17,9,418,1,8,427
14,5,14069,1988,3,416,366,154,46,15,997,2,19,1018
14,5,14069,1989,3,313,341,123,32,15,824,0,9,833
14,5,14069,1990,3,188,133,75,13,12,421,0,8,429
14,5,14069,1991,3,306,291,143,16,9,765,0,13,778
14,5,14069,1992,3,141,109,79,11,4,344,0,11,355
14,5,14069,1993,3,318,337,230,16,3,904,1,20,925
14,5,14069,1994,3,234,129,106,10,15,494,1,15,510
14,5,14069,1995,3,244,356,217,32,16,865,6,12,883
14,5,14069,1996,3,755,651,567,66,32,2071,2,37,2110
14,5,14069,1997,3,463,518,287,73,20,1361,4,30,1395
14,5,14069,1998,3,863,715,457,108,40,2183,3,44,2230
14,5,14069,1999,3,366,407,244,45,13,1075,2,21,1098
14,5,14069,2000,3,439,425,262,62,20,1208,0,16,1224
14,5,14069,2001,3,240,117,91,31,2,481,0,13,494
14,5,14069,2002,3,252,131,81,22,6,492,0,7,499
14,5,14070,2003,3,241,296,85,36,2,660,1,24,685
14,5,14070,2004,3,166,217,36,28,3,450,0,12,462
14,5,14070,2005,3,170,260,39,29,0,498,0,17,515
14,5,14070,2006,3,222,269,66,36,0,593,0,15,608
14,5,14070,2007,3,417,239,34,6,1,697,2,15,714
14,5,14070,2008,3,56,37,41,3,0,137,0,3,140
14,5,14070,2009,3,334,141,32,8,6,521,0,21,542
14,5,14070,2010,3,303,204,37,1,2,547,0,44,591
14,5,14070,2011,3,162,144,31,6,2,345,0,16,361
14,5,14081,2150,3,84,117,178,6,7,392,0,21,413
14,5,14081,2151,3,27,160,188,0,2,377,0,9,386
14,5,14081,2152,3,11,49,75,3,0,138,0,0,138
14,5,14081,2153,3,52,268,437,10,2,769,0,36,805
14,5,14081,2154,3,47,128,153,0,1,329,0,7,336
14,5,14081,2155,3,32,92,163,4,0,291,0,7,298
14,5,14081,2156,3,55,115,117,2,2,291,1,7,299
14,5,14085,2212,3,380,471,116,33,5,1005,0,45,1050
14,5,14085,2213,3,613,759,175,31,18,1596,0,53,1649
14,5,14085,2214,3,511,632,115,27,9,1294,0,55,1349
14,5,14085,2215,3,139,182,81,5,0,407,0,11,418
14,5,14085,2216,3,65,158,35,0,0,258,0,8,266
14,5,14085,2217,3,116,83,21,1,0,221,0,9,230
14,5,14085,2218,3,16,24,0,0,0,40,0,2,42
14,5,14085,2219,3,21,79,13,8,0,121,0,3,124
14,5,14085,2220,3,235,229,43,3,3,513,0,20,533
14,5,14085,2221,3,79,43,10,1,0,133,0,6,139
14,5,14085,2222,3,92,192,53,2,1,340,0,17,357
14,5,14101,2633,3,147,451,148,55,18,819,0,24,843
14,5,14101,2634,3,240,343,182,110,21,896,0,22,918
14,5,14101,2635,3,253,475,224,73,20,1045,5,49,1099
14,5,14101,2636,3,170,326,143,78,12,729,0,15,744
14,5,14101,2637,3,148,294,83,24,10,559,0,27,586
14,5,14101,2638,3,138,178,141,21,65,543,0,29,572
14,5,14101,2639,3,164,177,312,55,12,720,0,43,763
14,5,14101,2640,3,94,150,200,143,21,608,1,28,637
14,5,14101,2641,3,65,96,49,8,3,221,0,12,233
14,5,14101,2642,3,205,329,195,42,50,821,3,39,863
14,5,14101,2643,3,526,323,286,51,33,1219,0,20,1239
14,5,14101,2644,3,78,169,124,30,17,418,1,23,442
14,5,14101,2645,3,72,35,92,20,7,226,1,8,235
14,5,14101,2646,3,179,136,72,67,14,468,2,33,503
14,5,14101,2647,3,42,38,228,18,2,328,0,8,336
14,5,14101,2648,3,222,113,238,55,4,632,1,31,664
14,5,14101,2649,3,231,155,430,33,9,858,0,22,880
14,6,14120,2900,3,474,423,155,93,45,1190,1,24,1215
14,6,14120,2901,3,278,218,96,41,13,646,3,12,661
14,6,14120,2902,3,589,497,151,79,33,1349,4,37,1390
14,6,14120,2903,3,426,375,93,59,36,989,5,21,1015
14,6,14120,2904,3,344,347,84,52,19,846,0,24,870
14,6,14120,2905,3,377,421,91,74,32,995,1,14,1010
14,6,14120,2906,3,579,389,114,71,29,1182,0,27,1209
14,6,14120,2907,3,411,332,87,45,21,896,1,25,922
14,6,14120,2908,3,426,390,98,61,23,998,0,21,1019
14,6,14120,2911,3,711,387,126,61,29,1314,6,20,1340
14,6,14120,2912,3,454,273,80,40,29,876,4,4,884
14,6,14120,2913,3,429,374,114,50,18,985,0,34,1019
14,6,14120,2914,3,269,286,63,31,14,663,3,16,682
14,6,14120,3018,3,1033,1110,181,92,30,2446,19,45,2510
14,6,14120,3019,3,584,785,156,70,20,1615,3,39,1657
14,6,14120,3020,3,837,920,181,85,41,2064,5,49,2118
14,6,14120,3021,3,375,515,70,38,21,1019,0,25,1044
14,6,14120,3022,3,373,716,77,56,20,1242,10,19,1271
14,6,14120,3023,3,1114,1269,264,123,48,2818,5,75,2898
14,6,14120,3024,3,1713,1591,525,276,107,4212,11,84,4307
14,6,14120,3025,3,85,109,6,0,0,200,0,3,203
14,6,14120,3026,3,93,196,30,16,7,342,2,13,357
14,6,14120,3029,3,133,231,27,6,9,406,3,31,440
14,6,14120,3030,3,619,595,144,83,25,1466,9,32,1507
14,6,14120,3031,3,612,441,137,97,19,1306,5,37,1348
14,6,14120,3032,3,3862,1720,808,478,231,7099,12,84,7195
14,6,14120,3033,3,1964,1037,462,290,107,3860,6,45,3911
14,6,14120,3034,3,420,360,124,67,20,991,1,21,1013
14,6,14120,3035,3,433,272,115,40,25,885,0,17,902
14,6,14120,3036,3,613,340,130,63,42,1188,2,13,1203
14,6,14120,3037,3,634,342,139,100,26,1241,3,21,1265
14,6,14120,3038,3,704,378,160,86,58,1386,4,15,1405
14,6,14120,3039,3,521,319,138,76,32,1086,2,12,1100
14,6,14120,3040,3,478,393,107,67,31,1076,0,18,1094
14,6,14120,3041,3,314,272,72,49,17,724,1,16,741
14,6,14120,3042,3,495,368,82,73,26,1044,2,21,1067
14,6,14120,3043,3,329,294,86,60,18,787,0,11,798
14,6,14120,3044,3,217,185,55,35,13,505,1,2,508
14,6,14120,3045,3,434,345,100,54,19,952,4,14,970
14,6,14120,3046,3,616,426,141,81,39,1303,6,24,1333
14,6,14120,3047,3,309,281,69,50,16,725,3,10,738
14,6,14120,3048,3,785,502,135,120,34,1576,1,20,1597
14,6,14120,3049,3,465,368,94,67,18,1012,4,11,1027
14,6,14120,3050,3,485,369,144,49,37,1084,2,38,1124
14,6,14120,3051,3,346,327,88,59,19,839,3,12,854
14,6,14120,3052,3,503,333,104,48,15,1003,3,32,1038
14,6,14120,3053,3,591,472,130,67,25,1285,2,26,1313
14,6,14120,3054,3,377,346,111,54,11,899,1,23,923
14,6,14120,3055,3,374,243,102,39,19,777,4,27,808
14,6,14120,3056,3,410,288,86,54,24,862,5,22,889
14,6,14120,3057,3,281,204,83,46,15,629,3,13,645
14,6,14120,3058,3,512,366,191,42,26,1137,8,30,1175
14,6,14120,3059,3,365,266,82,67,8,788,1,22,811
14,6,14120,3060,3,242,174,54,24,11,505,1,17,523
14,6,14120,3061,3,543,444,143,51,21,1202,7,35,1244
14,6,14120,3062,3,305,335,74,41,19,774,4,13,791
14,6,14120,3063,3,315,254,68,38,12,687,0,9,696
14,6,14120,3064,3,500,372,117,62,23,1074,0,25,1099
14,6,14120,3065,3,550,431,152,90,28,1251,4,15,1270
14,6,14120,3066,3,536,341,125,55,26,1083,2,10,1095
14,6,14120,3067,3,1638,364,114,33,60,2209,3,10,2222
14,6,14120,3068,3,1612,750,163,100,44,2669,5,21,2695
14,6,14120,3069,3,771,461,75,37,18,1362,0,8,1370
14,6,14120,3070,3,229,244,58,29,10,570,2,20,592
14,6,14120,3071,3,639,456,179,85,41,1400,2,30,1432
14,6,14120,3072,3,426,341,107,55,23,952,1,24,977
14,6,14120,3073,3,545,375,137,53,39,1149,1,13,1163
14,6,14120,3074,3,719,353,95,45,29,1241,1,23,1265
14,6,14120,3075,3,654,307,110,47,27,1145,3,17,1165
14,6,14120,3076,3,1073,380,125,66,35,1679,1,19,1699
14,6,14120,3077,3,1339,283,94,40,35,1791,0,12,1803
14,6,14120,3078,3,997,276,101,44,32,1450,1,13,1464
14,6,14120,3079,3,1479,446,147,63,34,2169,1,20,2190
14,6,14120,3080,3,1084,301,111,53,36,1585,0,6,1591
14,6,14120,3081,3,609,163,84,35,26,917,1,1,919
14,6,14120,3082,3,1057,344,97,66,30,1594,2,12,1608
14,6,14120,3083,3,1026,239,55,38,27,1385,1,6,1392
14,6,14120,3084,3,624,253,72,41,39,1029,1,9,1039
14,6,14120,3085,3,459,212,103,42,29,845,2,9,856
14,6,14120,3086,3,2018,873,287,155,97,3430,8,35,3473
14,6,14120,3087,3,1994,511,261,123,77,2966,4,10,2980
14,6,14120,3088,3,717,174,68,28,19,1006,2,16,1024
14,6,14120,3089,3,486,150,52,24,22,734,0,6,740
14,6,14120,3090,3,861,192,91,39,33,1216,2,15,1233
14,6,14120,3091,3,901,248,94,67,32,1342,1,18,1361
14,6,14120,3092,3,877,250,110,69,38,1344,0,10,1354
14,6,14120,3093,3,851,187,111,36,26,1211,1,12,1224
14,6,14120,3094,3,981,286,101,60,44,1472,0,16,1488
14,6,14120,3095,3,849,377,107,42,46,1421,3,13,1437
14,6,14120,3096,3,352,360,72,52,12,848,0,22,870
14,6,14120,3104,3,1109,308,130,52,46,1645,1,16,1662
14,6,14120,3105,3,926,335,117,69,46,1493,0,4,1497
14,6,14120,3106,3,1232,265,124,39,39,1699,2,3,1704
14,6,14120,3107,3,888,199,73,36,44,1240,0,5,1245
14,6,14120,3108,3,960,190,96,39,31,1316,0,9,1325
14,6,14120,3109,3,532,142,46,21,14,755,0,3,758
14,6,14120,3110,3,1074,243,94,48,32,1491,1,11,1503
14,6,14120,3116,3,2111,1344,291,141,77,3964,4,47,4015
14,6,14120,3117,3,381,567,101,52,15,1116,3,25,1144
14,6,14120,3118,3,428,689,116,79,24,1336,1,53,1390
14,6,14120,3119,3,701,745,258,80,39,1823,12,37,1872
14,6,14120,3134,3,705,175,87,27,26,1020,1,7,1028
14,6,14120,3135,3,706,216,92,59,39,1112,0,14,1126
14,6,14120,3140,3,770,188,59,30,33,1080,1,10,1091
14,6,14120,3141,3,787,192,112,32,25,1148,0,4,1152
14,6,14120,3142,3,696,156,77,30,22,981,4,6,991
14,6,14120,3143,3,969,239,64,49,29,1350,0,16,1366
14,6,14120,3144,3,991,275,137,50,36,1489,0,12,1501
14,6,14120,3145,3,1081,261,124,58,41,1565,3,11,1579
14,6,14120,3170,3,1092,271,145,59,30,1597,1,26,1624
14,6,14120,3171,3,774,231,76,32,32,1145,0,9,1154
14,6,14120,3226,3,552,707,164,74,22,1519,9,38,1566
14,6,14120,3227,3,389,300,85,43,16,833,4,17,854
14,6,14120,3228,3,320,385,136,54,18,913,4,16,933
14,6,14120,3229,3,473,445,134,86,14,1152,4,31,1187
14,6,14120,3230,3,397,454,162,78,23,1114,2,32,1148
14,6,14120,3231,3,686,564,192,85,33,1560,4,33,1597
14,6,14120,3232,3,236,148,91,24,18,517,1,2,520
14,6,14120,3233,3,69,157,58,9,5,298,0,7,305
14,6,14120,3234,3,671,478,82,54,19,1304,4,27,1335
14,6,14120,3235,3,821,778,205,89,29,1922,5,37,1964
14,6,14120,3237,3,650,126,83,22,23,904,0,6,910
14,7,14102,2650,3,738,899,197,124,49,2007,4,71,2082
14,7,14102,2651,3,1003,1218,322,219,77,2839,14,77,2930
14,7,14102,2652,3,441,623,160,86,28,1338,4,30,1372
14,7,14102,2653,3,311,313,82,39,24,769,3,20,792
14,7,14102,2654,3,365,360,111,53,33,922,0,18,940
14,7,14102,2655,3,454,545,135,84,30,1248,3,29,1280
14,7,14102,2656,3,583,630,171,156,36,1576,9,48,1633
14,7,14102,2657,3,525,518,105,103,26,1277,5,53,1335
14,7,14102,2658,3,305,289,51,68,18,731,0,21,752
14,7,14102,2659,3,427,301,70,69,29,896,6,26,928
14,7,14102,2660,3,929,865,332,148,56,2330,11,60,2401
14,7,14102,2661,3,1385,1283,446,418,84,3616,8,96,3720
14,7,14102,2662,3,1021,972,328,216,68,2605,12,86,2703
14,7,14102,2663,3,558,475,138,99,27,1297,0,42,1339
14,7,14102,2664,3,673,566,183,126,33,1581,3,32,1616
14,7,14102,2665,3,426,535,290,85,31,1367,0,41,1408
14,7,14102,2666,3,392,491,176,65,33,1157,3,24,1184
14,7,14102,2667,3,397,446,140,55,28,1066,2,27,1095
14,7,14102,2668,3,429,484,163,73,20,1169,2,21,1192
14,7,14102,2669,3,377,329,120,52,18,896,5,31,932
14,7,14102,2670,3,557,585,237,98,26,1503,5,26,1534
14,7,14102,2671,3,537,502,201,82,40,1362,4,40,1406
14,7,14102,2672,3,364,380,169,30,27,970,1,37,1008
14,7,14102,2673,3,348,405,146,65,33,997,5,21,1023
14,7,14102,2674,3,433,429,186,122,34,1204,2,14,1220
14,7,14102,2675,3,412,359,106,70,22,969,2,14,985
14,7,14102,2676,3,1216,994,297,130,43,2680,4,68,2752
14,7,14102,2677,3,753,823,271,163,50,2060,5,50,2115
14,7,14102,2678,3,557,429,193,97,39,1315,0,35,1350
14,7,14102,2679,3,882,531,217,107,44,1781,8,45,1834
14,7,14102,2680,3,488,386,141,64,25,1104,9,36,1149
14,7,14102,2681,3,626,667,172,108,44,1617,5,42,1664
14,7,14102,2682,3,641,550,202,111,40,1544,5,34,1583
14,7,14102,2683,3,751,664,166,96,35,1712,1,54,1767
14,7,14102,2684,3,836,718,205,102,60,1921,9,79,2009
14,7,14102,2685,3,510,606,122,64,27,1329,2,28,1359
14,7,14102,2686,3,764,747,197,140,53,1901,5,47,1953
14,7,14102,2687,3,607,692,103,69,31,1502,3,42,1547
14,7,14102,2688,3,250,280,72,21,7,630,2,16,648
14,7,14102,2689,3,253,251,46,29,18,597,1,9,607
14,7,14102,2690,3,311,247,62,28,12,660,4,21,685
14,7,14102,2691,3,872,795,172,109,36,1984,1,59,2044
14,7,14102,2692,3,543,457,69,70,23,1162,6,20,1188
14,7,14102,2693,3,914,671,246,125,89,2045,2,39,2086
14,7,14102,2694,3,535,352,73,60,29,1049,2,29,1080
14,7,14102,2695,3,838,527,189,80,43,1677,1,35,1713
14,7,14102,2696,3,423,275,55,49,17,819,3,22,844
14,7,14102,2697,3,1535,1231,408,278,107,3559,4,69,3632
14,7,14102,2698,3,357,312,118,117,31,935,2,16,953
14,7,14102,2699,3,285,241,98,91,22,737,0,9,746
14,7,14102,2700,3,393,287,97,58,34,869,5,8,882
14,7,14102,2701,3,559,628,188,147,33,1555,8,30,1593
14,7,14102,2702,3,772,543,219,113,44,1691,2,43,1736
14,7,14102,2703,3,574,515,159,78,31,1357,6,36,1399
14,7,14102,2704,3,656,360,144,118,41,1319,0,17,1336
14,7,14102,2705,3,343,410,94,65,31,943,1,20,964
14,7,14102,2706,3,308,283,72,58,15,736,1,24,761
14,7,14102,2707,3,1305,1194,452,260,85,3296,10,47,3353
14,7,14102,2708,3,497,512,138,108,30,1285,7,22,1314
14,7,14102,2709,3,1940,1229,461,350,156,4136,28,57,4221
14,7,14102,2710,3,1439,1012,369,247,143,3210,6,43,3259
14,7,14102,2711,3,1628,1130,400,203,100,3461,15,49,3525
14,7,14102,2712,3,502,639,118,128,31,1418,2,56,1476
14,7,14102,2713,3,382,387,132,75,43,1019,1,18,1038
14,7,14102,2714,3,558,315,176,87,25,1161,4,7,1172
14,7,14102,2715,3,316,354,106,65,19,860,0,5,865
14,7,14102,2716,3,988,636,237,180,59,2100,3,29,2132
14,7,14102,2717,3,685,594,141,87,29,1536,5,25,1566
14,7,14102,2718,3,619,572,145,119,31,1486,10,44,1540
14,7,14102,2719,3,430,419,157,72,36,1114,14,29,1157
14,7,14102,2720,3,432,327,128,72,32,991,1,22,1014
14,7,14102,2721,3,1207,1322,361,166,65,3121,16,105,3242
14,7,14102,2722,3,791,831,281,126,48,2077,5,61,2143
14,7,14102,2723,3,823,579,168,87,36,1693,10,57,1760
14,7,14102,2724,3,401,203,29,14,8,655,2,13,670
14,7,14102,2725,3,569,364,66,30,22,1051,9,37,1097
14,7,14102,2726,3,438,270,71,39,15,833,2,40,875
14,7,14102,2727,3,530,441,167,55,30,1223,1,44,1268
14,7,14102,2728,3,538,430,109,73,37,1187,0,20,1207
14,7,14102,2729,3,348,278,56,27,5,714,3,20,737
14,7,14102,3311,3,181,162,41,28,8,420,1,8,429
14,8,14041,570,3,384,108,64,22,14,592,2,4,598
14,8,14041,571,3,257,101,53,34,12,457,0,6,463
14,8,14041,572,3,324,170,63,47,18,622,0,13,635
14,8,14041,573,3,298,153,56,42,8,557,0,6,563
14,8,14041,574,3,279,111,58,43,9,500,0,4,504
14,8,14041,575,3,264,114,52,26,17,473,0,12,485
14,8,14041,576,3,245,160,55,29,13,502,1,6,509
14,8,14041,577,3,258,138,54,44,32,526,0,15,541
14,8,14041,578,3,319,270,84,52,33,758,3,10,771
14,8,14041,579,3,304,171,75,39,18,607,11,19,637
14,8,14041,580,3,217,120,36,32,14,419,0,17,436
14,8,14041,581,3,282,155,66,37,19,559,0,9,568
14,8,14041,582,3,360,239,83,46,11,739,3,10,752
14,8,14041,583,3,222,139,61,35,15,472,2,7,481
14,8,14041,584,3,242,200,60,33,21,556,0,19,575
14,8,14041,585,3,282,169,43,32,19,545,2,4,551
14,8,14041,586,3,534,282,91,71,19,997,4,19,1020
14,8,14041,587,3,511,264,113,68,29,985,1,22,1008
14,8,14041,588,3,359,132,53,31,13,588,0,14,602
14,8,14041,589,3,343,178,36,26,13,596,0,19,615
14,8,14041,590,3,489,165,62,21,10,747,0,8,755
14,8,14041,591,3,480,122,32,31,11,676,0,5,681
14,8,14041,592,3,500,99,27,14,12,652,1,5,658
14,8,14041,593,3,651,175,83,26,22,957,0,7,964
14,8,14041,594,3,469,110,40,14,9,642,0,5,647
14,8,14041,595,3,327,105,33,13,10,488,0,1,489
14,8,14041,596,3,435,144,59,38,18,694,1,5,700
14,8,14041,597,3,399,109,33,15,17,573,0,2,575
14,8,14041,598,3,349,94,27,17,11,498,0,10,508
14,8,14041,599,3,450,207,68,31,13,769,0,14,783
14,8,14041,600,3,513,274,107,39,24,957,1,17,975
14,8,14041,601,3,450,209,85,43,30,817,1,13,831
14,8,14041,602,3,529,217,84,55,32,917,12,22,951
14,8,14041,603,3,365,136,57,29,18,605,2,3,610
14,8,14041,604,3,302,169,73,42,14,600,0,10,610
14,8,14041,605,3,305,146,98,34,21,604,1,14,619
14,8,14041,606,3,210,141,46,35,22,454,5,12,471
14,8,14041,607,3,251,151,50,41,16,509,2,0,511
14,8,14041,608,3,220,173,101,35,17,546,0,10,556
14,8,14041,609,3,399,212,110,56,23,800,0,15,815
14,8,14041,610,3,230,150,73,28,16,497,1,9,507
14,8,14041,611,3,251,182,90,35,14,572,3,6,581
14,8,14041,612,3,246,141,83,36,15,521,2,9,532
14,8,14041,613,3,234,185,88,20,16,543,0,13,556
14,8,14041,614,3,243,219,96,45,22,625,0,19,644
14,8,14041,615,3,186,149,49,35,14,433,3,5,441
14,8,14041,616,3,292,242,99,59,22,714,0,11,725
14,8,14041,617,3,239,244,69,51,17,620,2,7,629
14,8,14041,618,3,203,161,82,23,36,505,1,4,510
14,8,14041,619,3,164,63,52,20,10,309,0,6,315
14,8,14041,620,3,188,135,38,28,6,395,1,3,399
14,8,14041,621,3,272,146,92,33,12,555,2,6,563
14,8,14041,622,3,338,172,95,48,22,675,1,4,680
14,8,14041,623,3,246,151,76,40,11,524,2,7,533
14,8,14041,624,3,295,173,86,40,21,615,1,8,624
14,8,14041,625,3,232,88,51,22,16,409,0,6,415
14,8,14041,626,3,383,149,84,24,27,667,0,6,673
14,8,14041,627,3,414,148,53,35,23,673,1,8,682
14,8,14041,628,3,394,85,30,14,24,547,1,8,556
14,8,14041,629,3,315,73,33,18,8,447,1,5,453
14,8,14041,630,3,552,141,63,18,9,783,1,5,789
14,8,14041,631,3,610,184,69,36,25,924,1,7,932
14,8,14041,632,3,334,92,53,29,13,521,0,1,522
14,8,14041,667,3,458,284,112,88,29,971,3,25,999
14,8,14041,668,3,405,237,98,63,27,830,0,21,851
14,8,14041,669,3,577,315,113,79,28,1112,6,13,1131
14,8,14041,670,3,333,168,79,57,20,657,4,19,680
14,8,14041,671,3,258,212,74,34,24,602,4,12,618
14,8,14041,672,3,445,212,92,46,28,823,0,24,847
14,8,14041,673,3,456,228,130,63,31,908,1,15,924
14,8,14041,674,3,569,321,141,63,36,1130,1,32,1163
14,8,14041,675,3,251,332,100,45,27,755,0,24,779
14,8,14041,676,3,389,204,99,46,20,758,4,18,780
14,8,14041,677,3,393,239,97,47,18,794,6,20,820
14,8,14041,678,3,306,216,90,49,19,680,0,5,685
14,8,14041,679,3,368,260,82,63,24,797,10,23,830
14,8,14041,680,3,461,284,123,66,20,954,0,15,969
14,8,14041,681,3,310,235,89,55,18,707,1,14,722
14,8,14041,682,3,352,188,60,50,22,672,2,14,688
14,8,14041,683,3,491,293,116,58,31,989,3,21,1013
14,8,14041,684,3,499,303,137,93,34,1066,3,21,1090
14,8,14041,685,3,501,309,101,66,23,1000,2,21,1023
14,8,14041,686,3,442,247,120,57,29,895,2,19,916
14,8,14041,687,3,461,191,180,75,14,921,0,31,952
14,8,14041,688,3,427,199,83,53,20,782,3,34,819
14,8,14041,689,3,244,153,60,44,29,530,0,22,552
14,8,14041,690,3,365,170,76,47,22,680,2,8,690
14,8,14041,691,3,523,249,85,60,25,942,1,22,965
14,8,14041,692,3,503,228,126,72,23,952,0,25,977
14,8,14041,734,3,323,258,97,46,24,748,4,27,779
14,8,14041,735,3,376,192,87,50,13,718,0,7,725
14,8,14041,736,3,569,319,150,85,33,1156,2,28,1186
14,8,14041,737,3,227,175,47,38,12,499,0,14,513
14,8,14041,738,3,247,233,84,44,16,624,1,11,636
14,8,14041,739,3,325,301,102,74,23,825,2,16,843
14,8,14041,740,3,297,208,70,42,20,637,2,14,653
14,8,14041,741,3,320,244,87,57,15,723,3,18,744
14,8,14041,742,3,275,173,68,39,13,568,2,13,583
14,8,14041,743,3,365,226,68,39,15,713,1,18,732
14,8,14041,750,3,497,334,125,82,16,1054,4,18,1076
14,8,14041,751,3,480,302,91,79,25,977,2,16,995
14,8,14041,752,3,366,262,95,70,16,809,4,30,843
14,8,14041,753,3,253,197,73,37,15,575,0,22,597
14,8,14041,754,3,232,156,39,40,9,476,1,12,489
14,8,14041,757,3,410,111,50,14,18,603,0,6,609
14,8,14041,1009,3,296,148,88,37,15,584,3,9,596
14,8,14041,1010,3,415,159,80,34,9,697,1,6,704
14,8,14041,1011,3,569,249,121,35,41,1015,1,19,1035
14,8,14041,1012,3,437,247,113,50,22,869,0,9,878
14,8,14041,1013,3,415,209,97,48,9,778,0,15,793
14,8,14041,1014,3,481,277,126,63,27,974,0,7,981
14,8,14041,1015,3,300,178,90,47,22,637,1,6,644
14,8,14041,1016,3,254,184,102,53,21,614,1,6,621
14,8,14041,1017,3,323,200,102,41,17,683,3,16,702
14,8,14041,1018,3,173,130,62,35,13,413,1,9,423
14,8,14041,1019,3,364,212,88,55,25,744,0,17,761
14,8,14041,1020,3,179,153,50,27,6,415,0,1,416
14,8,14041,1021,3,283,209,75,60,17,644,0,4,648
14,8,14041,1022,3,275,125,73,29,13,515,0,3,518
14,8,14041,1023,3,202,152,51,27,12,444,0,6,450
14,8,14041,1024,3,233,153,60,28,9,483,3,5,491
14,8,14041,1025,3,244,173,87,44,13,561,0,11,572
14,8,14041,1026,3,145,90,26,18,8,287,1,5,293
14,8,14041,1027,3,221,216,61,34,18,550,1,15,566
14,8,14041,1028,3,132,137,37,19,3,328,0,8,336
14,8,14041,1029,3,114,115,38,9,4,280,1,9,290
14,8,14041,1030,3,199,169,70,39,18,495,0,15,510
14,8,14041,1031,3,184,167,66,34,16,467,2,12,481
14,8,14041,1032,3,198,192,61,31,16,498,2,10,510
14,8,14041,1033,3,358,297,91,71,26,843,0,4,847
14,8,14041,1034,3,162,137,34,34,9,376,0,5,381
14,8,14041,1035,3,335,210,62,63,12,682,1,16,699
14,8,14041,1036,3,244,151,53,41,16,505,4,9,518
14,8,14041,1037,3,234,170,59,32,12,507,1,8,516
14,8,14041,1038,3,264,182,50,40,12,548,2,11,561
14,8,14041,1039,3,233,121,49,48,16,467,0,11,478
14,8,14041,1040,3,315,152,73,44,18,602,2,4,608
14,8,14041,1041,3,271,197,70,49,14,601,2,12,615
14,8,14041,1042,3,307,220,65,63,17,672,3,16,691
14,8,14041,1043,3,255,155,71,42,16,539,1,10,550
14,8,14041,1044,3,212,196,78,40,10,536,3,10,549
14,8,14041,1045,3,127,94,33,15,3,272,3,0,275
14,8,14041,1046,3,163,182,47,38,10,440,2,8,450
14,8,14041,1047,3,190,185,71,33,21,500,0,6,506
14,8,14041,1048,3,98,116,29,19,8,270,0,2,272
14,8,14041,1049,3,54,84,35,11,7,191,0,2,193
14,8,14041,1087,3,1085,239,88,32,27,1471,3,3,1477
14,8,14041,1088,3,935,232,114,55,32,1368,1,7,1376
14,8,14041,1089,3,635,142,41,20,19,857,1,3,861
14,8,14041,1090,3,416,169,77,53,19,734,0,5,739
14,8,14041,1091,3,741,326,184,79,32,1362,0,21,1383
14,8,14041,1092,3,573,205,96,32,31,937,0,6,943
14,8,14041,1093,3,507,190,89,44,19,849,4,17,870
14,8,14041,1094,3,378,168,60,32,15,653,0,3,656
14,8,14041,1095,3,346,177,75,31,15,644,0,3,647
14,8,14041,1096,3,270,233,82,63,17,665,0,17,682
14,8,14041,1097,3,227,234,56,31,12,560,0,10,570
14,8,14041,1098,3,489,171,104,60,30,854,2,16,872
14,8,14041,1099,3,198,190,26,30,9,453,0,9,462
14,8,14041,1100,3,416,349,100,74,23,962,2,21,985
14,8,14041,1101,3,386,287,107,83,32,895,6,17,918
14,8,14041,1102,3,411,343,104,79,20,957,1,17,975
14,8,14041,1103,3,549,339,136,102,28,1154,3,18,1175
14,8,14041,1104,3,413,267,117,77,14,888,0,28,916
14,8,14041,1105,3,354,202,96,70,35,757,0,7,764
14,8,14041,1106,3,529,323,118,77,30,1077,2,19,1098
14,8,14041,1107,3,396,241,111,67,23,838,2,11,851
14,8,14041,1108,3,633,283,110,82,32,1140,3,15,1158
14,8,14041,1109,3,415,156,79,62,23,735,0,13,748
14,8,14041,1110,3,294,198,67,60,10,629,0,20,649
14,8,14041,1111,3,360,286,114,84,24,868,1,28,897
14,8,14041,1112,3,346,220,87,45,16,714,0,26,740
14,8,14041,1113,3,640,303,111,91,30,1175,1,11,1187
14,8,14041,1114,3,237,162,60,40,16,515,1,11,527
14,8,14041,1115,3,436,264,119,70,20,909,0,14,923
14,8,14041,1116,3,515,268,104,64,45,996,3,14,1013
14,8,14041,1117,3,335,190,71,35,11,642,0,6,648
14,8,14041,1118,3,314,175,58,29,17,593,1,13,607
14,8,14041,1119,3,444,66,32,19,16,577,0,1,578
14,8,14041,1120,3,675,147,39,25,18,904,0,4,908
14,8,14041,1121,3,595,178,48,36,22,879,0,8,887
14,8,14041,1122,3,580,108,50,19,17,774,1,7,782
14,8,14041,1123,3,852,191,82,24,19,1168,0,7,1175
14,8,14041,1124,3,606,167,56,36,13,878,1,6,885
14,8,14041,1125,3,748,184,60,22,14,1028,0,5,1033
14,8,14041,1126,3,874,206,65,38,26,1209,3,9,1221
14,8,14041,1127,3,544,148,77,25,33,827,2,6,835
14,8,14041,1128,3,843,245,88,37,31,1244,0,14,1258
14,8,14041,1129,3,760,228,115,26,40,1169,3,10,1182
14,8,14041,1130,3,422,145,85,40,20,712,0,12,724
14,8,14041,1131,3,398,180,62,30,20,690,0,1,691
14,8,14041,1132,3,371,170,57,26,24,648,0,4,652
14,8,14041,1133,3,367,241,82,47,18,755,3,13,771
14,8,14041,1134,3,127,157,50,14,18,366,3,9,378
14,8,14041,1135,3,310,210,78,35,21,654,1,14,669
14,8,14041,1136,3,369,276,94,39,26,804,3,16,823
14,8,14041,1137,3,447,222,122,72,37,900,3,13,916
14,8,14041,1138,3,187,124,44,31,14,400,0,0,400
14,8,14041,1139,3,355,310,101,62,22,850,0,17,867
14,8,14041,1140,3,314,243,84,39,24,704,4,24,732
14,8,14041,1141,3,400,192,129,52,23,796,0,11,807
14,8,14041,1142,3,520,241,148,34,21,964,2,18,984
14,8,14041,1143,3,473,223,95,45,21,857,4,16,877
14,8,14041,1144,3,477,216,104,57,18,872,0,10,882
14,8,14041,1145,3,423,246,146,63,26,904,1,16,921
14,8,14041,1146,3,305,192,104,57,22,680,2,11,693
14,8,14041,1147,3,270,243,91,95,13,712,0,26,738
14,8,14041,1148,3,292,207,71,47,21,638,0,10,648
14,8,14041,1149,3,203,214,79,39,14,549,3,7,559
14,8,14041,1150,3,414,270,101,57,28,870,0,11,881
14,8,14041,1151,3,511,266,100,53,20,950,0,18,968
14,8,14041,1152,3,493,255,77,59,20,904,2,14,920
14,8,14041,1153,3,339,259,85,57,18,758,3,24,785
14,8,14041,1154,3,420,289,81,50,19,859,1,16,876
14,8,14041,1155,3,379,125,56,14,12,586,1,3,590
14,8,14041,1156,3,373,239,65,46,20,743,0,14,757
14,8,14041,1157,3,321,165,54,33,12,585,1,5,591
14,8,14041,1158,3,284,162,49,40,10,545,0,1,546
14,8,14041,1159,3,395,190,54,35,19,693,1,5,699
14,8,14041,1160,3,336,110,56,27,25,554,0,6,560
14,8,14041,1161,3,532,154,51,24,26,787,0,10,797
14,8,14041,1162,3,642,156,47,29,14,888,1,5,894
14,8,14041,1163,3,615,174,36,30,23,878,0,9,887
14,8,14041,1164,3,613,177,51,22,18,881,4,12,897
14,8,14041,1165,3,567,145,73,27,29,841,0,4,845
14,8,14041,1166,3,260,234,79,38,17,628,4,19,651
14,8,14041,1167,3,247,138,52,45,17,499,0,9,508
14,8,14041,1168,3,181,113,39,33,12,378,0,6,384
14,8,14041,1169,3,292,231,62,38,13,636,0,19,655
14,8,14041,1170,3,234,178,49,35,9,505,5,4,514
14,8,14041,1171,3,279,253,71,51,10,664,0,10,674
14,8,14041,1172,3,318,195,74,43,10,640,2,5,647
14,8,14041,1173,3,244,195,53,45,40,577,0,12,589
14,8,14041,1174,3,351,205,103,30,10,699,2,7,708
14,8,14041,1175,3,398,299,103,58,13,871,3,21,895
14,8,14041,1176,3,385,357,92,51,24,909,1,10,920
14,8,14041,1177,3,320,254,61,46,20,701,0,12,713
14,8,14041,1178,3,281,198,63,41,13,596,0,7,603
14,8,14041,1179,3,224,329,63,50,15,681,1,18,700
14,8,14041,1180,3,416,290,121,79,41,947,3,18,968
14,8,14041,1181,3,153,102,50,16,9,330,0,6,336
14,8,14041,1182,3,262,99,57,25,6,449,0,7,456
14,8,14041,1183,3,198,142,58,29,11,438,1,14,453
14,8,14041,1184,3,183,128,43,24,0,378,0,6,384
14,8,14041,1185,3,179,151,84,34,14,462,0,0,462
14,8,14041,1186,3,142,90,55,29,7,323,0,6,329
14,8,14041,1357,3,649,299,118,71,26,1163,1,12,1176
14,8,14041,1358,3,642,308,175,83,35,1243,3,11,1257
14,8,14041,1359,3,483,236,130,91,30,970,0,5,975
14,8,14041,1360,3,429,238,124,59,29,879,1,27,907
14,8,14041,1361,3,530,314,132,56,23,1055,1,7,1063
14,9,14041,1187,3,630,415,239,84,26,1394,4,25,1423
14,9,14041,1188,3,498,311,202,67,26,1104,1,35,1140
14,9,14041,1189,3,423,305,124,76,22,950,0,27,977
14,9,14041,1190,3,290,268,83,41,9,691,1,22,714
14,9,14041,1191,3,372,229,120,39,14,774,2,25,801
14,9,14041,1192,3,432,356,140,62,27,1017,0,41,1058
14,9,14041,1193,3,1071,702,447,191,61,2472,1,39,2512
14,9,14041,1194,3,788,547,235,129,51,1750,5,33,1788
14,9,14041,1195,3,305,342,102,52,36,837,0,20,857
14,9,14041,1196,3,497,466,134,63,20,1180,1,25,1206
14,9,14041,1197,3,515,422,179,95,24,1235,2,28,1265
14,9,14041,1198,3,393,358,136,55,13,955,0,35,990
14,9,14041,1199,3,324,237,116,46,21,744,2,15,761
14,9,14041,1200,3,574,480,204,86,32,1376,3,30,1409
14,9,14041,1201,3,354,315,144,66,22,901,6,5,912
14,9,14041,1202,3,291,262,115,51,18,737,3,26,766
14,9,14041,1203,3,267,233,102,59,18,679,1,17,697
14,9,14041,1204,3,428,369,179,75,25,1076,4,29,1109
14,9,14041,1205,3,375,358,173,61,23,990,5,32,1027
14,9,14041,1206,3,404,379,192,59,25,1059,5,26,1090
14,9,14041,1207,3,600,527,202,98,25,1452,4,37,1493
14,9,14041,1208,3,377,419,196,67,25,1084,0,33,1117
14,9,14041,1209,3,501,474,217,92,31,1315,4,44,1363
14,9,14041,1210,3,226,271,148,65,16,726,1,19,746
14,9,14041,1211,3,301,345,156,69,20,891,2,18,911
14,9,14041,1212,3,312,247,138,38,12,747,1,15,763
14,9,14041,1213,3,541,449,214,103,33,1340,6,44,1390
14,9,14041,1214,3,287,289,131,56,14,777,0,26,803
14,9,14041,1215,3,245,192,125,53,9,624,0,23,647
14,9,14041,1216,3,546,532,252,104,32,1466,2,47,1515
14,9,14041,1217,3,594,546,336,104,35,1615,7,44,1666
14,9,14041,1218,3,440,393,242,77,32,1184,6,27,1217
14,9,14041,1219,3,422,379,175,77,23,1076,7,17,1100
14,9,14041,1220,3,440,352,197,64,14,1067,3,33,1103
14,9,14041,1221,3,359,286,115,45,17,822,0,14,836
14,9,14041,1222,3,279,221,127,39,18,684,0,11,695
14,9,14041,1223,3,327,274,131,52,23,807,0,16,823
14,9,14041,1224,3,1179,663,413,139,47,2441,2,15,2458
14,9,14041,1225,3,368,269,165,69,22,893,0,15,908
14,9,14041,1226,3,239,258,154,71,13,735,1,8,744
14,9,14041,1227,3,460,327,151,72,18,1028,1,10,1039
14,9,14041,1228,3,316,288,107,48,10,769,2,21,792
14,9,14041,1229,3,336,254,105,47,5,747,2,32,781
14,9,14041,1230,3,293,262,120,50,13,738,2,15,755
14,9,14041,1231,3,274,189,138,26,9,636,0,19,655
14,9,14041,1232,3,226,200,105,33,20,584,0,17,601
14,9,14041,1233,3,505,299,159,57,20,1040,0,18,1058
14,9,14041,1234,3,462,427,140,62,16,1107,5,14,1126
14,9,14041,1235,3,448,353,172,60,18,1051,0,36,1087
14,9,14041,1236,3,455,378,136,57,29,1055,5,27,1087
14,9,14041,1237,3,480,303,192,54,31,1060,1,29,1090
14,9,14041,1238,3,546,325,262,77,34,1244,6,24,1274
14,9,14041,1239,3,378,337,140,61,10,926,2,20,948
14,9,14041,1240,3,377,256,118,44,13,808,7,22,837
14,9,14041,1241,3,330,257,122,29,18,756,2,18,776
14,9,14041,1242,3,815,532,326,74,29,1776,4,33,1813
14,9,14041,1243,3,493,383,219,67,19,1181,3,32,1216
14,9,14041,1244,3,480,438,232,52,23,1225,0,29,1254
14,9,14041,1245,3,332,209,119,57,19,736,1,25,762
14,9,14041,1246,3,355,270,123,55,17,820,4,17,841
14,9,14041,1247,3,700,641,403,185,37,1966,2,26,1994
14,9,14041,1248,3,438,405,250,95,38,1226,2,11,1239
14,9,14041,1249,3,536,433,226,78,30,1303,6,28,1337
14,9,14041,1250,3,273,251,104,37,16,681,1,5,687
14,9,14041,1251,3,287,254,97,40,15,693,2,25,720
14,9,14041,1252,3,587,456,244,78,41,1406,0,21,1427
14,9,14041,1253,3,314,221,129,47,28,739,0,15,754
14,9,14041,1254,3,397,205,145,60,14,821,4,17,842
14,9,14041,1255,3,548,403,200,70,47,1268,4,27,1299
14,9,14041,1256,3,586,425,249,95,48,1403,3,33,1439
14,9,14041,1257,3,534,306,232,67,37,1176,0,10,1186
14,9,14041,1258,3,236,133,108,34,11,522,0,6,528
14,9,14041,1259,3,156,98,52,20,2,328,0,10,338
14,9,14041,1260,3,320,271,126,74,22,813,0,14,827
14,9,14041,1261,3,531,572,298,144,40,1585,1,12,1598
14,9,14041,1262,3,531,396,227,66,16,1236,4,32,1272
14,9,14041,1263,3,309,172,75,41,10,607,0,10,617
14,9,14041,1264,3,293,176,103,24,15,611,1,15,627
14,9,14041,1265,3,433,296,151,42,16,938,0,17,955
14,9,14041,1266,3,334,241,121,42,24,762,0,22,784
14,9,14041,1267,3,589,328,166,56,53,1192,3,15,1210
14,9,14041,1268,3,445,247,157,34,28,911,5,21,937
14,9,14041,1269,3,456,253,168,41,16,934,1,28,963
14,9,14041,1270,3,455,340,187,57,26,1065,6,27,1098
14,9,14041,1271,3,391,305,162,63,30,951,7,15,973
14,9,14041,1272,3,405,346,154,60,20,985,3,25,1013
14,9,14041,1273,3,457,383,166,50,29,1085,4,31,1120
14,9,14041,1274,3,505,290,173,62,18,1048,0,25,1073
14,9,14041,1275,3,384,246,138,42,13,823,1,21,845
14,9,14041,1276,3,304,221,116,47,11,699,0,20,719
14,9,14041,1277,3,354,302,161,51,27,895,2,20,917
14,9,14041,1278,3,541,372,185,50,20,1168,0,30,1198
14,9,14041,1279,3,421,235,135,60,14,865,2,16,883
14,9,14041,1280,3,468,327,154,65,24,1038,3,28,1069
14,9,14041,1281,3,251,243,125,54,27,700,2,20,722
14,9,14041,1282,3,260,149,103,25,10,547,1,11,559
14,9,14041,1283,3,511,373,168,55,16,1123,0,25,1148
14,9,14041,1284,3,331,177,134,29,13,684,2,15,701
14,9,14041,1285,3,294,237,90,28,9,658,0,7,665
14,9,14041,1286,3,374,257,120,34,18,803,0,26,829
14,9,14041,1287,3,359,241,118,42,13,773,5,15,793
14,9,14041,1288,3,554,351,146,64,17,1132,1,31,1164
14,9,14041,1289,3,416,283,117,72,20,908,0,19,927
14,9,14041,1290,3,300,275,88,25,9,697,1,13,711
14,9,14041,1291,3,373,251,126,50,13,813,0,18,831
14,9,14041,1292,3,494,378,171,44,23,1110,2,27,1139
14,9,14041,1293,3,677,319,247,60,28,1331,0,19,1350
14,9,14041,1294,3,330,221,144,33,15,743,0,6,749
14,9,14041,1295,3,320,204,109,52,16,701,0,10,711
14,9,14041,1296,3,536,274,206,38,17,1071,4,13,1088
14,9,14041,1297,3,539,287,184,59,30,1099,2,18,1119
14,9,14041,1298,3,472,249,145,44,19,929,3,19,951
14,9,14041,1299,3,353,173,129,24,12,691,1,12,704
14,9,14041,1300,3,370,191,165,48,20,794,1,6,801
14,9,14041,1301,3,420,189,143,45,10,807,3,11,821
14,9,14041,1302,3,461,186,135,41,18,841,0,9,850
14,9,14041,1303,3,594,256,262,46,25,1183,0,6,1189
14,9,14041,1304,3,364,221,167,63,27,842,1,9,852
14,9,14041,1305,3,346,186,155,41,16,744,0,23,767
14,9,14041,1306,3,374,180,181,41,28,804,0,9,813
14,9,14041,1307,3,749,373,239,54,30,1445,0,17,1462
14,9,14041,1308,3,424,200,127,44,19,814,0,20,834
14,9,14041,1309,3,728,305,272,74,24,1403,2,16,1421
14,9,14041,1310,3,693,289,215,61,23,1281,1,15,1297
14,9,14041,1311,3,281,195,125,34,9,644,0,20,664
14,9,14041,1312,3,322,185,86,41,12,646,1,15,662
14,9,14041,1313,3,301,223,131,33,13,701,1,15,717
14,9,14041,1314,3,231,174,85,23,11,524,0,8,532
14,9,14041,1315,3,397,247,148,51,19,862,3,30,895
14,9,14041,1316,3,304,198,87,48,9,646,0,17,663
14,9,14041,1317,3,400,214,130,38,11,793,3,16,812
14,9,14041,1341,3,440,276,155,45,18,934,1,20,955
14,9,14041,1342,3,485,242,146,35,21,929,4,23,956
14,9,14041,1343,3,398,308,135,69,15,925,1,31,957
14,9,14041,1344,3,452,291,117,66,19,945,2,25,972
14,9,14041,1345,3,537,333,150,86,23,1129,5,24,1158
14,9,14041,1346,3,502,246,147,49,10,954,2,15,971
14,9,14041,1347,3,562,329,216,67,19,1193,1,33,1227
14,9,14041,1348,3,367,214,135,48,19,783,4,17,804
14,9,14041,1349,3,335,285,158,40,15,833,1,26,860
14,9,14041,1350,3,466,243,158,37,14,918,1,11,930
14,9,14041,1351,3,541,239,154,43,23,1000,0,9,1009
14,9,14041,1352,3,446,175,131,48,24,824,0,14,838
14,9,14041,1353,3,606,261,200,77,26,1170,0,18,1188
14,9,14041,1354,3,243,177,100,38,13,571,0,6,577
14,9,14041,1355,3,473,224,185,61,29,972,0,8,980
14,9,14041,1356,3,497,223,168,50,18,956,0,10,966
14,9,14041,1362,3,284,222,94,39,13,652,2,8,662
14,9,14041,1363,3,261,202,105,38,8,614,0,13,627
14,9,14041,1364,3,434,254,174,44,18,924,1,19,944
14,9,14041,1365,3,433,316,171,57,25,1002,1,21,1024
14,9,14041,1366,3,308,221,119,36,13,697,0,20,717
14,9,14041,1367,3,262,156,104,27,9,558,1,13,572
14,9,14041,1368,3,364,186,157,46,34,787,2,15,804
14,9,14041,1369,3,271,165,33,18,7,494,2,9,505
14,9,14041,1370,3,273,221,85,33,12,624,1,19,644
14,9,14041,1371,3,548,401,136,70,34,1189,2,16,1207
14,9,14041,1372,3,388,252,114,32,15,801,1,12,814
14,9,14041,1373,3,455,321,136,69,23,1004,2,27,1033
14,10,14120,3097,3,825,360,122,57,38,1402,2,25,1429
14,10,14120,3098,3,554,328,90,54,20,1046,2,21,1069
14,10,14120,3099,3,666,422,135,61,31,1315,3,18,1336
14,10,14120,3100,3,744,337,169,69,44,1363,8,28,1399
14,10,14120,3101,3,882,386,81,46,35,1430,0,13,1443
14,10,14120,3102,3,701,254,99,39,31,1124,2,11,1137
14,10,14120,3103,3,1214,465,197,80,68,2024,5,12,2041
14,10,14120,3111,3,2048,757,268,87,75,3235,5,21,3261
14,10,14120,3112,3,1531,551,172,74,62,2390,1,16,2407
14,10,14120,3113,3,1477,548,193,89,61,2368,2,7,2377
14,10,14120,3114,3,2200,1004,374,159,112,3849,1,44,3894
14,10,14120,3115,3,695,287,144,55,35,1216,0,14,1230
14,10,14120,3120,3,492,786,213,61,37,1589,12,62,1663
14,10,14120,3121,3,834,824,243,96,42,2039,0,57,2096
14,10,14120,3122,3,858,939,272,167,57,2293,3,80,2376
14,10,14120,3123,3,480,209,63,31,30,813,0,12,825
14,10,14120,3124,3,445,439,91,64,18,1057,0,23,1080
14,10,14120,3125,3,651,316,141,66,36,1210,5,10,1225
14,10,14120,3126,3,1701,724,281,154,79,2939,1,19,2959
14,10,14120,3127,3,369,263,106,37,24,799,2,8,809
14,10,14120,3128,3,476,162,172,64,13,887,2,6,895
14,10,14120,3129,3,904,709,165,129,84,1991,7,20,2018
14,10,14120,3130,3,705,594,145,98,39,1581,8,33,1622
14,10,14120,3131,3,627,347,116,52,25,1167,2,14,1183
14,10,14120,3132,3,1350,729,227,120,60,2486,6,26,2518
14,10,14120,3133,3,1119,367,126,51,40,1703,1,13,1717
14,10,14120,3136,3,548,207,70,39,15,879,0,15,894
14,10,14120,3137,3,506,263,86,51,14,920,1,13,934
14,10,14120,3138,3,598,267,50,41,24,980,1,7,988
14,10,14120,3139,3,642,246,59,31,21,999,1,3,1003
14,10,14120,3146,3,740,270,85,47,35,1177,2,12,1191
14,10,14120,3147,3,1510,677,234,116,84,2621,2,27,2650
14,10,14120,3148,3,617,493,163,69,41,1383,2,21,1406
14,10,14120,3149,3,871,385,116,66,39,1477,5,16,1498
14,10,14120,3150,3,307,339,107,60,24,837,1,23,861
14,10,14120,3151,3,827,655,165,106,65,1818,3,46,1867
14,10,14120,3152,3,1127,1149,326,154,43,2799,8,77,2884
14,10,14120,3153,3,837,724,203,133,42,1939,9,46,1994
14,10,14120,3154,3,2061,1817,620,272,92,4862,26,134,5022
14,10,14120,3155,3,961,772,187,134,53,2107,8,61,2176
14,10,14120,3156,3,723,602,173,101,37,1636,9,38,1683
14,10,14120,3157,3,992,772,202,116,39,2121,7,49,2177
14,10,14120,3158,3,885,846,210,130,50,2121,4,56,2181
14,10,14120,3159,3,770,582,228,97,39,1716,1,41,1758
14,10,14120,3160,3,716,563,160,103,40,1582,7,31,1620
14,10,14120,3161,3,871,355,160,77,38,1501,0,2,1503
14,10,14120,3162,3,769,300,130,60,38,1297,0,12,1309
14,10,14120,3163,3,845,306,121,66,42,1380,2,14,1396
14,10,14120,3164,3,464,192,67,22,24,769,0,10,779
14,10,14120,3165,3,410,173,49,28,15,675,2,5,682
14,10,14120,3166,3,765,257,128,44,28,1222,1,9,1232
14,10,14120,3167,3,1037,393,131,55,39,1655,1,7,1663
14,10,14120,3168,3,1171,482,162,84,61,1960,2,15,1977
14,10,14120,3169,3,576,238,57,40,20,931,2,8,941
14,10,14120,3173,3,910,409,137,90,30,1576,3,31,1610
14,10,14120,3174,3,546,281,106,83,27,1043,2,26,1071
14,10,14120,3175,3,482,346,109,90,23,1050,4,27,1081
14,10,14120,3176,3,589,338,131,61,39,1158,2,26,1186
14,10,14120,3177,3,717,278,111,63,27,1196,7,29,1232
14,10,14120,3178,3,683,273,135,52,29,1172,2,2,1176
14,10,14120,3179,3,803,283,112,53,36,1287,1,10,1298
14,10,14120,3180,3,784,284,98,64,29,1259,6,16,1281
14,10,14120,3181,3,678,282,98,51,35,1144,0,7,1151
14,10,14120,3182,3,687,185,142,35,31,1080,0,9,1089
14,10,14120,3183,3,654,255,85,34,23,1051,2,3,1056
14,10,14120,3184,3,644,231,85,27,18,1005,1,7,1013
14,10,14120,3185,3,806,216,92,32,32,1178,2,3,1183
14,10,14120,3186,3,834,260,97,49,39,1279,2,13,1294
14,10,14120,3187,3,897,390,147,55,37,1526,0,29,1555
14,10,14120,3188,3,1070,374,155,66,53,1718,0,6,1724
14,10,14120,3189,3,835,280,118,43,39,1315,2,15,1332
14,10,14120,3190,3,557,254,112,72,35,1030,3,10,1043
14,10,14120,3191,3,484,272,76,30,34,896,0,13,909
14,10,14120,3192,3,459,298,73,85,16,931,0,10,941
14,10,14120,3193,3,393,229,64,49,11,746,0,12,758
14,10,14120,3194,3,781,321,104,59,24,1289,2,14,1305
14,10,14120,3195,3,714,277,117,51,28,1187,0,10,1197
14,10,14120,3196,3,792,250,113,48,34,1237,0,16,1253
14,10,14120,3197,3,786,255,122,57,33,1253,2,26,1281
14,10,14120,3198,3,630,329,147,93,22,1221,6,18,1245
14,10,14120,3200,3,311,141,56,37,11,556,0,8,564
14,10,14120,3205,3,558,235,133,45,34,1005,0,7,1012
14,10,14120,3206,3,832,696,182,140,55,1905,2,32,1939
14,10,14120,3207,3,284,305,75,40,20,724,2,28,754
14,10,14120,3208,3,620,480,150,107,26,1383,7,31,1421
14,10,14120,3209,3,315,248,87,44,26,720,2,32,754
14,10,14120,3210,3,845,437,150,87,46,1565,7,30,1602
14,10,14120,3211,3,799,543,209,108,34,1693,10,50,1753
14,10,14120,3212,3,707,442,149,65,32,1395,10,39,1444
14,10,14120,3213,3,703,576,198,90,43,1610,0,51,1661
14,10,14120,3214,3,334,390,118,52,17,911,2,35,948
14,10,14120,3215,3,1940,1223,382,150,85,3780,2,82,3864
14,10,14120,3216,3,598,764,159,68,27,1616,2,39,1657
14,10,14120,3217,3,625,328,240,66,32,1291,7,12,1310
14,10,14120,3218,3,276,151,50,32,18,527,0,11,538
14,10,14120,3219,3,1866,404,153,90,49,2562,1,6,2569
14,10,14120,3220,3,593,180,57,32,23,885,1,10,896
14,10,14120,3221,3,279,289,116,52,11,747,4,11,762
14,10,14120,3222,3,468,284,109,69,20,950,6,26,982
14,10,14120,3223,3,721,496,176,93,41,1527,6,41,1574
14,10,14120,3224,3,435,275,103,49,16,878,4,15,897
14,10,14120,3225,3,986,719,260,152,44,2161,3,38,2202
14,10,14120,3236,3,309,372,97,47,26,851,0,23,874
14,11,14041,633,3,299,222,93,53,15,682,1,15,698
14,11,14041,634,3,255,172,85,38,14,564,0,15,579
14,11,14041,635,3,345,213,94,42,16,710,4,23,737
14,11,14041,636,3,306,182,59,41,17,605,2,23,630
14,11,14041,637,3,561,325,175,75,28,1164,3,30,1197
14,11,14041,638,3,698,313,221,109,32,1373,6,18,1397
14,11,14041,639,3,348,185,102,48,20,703,0,3,706
14,11,14041,640,3,307,190,75,46,7,625,1,22,648
14,11,14041,641,3,371,196,117,72,7,763,11,18,792
14,11,14041,642,3,286,237,82,67,22,694,3,24,721
14,11,14041,643,3,364,250,86,51,18,769,3,20,792
14,11,14041,644,3,281,286,64,44,17,692,3,16,711
14,11,14041,645,3,441,298,137,65,9,950,6,22,978
14,11,14041,646,3,405,312,131,53,17,918,1,18,937
14,11,14041,647,3,403,318,126,72,11,930,1,18,949
14,11,14041,648,3,275,166,151,34,95,721,1,26,748
14,11,14041,649,3,251,234,130,66,22,703,7,14,724
14,11,14041,650,3,292,303,119,56,13,783,3,22,808
14,11,14041,651,3,311,276,100,43,18,748,0,11,759
14,11,14041,652,3,305,252,110,44,22,733,5,17,755
14,11,14041,653,3,454,265,118,96,20,953,0,17,970
14,11,14041,654,3,290,221,64,58,17,650,4,12,666
14,11,14041,655,3,233,222,62,62,22,601,4,6,611
14,11,14041,656,3,241,208,48,44,14,555,2,11,568
14,11,14041,657,3,67,90,11,18,6,192,0,5,197
14,11,14041,658,3,87,79,23,18,5,212,3,3,218
14,11,14041,659,3,123,125,39,34,3,324,1,5,330
14,11,14041,660,3,225,121,107,42,11,506,3,25,534
14,11,14041,661,3,344,240,102,55,25,766,7,8,781
14,11,14041,662,3,276,215,57,47,10,605,0,9,614
14,11,14041,663,3,559,334,135,103,25,1156,1,20,1177
14,11,14041,664,3,539,273,137,84,36,1069,1,35,1105
14,11,14041,665,3,680,424,205,120,40,1469,2,28,1499
14,11,14041,666,3,547,271,150,81,24,1073,4,13,1090
14,11,14041,693,3,391,180,102,69,13,755,3,16,774
14,11,14041,694,3,336,223,58,75,14,706,1,21,728
14,11,14041,695,3,474,283,99,60,19,935,5,25,965
14,11,14041,696,3,516,363,134,96,29,1138,2,33,1173
14,11,14041,697,3,398,294,113,88,12,905,3,15,923
14,11,14041,698,3,258,218,89,99,18,682,3,23,708
14,11,14041,699,3,474,286,126,105,23,1014,0,28,1042
14,11,14041,700,3,497,249,94,78,14,932,1,15,948
14,11,14041,701,3,591,287,131,101,21,1131,1,12,1144
14,11,14041,702,3,360,217,68,153,11,809,0,13,822
14,11,14041,703,3,321,211,120,70,32,754,3,9,766
14,11,14041,704,3,422,252,132,78,22,906,4,13,923
14,11,14041,705,3,316,228,97,77,18,736,4,16,756
14,11,14041,706,3,333,297,97,90,20,837,0,13,850
14,11,14041,707,3,255,148,76,33,15,527,2,4,533
14,11,14041,708,3,259,183,103,45,29,619,3,5,627
14,11,14041,709,3,243,194,78,32,16,563,5,13,581
14,11,14041,710,3,589,388,192,109,35,1313,4,17,1334
14,11,14041,711,3,345,184,109,44,18,700,1,12,713
14,11,14041,712,3,962,622,318,120,49,2071,8,33,2112
14,11,14041,713,3,282,288,76,71,17,734,0,9,743
14,11,14041,714,3,305,237,68,59,12,681,6,13,700
14,11,14041,715,3,189,175,59,31,6,460,1,9,470
14,11,14041,716,3,310,309,98,43,19,779,2,16,797
14,11,14041,717,3,410,340,91,49,20,910,1,12,923
14,11,14041,718,3,367,280,99,71,18,835,2,17,854
14,11,14041,719,3,262,265,81,52,16,676,0,9,685
14,11,14041,720,3,395,371,119,53,23,961,3,12,976
14,11,14041,721,3,283,273,94,39,14,703,1,15,719
14,11,14041,722,3,378,248,77,38,14,755,1,27,783
14,11,14041,723,3,346,238,104,77,17,782,3,20,805
14,11,14041,724,3,535,443,150,114,38,1280,1,33,1314
14,11,14041,725,3,518,353,116,71,21,1079,5,23,1107
14,11,14041,726,3,495,287,159,106,27,1074,7,22,1103
14,11,14041,727,3,590,322,135,116,34,1197,11,10,1218
14,11,14041,728,3,387,320,105,83,25,920,5,16,941
14,11,14041,729,3,371,247,98,64,20,800,1,24,825
14,11,14041,730,3,516,361,163,92,26,1158,1,33,1192
14,11,14041,731,3,466,309,129,70,16,990,5,18,1013
14,11,14041,732,3,268,186,78,40,12,584,0,12,596
14,11,14041,733,3,216,158,56,21,10,461,1,14,476
14,11,14041,744,3,363,197,88,51,21,720,0,13,733
14,11,14041,745,3,305,195,71,34,14,619,0,13,632
14,11,14041,746,3,244,137,66,42,12,501,5,10,516
14,11,14041,747,3,233,161,67,41,12,514,1,10,525
14,11,14041,748,3,572,332,121,93,19,1137,5,27,1169
14,11,14041,749,3,520,273,106,60,22,981,0,23,1004
14,11,14041,755,3,368,188,73,57,15,701,5,14,720
14,11,14041,756,3,435,339,122,79,34,1009,1,32,1042
14,11,14041,1318,3,439,301,142,66,23,971,2,24,997
14,11,14041,1319,3,445,358,153,66,12,1034,1,21,1056
14,11,14041,1320,3,400,322,121,83,23,949,4,24,977
14,11,14041,1321,3,380,277,75,53,20,805,4,26,835
14,11,14041,1322,3,244,192,57,45,13,551,2,17,570
14,11,14041,1323,3,304,224,81,49,14,672,1,18,691
14,11,14041,1324,3,294,284,95,59,17,749,4,9,762
14,11,14041,1325,3,305,254,98,42,18,717,3,21,741
14,11,14041,1326,3,284,238,116,46,26,710,0,13,723
14,11,14041,1327,3,554,409,143,83,26,1215,7,16,1238
14,11,14041,1328,3,522,388,147,71,20,1148,6,32,1186
14,11,14041,1329,3,275,249,91,40,20,675,5,19,699
14,11,14041,1330,3,487,427,112,81,29,1136,4,33,1173
14,11,14041,1331,3,106,1074,489,59,14,1742,2,55,1799
14,11,14041,1332,3,532,443,176,84,34,1269,9,29,1307
14,11,14041,1333,3,626,494,183,120,25,1448,7,38,1493
14,11,14041,1334,3,321,283,107,39,17,767,3,23,793
14,11,14041,1335,3,377,267,101,54,16,815,0,23,838
14,11,14041,1336,3,555,420,152,74,25,1226,6,44,1276
14,11,14041,1337,3,434,231,136,66,24,891,1,8,900
14,11,14041,1338,3,372,247,84,50,15,768,8,9,785
14,11,14041,1339,3,386,303,105,77,22,893,2,36,931
14,11,14041,1340,3,523,318,148,69,26,1084,2,28,1114
14,11,14041,1374,3,308,191,95,49,12,655,1,13,669
14,11,14041,1375,3,263,290,83,53,12,701,3,18,722
14,11,14041,1376,3,406,326,127,67,2,928,2,13,943
14,11,14041,1377,3,306,282,126,41,23,778,1,19,798
14,11,14041,1378,3,805,506,182,115,36,1644,9,41,1694
14,11,14041,1379,3,506,438,195,89,15,1243,6,6,1255
14,11,14041,1380,3,318,365,162,66,21,932,1,16,949
14,11,14041,1381,3,230,259,98,37,16,640,5,21,666
14,11,14041,1382,3,266,273,86,52,15,692,2,17,711
14,11,14041,1383,3,217,246,100,40,16,619,4,19,642
14,11,14041,1384,3,170,252,164,30,10,626,2,30,658
14,11,14041,1385,3,533,446,135,75,18,1207,2,30,1239
14,11,14041,1386,3,276,250,85,44,11,666,6,13,685
14,11,14041,1387,3,531,450,118,77,29,1205,6,37,1248
14,11,14041,1388,3,298,238,64,49,9,658,2,10,670
14,11,14041,1389,3,432,494,180,92,22,1220,5,27,1252
14,11,14041,1390,3,75,380,182,34,2,673,0,23,696
14,11,14041,1391,3,91,407,246,30,6,780,0,20,800
14,11,14041,1392,3,110,379,222,22,11,744,0,13,757
14,11,14041,1393,3,345,229,107,39,10,730,3,13,746
14,11,14041,1394,3,248,317,139,46,19,769,2,11,782
14,11,14041,1395,3,260,405,156,49,9,879,1,30,910
14,11,14041,1396,3,264,284,116,34,17,715,3,22,740
14,11,14041,1397,3,463,554,227,88,23,1355,5,17,1377
14,11,14041,1398,3,291,213,97,41,11,653,2,15,670
14,11,14041,1399,3,473,289,101,65,24,952,1,12,965
14,11,14041,1400,3,507,273,111,65,31,987,1,29,1017
14,11,14041,1401,3,449,308,125,116,28,1026,4,26,1056
14,11,14041,1402,3,467,297,111,88,27,990,1,10,1001
14,11,14041,1403,3,584,370,116,77,26,1173,2,21,1196
14,11,14041,1404,3,368,194,89,47,23,721,2,16,739
14,11,14041,1405,3,310,258,74,53,19,714,2,7,723
14,11,14041,1406,3,313,205,55,35,21,629,6,17,652
14,11,14041,1407,3,449,356,96,72,25,998,3,24,1025
14,11,14041,1408,3,449,309,96,71,20,945,3,24,972
14,11,14041,1409,3,469,332,109,60,20,990,6,23,1019
14,11,14041,1410,3,362,175,99,44,16,696,1,16,713
14,11,14041,1411,3,343,265,100,58,24,790,2,14,806
14,11,14041,1412,3,383,252,97,50,13,795,3,21,819
14,11,14041,1413,3,420,327,173,60,17,997,4,34,1035
14,11,14041,1414,3,368,226,99,60,24,777,3,8,788
14,11,14041,1415,3,375,270,92,58,18,813,6,24,843
14,11,14041,1416,3,504,378,139,89,28,1138,5,28,1171
14,11,14041,1417,3,521,319,138,58,20,1056,3,23,1082
14,11,14041,1418,3,280,268,92,47,24,711,2,19,732
14,11,14041,1419,3,271,204,88,38,17,618,6,20,644
14,11,14041,1420,3,291,249,82,61,19,702,5,12,719
14,11,14041,1421,3,283,247,83,78,17,708,3,9,720
14,11,14041,1422,3,377,331,117,73,19,917,12,23,952
14,11,14041,1423,3,296,249,84,60,15,704,0,14,718
14,11,14041,1424,3,423,358,115,63,31,990,4,18,1012
14,11,14041,1425,3,351,304,98,69,23,845,5,19,869
14,11,14041,1426,3,305,227,85,43,12,672,1,17,690
14,11,14041,1427,3,378,331,96,70,39,914,9,8,931
14,11,14041,1428,3,391,241,109,77,26,844,1,9,854
14,11,14041,1429,3,293,218,58,52,13,634,2,18,654
14,11,14041,1430,3,366,200,86,45,19,716,4,16,736
14,11,14041,1431,3,592,354,158,69,24,1197,3,6,1206
14,11,14041,1432,3,275,186,67,36,16,580,1,21,602
14,11,14041,1433,3,379,239,114,54,12,798,3,20,821
14,11,14041,1434,3,404,240,92,54,21,811,0,17,828
14,11,14041,1435,3,656,504,188,126,36,1510,2,28,1540
14,11,14041,1436,3,618,440,136,88,28,1310,3,27,1340
14,11,14041,1437,3,303,168,96,36,10,613,2,16,631
14,11,14041,1438,3,301,176,74,46,11,608,2,10,620
14,11,14041,1459,3,562,412,122,99,37,1232,5,27,1264
14,11,14041,1463,3,290,194,77,45,11,617,2,14,633
14,11,14041,1464,3,323,207,110,51,12,703,0,14,717
14,12,14072,2024,3,465,555,367,145,31,1563,1,51,1615
14,12,14072,2025,3,534,843,445,226,42,2090,6,60,2156
14,12,14072,2026,3,177,284,165,57,11,694,0,23,717
14,12,14072,2027,3,309,473,196,129,26,1133,1,36,1170
14,12,14072,2028,3,252,416,221,101,27,1017,0,31,1048
14,12,14072,2029,3,182,354,225,69,11,841,0,28,869
14,12,14072,2030,3,459,690,457,207,43,1856,10,44,1910
14,12,14072,2031,3,349,546,131,79,22,1127,6,41,1174
14,12,14072,2032,3,267,383,122,63,10,845,4,0,849
14,12,14072,2033,3,373,563,124,73,9,1142,5,28,1175
14,12,14072,2034,3,262,454,134,85,21,956,3,13,972
14,12,14072,2035,3,996,1618,444,224,52,3334,12,118,3464
14,12,14072,2036,3,483,987,172,75,45,1762,5,85,1852
14,12,14072,2037,3,495,357,114,65,26,1057,0,19,1076
14,12,14072,2038,3,726,676,276,151,36,1865,4,51,1920
14,12,14072,2039,3,564,478,216,123,28,1409,6,39,1454
14,12,14072,2040,3,589,587,188,107,33,1504,4,27,1535
14,12,14072,2041,3,327,453,136,74,18,1008,2,22,1032
14,12,14072,2042,3,232,180,71,49,23,555,3,25,583
14,12,14072,2043,3,843,1446,533,188,49,3059,23,106,3188
14,12,14072,2044,3,507,452,430,156,38,1583,11,82,1676
14,12,14072,2045,3,390,597,295,179,36,1497,9,18,1524
14,12,14072,2046,3,366,421,285,147,29,1248,2,30,1280
14,12,14072,2047,3,186,31,28,10,11,266,0,1,267
14,12,14072,2048,3,192,289,165,38,16,700,9,10,719
14,12,14072,2049,3,1012,1311,652,198,60,3233,13,107,3353
14,12,14098,2438,3,471,441,154,47,12,1125,1,30,1156
14,12,14098,2439,3,475,418,183,74,19,1169,4,19,1192
14,12,14098,2440,3,347,443,139,45,4,978,1,17,996
14,12,14098,2441,3,333,359,164,39,8,903,0,24,927
14,12,14098,2442,3,451,468,179,55,10,1163,2,33,1198
14,12,14098,2443,3,444,436,205,55,13,1153,3,26,1182
14,12,14098,2444,3,2607,1657,792,362,106,5524,6,86,5616
14,12,14098,2445,3,362,417,215,26,11,1031,0,24,1055
14,12,14098,2446,3,1048,398,277,148,44,1915,2,51,1968
14,12,14098,2447,3,1549,838,481,231,71,3170,5,74,3249
14,12,14098,2448,3,673,337,180,93,19,1302,5,23,1330
14,12,14098,2449,3,962,350,270,120,41,1743,1,37,1781
14,12,14098,2450,3,835,479,188,80,37,1619,3,35,1657
14,12,14098,2451,3,1708,924,528,248,77,3485,4,73,3562
14,12,14098,2452,3,529,508,149,72,25,1283,6,25,1314
14,12,14098,2453,3,1170,660,480,174,52,2536,2,73,2611
14,12,14098,2454,3,623,409,344,115,28,1519,2,43,1564
14,12,14098,2455,3,1216,817,501,251,79,2864,8,60,2932
14,12,14098,2456,3,579,473,251,79,25,1407,3,36,1446
14,12,14098,2457,3,488,343,196,73,15,1115,6,22,1143
14,12,14098,2458,3,507,252,194,62,28,1043,1,17,1061
14,12,14098,2459,3,326,438,340,108,9,1221,2,18,1241
14,12,14098,2460,3,609,307,304,45,19,1284,5,29,1318
14,12,14098,2461,3,235,298,255,62,8,858,0,14,872
14,12,14098,2462,3,579,353,318,90,26,1366,3,28,1397
14,12,14098,2463,3,710,297,178,65,14,1264,1,46,1311
14,12,14098,2464,3,594,270,174,48,13,1099,0,27,1126
14,12,14098,2465,3,2588,866,406,179,116,4155,3,83,4241
14,12,14098,2466,3,883,199,55,20,25,1182,0,7,1189
14,12,14098,2467,3,798,414,229,80,25,1546,3,36,1585
14,12,14098,2468,3,794,607,478,106,25,2010,6,53,2069
14,12,14098,2469,3,567,453,235,105,21,1381,2,46,1429
14,12,14098,2470,3,401,414,101,55,32,1003,4,11,1018
14,12,14098,2471,3,269,275,101,69,7,721,0,16,737
14,12,14098,2472,3,662,625,138,103,13,1541,1,47,1589
14,12,14099,2526,3,557,495,117,57,32,1258,4,32,1294
14,12,14099,2528,3,692,486,175,80,44,1477,3,38,1518
14,12,14099,2529,3,581,260,165,71,26,1103,4,32,1139
14,12,14099,2530,3,1269,782,338,107,87,2583,21,26,2630
14,12,14099,2531,3,712,357,145,65,25,1304,4,18,1326
14,12,14099,2533,3,588,262,109,39,21,1019,3,9,1031
14,12,14099,2534,3,816,297,132,55,38,1338,1,23,1362
14,12,14099,2535,3,307,190,102,34,15,648,4,8,660
14,12,14099,2536,3,350,309,133,58,15,865,3,24,892
14,12,14099,2537,3,558,285,160,64,33,1100,1,12,1113
14,12,14099,2538,3,446,419,123,78,30,1096,4,24,1124
14,12,14099,2539,3,513,522,151,82,25,1293,11,17,1321
14,12,14099,2540,3,946,561,205,118,86,1916,7,46,1969
14,12,14099,2541,3,539,458,115,62,23,1197,6,39,1242
14,12,14099,2542,3,517,423,107,47,20,1114,6,30,1150
14,12,14099,2543,3,483,355,131,60,19,1048,7,26,1081
14,12,14099,2544,3,390,377,130,40,31,968,5,20,993
14,12,14099,2545,3,523,591,181,68,35,1398,4,38,1440
14,12,14099,2546,3,515,364,219,84,24,1206,6,34,1246
14,12,14099,2547,3,450,345,158,53,28,1034,6,31,1071
14,12,14099,2548,3,715,745,249,143,47,1899,14,51,1964
14,12,14099,2555,3,335,342,87,64,15,843,1,23,867
14,12,14099,2556,3,914,836,328,157,69,2304,9,60,2373
14,12,14099,2557,3,417,584,135,78,17,1231,8,37,1276
14,12,14099,2558,3,338,509,132,67,34,1080,4,43,1127
14,12,14099,2559,3,518,519,88,51,28,1204,6,26,1236
14,12,14099,2560,3,271,318,96,38,13,736,2,21,759
14,12,14099,2561,3,171,472,73,49,15,780,0,15,795
14,12,14099,2562,3,929,1181,210,104,46,2470,2,87,2559
14,12,14099,2563,3,620,594,159,72,41,1486,7,41,1534
14,12,14099,2564,3,517,793,174,98,30,1612,17,52,1681
14,12,14099,2565,3,283,592,120,75,19,1089,11,19,1119
14,12,14099,2566,3,401,699,197,72,42,1411,1,39,1451
14,12,14099,2567,3,982,905,434,154,94,2569,4,80,2653
14,12,14099,2587,3,1045,1031,277,158,66,2577,7,67,2651
14,12,14099,2620,3,671,492,112,54,24,1353,5,11,1369
14,12,14099,2621,3,585,384,72,35,24,1100,3,32,1135
14,12,14099,2622,3,426,344,50,22,14,856,1,23,880
14,12,14099,2623,3,532,423,92,31,10,1088,0,33,1121
14,12,14099,2624,3,962,701,139,77,38,1917,5,34,1956
14,12,14099,3310,3,28,19,6,2,1,56,0,3,59
14,13,14041,772,3,264,163,53,42,11,533,1,10,544
14,13,14041,773,3,306,214,94,35,7,656,2,16,674
14,13,14041,774,3,300,203,68,42,21,634,3,8,645
14,13,14041,775,3,267,127,53,40,17,504,0,8,512
14,13,14041,776,3,293,199,87,28,8,615,0,14,629
14,13,14041,777,3,500,262,129,73,28,992,1,9,1002
14,13,14041,778,3,472,231,91,58,19,871,0,20,891
14,13,14041,780,3,315,222,77,56,28,698,3,15,716
14,13,14041,781,3,269,169,80,34,11,563,3,26,592
14,13,14041,782,3,317,198,81,38,16,650,2,7,659
14,13,14041,783,3,288,213,77,52,20,650,3,17,670
14,13,14041,784,3,582,325,139,74,30,1150,3,22,1175
14,13,14041,785,3,288,172,58,35,11,564,0,5,569
14,13,14041,786,3,283,132,61,33,13,522,2,14,538
14,13,14041,787,3,419,272,77,51,23,842,1,12,855
14,13,14041,788,3,570,260,120,69,22,1041,0,15,1056
14,13,14041,789,3,510,215,109,43,32,909,1,25,935
14,13,14041,790,3,476,364,104,63,25,1032,4,17,1053
14,13,14041,929,3,97,178,60,28,7,370,1,18,389
14,13,14041,930,3,112,94,25,29,4,264,0,1,265
14,13,14041,931,3,133,194,64,33,8,432,2,14,448
14,13,14041,932,3,253,266,96,27,23,665,1,14,680
14,13,14041,933,3,154,180,52,34,7,427,4,7,438
14,13,14041,935,3,337,243,114,44,24,762,2,13,777
14,13,14041,936,3,309,179,88,51,16,643,5,5,653
14,13,14041,937,3,371,272,68,43,19,773,3,15,791
14,13,14041,938,3,293,179,48,37,11,568,3,18,589
14,13,14041,939,3,289,204,75,51,9,628,2,19,649
14,13,14041,940,3,344,237,73,41,11,706,3,15,724
14,13,14041,941,3,311,275,94,58,10,748,0,13,761
14,13,14041,942,3,294,278,86,46,14,718,2,0,720
14,13,14041,943,3,217,161,44,23,15,460,0,13,473
14,13,14041,944,3,217,141,44,41,11,454,4,13,471
14,13,14041,945,3,258,223,73,48,13,615,0,13,628
14,13,14041,946,3,277,193,51,34,15,570,4,9,583
14,13,14041,947,3,187,145,61,32,16,441,1,8,450
14,13,14041,948,3,159,107,42,23,7,338,1,6,345
14,13,14041,949,3,260,244,63,40,10,617,3,12,632
14,13,14041,950,3,370,245,78,47,23,763,7,15,785
14,13,14041,951,3,236,153,58,22,9,478,4,9,491
14,13,14041,952,3,266,148,49,29,11,503,1,6,510
14,13,14041,953,3,233,165,47,32,17,494,4,11,509
14,13,14041,954,3,304,137,54,43,18,556,0,10,566
14,13,14041,955,3,235,208,56,38,26,563,2,12,577
14,13,14041,956,3,305,184,60,33,14,596,0,13,609
14,13,14041,957,3,248,201,46,36,11,542,0,12,554
14,13,14041,958,3,315,349,109,58,15,846,2,8,856
14,13,14041,959,3,227,237,63,35,15,577,0,4,581
14,13,14041,960,3,151,208,41,38,26,464,1,11,476
14,13,14041,961,3,183,167,57,17,11,435,2,15,452
14,13,14041,962,3,265,171,54,43,14,547,0,6,553
14,13,14041,963,3,243,181,60,45,20,549,1,9,559
14,13,14041,964,3,383,331,91,52,18,875,0,19,894
14,13,14041,965,3,222,226,89,34,15,586,0,15,601
14,13,14041,966,3,194,207,77,63,21,562,0,15,577
14,13,14041,967,3,462,231,113,40,17,863,0,4,867
14,13,14041,968,3,399,219,82,54,12,766,3,9,778
14,13,14041,969,3,255,143,61,34,20,513,0,9,522
14,13,14041,970,3,182,104,46,25,5,362,0,4,366
14,13,14041,971,3,171,119,51,32,15,388,0,9,397
14,13,14041,972,3,187,140,50,31,15,423,0,12,435
14,13,14041,973,3,270,187,83,37,8,585,1,7,593
14,13,14041,974,3,259,137,43,18,7,464,0,12,476
14,13,14041,975,3,296,266,73,27,25,687,12,8,707
14,13,14041,976,3,152,148,32,21,13,366,2,7,375
14,13,14041,977,3,142,153,43,22,13,373,0,9,382
14,13,14041,978,3,210,193,74,34,13,524,1,13,538
14,13,14041,979,3,152,96,39,23,9,319,2,4,325
14,13,14041,980,3,199,191,55,39,8,492,2,9,503
14,13,14041,981,3,215,218,54,41,5,533,5,19,557
14,13,14041,982,3,345,245,100,62,19,771,2,26,799
14,13,14041,983,3,140,96,26,35,9,306,1,7,314
14,13,14041,984,3,333,199,94,43,23,692,2,12,706
14,13,14041,985,3,149,83,38,12,6,288,0,4,292
14,13,14041,986,3,240,128,66,20,11,465,0,7,472
14,13,14041,987,3,235,146,60,32,9,482,1,7,490
14,13,14041,988,3,373,255,140,60,26,854,5,22,881
14,13,14041,989,3,178,83,51,10,6,328,0,14,342
14,13,14041,990,3,344,425,97,43,16,925,0,29,954
14,13,14041,991,3,242,187,51,19,21,520,0,13,533
14,13,14041,992,3,240,179,44,24,10,497,1,9,507
14,13,14041,993,3,208,290,44,27,14,583,0,21,604
14,13,14041,994,3,424,309,86,43,18,880,1,20,901
14,13,14041,995,3,222,201,53,19,7,502,7,7,516
14,13,14041,996,3,745,401,135,88,37,1406,1,21,1428
14,13,14041,997,3,191,176,53,42,5,467,0,9,476
14,13,14041,998,3,243,183,55,23,7,511,2,13,526
14,13,14041,999,3,666,353,173,85,34,1311,1,36,1348
14,13,14041,1000,3,271,162,55,43,11,542,1,4,547
14,13,14041,1001,3,364,293,77,58,14,806,1,19,826
14,13,14041,1002,3,249,281,81,53,11,675,2,13,690
14,13,14041,1003,3,334,292,83,41,13,763,0,9,772
14,13,14041,1004,3,481,366,121,92,20,1080,3,16,1099
14,13,14041,1005,3,472,236,131,74,18,931,5,14,950
14,13,14041,1006,3,400,178,57,45,9,689,0,9,698
14,13,14041,1007,3,485,231,101,75,20,912,1,24,937
14,13,14041,1008,3,677,400,138,94,21,1330,0,22,1352
14,13,14041,1050,3,175,125,61,17,19,397,1,8,406
14,13,14041,1051,3,165,112,60,14,16,367,0,11,378
14,13,14041,1052,3,232,115,71,21,13,452,1,6,459
14,13,14041,1053,3,255,92,89,30,16,482,1,5,488
14,13,14041,1054,3,249,102,44,16,12,423,0,7,430
14,13,14041,1055,3,206,71,35,11,11,334,0,2,336
14,13,14041,1056,3,439,107,70,23,20,659,2,8,669
14,13,14041,1057,3,221,53,23,14,15,326,0,6,332
14,13,14041,1059,3,262,82,23,27,16,410,2,3,415
14,13,14041,1060,3,252,77,51,19,16,415,0,7,422
14,13,14041,1061,3,496,173,105,40,49,863,0,9,872
14,13,14041,1062,3,382,139,84,36,22,663,1,9,673
14,13,14041,1063,3,176,76,35,23,16,326,2,4,332
14,13,14041,1064,3,289,151,81,40,32,593,0,7,600
14,13,14041,1065,3,402,264,122,65,39,892,1,18,911
14,13,14041,1066,3,286,195,91,42,21,635,2,8,645
14,13,14041,1067,3,180,172,67,24,16,459,2,11,472
14,13,14041,1068,3,293,221,67,31,16,628,3,11,642
14,13,14041,1069,3,264,140,58,26,20,508,3,4,515
14,13,14041,1070,3,395,189,79,39,20,722,2,11,735
14,13,14041,1071,3,407,163,93,43,30,736,0,7,743
14,13,14041,1072,3,320,159,71,17,8,575,2,7,584
14,13,14041,1073,3,215,110,38,21,11,395,0,5,400
14,13,14041,1074,3,289,158,66,30,21,564,0,10,574
14,13,14041,1075,3,533,160,90,32,24,839,1,10,850
14,13,14041,1076,3,278,124,41,31,18,492,0,6,498
14,13,14041,1439,3,273,254,83,34,14,658,2,16,676
14,13,14041,1440,3,294,217,74,45,16,646,2,9,657
14,13,14041,1441,3,309,254,65,54,12,694,3,22,719
14,13,14041,1442,3,318,193,74,44,23,652,2,9,663
14,13,14041,1443,3,206,154,38,38,11,447,4,2,453
14,13,14041,1444,3,266,211,55,43,12,587,2,8,597
14,13,14041,1445,3,272,192,55,19,7,545,2,7,554
14,13,14041,1446,3,268,249,58,35,13,623,9,4,636
14,13,14041,1447,3,360,256,95,61,28,800,3,19,822
14,13,14041,1448,3,673,346,161,92,33,1305,5,29,1339
14,13,14041,1449,3,514,285,106,48,28,981,2,8,991
14,13,14041,1450,3,626,357,177,109,37,1306,5,25,1336
14,13,14041,1451,3,563,303,78,68,27,1039,2,23,1064
14,13,14041,1452,3,559,340,165,77,27,1168,2,26,1196
14,13,14041,1453,3,625,320,130,95,31,1201,2,22,1225
14,13,14041,1454,3,586,324,125,73,37,1145,4,33,1182
14,13,14041,1455,3,625,306,102,72,29,1134,2,34,1170
14,13,14041,1456,3,540,309,107,71,27,1054,8,14,1076
14,13,14041,1457,3,445,219,81,59,23,827,3,17,847
14,13,14041,1458,3,445,278,95,52,20,890,1,22,913
14,13,14041,1460,3,327,235,76,52,19,709,1,19,729
14,13,14041,1461,3,441,250,85,71,22,869,4,12,885
14,13,14041,1462,3,360,250,58,43,18,729,0,18,747
14,13,14041,1465,3,454,281,120,84,20,959,6,33,998
14,13,14041,1466,3,472,314,120,68,38,1012,2,15,1029
14,13,14041,1467,3,402,309,103,67,17,898,1,19,918
14,13,14041,1468,3,403,256,108,54,38,859,2,27,888
14,13,14041,1469,3,332,271,108,68,8,787,0,26,813
14,13,14041,1470,3,411,271,123,90,27,922,0,11,933
14,13,14041,1471,3,383,336,119,76,32,946,9,18,973
14,13,14041,1472,3,291,334,96,52,24,797,0,18,815
14,13,14041,1473,3,313,297,89,71,14,784,4,10,798
14,13,14041,1474,3,405,328,158,93,31,1015,5,19,1039
14,13,14041,1475,3,374,334,109,39,30,886,1,23,910
14,13,14041,1476,3,371,351,122,78,27,949,1,18,968
14,13,14041,1477,3,356,311,92,62,22,843,0,33,876
14,13,14041,1478,3,273,259,76,49,14,671,1,11,683
14,13,14041,1479,3,305,291,89,46,12,743,5,20,768
14,13,14041,1480,3,294,264,92,66,20,736,4,27,767
14,13,14041,1481,3,375,310,77,70,19,851,6,16,873
14,13,14041,1482,3,413,346,96,54,12,921,1,29,951
14,13,14041,1483,3,513,354,86,60,21,1034,5,26,1065
14,13,14041,1484,3,986,509,230,151,51,1927,3,28,1958
14,13,14041,1485,3,244,159,59,53,16,531,3,3,537
14,13,14041,1486,3,367,187,71,36,20,681,1,9,691
14,13,14041,1487,3,309,161,68,48,21,607,1,8,616
14,13,14041,1488,3,336,188,87,49,19,679,2,12,693
14,13,14041,1489,3,281,173,85,49,15,603,4,4,611
14,13,14041,1490,3,396,228,64,52,20,760,0,8,768
14,13,14041,1491,3,300,206,74,46,18,644,1,11,656
14,13,14041,1492,3,388,235,78,48,12,761,3,23,787
14,13,14041,1493,3,378,207,81,43,14,723,3,13,739
14,13,14041,1494,3,313,258,96,47,20,734,4,14,752
14,13,14041,1495,3,401,269,115,58,24,867,3,14,884
14,13,14041,1496,3,318,148,60,31,14,571,0,14,585
14,13,14041,1497,3,435,287,83,63,23,891,2,17,910
14,13,14041,1498,3,566,310,104,73,36,1089,0,22,1111
14,13,14041,1499,3,557,319,147,83,25,1131,7,18,1156
14,13,14041,1500,3,468,236,98,84,23,909,0,9,918
14,13,14041,1501,3,416,290,156,62,38,962,3,11,976
14,13,14041,1502,3,461,299,125,71,29,985,0,18,1003
14,13,14041,1503,3,628,256,146,87,37,1154,6,9,1169
14,13,14041,1504,3,451,246,114,86,34,931,0,9,940
14,13,14041,1505,3,463,229,107,61,29,889,1,13,903
14,13,14041,1506,3,533,272,107,68,33,1013,0,13,1026
14,13,14041,1507,3,612,220,71,79,29,1011,5,15,1031
14,13,14041,1508,3,380,212,96,50,30,768,2,11,781
14,13,14041,1509,3,552,244,101,57,27,981,1,8,990
14,13,14041,1510,3,351,220,97,44,26,738,1,9,748
14,13,14041,1511,3,514,227,115,62,19,937,0,7,944
14,13,14041,1512,3,442,234,67,34,23,800,0,7,807
14,13,14041,1513,3,347,247,55,35,21,705,1,13,719
14,13,14041,1514,3,635,341,134,72,35,1217,11,16,1244
14,13,14041,1515,3,414,344,87,60,38,943,4,12,959
14,13,14041,1516,3,392,215,99,54,13,773,1,8,782
14,13,14041,1517,3,663,452,130,73,24,1342,2,25,1369
14,13,14041,1518,3,472,241,85,65,26,889,0,11,900
14,13,14041,1519,3,435,250,70,73,24,852,5,10,867
14,13,14041,1520,3,423,241,107,62,20,853,2,14,869
14,13,14041,1521,3,400,200,97,63,30,790,6,15,811
14,13,14041,1522,3,324,211,61,46,26,668,0,14,682
14,13,14041,1523,3,517,219,98,46,27,907,1,11,919
14,13,14041,1524,3,371,183,72,48,22,696,0,16,712
14,13,14041,1525,3,342,228,85,46,17,718,3,19,740
14,13,14041,1526,3,546,366,125,74,19,1130,8,14,1152
14,13,14041,1527,3,253,130,56,37,22,498,1,15,514
14,13,14041,1528,3,299,177,61,32,16,585,3,5,593
14,13,14041,1529,3,239,216,67,36,14,572,0,9,581
14,13,14041,1530,3,319,171,57,36,15,598,1,9,608
14,13,14041,1531,3,406,217,71,63,11,768,3,13,784
14,13,14041,1532,3,299,136,47,27,8,517,1,11,529
14,13,14041,1533,3,252,141,37,25,12,467,0,13,480
14,13,14041,1534,3,656,331,150,81,33,1251,6,16,1273
14,13,14041,1535,3,485,237,88,58,22,890,1,24,915
14,13,14041,1536,3,405,200,84,58,20,767,5,9,781
14,13,14041,1537,3,384,221,105,42,22,774,0,20,794
14,13,14041,1538,3,460,242,212,55,22,991,3,8,1002
14,13,14041,1539,3,705,318,134,71,32,1260,3,14,1277
14,13,14041,1540,3,309,174,57,57,16,613,2,9,624
14,13,14041,1541,3,430,224,106,42,26,828,1,11,840
14,13,14041,1542,3,428,273,57,54,13,825,0,19,844
14,13,14041,1543,3,373,197,57,48,9,684,7,16,707
14,13,14041,1544,3,349,251,59,62,23,744,0,5,749
14,13,14041,1545,3,464,292,79,67,27,929,0,24,953
14,13,14041,1546,3,364,260,61,45,22,752,0,10,762
14,13,14041,1547,3,379,193,76,38,14,700,3,13,716
14,13,14041,1548,3,354,198,96,56,15,719,1,11,731
14,14,14041,758,3,513,108,61,25,22,729,2,5,736
14,14,14041,759,3,767,168,88,41,33,1097,1,10,1108
14,14,14041,760,3,709,136,33,25,23,926,0,8,934
14,14,14041,761,3,540,122,74,29,22,787,0,4,791
14,14,14041,762,3,632,135,74,20,31,892,1,7,900
14,14,14041,763,3,490,78,38,15,16,637,2,6,645
14,14,14041,764,3,382,76,34,9,18,519,0,3,522
14,14,14041,765,3,375,82,49,15,14,535,1,3,539
14,14,14041,766,3,684,195,75,41,24,1019,0,8,1027
14,14,14041,767,3,442,129,40,22,14,647,1,1,649
14,14,14041,768,3,404,124,45,15,6,594,0,3,597
14,14,14041,769,3,633,157,71,26,20,907,2,5,914
14,14,14041,770,3,521,125,49,12,23,730,0,9,739
14,14,14041,771,3,478,276,146,61,33,994,2,15,1011
14,14,14041,779,3,356,249,104,69,22,800,3,24,827
14,14,14041,791,3,602,443,156,84,36,1321,3,38,1362
14,14,14041,792,3,446,197,130,49,28,850,1,26,877
14,14,14041,793,3,427,302,72,71,20,892,3,32,927
14,14,14041,794,3,637,247,161,65,31,1141,1,14,1156
14,14,14041,795,3,398,140,87,42,25,692,2,11,705
14,14,14041,796,3,330,164,85,53,22,654,5,16,675
14,14,14041,797,3,600,255,95,52,20,1022,1,23,1046
14,14,14041,798,3,607,241,89,50,36,1023,3,18,1044
14,14,14041,799,3,917,282,167,44,44,1454,4,18,1476
14,14,14041,800,3,335,107,67,39,16,564,0,7,571
14,14,14041,801,3,406,125,57,27,12,627,3,8,638
14,14,14041,802,3,601,158,88,31,24,902,0,11,913
14,14,14041,803,3,677,170,67,32,28,974,2,7,983
14,14,14041,804,3,640,141,52,25,16,874,0,3,877
14,14,14041,805,3,721,172,86,23,33,1035,1,8,1044
14,14,14041,806,3,725,201,84,35,26,1071,0,8,1079
14,14,14041,807,3,968,314,132,67,48,1529,2,8,1539
14,14,14041,808,3,751,280,127,81,56,1295,2,17,1314
14,14,14041,809,3,803,261,103,62,32,1261,1,10,1272
14,14,14041,810,3,842,289,133,62,41,1367,2,16,1385
14,14,14041,811,3,565,189,103,46,23,926,1,5,932
14,14,14041,812,3,515,155,91,57,24,842,0,19,861
14,14,14041,813,3,775,263,159,65,37,1299,1,13,1313
14,14,14041,814,3,517,168,111,72,26,894,5,12,911
14,14,14041,815,3,414,176,66,41,15,712,0,10,722
14,14,14041,816,3,484,291,98,75,22,970,5,16,991
14,14,14041,817,3,447,168,77,32,24,748,2,13,763
14,14,14041,818,3,287,190,64,42,20,603,0,19,622
14,14,14041,819,3,447,172,100,40,27,786,0,14,800
14,14,14041,820,3,391,147,73,35,14,660,2,6,668
14,14,14041,821,3,714,297,169,58,39,1277,1,13,1291
14,14,14041,822,3,429,214,115,50,19,827,2,7,836
14,14,14041,823,3,361,136,80,27,21,625,1,8,634
14,14,14041,824,3,549,217,175,72,31,1044,1,9,1054
14,14,14041,825,3,561,274,138,89,30,1092,0,16,1108
14,14,14041,826,3,683,226,133,67,17,1126,1,15,1142
14,14,14041,827,3,729,240,184,77,28,1258,1,11,1270
14,14,14041,828,3,797,317,160,85,35,1394,3,17,1414
14,14,14041,829,3,624,323,164,90,29,1230,1,25,1256
14,14,14041,830,3,846,260,154,87,40,1387,1,16,1404
14,14,14041,831,3,781,264,160,65,34,1304,1,14,1319
14,14,14041,832,3,873,288,168,97,36,1462,2,18,1482
14,14,14041,833,3,719,277,126,60,27,1209,2,16,1227
14,14,14041,834,3,679,279,104,47,33,1142,2,11,1155
14,14,14041,835,3,770,271,136,98,40,1315,1,18,1334
14,14,14041,836,3,613,236,100,60,31,1040,0,7,1047
14,14,14041,837,3,698,248,122,59,27,1154,1,16,1171
14,14,14041,838,3,754,279,152,72,39,1296,0,14,1310
14,14,14041,839,3,485,328,119,80,26,1038,2,27,1067
14,14,14041,840,3,411,335,71,50,19,886,1,22,909
14,14,14041,841,3,409,264,127,46,11,857,0,26,883
14,14,14041,842,3,566,225,199,69,33,1092,4,18,1114
14,14,14041,843,3,429,161,85,49,15,739,1,9,749
14,14,14041,844,3,549,266,144,54,28,1041,8,31,1080
14,14,14041,845,3,402,260,133,64,34,893,3,25,921
14,14,14041,846,3,362,159,93,47,18,679,4,20,703
14,14,14041,847,3,364,196,85,62,20,727,1,18,746
14,14,14041,848,3,320,231,56,44,14,665,1,15,681
14,14,14041,849,3,509,290,97,37,16,949,3,13,965
14,14,14041,850,3,306,176,73,60,14,629,0,13,642
14,14,14041,851,3,568,301,127,76,29,1101,8,29,1138
14,14,14041,852,3,443,335,161,84,33,1056,5,24,1085
14,14,14041,853,3,635,418,144,82,40,1319,1,23,1343
14,14,14041,854,3,607,355,192,87,36,1277,15,21,1313
14,14,14041,855,3,618,335,129,68,28,1178,3,35,1216
14,14,14041,856,3,659,416,151,95,29,1350,2,25,1377
14,14,14041,857,3,557,319,126,73,32,1107,5,12,1124
14,14,14041,858,3,248,126,111,37,14,536,1,5,542
14,14,14041,859,3,409,221,130,48,42,850,5,8,863
14,14,14041,860,3,316,169,77,37,15,614,2,8,624
14,14,14041,861,3,338,197,75,36,10,656,1,8,665
14,14,14041,862,3,499,305,118,82,24,1028,10,22,1060
14,14,14041,863,3,553,318,167,99,16,1153,6,30,1189
14,14,14041,864,3,356,210,90,61,19,736,3,5,744
14,14,14041,865,3,301,170,107,45,15,638,2,6,646
14,14,14041,866,3,396,186,95,49,23,749,0,15,764
14,14,14041,867,3,230,140,48,39,7,464,0,11,475
14,14,14041,868,3,593,407,154,93,38,1285,8,20,1313
14,14,14041,869,3,539,350,132,89,30,1140,0,15,1155
14,14,14041,870,3,395,279,86,73,20,853,5,2,860
14,14,14041,871,3,396,298,94,58,22,868,3,8,879
14,14,14041,872,3,346,182,62,50,20,660,2,16,678
14,14,14041,873,3,532,382,165,72,36,1187,1,24,1212
14,14,14041,874,3,656,377,123,80,26,1262,4,35,1301
14,14,14041,875,3,628,383,145,118,23,1297,5,32,1334
14,14,14041,876,3,651,471,140,75,39,1376,4,38,1418
14,14,14041,877,3,667,332,164,83,28,1274,2,27,1303
14,14,14041,878,3,438,290,73,42,17,860,5,22,887
14,14,14041,879,3,343,236,75,42,11,707,0,22,729
14,14,14041,880,3,676,332,157,88,30,1283,9,28,1320
14,14,14041,881,3,567,323,159,80,24,1153,2,27,1182
14,14,14041,882,3,507,353,132,52,30,1074,1,26,1101
14,14,14041,883,3,545,338,136,95,26,1140,5,20,1165
14,14,14041,884,3,393,239,102,61,16,811,2,14,827
14,14,14041,885,3,604,318,127,103,27,1179,7,16,1202
14,14,14041,886,3,811,380,187,102,36,1516,0,27,1543
14,14,14041,887,3,898,346,187,98,54,1583,1,10,1594
14,14,14041,888,3,824,297,149,74,42,1386,0,12,1398
14,14,14041,889,3,457,185,101,40,22,805,0,8,813
14,14,14041,890,3,461,193,108,43,28,833,2,9,844
14,14,14041,891,3,615,305,115,66,29,1130,3,20,1153
14,14,14041,892,3,427,167,104,41,30,769,0,6,775
14,14,14041,893,3,671,373,151,91,46,1332,9,26,1367
14,14,14041,894,3,591,340,216,90,44,1281,6,29,1316
14,14,14041,895,3,680,438,170,104,18,1410,3,28,1441
14,14,14041,896,3,391,266,126,57,23,863,7,15,885
14,14,14041,897,3,365,161,94,44,13,677,0,13,690
14,14,14041,898,3,394,250,112,47,26,829,0,32,861
14,14,14041,899,3,564,255,123,52,26,1020,0,25,1045
14,14,14041,900,3,535,312,129,77,25,1078,10,19,1107
14,14,14041,901,3,482,340,143,76,28,1069,3,32,1104
14,14,14041,902,3,677,403,180,109,45,1414,6,36,1456
14,14,14041,903,3,394,260,105,61,26,846,5,27,878
14,14,14041,904,3,559,397,129,73,32,1190,10,39,1239
14,14,14041,905,3,320,244,76,44,15,699,10,20,729
14,14,14041,906,3,336,189,50,44,17,636,1,10,647
14,14,14041,907,3,576,387,159,73,23,1218,4,26,1248
14,14,14041,908,3,339,219,95,55,18,726,1,32,759
14,14,14041,909,3,226,196,59,33,19,533,0,12,545
14,14,14041,910,3,514,382,106,82,31,1115,3,12,1130
14,14,14041,911,3,583,285,136,81,28,1113,0,27,1140
14,14,14041,912,3,415,231,89,70,25,830,2,13,845
14,14,14041,913,3,414,263,103,74,31,885,2,12,899
14,14,14041,914,3,522,308,126,87,25,1068,2,23,1093
14,14,14041,915,3,419,251,76,65,18,829,1,6,836
14,14,14041,916,3,733,329,132,97,40,1331,0,23,1354
14,14,14041,917,3,431,289,131,79,21,951,1,30,982
14,14,14041,918,3,617,414,176,106,25,1338,4,36,1378
14,14,14041,919,3,490,313,180,70,36,1089,3,20,1112
14,14,14041,920,3,515,373,170,166,24,1248,8,30,1286
14,14,14041,921,3,363,240,124,60,27,814,3,33,850
14,14,14041,922,3,528,435,170,71,37,1241,2,60,1303
14,14,14041,923,3,456,299,293,109,38,1195,8,29,1232
14,14,14041,924,3,148,134,66,28,11,387,1,6,394
14,14,14041,925,3,542,417,203,71,35,1268,2,28,1298
14,14,14041,926,3,623,451,210,135,38,1457,2,32,1491
14,14,14041,927,3,516,324,192,88,22,1142,5,14,1161
14,14,14041,928,3,517,340,120,82,17,1076,6,16,1098
14,14,14041,1058,3,505,134,92,14,25,770,0,7,777
14,14,14041,1077,3,481,164,56,35,18,754,0,7,761
14,14,14041,1078,3,643,146,62,20,26,897,1,10,908
14,14,14041,1079,3,309,120,51,24,16,520,2,10,532
14,14,14041,1080,3,238,135,44,18,17,452,3,9,464
14,14,14041,1081,3,241,143,65,21,8,478,2,3,483
14,14,14041,1082,3,363,212,77,42,16,710,3,9,722
14,14,14041,1083,3,334,169,77,43,17,640,0,15,655
14,14,14041,1084,3,248,136,64,33,10,491,0,14,505
14,14,14041,1085,3,328,138,48,41,10,565,0,17,582
14,14,14041,1086,3,411,212,73,62,21,779,1,12,792
14,14,14041,2599,3,258,253,74,43,37,665,1,23,689
14,14,14041,2600,3,307,240,81,39,29,696,1,25,722
14,14,14041,3315,3,282,215,92,41,17,647,0,8,655
14,15,14013,161,3,769,455,49,33,14,1320,8,38,1366
14,15,14013,162,3,328,168,22,7,1,526,0,10,536
14,15,14013,163,3,735,285,56,34,10,1120,1,20,1141
14,15,14013,164,3,511,233,33,50,10,837,0,21,858
14,15,14013,165,3,431,211,26,25,3,696,2,10,708
14,15,14013,166,3,684,417,56,54,12,1223,0,26,1249
14,15,14013,167,3,747,536,49,60,7,1399,1,38,1438
14,15,14013,168,3,546,307,44,27,11,935,1,15,951
14,15,14013,169,3,488,315,25,32,11,871,0,19,890
14,15,14013,170,3,646,380,47,26,8,1107,2,18,1127
14,15,14013,171,3,652,466,66,52,18,1254,1,18,1273
14,15,14013,172,3,720,642,52,65,15,1494,1,42,1537
14,15,14013,173,3,677,421,63,36,20,1217,0,29,1246
14,15,14013,174,3,188,236,36,19,6,485,0,11,496
14,15,14013,175,3,201,214,47,13,0,475,0,9,484
14,15,14013,176,3,762,176,27,5,1,971,0,27,998
14,15,14013,177,3,773,207,25,10,3,1018,0,60,1078
14,15,14013,178,3,65,13,0,0,0,78,0,0,78
14,15,14013,179,3,194,55,4,3,2,258,0,19,277
14,15,14013,180,3,465,128,20,8,10,631,0,20,651
14,15,14013,181,3,460,238,35,5,5,743,2,10,755
14,15,14013,182,3,331,470,37,8,2,848,5,25,878
14,15,14013,183,3,163,224,26,4,1,418,2,13,433
14,15,14013,184,3,467,511,62,26,6,1072,0,27,1099
14,15,14013,185,3,176,363,72,8,4,623,1,22,646
14,15,14013,186,3,272,265,55,4,4,600,0,25,625
14,15,14013,187,3,270,302,33,6,1,612,0,25,637
14,15,14016,224,3,558,563,80,10,7,1218,0,11,1229
14,15,14016,225,3,801,969,58,16,7,1851,8,41,1900
14,15,14016,226,3,554,639,51,11,3,1258,0,27,1285
14,15,14016,227,3,583,774,65,11,10,1443,0,22,1465
14,15,14016,228,3,389,325,94,15,6,829,0,16,845
14,15,14016,229,3,264,269,71,7,7,618,0,34,652
14,15,14016,230,3,322,252,97,5,2,678,0,15,693
14,15,14016,231,3,332,226,72,2,4,636,3,13,652
14,15,14016,232,3,395,394,154,11,6,960,1,25,986
14,15,14016,233,3,1194,381,20,18,7,1620,0,20,1640
14,15,14016,235,3,43,76,3,2,1,125,0,6,131
14,15,14016,236,3,64,305,66,7,0,442,0,15,457
14,15,14016,237,3,15,90,34,0,2,141,0,1,142
14,15,14016,238,3,162,191,76,11,7,447,0,6,453
14,15,14016,239,3,81,87,55,3,1,227,0,17,244
14,15,14016,240,3,183,161,45,2,3,394,2,8,404
14,15,14016,241,3,81,224,37,2,1,345,0,20,365
14,15,14016,242,3,301,195,31,2,2,531,0,23,554
14,15,14016,243,3,385,302,175,4,5,871,0,29,900
14,15,14018,256,3,448,610,256,109,8,1431,3,31,1465
14,15,14018,257,3,384,396,242,75,10,1107,0,15,1122
14,15,14018,258,3,492,417,332,123,11,1375,0,34,1409
14,15,14018,259,3,265,414,252,86,5,1022,1,25,1048
14,15,14018,260,3,243,336,188,76,3,846,0,19,865
14,15,14018,261,3,383,457,242,71,4,1157,0,35,1192
14,15,14018,262,3,315,401,184,70,5,975,1,23,999
14,15,14018,263,3,272,335,192,54,3,856,5,23,884
14,15,14018,264,3,225,296,117,27,3,668,1,12,681
14,15,14018,265,3,273,476,171,71,5,996,1,26,1023
14,15,14018,266,3,248,281,71,28,4,632,0,15,647
14,15,14018,267,3,279,521,138,62,6,1006,0,7,1013
14,15,14018,268,3,170,362,66,26,1,625,1,12,638
14,15,14018,269,3,260,461,140,46,9,916,1,15,932
14,15,14018,270,3,167,204,103,12,2,488,2,21,511
14,15,14018,271,3,159,283,84,8,5,539,0,20,559
14,15,14018,272,3,152,54,40,5,3,254,4,6,264
14,15,14018,273,3,303,181,93,12,2,591,1,9,601
14,15,14018,274,3,171,173,94,13,0,451,0,18,469
14,15,14018,275,3,183,153,110,12,3,461,0,6,467
14,15,14018,276,3,128,44,97,7,3,279,1,0,280
14,15,14018,277,3,110,72,77,3,0,262,0,9,271
14,15,14018,278,3,223,68,78,12,2,383,0,8,391
14,15,14018,279,3,94,75,213,5,3,390,0,11,401
14,15,14018,280,3,168,151,130,16,0,465,0,16,481
14,15,14018,281,3,50,120,237,4,0,411,0,8,419
14,15,14018,282,3,81,156,111,13,1,362,2,7,371
14,15,14018,283,3,375,210,76,44,5,710,3,12,725
14,15,14018,284,3,111,73,22,13,2,221,0,7,228
14,15,14018,285,3,133,211,236,32,2,614,3,23,640
14,15,14018,286,3,101,50,44,0,2,197,0,5,202
14,15,14018,287,3,451,214,126,32,11,834,0,8,842
14,15,14018,288,3,328,214,67,7,3,619,1,14,634
14,15,14018,289,3,226,158,96,4,1,485,0,3,488
14,15,14018,290,3,316,296,237,11,5,865,0,10,875
14,15,14018,291,3,151,165,113,11,1,441,0,9,450
14,15,14034,483,3,700,772,45,18,4,1539,0,25,1564
14,15,14034,484,3,439,224,25,12,2,702,1,7,710
14,15,14034,485,3,394,241,23,6,3,667,0,15,682
14,15,14034,486,3,296,170,16,12,0,494,0,10,504
14,15,14034,487,3,473,242,17,8,3,743,0,13,756
14,15,14034,488,3,510,237,53,8,5,813,0,9,822
14,15,14034,489,3,326,363,58,11,7,765,1,19,785
14,15,14034,490,3,236,208,15,1,0,460,1,11,472
14,15,14034,491,3,211,158,12,2,0,383,0,9,392
14,15,14034,492,3,13,79,4,0,0,96,0,1,97
14,15,14034,493,3,169,185,12,3,0,369,0,14,383
14,15,14034,494,3,95,35,4,2,0,136,0,1,137
14,15,14034,495,3,122,248,5,2,0,377,1,7,385
14,15,14034,496,3,138,399,15,1,0,553,0,7,560
14,15,14034,497,3,144,195,27,1,1,368,2,3,373
14,15,14034,498,3,183,136,13,5,0,337,0,5,342
14,15,14049,1635,3,396,312,189,88,9,994,1,35,1030
14,15,14049,1636,3,674,503,149,181,17,1524,3,38,1565
14,15,14049,1637,3,504,304,115,93,5,1021,1,39,1061
14,15,14049,1638,3,252,144,99,60,2,557,0,10,567
14,15,14049,1639,3,301,176,58,110,4,649,0,13,662
14,15,14049,1640,3,198,129,31,31,0,389,0,5,394
14,15,14049,1641,3,367,310,92,104,6,879,1,20,900
14,15,14049,1642,3,316,302,51,78,2,749,0,19,768
14,15,14049,1643,3,504,342,119,93,4,1062,0,51,1113
14,15,14049,1644,3,189,333,256,88,4,870,1,38,909
14,15,14049,1646,3,113,120,23,20,1,277,0,0,277
14,15,14050,1647,3,338,256,36,13,7,650,1,26,677
14,15,14050,1648,3,279,342,39,14,9,683,1,27,711
14,15,14050,1649,3,480,259,33,21,11,804,1,24,829
14,15,14050,1650,3,446,278,57,27,7,815,0,31,846
14,15,14050,1651,3,637,356,70,19,14,1096,3,32,1131
14,15,14050,1652,3,100,73,3,1,0,177,0,10,187
14,15,14050,1653,3,268,107,17,5,3,400,0,17,417
14,15,14050,1654,3,327,109,13,2,5,456,2,19,477
14,15,14050,1655,3,615,180,28,10,5,838,2,41,881
14,15,14050,1656,3,156,88,17,0,0,261,1,8,270
14,15,14050,1657,3,264,68,5,3,7,347,1,9,357
14,15,14050,1658,3,450,202,4,3,2,661,0,21,682
14,15,14050,1659,3,226,42,15,1,2,286,0,9,295
14,15,14050,1660,3,358,78,9,2,4,451,0,20,471
14,15,14065,1844,3,605,417,126,58,16,1222,5,35,1262
14,15,14065,1845,3,434,307,80,37,13,871,0,13,884
14,15,14065,1846,3,426,313,116,41,16,912,0,31,943
14,15,14065,1847,3,561,459,179,83,15,1297,1,26,1324
14,15,14065,1848,3,438,322,110,58,13,941,1,16,958
14,15,14065,1849,3,387,225,89,39,9,749,2,16,767
14,15,14065,1850,3,503,342,99,55,14,1013,1,11,1025
14,15,14065,1851,3,582,371,177,49,14,1193,6,26,1225
14,15,14065,1852,3,1057,677,241,77,31,2083,0,20,2103
14,15,14065,1853,3,565,359,105,42,8,1079,1,23,1103
14,15,14065,1854,3,442,316,88,30,14,890,0,26,916
14,15,14065,1855,3,408,286,90,29,10,823,1,17,841
14,15,14065,1856,3,433,238,93,30,6,800,1,16,817
14,15,14065,1857,3,471,323,173,31,9,1007,0,15,1022
14,15,14065,1858,3,395,198,83,23,8,707,0,25,732
14,15,14065,1859,3,505,248,112,29,11,905,1,19,925
14,15,14065,1860,3,289,139,59,21,4,512,1,8,521
14,15,14065,1861,3,409,258,74,31,4,776,0,6,782
14,15,14065,1862,3,342,212,34,23,4,615,1,12,628
14,15,14065,1863,3,247,162,56,14,3,482,1,9,492
14,15,14065,1864,3,466,253,77,18,6,820,0,23,843
14,15,14065,1865,3,285,135,71,18,5,514,0,17,531
14,15,14065,1866,3,472,274,92,51,7,896,1,10,907
14,15,14065,1867,3,395,220,79,25,10,729,1,19,749
14,15,14065,1868,3,521,348,107,67,8,1051,0,18,1069
14,15,14065,1869,3,295,158,35,15,3,506,1,25,532
14,15,14065,1870,3,447,194,63,20,8,732,0,4,736
14,15,14065,1871,3,418,210,64,23,12,727,0,13,740
14,15,14065,1872,3,519,292,138,30,5,984,4,17,1005
14,15,14065,1873,3,340,235,108,49,8,740,1,15,756
14,15,14065,1874,3,542,274,120,50,13,999,3,16,1018
14,15,14065,1875,3,737,381,160,93,17,1388,10,38,1436
14,15,14065,1876,3,687,453,176,53,15,1384,0,47,1431
14,15,14065,1877,3,820,533,223,73,19,1668,7,33,1708
14,15,14065,1878,3,552,304,163,44,7,1070,2,20,1092
14,15,14065,1879,3,468,309,96,24,10,907,0,24,931
14,15,14065,1880,3,152,106,41,5,2,306,0,11,317
14,15,14065,1881,3,169,216,22,3,2,412,0,11,423
14,15,14065,1882,3,248,104,18,10,3,383,0,15,398
14,15,14065,1883,3,194,150,41,7,2,394,1,10,405
14,15,14065,1884,3,211,86,68,9,6,380,0,12,392
14,15,14065,1885,3,540,340,74,23,6,983,0,25,1008
14,15,14106,2748,3,670,264,36,25,2,997,0,19,1016
14,15,14106,2749,3,899,559,97,32,10,1597,2,57,1656
14,15,14106,2750,3,524,366,68,18,2,978,0,33,1011
14,15,14106,2751,3,510,398,33,25,5,971,0,23,994
14,15,14106,2752,3,384,194,29,17,3,627,3,18,648
14,15,14106,2753,3,76,133,22,10,3,244,0,21,265
14,15,14106,2754,3,197,86,8,10,0,301,0,9,310
14,15,14106,2755,3,132,103,6,12,3,256,0,13,269
14,15,14106,2756,3,195,327,31,25,2,580,0,26,606
14,15,14106,2757,3,198,160,34,28,3,423,0,23,446
14,15,14106,2758,3,55,191,16,11,8,281,0,8,289
14,15,14106,2759,3,247,166,41,13,4,471,0,22,493
14,15,14106,2760,3,102,145,13,0,0,260,0,18,278
14,15,14106,2761,3,318,364,30,44,2,758,0,26,784
14,15,14123,3265,3,330,310,59,5,4,708,3,20,731
14,15,14123,3266,3,272,350,46,16,7,691,1,15,707
14,15,14123,3267,3,268,156,37,3,0,464,2,5,471
14,15,14123,3268,3,65,61,13,1,0,140,0,5,145
14,15,14123,3269,3,149,179,52,3,3,386,0,8,394
14,15,14123,3270,3,82,152,32,1,0,267,0,4,271
14,15,14123,3271,3,228,293,45,2,2,570,2,11,583
14,15,14123,3272,3,196,194,105,6,3,504,2,19,525
14,15,14123,3273,3,344,231,84,6,6,671,5,35,711
14,15,14123,3274,3,133,50,48,4,4,239,2,4,245
14,15,14123,3275,3,351,258,75,13,6,703,1,11,715
14,15,14123,3276,3,381,267,68,20,5,741,2,18,761
14,15,14123,3277,3,187,153,60,9,6,415,3,8,426
14,16,14099,2473,3,511,347,121,72,27,1078,2,20,1100
14,16,14099,2474,3,394,196,71,50,25,736,0,9,745
14,16,14099,2475,3,377,200,63,38,15,693,1,20,714
14,16,14099,2476,3,284,267,74,43,15,683,2,17,702
14,16,14099,2477,3,399,357,134,62,20,972,4,30,1006
14,16,14099,2478,3,352,240,87,46,17,742,1,12,755
14,16,14099,2479,3,340,187,70,38,24,659,1,10,670
14,16,14099,2480,3,423,178,74,31,13,719,1,12,732
14,16,14099,2481,3,387,188,65,55,17,712,0,15,727
14,16,14099,2482,3,665,397,128,55,23,1268,3,30,1301
14,16,14099,2483,3,570,237,76,57,21,961,3,16,980
14,16,14099,2484,3,498,262,118,45,15,938,0,17,955
14,16,14099,2485,3,363,213,84,35,13,708,1,17,726
14,16,14099,2486,3,651,438,150,97,34,1370,8,24,1402
14,16,14099,2487,3,924,427,138,78,52,1619,1,32,1652
14,16,14099,2488,3,532,317,136,81,29,1095,4,20,1119
14,16,14099,2489,3,356,189,86,45,11,687,1,19,707
14,16,14099,2490,3,449,257,94,53,13,866,1,16,883
14,16,14099,2491,3,626,503,124,82,35,1370,4,45,1419
14,16,14099,2492,3,255,252,56,27,8,598,3,11,612
14,16,14099,2493,3,123,115,48,26,7,319,0,10,329
14,16,14099,2494,3,212,157,71,20,17,477,3,14,494
14,16,14099,2495,3,301,200,96,31,12,640,1,17,658
14,16,14099,2496,3,311,217,76,30,13,647,1,9,657
14,16,14099,2497,3,608,335,122,79,29,1173,3,24,1200
14,16,14099,2498,3,382,214,95,48,10,749,1,14,764
14,16,14099,2499,3,358,195,65,45,18,681,0,0,681
14,16,14099,2500,3,434,370,117,37,19,977,2,6,985
14,16,14099,2501,3,501,288,78,49,17,933,0,19,952
14,16,14099,2502,3,402,237,99,52,19,809,1,10,820
14,16,14099,2503,3,481,201,103,46,17,848,3,18,869
14,16,14099,2504,3,460,212,87,58,23,840,2,15,857
14,16,14099,2505,3,507,268,74,45,15,909,2,29,940
14,16,14099,2506,3,580,257,136,73,34,1080,3,17,1100
14,16,14099,2507,3,568,242,101,58,25,994,0,16,1010
14,16,14099,2508,3,438,193,99,64,32,826,1,19,846
14,16,14099,2509,3,504,238,93,67,18,920,0,46,966
14,16,14099,2510,3,649,371,123,76,31,1250,4,38,1292
14,16,14099,2511,3,543,235,81,51,20,930,1,16,947
14,16,14099,2512,3,517,334,148,61,31,1091,7,34,1132
14,16,14099,2513,3,762,347,102,78,22,1311,0,26,1337
14,16,14099,2514,3,237,207,39,23,8,514,1,4,519
14,16,14099,2515,3,231,220,70,39,16,576,0,13,589
14,16,14099,2516,3,280,212,74,39,9,614,2,9,625
14,16,14099,2517,3,369,280,70,40,13,772,2,20,794
14,16,14099,2518,3,405,286,70,50,13,824,0,24,848
14,16,14099,2519,3,799,457,148,77,18,1499,1,27,1527
14,16,14099,2520,3,553,335,115,61,13,1077,3,17,1097
14,16,14099,2521,3,359,204,66,39,7,675,2,2,679
14,16,14099,2522,3,362,186,76,42,13,679,2,19,700
14,16,14099,2523,3,1077,572,187,144,46,2026,5,45,2076
14,16,14099,2524,3,1132,656,252,144,54,2238,12,41,2291
14,16,14099,2525,3,407,219,74,51,17,768,0,11,779
14,16,14099,2527,3,415,229,111,74,15,844,0,29,873
14,16,14099,2532,3,525,296,91,67,29,1008,0,8,1016
14,16,14099,2549,3,440,375,181,74,19,1089,2,15,1106
14,16,14099,2550,3,468,317,137,69,18,1009,1,29,1039
14,16,14099,2551,3,490,329,156,70,17,1062,2,38,1102
14,16,14099,2552,3,642,348,146,75,22,1233,3,35,1271
14,16,14099,2553,3,560,426,158,67,23,1234,2,33,1269
14,16,14099,2554,3,535,489,157,92,34,1307,4,34,1345
14,16,14099,2568,3,763,794,200,133,41,1931,6,69,2006
14,16,14099,2569,3,651,492,217,140,25,1525,5,39,1569
14,16,14099,2570,3,403,345,170,103,61,1082,1,38,1121
14,16,14099,2571,3,295,165,87,56,15,618,3,12,633
14,16,14099,2572,3,293,141,78,61,8,581,0,18,599
14,16,14099,2573,3,329,249,84,55,19,736,2,15,753
14,16,14099,2574,3,382,316,98,101,17,914,2,18,934
14,16,14099,2575,3,333,243,85,73,12,746,1,12,759
14,16,14099,2576,3,599,456,172,156,55,1438,6,17,1461
14,16,14099,2577,3,692,497,195,186,28,1598,1,33,1632
14,16,14099,2578,3,651,502,176,193,41,1563,8,25,1596
14,16,14099,2579,3,310,323,112,74,16,835,6,9,850
14,16,14099,2580,3,237,226,109,93,32,697,6,7,710
14,16,14099,2581,3,218,195,92,89,16,610,6,13,629
14,16,14099,2582,3,536,340,125,157,30,1188,5,11,1204
14,16,14099,2583,3,595,479,155,117,32,1378,7,46,1431
14,16,14099,2584,3,535,336,139,127,20,1157,5,56,1218
14,16,14099,2585,3,651,483,162,125,16,1437,1,40,1478
14,16,14099,2586,3,841,556,202,104,42,1745,5,46,1796
14,16,14099,2588,3,741,778,197,113,24,1853,12,38,1903
14,16,14099,2589,3,497,427,128,78,30,1160,4,32,1196
14,16,14099,2590,3,676,534,191,63,25,1489,5,12,1506
14,16,14099,2591,3,527,437,142,94,21,1221,8,40,1269
14,16,14099,2592,3,605,442,162,121,29,1359,6,37,1402
14,16,14099,2593,3,636,477,140,100,35,1388,5,44,1437
14,16,14099,2594,3,524,597,183,123,29,1456,11,51,1518
14,16,14099,2595,3,556,544,164,91,21,1376,2,37,1415
14,16,14099,2596,3,640,581,148,96,37,1502,7,36,1545
14,16,14099,2597,3,311,387,117,51,25,891,5,31,927
14,16,14099,2598,3,356,367,97,60,17,897,5,31,933
14,16,14099,2601,3,368,293,99,73,25,858,5,24,887
14,16,14099,2602,3,701,484,205,54,34,1478,16,46,1540
14,16,14099,2603,3,523,483,156,82,25,1269,7,36,1312
14,16,14099,2605,3,689,550,220,103,34,1596,9,40,1645
14,16,14099,2606,3,802,603,154,114,35,1708,9,37,1754
14,16,14099,2607,3,777,498,178,103,36,1592,5,45,1642
14,16,14099,2608,3,273,220,34,35,10,572,1,17,590
14,16,14099,2609,3,443,283,87,79,17,909,1,31,941
14,16,14099,2610,3,299,228,66,45,19,657,7,8,672
14,16,14099,2611,3,534,554,122,81,25,1316,18,34,1368
14,16,14099,2612,3,459,204,43,25,7,738,0,44,782
14,16,14099,2613,3,1231,562,191,111,46,2141,2,23,2166
14,16,14099,2614,3,879,328,122,67,20,1416,3,32,1451
14,16,14099,2615,3,580,258,52,38,13,941,0,22,963
14,16,14099,2616,3,1685,850,410,162,80,3187,3,47,3237
14,16,14099,2617,3,243,243,29,22,8,545,0,20,565
14,16,14099,2618,3,646,288,160,63,30,1187,4,14,1205
14,16,14099,2619,3,1439,685,334,163,73,2694,12,48,2754
14,16,14099,3172,3,559,191,119,55,26,950,0,11,961
14,16,14099,3199,3,697,344,237,71,28,1377,4,48,1429
14,16,14099,3201,3,1031,708,267,161,64,2231,6,26,2263
14,16,14099,3202,3,497,296,98,90,28,1009,3,21,1033
14,16,14099,3203,3,289,130,57,41,71,588,0,11,599
14,16,14099,3204,3,650,324,187,87,51,1299,3,16,1318
14,16,14099,3312,3,309,260,111,56,26,762,2,14,778
14,16,14099,3313,3,354,232,138,48,27,799,6,11,816
14,16,14099,3314,3,180,121,68,19,7,395,0,9,404
14,16,14099,3316,3,80,37,26,5,3,151,0,0,151
14,16,14099,3317,3,1224,412,280,133,58,2107,3,10,2120
14,16,14099,3318,3,351,221,66,48,16,702,2,21,725
14,16,14099,3319,3,27,10,6,6,1,50,0,1,51
14,16,14099,3320,3,108,41,15,21,3,188,0,5,193
14,16,14099,3321,3,374,223,82,67,29,775,0,15,790
14,16,14099,3322,3,343,285,75,72,19,794,1,15,810
14,16,14099,3323,3,117,50,41,10,12,230,0,1,231
14,16,14099,3324,3,396,109,77,36,19,637,1,3,641
14,16,14099,3325,3,90,24,20,8,0,142,0,0,142
14,16,14099,3326,3,48,9,49,5,13,124,0,5,129
14,16,14099,3327,3,72,15,13,14,0,114,0,0,114
14,16,14099,3328,3,147,77,33,26,12,295,0,6,301
14,16,14099,3329,3,147,90,57,15,8,317,0,4,321
14,16,14099,3330,3,131,63,47,12,12,265,0,3,268
14,16,14099,3331,3,125,35,23,11,5,199,0,1,200
14,16,14099,3332,3,144,68,39,13,14,278,1,3,282
14,16,14099,3333,3,130,85,29,19,7,270,0,5,275
14,16,14099,3334,3,180,91,26,26,10,333,0,3,336
14,16,14099,3335,3,171,116,47,18,7,359,3,7,369
14,16,14099,3336,3,167,125,32,27,7,358,0,12,370
14,16,14099,3337,3,185,124,51,26,13,399,4,8,411
14,16,14099,3338,3,183,136,40,38,13,410,4,13,427
14,16,14099,3339,3,178,152,54,24,4,412,10,10,432
14,16,14099,3340,3,150,107,37,17,5,316,1,16,333
14,16,14099,3341,3,109,161,45,15,5,335,1,0,336
14,16,14099,3342,3,135,104,74,20,12,345,5,6,356
14,16,14099,3343,3,103,98,48,23,1,273,1,6,280
14,16,14099,3344,3,128,81,42,16,10,277,1,6,284
14,16,14099,3345,3,108,101,86,21,9,325,3,5,333
14,16,14099,3346,3,108,161,36,21,9,335,1,9,345
14,16,14099,3347,3,117,206,32,17,9,381,5,11,397
14,16,14099,3348,3,168,165,44,23,12,412,0,9,421
14,16,14099,3349,3,191,136,40,25,8,400,1,12,413
14,16,14099,3350,3,140,163,64,21,6,394,0,17,411
14,16,14099,3351,3,100,157,69,14,3,343,3,10,356
14,16,14099,3352,3,130,119,90,26,9,374,8,0,382
14,16,14099,3353,3,93,157,51,17,5,323,0,10,333
14,16,14099,3354,3,54,115,36,7,5,217,0,12,229
14,16,14099,3355,3,16,29,18,4,0,67,3,2,72
14,17,14002,13,3,142,203,636,21,59,1061,0,24,1085
14,17,14002,14,3,248,210,180,12,44,694,0,23,717
14,17,14002,15,3,242,235,278,67,71,893,3,29,925
14,17,14002,16,3,195,190,357,19,46,807,3,35,845
14,17,14002,17,3,257,146,218,25,25,671,1,23,695
14,17,14002,18,3,187,498,218,38,93,1034,0,30,1064
14,17,14002,19,3,200,361,203,43,62,869,0,14,883
14,17,14002,20,3,112,324,129,29,35,629,0,22,651
14,17,14002,21,3,91,270,113,24,20,518,0,17,535
14,17,14002,22,3,216,318,380,44,111,1069,0,40,1109
14,17,14002,23,3,86,98,89,19,17,309,0,13,322
14,17,14014,188,3,672,304,98,29,5,1108,0,16,1124
14,17,14014,189,3,448,306,73,5,3,835,0,34,869
14,17,14014,190,3,310,177,40,10,4,541,0,4,545
14,17,14014,191,3,185,145,17,1,1,349,0,10,359
14,17,14014,192,3,164,214,40,4,0,422,0,8,430
14,17,14014,193,3,335,162,52,5,5,559,2,18,579
14,17,14027,427,3,280,107,80,8,0,475,0,21,496
14,17,14027,428,3,461,207,57,11,2,738,0,12,750
14,17,14027,429,3,504,204,88,3,4,803,0,14,817
14,17,14027,430,3,32,37,3,0,3,75,0,1,76
14,17,14027,431,3,164,103,46,3,1,317,0,10,327
14,17,14031,457,3,315,411,261,55,18,1060,2,35,1097
14,17,14031,458,3,412,504,402,87,31,1436,1,37,1474
14,17,14031,459,3,411,442,354,84,30,1321,4,35,1360
14,17,14031,460,3,221,260,174,39,11,705,0,22,727
14,17,14031,461,3,252,366,168,69,14,869,0,22,891
14,17,14031,462,3,193,327,169,54,13,756,4,13,773
14,17,14031,463,3,302,435,249,52,12,1050,1,48,1099
14,17,14031,464,3,239,311,166,40,8,764,0,26,790
14,17,14031,465,3,157,110,69,15,12,363,0,0,363
14,17,14031,466,3,450,363,117,81,32,1043,1,43,1087
14,17,14031,467,3,495,405,98,65,32,1095,1,38,1134
14,17,14031,468,3,399,362,126,50,27,964,1,32,997
14,17,14031,469,3,321,235,113,56,23,748,3,22,773
14,17,14031,470,3,571,543,225,118,23,1480,5,33,1518
14,17,14031,471,3,267,247,92,74,9,689,0,19,708
14,17,14031,472,3,351,378,99,87,22,937,0,28,965
14,17,14031,473,3,164,169,166,30,6,535,0,32,567
14,17,14031,474,3,209,226,172,36,10,653,0,22,675
14,17,14031,475,3,481,357,285,87,52,1262,4,25,1291
14,17,14046,1591,3,648,358,113,82,22,1223,4,37,1264
14,17,14046,1592,3,649,364,93,87,10,1203,0,44,1247
14,17,14046,1593,3,420,229,49,38,9,745,0,23,768
14,17,14046,1594,3,449,361,162,242,13,1227,2,15,1244
14,17,14046,1595,3,308,370,123,99,5,905,3,30,938
14,17,14046,1596,3,609,367,194,254,15,1439,0,30,1469
14,17,14046,1597,3,423,344,98,43,8,916,0,25,941
14,17,14046,1598,3,184,251,45,31,8,519,1,12,532
14,17,14046,1599,3,288,344,53,44,8,737,2,18,757
14,17,14046,1600,3,24,11,21,15,1,72,0,3,75
14,17,14046,1601,3,327,523,62,65,7,984,4,28,1016
14,17,14052,1671,3,423,203,173,55,48,902,1,25,928
14,17,14052,1672,3,388,275,201,61,34,959,1,38,998
14,17,14052,1673,3,191,160,137,50,15,553,0,6,559
14,17,14052,1674,3,585,283,197,100,57,1222,0,61,1283
14,17,14052,1675,3,747,365,246,96,79,1533,1,54,1588
14,17,14052,1676,3,502,329,203,127,62,1223,3,48,1274
14,17,14052,1677,3,370,205,208,51,29,863,0,15,878
14,17,14052,1678,3,692,220,178,60,40,1190,0,28,1218
14,17,14052,1679,3,73,62,39,12,5,191,0,16,207
14,17,14052,1680,3,132,88,43,14,9,286,0,17,303
14,17,14052,1681,3,497,438,155,97,67,1254,2,38,1294
14,17,14052,1682,3,330,334,149,102,21,936,2,23,961
14,17,14052,1683,3,262,148,39,48,14,511,0,14,525
14,17,14052,1684,3,279,240,103,88,24,734,2,14,750
14,17,14052,1685,3,253,222,80,40,7,602,0,16,618
14,17,14052,1686,3,359,173,73,66,22,693,0,34,727
14,17,14052,1687,3,213,128,49,20,14,424,1,20,445
14,17,14052,1688,3,328,172,311,74,37,922,0,26,948
14,17,14053,1689,3,275,255,101,31,20,682,0,21,703
14,17,14053,1690,3,330,275,153,25,18,801,3,12,816
14,17,14053,1691,3,288,323,229,46,14,900,0,32,932
14,17,14053,1692,3,376,383,292,45,20,1116,3,25,1144
14,17,14053,1693,3,120,238,118,16,6,498,0,10,508
14,17,14053,1694,3,457,87,59,15,3,621,0,28,649
14,17,14053,1695,3,251,405,171,19,15,861,1,23,885
14,17,14059,1797,3,199,132,271,8,3,613,0,11,624
14,17,14059,1798,3,155,113,104,5,2,379,0,5,384
14,17,14059,1799,3,155,72,141,12,3,383,0,11,394
14,17,14059,1800,3,178,40,69,5,2,294,0,7,301
14,17,14059,1801,3,117,61,84,2,0,264,0,4,268
14,17,14061,1815,3,408,348,282,30,39,1107,5,42,1154
14,17,14061,1816,3,325,452,223,39,14,1053,10,28,1091
14,17,14061,1817,3,235,310,316,24,17,902,1,23,926
14,17,14061,1818,3,158,187,125,18,13,501,2,15,518
14,17,14061,1819,3,141,111,168,6,16,442,0,35,477
14,17,14061,1820,3,82,120,124,16,3,345,0,13,358
14,17,14061,1821,3,148,89,98,12,12,359,0,19,378
14,17,14061,1822,3,34,47,56,0,2,139,0,3,142
14,17,14061,1823,3,170,181,138,3,8,500,1,30,531
14,17,14068,1914,3,212,130,99,23,8,472,0,10,482
14,17,14068,1915,3,408,285,316,64,15,1088,5,21,1114
14,17,14068,1916,3,300,162,239,55,12,768,1,15,784
14,17,14068,1917,3,199,115,105,20,9,448,1,6,455
14,17,14068,1918,3,290,188,174,32,15,699,0,24,723
14,17,14068,1919,3,346,213,249,46,23,877,0,24,901
14,17,14068,1920,3,246,170,283,39,17,755,1,10,766
14,17,14068,1921,3,349,196,187,43,17,792,2,17,811
14,17,14068,1922,3,303,197,134,35,17,686,0,6,692
14,17,14068,1923,3,252,169,194,22,11,648,1,8,657
14,17,14068,1924,3,295,217,192,12,5,721,11,8,740
14,17,14068,1925,3,612,353,229,21,4,1219,2,24,1245
14,17,14068,1926,3,360,208,240,39,17,864,3,23,890
14,17,14068,1927,3,223,205,248,39,14,729,3,28,760
14,17,14068,1928,3,289,181,179,47,17,713,2,29,744
14,17,14068,1929,3,208,307,422,43,11,991,0,32,1023
14,17,14068,1930,3,96,155,262,3,4,520,0,13,533
14,17,14068,1931,3,158,713,769,4,36,1680,0,83,1763
14,17,14068,1932,3,30,160,73,2,1,266,0,10,276
14,17,14068,1933,3,404,308,159,23,11,905,0,20,925
14,17,14071,2012,3,140,133,173,4,4,454,0,17,471
14,17,14071,2013,3,207,251,232,9,3,702,0,40,742
14,17,14071,2014,3,40,117,111,0,2,270,0,5,275
14,17,14071,2015,3,66,207,165,4,5,447,0,20,467
14,17,14071,2016,3,46,92,136,0,0,274,0,7,281
14,17,14071,2017,3,89,30,50,6,1,176,0,7,183
14,17,14071,2018,3,133,363,186,6,6,694,0,17,711
14,17,14071,2019,3,51,145,85,3,5,289,0,7,296
14,17,14071,2020,3,9,27,34,0,0,70,0,2,72
14,17,14071,2021,3,72,77,23,3,1,176,1,5,182
14,17,14071,2022,3,48,29,41,1,2,121,1,4,126
14,17,14071,2023,3,80,86,85,3,1,255,0,5,260
14,17,14090,2298,3,260,130,91,4,11,496,1,12,509
14,17,14090,2299,3,257,198,170,2,8,635,1,26,662
14,17,14090,2300,3,145,235,139,7,5,531,0,19,550
14,17,14093,2330,3,270,270,67,22,6,635,1,18,654
14,17,14093,2331,3,340,201,36,13,3,593,1,11,605
14,17,14093,2332,3,157,254,33,2,1,447,0,31,478
14,17,14093,2333,3,155,174,31,7,1,368,0,9,377
14,17,14093,2334,3,347,283,36,24,7,697,0,21,718
14,17,14093,2335,3,134,247,15,0,2,398,0,15,413
14,17,14093,2336,3,112,93,15,4,2,226,0,5,231
14,17,14093,2337,3,132,293,17,5,4,451,0,16,467
14,17,14093,2338,3,299,272,58,8,3,640,2,29,671
14,17,14093,2339,3,293,361,44,23,7,728,0,19,747
14,17,14097,2424,3,431,262,182,18,14,907,1,22,930
14,17,14097,2425,3,259,107,143,27,10,546,0,23,569
14,17,14097,2426,3,243,144,132,12,11,542,1,23,566
14,17,14097,2427,3,248,97,105,5,8,463,0,8,471
14,17,14097,2428,3,186,66,74,10,4,340,0,13,353
14,17,14097,2429,3,184,145,97,6,7,439,0,22,461
14,17,14097,2430,3,368,143,123,11,4,649,0,21,670
14,17,14097,2431,3,323,138,89,11,14,575,0,16,591
14,17,14097,2432,3,162,138,132,10,13,455,0,22,477
14,17,14097,2433,3,128,103,51,4,3,289,0,22,311
14,17,14097,2434,3,293,155,99,15,7,569,0,14,583
14,17,14097,2435,3,168,354,292,8,23,845,4,40,889
14,17,14097,2436,3,125,102,29,0,8,264,0,10,274
14,17,14097,2437,3,91,101,41,2,6,241,1,10,252
14,17,14108,2767,3,449,199,111,27,22,808,0,40,848
14,17,14108,2768,3,388,209,292,39,9,937,0,24,961
14,17,14108,2769,3,276,174,124,36,6,616,0,12,628
14,17,14108,2770,3,221,104,76,14,10,425,0,20,445
14,17,14113,2824,3,187,170,86,2,0,445,1,5,451
14,17,14113,2825,3,298,219,108,5,6,636,0,14,650
14,17,14113,2826,3,484,380,224,17,7,1112,0,20,1132
14,17,14113,2827,3,37,6,9,0,0,52,0,0,52
14,17,14113,2828,3,171,129,83,4,3,390,0,6,396
14,17,14119,2884,3,377,192,168,26,54,817,2,14,833
14,17,14119,2885,3,281,208,131,40,33,693,0,22,715
14,17,14119,2886,3,337,227,176,34,27,801,2,17,820
14,17,14119,2887,3,486,342,245,77,41,1191,2,42,1235
14,17,14119,2888,3,292,202,214,51,35,794,0,18,812
14,17,14119,2889,3,416,339,424,56,45,1280,3,24,1307
14,17,14119,2890,3,444,259,280,36,42,1061,2,43,1106
14,17,14119,2891,3,228,175,167,21,36,627,0,30,657
14,17,14119,2892,3,159,134,153,24,20,490,0,14,504
14,17,14119,2893,3,261,213,166,29,23,692,2,48,742
14,17,14119,2894,3,165,141,101,24,13,444,0,23,467
14,17,14119,2895,3,261,148,105,9,14,537,3,40,580
14,17,14119,2896,3,109,116,64,12,4,305,0,10,315
14,17,14119,2897,3,114,173,162,32,13,494,0,26,520
14,17,14119,2898,3,220,283,197,48,33,781,2,43,826
14,17,14119,2899,3,145,249,142,5,21,562,0,44,606
14,17,14124,3278,3,631,479,125,24,21,1280,1,58,1339
14,17,14124,3279,3,416,364,64,22,15,881,2,19,902
14,17,14124,3280,3,361,384,50,15,21,831,2,25,858
14,17,14124,3281,3,520,327,116,32,25,1020,1,17,1038
14,17,14124,3282,3,542,455,143,30,21,1191,0,41,1232
14,17,14124,3283,3,564,450,183,23,21,1241,3,26,1270
14,17,14124,3284,3,374,277,94,15,8,768,1,5,774
14,17,14124,3285,3,634,484,102,27,18,1265,0,24,1289
14,17,14124,3286,3,468,400,77,20,10,975,3,15,993
14,17,14124,3287,3,447,379,74,14,13,927,0,17,944
14,17,14124,3288,3,447,252,84,20,13,816,0,24,840
14,17,14124,3289,3,684,362,94,47,18,1205,1,36,1242
14,17,14124,3290,3,117,159,34,8,6,324,0,17,341
14,17,14124,3291,3,533,164,53,18,4,772,3,22,797
14,17,14124,3292,3,92,44,6,2,1,145,1,3,149
14,17,14124,3293,3,107,51,10,1,0,169,0,5,174
14,17,14124,3294,3,163,93,47,4,2,309,0,15,324
14,17,14124,3295,3,247,144,64,10,9,474,2,16,492
14,17,14124,3296,3,92,188,18,13,9,320,4,11,335
14,17,14124,3297,3,294,89,67,12,3,465,0,20,485
14,17,14124,3298,3,90,60,16,2,1,169,0,5,174
14,17,14124,3299,3,38,13,9,0,0,60,0,3,63
14,17,14124,3300,3,128,70,16,1,3,218,1,7,226
14,17,14124,3301,3,1125,362,94,41,23,1645,4,42,1691
14,17,14124,3302,3,485,446,83,28,10,1052,8,26,1086
14,17,14124,3303,3,393,56,68,6,2,525,4,12,541
14,17,14124,3304,3,226,109,43,9,9,396,0,17,413
14,17,14124,3305,3,217,130,29,7,1,384,0,14,398
14,17,14124,3306,3,282,268,26,6,5,587,1,10,598
14,17,14124,3307,3,301,279,32,14,3,629,4,22,655
14,17,14124,3308,3,384,210,19,5,3,621,1,17,639
14,17,14124,3309,3,478,386,66,13,10,953,2,26,981
14,18,14006,48,3,393,442,158,53,42,1088,0,35,1123
14,18,14006,50,3,187,180,88,27,20,502,4,24,530
14,18,14006,51,3,245,223,60,20,24,572,0,25,597
14,18,14006,52,3,523,399,167,68,43,1200,0,39,1239
14,18,14006,53,3,206,234,95,29,17,581,1,5,587
14,18,14006,54,3,232,192,62,19,24,529,2,14,545
14,18,14006,55,3,229,213,68,28,21,559,0,34,593
14,18,14006,56,3,354,374,176,83,33,1020,1,2,1023
14,18,14006,57,3,351,234,91,42,19,737,1,8,746
14,18,14006,58,3,309,226,85,33,8,661,0,18,679
14,18,14006,59,3,319,344,98,34,16,811,0,18,829
14,18,14006,60,3,124,180,45,21,13,383,0,13,396
14,18,14006,61,3,272,280,74,52,13,691,0,17,708
14,18,14006,62,3,328,226,84,42,21,701,3,21,725
14,18,14006,63,3,286,281,132,49,27,775,0,16,791
14,18,14006,64,3,259,212,116,56,23,666,2,30,698
14,18,14006,65,3,274,253,101,49,12,689,0,16,705
14,18,14006,66,3,334,272,121,37,18,782,0,23,805
14,18,14006,67,3,558,545,223,77,43,1446,1,34,1481
14,18,14006,69,3,265,198,107,32,21,623,0,20,643
14,18,14006,70,3,163,152,202,12,8,537,0,9,546
14,18,14006,71,3,186,100,135,15,2,438,2,11,451
14,18,14006,72,3,485,282,261,67,40,1135,10,24,1169
14,18,14006,73,3,73,99,30,7,3,212,0,15,227
14,18,14006,74,3,42,22,62,2,1,129,0,3,132
14,18,14006,75,3,130,178,55,15,15,393,1,23,417
14,18,14006,76,3,215,110,40,32,6,403,0,15,418
14,18,14006,77,3,96,139,208,36,11,490,5,12,507
14,18,14006,78,3,162,105,67,20,8,362,0,16,378
14,18,14006,79,3,218,173,38,14,14,457,0,12,469
14,18,14006,80,3,356,169,60,14,13,612,0,24,636
14,18,14006,81,3,150,174,78,11,20,433,1,19,453
14,18,14006,82,3,89,21,15,3,2,130,0,6,136
14,18,14006,83,3,29,18,7,0,0,54,0,5,59
14,18,14006,84,3,117,102,51,21,7,298,0,17,315
14,18,14006,85,3,84,31,15,4,2,136,0,0,136
14,18,14006,86,3,76,28,20,8,3,135,0,5,140
14,18,14006,87,3,185,165,66,10,11,437,3,9,449
14,18,14006,88,3,214,109,39,4,6,372,1,19,392
14,18,14006,89,3,153,62,41,7,6,269,0,10,279
14,18,14006,90,3,56,124,16,7,1,204,0,8,212
14,18,14006,91,3,185,152,91,16,4,448,1,11,460
14,18,14006,92,3,48,11,5,1,2,67,0,0,67
14,18,14006,93,3,92,56,24,4,3,179,0,12,191
14,18,14010,144,3,302,274,81,30,2,689,1,20,710
14,18,14010,145,3,362,285,127,38,0,812,3,22,837
14,18,14010,146,3,306,194,57,17,4,578,0,6,584
14,18,14010,147,3,31,56,5,5,0,97,0,3,100
14,18,14010,148,3,108,174,16,15,0,313,0,4,317
14,18,14015,194,3,551,414,88,76,13,1142,7,42,1191
14,18,14015,195,3,643,310,88,81,15,1137,3,19,1159
14,18,14015,196,3,327,193,49,34,5,608,0,9,617
14,18,14015,197,3,746,631,145,138,22,1682,1,38,1721
14,18,14015,198,3,434,219,66,46,4,769,0,9,778
14,18,14015,199,3,534,248,81,41,11,915,0,14,929
14,18,14015,200,3,379,358,67,49,7,860,1,17,878
14,18,14015,201,3,504,288,107,66,17,982,2,27,1011
14,18,14015,202,3,619,348,115,70,14,1166,1,27,1194
14,18,14015,203,3,383,354,63,67,9,876,2,31,909
14,18,14015,204,3,387,283,63,51,10,794,1,22,817
14,18,14015,205,3,438,261,72,49,9,829,0,17,846
14,18,14015,206,3,340,243,50,60,13,706,0,7,713
14,18,14015,207,3,557,440,140,78,9,1224,1,24,1249
14,18,14015,208,3,229,158,45,33,9,474,0,6,480
14,18,14015,209,3,520,366,112,73,13,1084,0,20,1104
14,18,14015,210,3,467,291,106,46,12,922,5,19,946
14,18,14015,211,3,240,169,34,28,4,475,0,11,486
14,18,14015,212,3,489,353,95,61,25,1023,0,47,1070
14,18,14015,213,3,231,119,13,28,2,393,0,9,402
14,18,14015,214,3,304,214,20,26,3,567,1,19,587
14,18,14015,215,3,93,160,22,15,0,290,0,9,299
14,18,14015,216,3,219,205,35,26,4,489,0,16,505
14,18,14015,217,3,240,256,39,34,4,573,0,26,599
14,18,14015,218,3,143,120,53,9,4,329,0,0,329
14,18,14015,219,3,174,199,22,9,4,408,1,17,426
14,18,14015,220,3,30,61,8,1,1,101,0,2,103
14,18,14015,221,3,101,68,20,3,0,192,1,1,194
14,18,14015,222,3,273,143,22,27,4,469,1,19,489
14,18,14015,223,3,222,222,26,11,3,484,2,23,509
14,18,14021,302,3,148,309,131,47,7,642,0,10,652
14,18,14021,303,3,205,246,166,27,10,654,1,18,673
14,18,14021,304,3,226,180,195,28,9,638,2,24,664
14,18,14021,305,3,161,235,133,27,4,560,1,9,570
14,18,14021,306,3,117,120,161,29,1,428,1,24,453
14,18,14021,307,3,152,165,161,24,8,510,0,10,520
14,18,14021,308,3,237,238,197,26,7,705,0,22,727
14,18,14021,309,3,69,114,112,8,0,303,0,7,310
14,18,14021,310,3,196,169,190,95,8,658,0,15,673
14,18,14021,311,3,189,298,242,149,4,882,1,48,931
14,18,14021,312,3,243,111,105,22,4,485,1,16,502
14,18,14021,313,3,75,181,162,51,0,469,0,12,481
14,18,14021,314,3,253,205,91,29,2,580,2,12,594
14,18,14021,315,3,92,116,107,16,2,333,0,17,350
14,18,14022,316,3,228,261,265,70,6,830,1,30,861
14,18,14022,317,3,164,210,186,52,9,621,3,12,636
14,18,14022,318,3,118,203,178,29,5,533,1,15,549
14,18,14022,319,3,258,364,156,46,12,836,0,18,854
14,18,14022,320,3,219,212,229,63,6,729,0,19,748
14,18,14022,321,3,241,287,229,96,12,865,2,19,886
14,18,14022,322,3,151,166,161,41,4,523,0,9,532
14,18,14022,323,3,179,195,92,58,2,526,0,15,541
14,18,14022,324,3,131,142,62,0,7,342,0,5,347
14,18,14022,325,3,391,204,154,34,11,794,5,16,815
14,18,14022,326,3,228,224,81,21,3,557,1,5,563
14,18,14022,327,3,345,301,333,23,16,1018,1,20,1039
14,18,14022,328,3,394,327,401,29,11,1162,0,42,1204
14,18,14022,329,3,21,60,47,1,1,130,0,8,138
14,18,14022,330,3,155,219,253,15,4,646,0,14,660
14,18,14022,331,3,349,379,285,64,8,1085,0,51,1136
14,18,14022,332,3,28,52,47,5,1,133,0,6,139
14,18,14025,394,3,465,188,355,39,11,1058,0,31,1089
14,18,14025,395,3,237,148,271,30,11,697,2,14,713
14,18,14025,396,3,217,135,252,47,8,659,0,20,679
14,18,14025,397,3,354,160,495,47,15,1071,1,30,1102
14,18,14025,398,3,346,164,335,48,8,901,0,19,920
14,18,14025,399,3,250,148,315,48,10,771,1,11,783
14,18,14025,400,3,132,56,114,16,4,322,1,3,326
14,18,14025,401,3,495,231,432,42,8,1208,1,18,1227
14,18,14025,402,3,232,151,165,27,3,578,0,12,590
14,18,14025,403,3,128,140,192,17,1,478,1,18,497
14,18,14025,404,3,179,255,154,22,10,620,1,20,641
14,18,14025,405,3,237,194,116,28,3,578,1,15,594
14,18,14025,406,3,154,224,151,9,3,541,0,18,559
14,18,14025,407,3,81,49,206,12,3,351,0,0,351
14,18,14025,408,3,273,471,176,91,13,1024,0,43,1067
14,18,14025,409,3,216,54,171,20,7,468,1,15,484
14,18,14025,410,3,107,56,162,13,5,343,0,11,354
14,18,14028,432,3,452,180,30,15,1,678,2,10,690
14,18,14028,433,3,477,221,43,12,1,754,2,13,769
14,18,14028,434,3,390,342,57,7,2,798,1,13,812
14,18,14028,435,3,442,591,94,16,2,1145,1,49,1195
14,18,14028,436,3,505,421,121,13,2,1062,1,40,1103
14,18,14028,437,3,538,570,30,11,4,1153,3,34,1190
14,18,14028,438,3,80,88,5,0,1,174,0,3,177
14,18,14028,439,3,391,262,199,12,5,869,3,28,900
14,18,14028,440,3,55,80,17,8,2,162,0,7,169
14,18,14033,479,3,365,291,88,32,5,781,2,41,824
14,18,14033,480,3,385,372,138,69,6,970,2,18,990
14,18,14033,481,3,94,99,29,6,0,228,0,11,239
14,18,14033,482,3,96,144,17,12,1,270,0,8,278
14,18,14035,499,3,469,349,16,8,4,846,1,19,866
14,18,14035,500,3,97,137,4,0,0,238,0,5,243
14,18,14039,549,3,472,399,87,63,13,1034,0,27,1061
14,18,14039,550,3,463,448,76,45,18,1050,1,25,1076
14,18,14039,551,3,295,257,46,20,14,632,0,10,642
14,18,14039,552,3,212,304,41,19,7,583,0,27,610
14,18,14039,553,3,501,537,88,77,13,1216,3,29,1248
14,18,14039,554,3,319,236,50,26,4,635,1,19,655
14,18,14039,555,3,476,378,77,56,7,994,2,29,1025
14,18,14039,556,3,264,222,35,35,7,563,0,7,570
14,18,14039,557,3,174,175,73,28,10,460,0,3,463
14,18,14039,558,3,378,322,74,51,19,844,0,28,872
14,18,14039,559,3,128,335,71,48,1,583,1,10,594
14,18,14039,560,3,51,110,10,1,2,174,0,0,174
14,18,14054,1696,3,333,132,146,35,6,652,1,21,674
14,18,14054,1697,3,265,121,128,35,0,549,2,12,563
14,18,14054,1698,3,256,158,173,20,1,608,0,10,618
14,18,14054,1699,3,161,112,49,1,1,324,0,8,332
14,18,14054,1700,3,244,145,79,7,2,477,0,8,485
14,18,14054,1701,3,85,52,50,6,0,193,0,3,196
14,18,14056,1776,3,81,109,113,12,6,321,0,11,332
14,18,14056,1777,3,151,194,163,27,8,543,2,17,562
14,18,14056,1778,3,217,247,213,40,8,725,0,30,755
14,18,14056,1779,3,209,151,103,26,5,494,0,26,520
14,18,14056,1780,3,124,174,43,53,3,397,0,18,415
14,18,14056,1781,3,117,109,58,67,3,354,2,15,371
14,18,14079,2115,3,343,232,363,50,9,997,0,33,1030
14,18,14079,2116,3,200,202,203,30,7,642,1,24,667
14,18,14079,2117,3,261,294,418,54,13,1040,2,42,1084
14,18,14079,2118,3,264,271,305,51,6,897,0,24,921
14,18,14079,2119,3,201,362,77,8,2,650,0,19,669
14,18,14079,2120,3,155,313,67,11,3,549,0,18,567
14,18,14079,2121,3,174,140,234,44,10,602,0,26,628
14,18,14079,2122,3,195,101,213,30,6,545,1,24,570
14,18,14079,2123,3,186,288,150,47,7,678,0,18,696
14,18,14079,2124,3,371,352,534,199,15,1471,1,51,1523
14,18,14079,2125,3,547,173,401,20,5,1146,2,34,1182
14,18,14079,2126,3,282,96,182,17,9,586,1,14,601
14,18,14079,2127,3,145,150,123,13,2,433,0,13,446
14,18,14079,2128,3,64,108,124,18,4,318,0,10,328
14,18,14079,2129,3,121,55,115,11,4,306,0,14,320
14,18,14079,2130,3,247,74,272,47,5,645,0,10,655
14,18,14079,2131,3,89,59,68,8,3,227,1,8,236
14,18,14089,2285,3,527,460,214,64,10,1275,1,27,1303
14,18,14089,2286,3,300,171,46,36,6,559,0,15,574
14,18,14089,2287,3,311,219,50,32,8,620,0,17,637
14,18,14089,2288,3,589,361,99,106,7,1162,0,34,1196
14,18,14089,2289,3,218,134,25,14,2,393,0,10,403
14,18,14089,2290,3,214,131,18,8,0,371,0,9,380
14,18,14089,2291,3,97,61,9,13,3,183,0,2,185
14,18,14089,2292,3,159,201,54,15,4,433,1,13,447
14,18,14089,2293,3,201,168,49,21,4,443,2,14,459
14,18,14089,2294,3,187,112,93,57,5,454,0,26,480
14,18,14089,2295,3,14,128,6,4,0,152,0,0,152
14,18,14089,2296,3,359,386,47,39,5,836,1,18,855
14,18,14089,2297,3,55,115,22,32,2,226,0,9,235
14,18,14091,2301,3,547,316,56,55,5,979,2,19,1000
14,18,14091,2302,3,497,264,69,19,2,851,1,14,866
14,18,14091,2303,3,274,214,49,23,5,565,0,7,572
14,18,14091,2304,3,332,102,9,5,2,450,0,7,457
14,18,14091,2305,3,52,66,7,1,0,126,0,1,127
14,18,14091,2306,3,244,138,30,56,1,469,0,15,484
14,18,14103,2730,3,590,289,32,8,3,922,0,15,937
14,18,14103,2731,3,308,248,10,1,0,567,0,3,570
14,18,14103,2732,3,308,259,16,2,8,593,0,5,598
14,18,14103,2733,3,239,150,27,4,2,422,1,1,424
14,18,14103,2734,3,260,230,23,3,2,518,0,18,536
14,18,14107,2762,3,409,265,40,9,8,731,3,21,755
14,18,14107,2763,3,98,77,2,1,0,178,0,5,183
14,18,14107,2764,3,115,214,48,4,14,395,0,0,395
14,18,14107,2765,3,109,106,31,5,7,258,0,6,264
14,18,14107,2766,3,189,308,60,11,9,577,0,16,593
14,18,14111,2804,3,356,384,103,82,21,946,1,23,970
14,18,14111,2805,3,242,217,100,59,11,629,1,27,657
14,18,14111,2806,3,172,123,50,25,6,376,0,9,385
14,18,14111,2807,3,210,224,43,48,4,529,0,10,539
14,18,14111,2808,3,254,191,50,44,5,544,0,17,561
14,18,14111,2809,3,252,167,60,57,2,538,1,17,556
14,18,14111,2810,3,146,133,56,31,13,379,1,19,399
14,18,14111,2811,3,265,93,95,26,6,485,2,15,502
14,18,14111,2812,3,169,107,181,38,7,502,0,2,504
14,18,14111,2813,3,129,103,28,53,6,319,0,16,335
14,18,14111,2814,3,98,137,47,27,4,313,0,14,327
14,18,14111,2815,3,30,127,18,27,3,205,0,10,215
14,18,14114,2829,3,381,447,159,84,142,1213,1,54,1268
14,18,14114,2830,3,366,362,130,59,95,1012,5,27,1044
14,18,14114,2831,3,280,311,154,72,96,913,1,34,948
14,18,14114,2832,3,226,180,177,70,42,695,0,52,747
14,18,14114,2833,3,222,176,162,39,43,642,0,19,661
14,18,14114,2834,3,129,196,184,33,37,579,0,27,606
14,18,14114,2835,3,128,178,179,29,26,540,3,8,551
14,18,14114,2836,3,16,63,37,2,16,134,1,10,145
14,18,14114,2837,3,127,183,116,35,48,509,0,23,532
14,18,14114,2838,3,272,223,164,64,90,813,5,32,850
14,19,14004,36,3,203,182,46,4,2,437,0,9,446
14,19,14004,37,3,314,488,106,10,3,921,1,24,946
14,19,14004,38,3,41,93,9,2,1,146,4,4,154
14,19,14004,39,3,348,386,73,12,8,827,0,17,844
14,19,14023,333,3,514,494,235,32,25,1300,0,24,1324
14,19,14023,334,3,509,468,178,26,19,1200,0,13,1213
14,19,14023,335,3,282,353,149,31,14,829,3,15,847
14,19,14023,336,3,505,374,141,33,14,1067,2,30,1099
14,19,14023,337,3,350,237,105,17,6,715,0,19,734
14,19,14023,338,3,459,409,139,27,18,1052,3,21,1076
14,19,14023,339,3,250,169,51,15,9,494,2,12,508
14,19,14023,340,3,282,305,108,23,19,737,1,20,758
14,19,14023,341,3,255,276,103,13,8,655,3,14,672
14,19,14023,342,3,483,472,167,21,14,1157,6,21,1184
14,19,14023,343,3,208,129,77,12,7,433,0,12,445
14,19,14023,344,3,193,138,85,7,5,428,0,10,438
14,19,14023,345,3,291,237,87,16,3,634,1,11,646
14,19,14023,346,3,247,196,65,9,3,520,0,9,529
14,19,14023,347,3,273,235,89,24,10,631,2,21,654
14,19,14023,348,3,326,280,149,26,10,791,5,21,817
14,19,14023,349,3,336,268,149,21,17,791,3,22,816
14,19,14023,350,3,83,68,32,10,4,197,0,4,201
14,19,14023,351,3,363,310,75,23,8,779,9,14,802
14,19,14023,352,3,314,285,112,10,5,726,1,5,732
14,19,14023,353,3,232,185,67,9,5,498,1,2,501
14,19,14023,354,3,506,463,160,32,20,1181,1,24,1206
14,19,14023,355,3,342,299,162,37,11,851,1,13,865
14,19,14023,356,3,396,360,120,20,11,907,2,7,916
14,19,14023,357,3,424,484,163,32,19,1122,7,20,1149
14,19,14023,358,3,318,318,154,22,9,821,0,24,845
14,19,14023,359,3,321,234,90,15,8,668,0,21,689
14,19,14023,360,3,377,365,138,30,10,920,2,22,944
14,19,14023,361,3,322,424,136,38,12,932,2,22,956
14,19,14023,362,3,248,267,106,17,9,647,0,19,666
14,19,14023,363,3,372,291,118,19,7,807,0,13,820
14,19,14023,364,3,383,337,112,14,9,855,2,9,866
14,19,14023,365,3,307,310,107,21,10,755,0,20,775
14,19,14023,366,3,131,100,36,10,3,280,1,2,283
14,19,14023,367,3,296,301,91,23,13,724,0,13,737
14,19,14023,368,3,262,220,106,22,12,622,2,21,645
14,19,14023,369,3,536,528,220,55,21,1360,8,21,1389
14,19,14023,370,3,684,828,292,80,20,1904,2,24,1930
14,19,14023,371,3,277,303,117,29,19,745,0,20,765
14,19,14023,372,3,418,250,147,30,8,853,1,26,880
14,19,14023,373,3,305,264,118,17,9,713,2,15,730
14,19,14023,374,3,409,444,159,40,21,1073,2,12,1087
14,19,14023,375,3,602,723,245,55,32,1657,4,55,1716
14,19,14023,376,3,469,388,165,32,20,1074,9,17,1100
14,19,14023,377,3,379,414,120,37,7,957,3,23,983
14,19,14023,378,3,446,452,179,42,15,1134,4,32,1170
14,19,14023,379,3,276,279,111,30,10,706,1,17,724
14,19,14023,380,3,305,352,135,30,11,833,4,28,865
14,19,14023,381,3,510,473,212,35,34,1264,0,22,1286
14,19,14023,382,3,79,64,39,0,1,183,1,5,189
14,19,14023,383,3,158,153,55,10,7,383,3,15,401
14,19,14024,384,3,204,375,102,132,3,816,0,25,841
14,19,14024,385,3,296,410,126,139,10,981,2,11,994
14,19,14024,386,3,184,258,32,61,2,537,0,16,553
14,19,14024,387,3,117,283,305,100,9,814,0,23,837
14,19,14024,388,3,277,128,206,45,6,662,0,17,679
14,19,14024,389,3,121,220,136,19,2,498,1,15,514
14,19,14024,390,3,45,57,54,9,0,165,0,8,173
14,19,14024,391,3,91,324,205,54,5,679,10,23,712
14,19,14024,392,3,108,181,102,72,5,468,1,16,485
14,19,14024,393,3,89,198,267,44,5,603,1,20,624
14,19,14038,541,3,415,416,124,17,3,975,0,20,995
14,19,14038,542,3,497,444,92,20,6,1059,2,31,1092
14,19,14038,543,3,461,391,58,23,6,939,0,24,963
14,19,14038,544,3,256,422,70,30,11,789,0,14,803
14,19,14038,545,3,512,657,105,49,18,1341,2,44,1387
14,19,14038,546,3,105,207,21,8,9,350,3,12,365
14,19,14038,547,3,89,52,7,1,0,149,0,3,152
14,19,14038,548,3,41,78,15,2,2,138,2,2,142
14,19,14051,1661,3,414,432,33,0,1,880,0,10,890
14,19,14051,1662,3,78,56,11,0,0,145,0,6,151
14,19,14051,1663,3,26,26,0,0,0,52,0,0,52
14,19,14051,1664,3,83,84,14,0,1,182,0,4,186
14,19,14051,1665,3,235,149,134,4,4,526,0,11,537
14,19,14051,1666,3,218,250,345,6,2,821,2,12,835
14,19,14051,1667,3,68,124,17,0,1,210,0,2,212
14,19,14051,1668,3,191,159,42,0,0,392,0,9,401
14,19,14051,1669,3,159,136,6,0,0,301,0,7,308
14,19,14051,1670,3,89,37,21,0,0,147,0,5,152
14,19,14058,1792,3,256,128,156,4,3,547,0,17,564
14,19,14058,1793,3,57,70,15,0,1,143,0,1,144
14,19,14058,1794,3,128,41,16,0,1,186,0,3,189
14,19,14058,1795,3,84,44,4,0,0,132,0,1,133
14,19,14058,1796,3,86,46,55,0,0,187,0,3,190
14,19,14067,1901,3,194,253,128,8,6,589,1,34,624
14,19,14067,1902,3,189,269,95,14,13,580,0,33,613
14,19,14067,1903,3,194,240,97,8,8,547,0,33,580
14,19,14067,1904,3,223,195,147,11,11,587,2,15,604
14,19,14067,1905,3,194,296,163,14,14,681,1,46,728
14,19,14067,1906,3,139,171,113,8,6,437,1,22,460
14,19,14067,1907,3,107,124,61,8,9,309,0,15,324
14,19,14067,1908,3,184,204,104,14,10,516,2,33,551
14,19,14067,1909,3,182,114,84,3,8,391,0,28,419
14,19,14067,1910,3,30,70,10,1,3,114,0,5,119
14,19,14067,1911,3,72,104,93,0,1,270,0,6,276
14,19,14067,1912,3,81,129,50,3,2,265,0,6,271
14,19,14067,1913,3,63,88,81,0,0,232,0,12,244
14,19,14083,2162,3,291,256,206,66,141,960,6,43,1009
14,19,14083,2163,3,233,291,181,39,87,831,0,12,843
14,19,14083,2164,3,260,359,160,42,72,893,4,17,914
14,19,14083,2165,3,261,245,198,60,55,819,1,24,844
14,19,14083,2166,3,192,187,167,52,55,653,3,30,686
14,19,14083,2168,3,257,279,156,55,62,809,7,18,834
14,19,14083,2169,3,207,177,83,22,21,510,1,16,527
14,19,14083,2170,3,191,192,69,47,24,523,0,12,535
14,19,14083,2171,3,315,354,179,67,81,996,1,39,1036
14,19,14083,2172,3,169,208,116,20,30,543,1,7,551
14,19,14083,2173,3,321,361,195,75,75,1027,0,25,1052
14,19,14083,2174,3,206,244,148,45,64,707,0,22,729
14,19,14083,2175,3,331,300,272,86,103,1092,1,38,1131
14,19,14083,2176,3,180,250,74,18,92,614,1,36,651
14,19,14083,2177,3,193,320,88,41,54,696,0,13,709
14,19,14083,2178,3,124,238,51,22,72,507,3,19,529
14,19,14083,2179,3,190,308,139,32,92,761,3,16,780
14,19,14083,2180,3,62,70,13,4,36,185,1,12,198
14,19,14086,2223,3,406,604,124,9,2,1145,1,7,1153
14,19,14086,2224,3,186,403,64,8,2,663,0,7,670
14,19,14086,2225,3,119,229,41,3,4,396,0,6,402
14,19,14086,2226,3,258,361,42,0,2,663,0,10,673
14,19,14086,2227,3,232,362,65,5,2,666,0,11,677
14,19,14086,2228,3,298,323,60,7,4,692,0,13,705
14,19,14086,2229,3,197,228,47,2,0,474,0,20,494
14,19,14086,2230,3,223,231,54,2,1,511,0,17,528
14,19,14086,2231,3,181,194,47,4,0,426,0,8,434
14,19,14086,2232,3,229,285,47,9,3,573,0,14,587
14,19,14086,2233,3,191,171,45,3,2,412,3,14,429
14,19,14086,2234,3,371,454,96,3,3,927,0,21,948
14,19,14086,2235,3,222,258,47,2,2,531,0,4,535
14,19,14086,2236,3,217,204,63,3,2,489,0,13,502
14,19,14086,2237,3,265,296,91,5,5,662,0,19,681
14,19,14086,2238,3,288,504,165,5,5,967,1,27,995
14,19,14086,2239,3,231,258,78,5,2,574,1,11,586
14,19,14086,2240,3,47,28,6,1,1,83,0,6,89
14,19,14086,2241,3,94,36,6,0,0,136,0,0,136
14,19,14086,2242,3,48,34,9,1,0,92,0,2,94
14,19,14086,2243,3,110,82,40,1,0,233,1,12,246
14,19,14086,2244,3,317,483,175,6,5,986,2,10,998
14,19,14086,2245,3,37,18,8,0,0,63,0,0,63
14,19,14086,2246,3,50,214,27,1,2,294,0,10,304
14,19,14086,2247,3,367,254,72,5,3,701,2,20,723
14,19,14086,2248,3,268,92,45,1,3,409,0,7,416
14,19,14086,2249,3,66,47,12,0,0,125,0,0,125
14,19,14086,2250,3,19,31,2,0,0,52,0,1,53
14,19,14086,2251,3,39,37,68,0,0,144,0,8,152
14,19,14086,2252,3,179,157,21,1,1,359,0,6,365
14,19,14086,2253,3,83,93,67,3,5,251,0,19,270
14,19,14086,2254,3,154,215,45,5,2,421,0,11,432
14,19,14086,2255,3,199,234,82,2,4,521,1,25,547
14,19,14086,2256,3,155,176,97,1,3,432,6,18,456
14,19,14086,2257,3,210,202,127,6,7,552,2,23,577
14,19,14086,2258,3,20,76,5,1,1,103,0,2,105
14,19,14086,2259,3,89,123,15,2,1,230,1,10,241
14,19,14087,2260,3,226,301,190,9,6,732,1,21,754
14,19,14087,2261,3,223,259,149,10,9,650,0,23,673
14,19,14087,2262,3,379,409,208,23,8,1027,0,32,1059
14,19,14087,2263,3,356,391,232,22,10,1011,1,23,1035
14,19,14087,2264,3,327,511,430,9,6,1283,3,18,1304
14,19,14087,2265,3,315,291,199,16,12,833,2,28,863
14,19,14087,2266,3,42,59,69,2,2,174,0,0,174
14,19,14087,2267,3,192,452,202,12,2,860,6,42,908
14,19,14087,2268,3,39,150,96,1,6,292,0,9,301
14,19,14088,2269,3,166,219,87,3,4,479,0,9,488
14,19,14088,2270,3,198,299,150,5,6,658,1,13,672
14,19,14088,2271,3,201,212,71,10,3,497,0,11,508
14,19,14088,2272,3,162,222,79,2,1,466,0,9,475
14,19,14088,2273,3,203,195,722,2,6,1128,0,19,1147
14,19,14088,2274,3,333,452,120,14,1,920,1,14,935
14,19,14088,2275,3,411,361,132,5,7,916,0,17,933
14,19,14088,2276,3,338,273,164,7,6,788,4,25,817
14,19,14088,2277,3,335,211,96,2,2,646,1,19,666
14,19,14088,2278,3,34,41,5,0,0,80,0,0,80
14,19,14088,2279,3,89,169,56,4,2,320,1,5,326
14,19,14088,2280,3,115,60,20,0,0,195,0,8,203
14,19,14088,2281,3,81,27,22,0,2,132,0,8,140
14,19,14088,2282,3,48,11,33,0,0,92,0,5,97
14,19,14088,2283,3,106,27,24,0,3,160,0,15,175
14,19,14088,2284,3,100,93,9,0,0,202,0,7,209
14,19,14100,2625,3,317,252,23,16,2,610,0,15,625
14,19,14100,2626,3,228,236,55,13,5,537,2,11,550
14,19,14100,2627,3,185,148,11,12,0,356,0,6,362
14,19,14100,2628,3,121,202,26,6,2,357,0,17,374
14,19,14100,2629,3,350,254,133,6,2,745,0,34,779
14,19,14100,2630,3,97,311,90,0,3,501,0,7,508
14,19,14100,2631,3,78,369,78,6,4,535,0,16,551
14,19,14100,2632,3,12,33,0,0,0,45,0,1,46
14,19,14104,2735,3,157,159,18,1,0,335,0,5,340
14,19,14104,2736,3,117,182,59,3,3,364,0,11,375
14,19,14104,2737,3,225,178,53,13,3,472,0,7,479
14,19,14104,2738,3,261,218,48,8,2,537,0,9,546
14,19,14104,2739,3,215,197,169,37,2,620,2,12,634
14,19,14104,2740,3,441,253,256,116,2,1068,4,27,1099
14,19,14104,2741,3,69,62,61,1,1,194,0,4,198
14,19,14109,2771,3,210,556,181,59,16,1022,3,24,1049
14,19,14109,2772,3,99,193,81,29,5,407,2,26,435
14,19,14109,2773,3,246,423,184,78,21,952,0,34,986
14,19,14109,2774,3,153,309,100,22,15,599,0,4,603
14,19,14109,2775,3,171,460,121,34,11,797,3,17,817
14,19,14109,2776,3,75,194,42,13,2,326,0,4,330
14,19,14109,2777,3,184,512,150,32,14,892,0,24,916
14,19,14109,2778,3,101,392,138,41,10,682,3,20,705
14,19,14109,2779,3,126,446,169,35,14,790,2,29,821
14,19,14109,2780,3,194,397,117,29,7,744,0,20,764
14,19,14109,2781,3,119,377,94,75,13,678,0,25,703
14,19,14109,2782,3,309,839,207,71,10,1436,6,18,1460
14,19,14109,2783,3,129,320,82,30,13,574,2,12,588
14,19,14109,2784,3,128,384,128,56,10,706,0,28,734
14,19,14109,2785,3,69,221,94,25,5,414,1,0,415
14,19,14109,2786,3,148,375,172,52,2,749,9,22,780
14,19,14109,2787,3,86,140,87,26,7,346,5,15,366
14,19,14109,2788,3,35,92,29,10,2,168,2,4,174
14,19,14109,2789,3,162,156,32,19,9,378,2,9,389
14,19,14109,2790,3,114,196,159,64,2,535,1,25,561
14,19,14109,2791,3,92,197,150,24,35,498,0,30,528
14,19,14109,2792,3,165,197,125,26,12,525,4,7,536
14,19,14109,2793,3,115,52,41,7,3,218,0,0,218
14,19,14121,3238,3,285,293,142,28,13,761,1,23,785
14,19,14121,3239,3,470,423,239,34,23,1189,5,35,1229
14,19,14121,3240,3,296,174,167,19,16,672,1,14,687
14,19,14121,3241,3,272,296,83,23,6,680,0,18,698
14,19,14121,3242,3,271,221,68,18,8,586,0,11,597
14,19,14121,3243,3,221,203,96,15,3,538,3,10,551
14,19,14121,3244,3,390,347,121,33,5,896,2,21,919
14,19,14121,3245,3,352,374,224,40,14,1004,2,21,1027
14,19,14121,3246,3,155,203,80,18,5,461,0,5,466
14,19,14121,3247,3,317,304,136,33,10,800,0,14,814
14,19,14121,3248,3,227,305,179,27,13,751,0,37,788
14,19,14121,3249,3,95,166,63,19,0,343,1,10,354
14,19,14121,3250,3,136,169,61,14,7,387,4,13,404
14,19,14121,3251,3,148,210,107,10,8,483,0,16,499
14,19,14121,3252,3,201,341,163,23,19,747,5,24,776
14,19,14121,3253,3,30,52,7,3,0,92,0,1,93
14,19,14121,3254,3,27,102,21,8,2,160,1,3,164
14,19,14121,3255,3,89,94,40,2,1,226,0,2,228
14,19,14121,3256,3,416,248,141,47,19,871,1,45,917
14,19,14121,3257,3,46,146,42,1,5,240,0,10,250
14,19,14121,3258,3,131,74,21,7,1,234,1,6,241
14,19,14122,3259,3,232,403,144,6,0,785,2,18,805
14,19,14122,3260,3,194,308,134,7,3,646,0,10,656
14,19,14122,3261,3,51,157,89,1,3,301,1,8,310
14,19,14122,3262,3,92,235,62,1,1,391,0,13,404
14,19,14122,3263,3,141,181,48,0,0,370,2,16,388
14,19,14122,3264,3,42,48,3,0,0,93,0,4,97
15,1,15001,1,3,296,363,113,45,26,843,7,27,877
15,1,15001,2,3,217,374,116,76,6,789,1,34,824
15,1,15001,3,3,374,339,183,83,16,995,2,26,1023
15,1,15001,4,3,214,511,154,10,4,893,8,38,939
15,1,15001,5,3,100,310,96,4,4,514,0,33,547
15,1,15001,6,3,180,167,74,7,2,430,0,21,451
15,1,15001,7,3,126,144,48,4,0,322,1,20,343
15,1,15001,8,3,142,123,61,4,3,333,2,10,345
15,1,15001,9,3,161,147,55,12,1,376,1,20,397
15,1,15001,10,3,163,186,105,4,1,459,3,14,476
15,1,15001,11,3,129,220,49,3,2,403,1,14,418
15,1,15001,12,3,94,220,165,7,4,490,1,14,505
15,1,15001,13,3,137,329,90,8,6,570,3,39,612
15,1,15001,14,3,180,501,171,23,12,887,1,28,916
15,1,15001,15,3,150,249,123,9,9,540,0,36,576
15,1,15001,16,3,181,248,157,16,2,604,5,27,636
15,1,15001,17,3,151,293,82,14,10,550,1,39,590
15,1,15001,18,3,80,171,35,11,7,304,0,21,325
15,1,15001,19,3,125,284,168,71,4,652,1,26,679
15,1,15001,20,3,111,241,219,190,7,768,0,77,845
15,1,15001,21,3,97,231,213,25,9,575,1,44,620
15,1,15001,22,3,113,281,268,30,9,701,6,22,729
15,1,15001,23,3,77,250,46,11,3,387,5,5,397
15,1,15001,24,3,213,299,112,14,6,644,1,24,669
15,1,15001,25,3,112,184,39,14,9,358,5,10,373
15,1,15001,26,3,248,354,100,14,13,729,0,30,759
15,1,15001,27,3,126,323,137,110,12,708,4,39,751
15,1,15001,28,3,166,332,150,133,9,790,2,61,853
15,1,15001,29,3,163,145,135,9,6,458,3,17,478
15,1,15001,30,3,109,304,129,59,7,608,3,33,644
15,1,15001,31,3,140,275,233,78,4,730,3,25,758
15,1,15001,32,3,102,388,76,8,0,574,4,10,588
15,1,15003,59,3,361,290,153,43,12,859,0,16,875
15,1,15003,60,3,124,179,280,18,10,611,2,23,636
15,1,15003,61,3,81,280,138,13,7,519,0,14,533
15,1,15003,62,3,174,163,169,12,9,527,2,46,575
15,1,15003,63,3,190,279,142,21,6,638,20,38,696
15,1,15003,64,3,75,125,123,16,8,347,0,13,360
15,1,15003,65,3,129,153,117,18,5,422,0,18,440
15,1,15003,66,3,164,171,160,30,11,536,2,20,558
15,1,15003,67,3,302,294,180,32,16,824,5,33,862
15,1,15003,68,3,264,171,137,50,6,628,1,21,650
15,1,15003,69,3,353,268,242,40,13,916,4,21,941
15,1,15003,70,3,397,328,317,62,22,1126,1,23,1150
15,1,15003,71,3,92,84,123,5,4,308,0,5,313
15,1,15003,72,3,737,315,362,72,24,1510,7,33,1550
15,1,15003,73,3,251,209,109,26,6,601,3,15,619
15,1,15003,74,3,182,238,95,15,7,537,1,20,558
15,1,15003,75,3,150,240,404,15,13,822,1,28,851
15,1,15003,76,3,137,134,263,41,13,588,6,29,623
15,1,15003,77,3,163,326,161,20,9,679,1,31,711
15,1,15003,78,3,73,136,38,6,2,255,1,6,262
15,1,15003,79,3,13,45,14,1,2,75,1,7,83
15,1,15003,80,3,132,209,107,8,7,463,11,18,492
15,1,15003,81,3,51,207,56,18,5,337,0,26,363
15,1,15027,1081,3,432,459,133,14,7,1045,3,34,1082
15,1,15027,1082,3,348,121,122,18,6,615,1,7,623
15,1,15027,1083,3,232,269,131,24,8,664,4,42,710
15,1,15027,1084,3,193,287,136,21,5,642,4,19,665
15,1,15027,1085,3,804,423,211,47,17,1502,4,58,1564
15,1,15027,1086,3,447,232,73,20,6,778,3,34,815
15,1,15027,1087,3,266,192,104,19,9,590,0,27,617
15,1,15027,1088,3,134,258,106,20,2,520,1,21,542
15,1,15027,1089,3,159,201,80,19,3,462,1,22,485
15,1,15027,1090,3,211,372,98,13,3,697,3,30,730
15,1,15027,1091,3,89,152,104,12,8,365,10,23,398
15,1,15027,1092,3,211,234,80,10,3,538,0,12,550
15,1,15027,1093,3,188,191,12,2,1,394,0,6,400
15,1,15027,1094,3,58,59,18,3,1,139,1,6,146
15,1,15046,2260,3,279,510,326,91,35,1241,13,33,1287
15,1,15046,2261,3,170,361,169,62,23,785,0,18,803
15,1,15046,2262,3,126,263,214,74,19,696,4,14,714
15,1,15046,2263,3,247,414,203,46,28,938,0,24,962
15,1,15046,2264,3,136,340,257,72,21,826,2,15,843
15,1,15046,2265,3,134,313,219,50,14,730,0,14,744
15,1,15046,2266,3,21,32,35,4,0,92,0,2,94
15,1,15046,2267,3,408,340,142,29,8,927,3,33,963
15,1,15046,2268,3,177,77,105,22,7,388,0,7,395
15,1,15046,2269,3,268,216,218,24,7,733,11,21,765
15,1,15046,2270,3,6,62,14,2,0,84,0,1,85
15,1,15046,2271,3,96,245,151,12,3,507,4,10,521
15,1,15046,2272,3,125,199,161,20,12,517,1,12,530
15,1,15046,2273,3,174,222,218,32,11,657,5,17,679
15,1,15046,2274,3,89,177,169,15,4,454,0,2,456
15,1,15046,2275,3,174,394,286,47,6,907,0,26,933
15,1,15046,2276,3,155,100,71,21,5,352,0,9,361
15,1,15046,2277,3,336,398,376,39,9,1158,2,27,1187
15,1,15046,2278,3,15,85,76,7,0,183,0,8,191
15,1,15046,2279,3,13,94,99,2,1,209,0,2,211
15,1,15046,2280,3,131,301,290,17,6,745,7,12,764
15,1,15046,2281,3,82,359,250,15,7,713,4,28,745
15,1,15046,2282,3,212,200,369,26,17,824,0,15,839
15,1,15046,2283,3,199,354,260,29,14,856,1,18,875
15,1,15046,2284,3,92,127,193,22,7,441,0,15,456
15,1,15046,2285,3,210,207,141,15,5,578,2,12,592
15,1,15046,2286,3,209,180,277,14,6,686,2,33,721
15,1,15046,2287,3,514,792,810,90,22,2228,8,44,2280
15,1,15046,2288,3,183,325,279,38,19,844,0,14,858
15,1,15046,2289,3,305,340,440,34,19,1138,0,25,1163
15,1,15046,2290,3,99,215,195,15,10,534,1,5,540
15,1,15046,2291,3,304,497,510,60,26,1397,3,27,1427
15,1,15046,2292,3,130,225,322,25,12,714,7,18,739
15,1,15046,2293,3,157,280,266,25,5,733,1,24,758
15,1,15046,2294,3,57,136,101,6,1,301,0,11,312
15,1,15046,2295,3,205,292,282,44,23,846,1,21,868
15,1,15046,2296,3,259,402,451,25,11,1148,6,16,1170
15,1,15046,2297,3,154,256,287,19,9,725,6,19,750
15,1,15046,2298,3,377,207,291,19,13,907,6,40,953
15,1,15046,2299,3,193,146,65,11,2,417,1,4,422
15,1,15046,2300,3,29,119,84,5,0,237,0,7,244
15,1,15046,2301,3,169,189,167,29,13,567,0,12,579
15,1,15046,2302,3,23,171,43,6,0,243,0,6,249
15,1,15046,2303,3,46,112,88,4,4,254,0,7,261
15,1,15048,2314,3,154,420,447,51,29,1101,1,16,1118
15,1,15048,2315,3,74,238,277,31,12,632,0,17,649
15,1,15048,2316,3,62,404,310,24,4,804,3,35,842
15,1,15048,2317,3,26,218,126,5,4,379,0,16,395
15,1,15048,2318,3,105,336,427,57,14,939,10,49,998
15,1,15048,2319,3,156,462,364,59,12,1053,11,37,1101
15,1,15048,2320,3,89,228,207,31,13,568,0,35,603
15,1,15048,2321,3,75,146,188,24,5,438,2,28,468
15,1,15048,2322,3,67,274,195,27,7,570,0,36,606
15,1,15048,2323,3,86,239,327,22,12,686,3,33,722
15,1,15048,2324,3,28,105,158,12,1,304,0,10,314
15,1,15048,2325,3,52,428,219,45,10,754,6,28,788
15,1,15048,2326,3,82,240,144,44,9,519,0,26,545
15,1,15048,2327,3,87,275,239,58,17,676,1,9,686
15,1,15048,2328,3,223,367,488,61,24,1163,3,51,1217
15,1,15048,2329,3,244,363,542,63,39,1251,4,46,1301
15,1,15048,2330,3,151,336,427,56,21,991,16,38,1045
15,1,15048,2331,3,128,298,360,34,8,828,5,23,856
15,1,15048,2332,3,190,348,397,35,21,991,6,37,1034
15,1,15048,2333,3,126,230,278,34,20,688,5,20,713
15,1,15048,2334,3,61,214,356,22,11,664,1,17,682
15,1,15048,2335,3,51,198,121,15,4,389,3,6,398
15,1,15048,2336,3,72,202,245,17,9,545,10,8,563
15,1,15048,2337,3,83,343,497,22,8,953,2,56,1011
15,1,15048,2338,3,70,256,307,26,13,672,1,37,710
15,1,15048,2339,3,81,217,317,30,9,654,1,26,681
15,1,15048,2340,3,22,148,169,35,10,384,1,16,401
15,1,15048,2341,3,99,230,377,17,6,729,9,27,765
15,1,15048,2342,3,21,90,48,10,0,169,0,5,174
15,1,15048,2343,3,92,227,296,28,21,664,7,16,687
15,1,15057,2554,3,115,148,121,24,12,420,1,14,435
15,1,15057,2555,3,169,176,151,22,10,528,8,30,566
15,1,15057,2556,3,37,181,135,14,2,369,0,25,394
15,1,15057,2557,3,93,166,151,61,4,475,2,23,500
15,1,15057,2558,3,51,174,132,27,7,391,3,45,439
15,1,15057,2559,3,14,119,85,29,3,250,0,38,288
15,1,15057,2560,3,218,223,232,40,9,722,8,24,754
15,1,15057,2561,3,227,226,161,34,11,659,5,23,687
15,1,15057,2562,3,86,124,70,14,3,297,0,21,318
15,1,15057,2563,3,43,65,49,13,1,171,1,8,180
15,1,15057,2564,3,127,442,197,21,8,795,2,23,820
15,1,15057,2565,3,109,341,128,14,5,597,1,11,609
15,1,15057,2566,3,113,150,81,12,4,360,3,16,379
15,1,15057,2567,3,80,103,90,14,3,290,5,22,317
15,1,15057,2568,3,184,246,222,48,4,704,5,32,741
15,1,15057,2569,3,48,92,87,22,4,253,3,3,259
15,1,15057,2570,3,61,253,135,14,6,469,6,44,519
15,1,15057,2571,3,140,384,193,18,11,746,2,65,813
15,1,15072,4008,3,346,446,178,32,25,1027,0,18,1045
15,1,15072,4009,3,383,588,210,41,20,1242,2,17,1261
15,1,15072,4010,3,129,204,108,28,7,476,7,8,491
15,1,15072,4011,3,162,442,115,28,16,763,1,11,775
15,1,15072,4012,3,76,207,64,16,1,364,0,16,380
15,1,15072,4013,3,143,273,90,22,12,540,0,11,551
15,1,15072,4014,3,177,194,78,15,6,470,0,17,487
15,1,15072,4015,3,152,129,50,16,6,353,2,1,356
15,1,15072,4016,3,104,173,77,10,4,368,0,6,374
15,1,15072,4017,3,67,106,30,18,6,227,3,6,236
15,1,15080,4158,3,967,605,205,67,20,1864,5,30,1899
15,1,15080,4159,3,197,155,69,15,3,439,1,9,449
15,1,15080,4160,3,195,164,42,16,4,421,1,4,426
15,1,15080,4161,3,310,233,135,45,7,730,0,12,742
15,1,15080,4162,3,340,373,93,16,4,826,0,24,850
15,1,15080,4163,3,185,84,29,4,3,305,2,8,315
15,1,15080,4164,3,85,45,34,11,3,178,2,0,180
15,1,15103,4725,3,226,258,153,12,10,659,0,14,673
15,1,15103,4726,3,227,157,132,8,4,528,2,25,555
15,1,15103,4727,3,331,302,85,22,4,744,3,20,767
15,1,15103,4728,3,218,210,78,8,6,520,1,17,538
15,1,15103,4729,3,237,298,99,9,4,647,0,18,665
15,1,15103,4730,3,245,195,88,6,6,540,0,17,557
15,1,15103,4731,3,474,279,180,23,12,968,0,33,1001
15,1,15103,4732,3,73,212,68,18,4,375,0,6,381
15,1,15103,4733,3,179,337,199,88,8,811,1,26,838
15,1,15103,4734,3,46,104,26,3,0,179,0,1,180
15,1,15103,4735,3,17,60,19,2,1,99,0,1,100
15,2,15010,219,3,449,163,255,68,32,967,4,10,981
15,2,15010,220,3,617,200,379,61,32,1289,1,26,1316
15,2,15010,221,3,574,163,336,71,36,1180,6,14,1200
15,2,15010,222,3,535,224,395,67,36,1257,2,19,1278
15,2,15010,223,3,342,81,220,39,26,708,5,9,722
15,2,15010,224,3,525,125,354,60,25,1089,1,20,1110
15,2,15010,225,3,184,46,90,12,4,336,3,6,345
15,2,15010,226,3,109,102,143,33,13,400,4,9,413
15,2,15010,227,3,210,50,86,12,7,365,7,7,379
15,2,15010,228,3,38,30,27,4,2,101,0,2,103
15,2,15010,229,3,27,11,41,6,1,86,0,2,88
15,2,15010,230,3,213,66,77,12,5,373,0,4,377
15,2,15010,231,3,235,192,226,33,12,698,3,19,720
15,2,15010,232,3,210,156,202,61,19,648,2,9,659
15,2,15023,654,3,373,432,805,132,54,1796,15,32,1843
15,2,15023,655,3,252,387,595,124,65,1423,13,37,1473
15,2,15023,656,3,304,462,628,155,55,1604,20,32,1656
15,2,15023,657,3,233,396,340,72,32,1073,6,16,1095
15,2,15023,658,3,322,493,542,153,70,1580,9,57,1646
15,2,15023,659,3,251,228,415,88,37,1019,9,33,1061
15,2,15023,660,3,249,293,504,67,46,1159,5,27,1191
15,2,15023,661,3,247,328,352,106,41,1074,5,20,1099
15,2,15023,662,3,330,322,434,92,44,1222,20,49,1291
15,2,15023,663,3,310,339,516,109,48,1322,15,36,1373
15,2,15023,664,3,444,446,682,130,82,1784,11,46,1841
15,2,15036,1956,3,266,284,241,42,22,855,1,15,871
15,2,15036,1957,3,232,239,180,38,18,707,8,7,722
15,2,15036,1958,3,197,199,129,25,11,561,5,7,573
15,2,15036,1959,3,756,1733,631,112,78,3310,10,70,3390
15,2,15036,1960,3,413,371,260,40,36,1120,11,15,1146
15,2,15036,1961,3,159,171,214,27,14,585,0,7,592
15,2,15036,1962,3,766,558,685,103,56,2168,6,39,2213
15,2,15036,1963,3,552,497,647,94,73,1863,12,27,1902
15,2,15036,1964,3,154,193,156,26,11,540,1,11,552
15,2,15036,1965,3,87,94,80,10,2,273,0,6,279
15,2,15036,1966,3,41,66,57,5,2,171,2,9,182
15,2,15036,1967,3,327,296,316,49,23,1011,0,21,1032
15,2,15036,1968,3,413,401,346,65,24,1249,4,23,1276
15,2,15036,1969,3,336,356,273,67,22,1054,6,14,1074
15,2,15036,1970,3,362,331,253,60,15,1021,2,9,1032
15,2,15036,1971,3,260,254,211,74,31,830,0,16,846
15,2,15036,1972,3,210,134,184,57,23,608,3,11,622
15,2,15036,1973,3,274,194,238,67,32,805,0,5,810
15,2,15036,1974,3,183,192,224,71,37,707,3,8,718
15,2,15036,1975,3,202,154,218,55,23,652,3,7,662
15,2,15092,4498,3,370,293,551,211,35,1460,5,26,1491
15,2,15092,4499,3,433,404,699,142,35,1713,3,40,1756
15,2,15092,4500,3,316,210,320,143,23,1012,0,27,1039
15,2,15092,4501,3,305,352,565,136,54,1412,14,35,1461
15,2,15092,4502,3,226,132,473,109,28,968,8,9,985
15,2,15092,4503,3,292,110,253,127,20,802,0,14,816
15,2,15092,4504,3,260,238,462,84,26,1070,1,25,1096
15,2,15092,4505,3,295,261,536,132,33,1257,6,28,1291
15,2,15092,4506,3,449,271,566,207,62,1555,4,28,1587
15,2,15092,4507,3,387,204,267,107,25,990,1,19,1010
15,2,15092,4508,3,260,266,334,125,24,1009,3,23,1035
15,2,15092,4509,3,340,259,493,130,33,1255,3,24,1282
15,2,15092,4510,3,367,380,594,145,34,1520,11,29,1560
15,2,15092,4511,3,396,171,480,122,29,1198,9,22,1229
15,2,15092,4512,3,298,242,554,180,40,1314,9,18,1341
15,2,15092,4513,3,221,144,452,168,27,1012,4,18,1034
15,2,15092,4514,3,131,133,252,115,10,641,7,17,665
15,2,15092,4515,3,403,248,458,52,26,1187,1,38,1226
15,2,15092,4516,3,231,143,303,48,19,744,6,21,771
15,2,15092,4517,3,260,241,406,66,25,998,4,28,1030
15,2,15092,4518,3,144,125,247,45,11,572,7,13,592
15,2,15092,4519,3,512,341,697,219,54,1823,5,19,1847
15,2,15092,4520,3,29,34,57,25,4,149,0,5,154
15,2,15092,4521,3,329,188,237,71,24,849,6,18,873
15,2,15092,4522,3,333,260,401,173,42,1209,11,26,1246
15,2,15096,4564,3,317,383,334,66,41,1141,5,24,1170
15,2,15096,4565,3,382,455,360,74,40,1311,3,42,1356
15,2,15096,4566,3,447,443,398,95,69,1452,4,34,1490
15,2,15096,4567,3,401,356,393,56,31,1237,6,16,1259
15,2,15096,4568,3,765,378,628,151,116,2038,6,27,2071
15,2,15096,4569,3,202,162,224,52,36,676,0,10,686
15,2,15096,4570,3,402,309,312,60,40,1123,0,16,1139
15,2,15096,4571,3,435,436,441,110,48,1470,6,30,1506
15,2,15096,4572,3,476,470,366,81,38,1431,4,21,1456
15,2,15096,4573,3,342,386,237,67,27,1059,6,10,1075
15,2,15096,4574,3,233,161,243,43,34,714,5,5,724
15,2,15096,4575,3,396,352,332,71,38,1189,0,23,1212
15,2,15096,4576,3,319,373,296,56,46,1090,4,16,1110
15,2,15096,4577,3,246,408,299,54,32,1039,4,18,1061
15,2,15096,4578,3,60,133,32,6,5,236,1,6,243
15,2,15096,4579,3,156,132,134,28,10,460,5,7,472
15,2,15096,4580,3,364,426,395,119,48,1352,8,21,1381
15,2,15096,4581,3,168,194,188,33,7,590,5,13,608
15,2,15096,4582,3,576,656,761,137,58,2188,18,35,2241
15,2,15096,4583,3,220,275,246,36,29,806,6,8,820
15,2,15096,4584,3,365,367,268,89,27,1116,1,12,1129
15,2,15096,4585,3,291,251,250,76,36,904,9,12,925
15,2,15096,4586,3,439,444,439,101,40,1463,8,34,1505
15,2,15096,4587,3,318,374,313,74,25,1104,2,25,1131
15,2,15097,4588,3,437,293,491,65,39,1325,3,14,1342
15,2,15097,4589,3,557,321,497,76,42,1493,9,21,1523
15,2,15097,4590,3,347,344,380,55,29,1155,9,9,1173
15,2,15097,4591,3,281,196,399,61,28,965,2,18,985
15,2,15097,4592,3,428,396,443,76,32,1375,4,24,1403
15,2,15097,4593,3,505,378,431,75,27,1416,3,15,1434
15,2,15097,4594,3,392,145,202,20,15,774,3,11,788
15,2,15097,4595,3,385,155,173,28,18,759,1,16,776
15,2,15097,4596,3,248,134,151,25,13,571,1,24,596
15,2,15097,4597,3,144,54,53,13,4,268,0,4,272
15,2,15097,4598,3,14,28,11,1,1,55,0,0,55
15,2,15097,4599,3,362,243,287,38,20,950,3,21,974
15,2,15097,4600,3,84,104,123,13,9,333,2,1,336
15,2,15113,5704,3,477,415,197,62,19,1170,5,27,1202
15,2,15113,5705,3,530,373,170,30,24,1127,4,31,1162
15,2,15113,5706,3,394,444,137,48,12,1035,0,34,1069
15,2,15113,5707,3,518,501,273,30,23,1345,14,38,1397
15,2,15113,5708,3,249,120,65,9,4,447,0,18,465
15,2,15113,5709,3,89,178,83,15,1,366,0,26,392
15,2,15113,5710,3,166,195,172,15,6,554,3,22,579
15,2,15113,5711,3,185,118,36,5,4,348,1,13,362
15,2,15113,5712,3,254,287,79,9,13,642,2,14,658
15,2,15113,5713,3,176,406,190,28,8,808,5,23,836
15,2,15113,5714,3,109,309,110,9,12,549,1,3,553
15,2,15113,5715,3,25,106,63,4,1,199,0,13,212
15,2,15113,5716,3,209,473,126,13,5,826,4,24,854
15,2,15113,5717,3,227,155,82,9,4,477,8,10,495
15,2,15113,5718,3,231,387,99,30,14,761,14,4,779
15,2,15113,5719,3,189,441,56,10,2,698,0,34,732
15,2,15113,5720,3,156,454,79,19,9,717,4,29,750
15,2,15113,5721,3,398,532,223,21,10,1184,2,38,1224
15,2,15113,5722,3,94,134,38,6,1,273,2,8,283
15,3,15014,417,3,757,1072,514,327,59,2729,4,36,2769
15,3,15014,418,3,598,704,316,90,45,1753,3,45,1801
15,3,15014,419,3,211,381,174,96,13,875,5,16,896
15,3,15014,420,3,255,469,161,65,19,969,2,18,989
15,3,15014,421,3,217,435,113,31,8,804,2,16,822
15,3,15014,422,3,470,873,350,97,36,1826,3,38,1867
15,3,15014,423,3,360,607,222,106,37,1332,10,17,1359
15,3,15014,424,3,246,393,142,134,14,929,1,16,946
15,3,15014,425,3,162,250,74,29,5,520,8,8,536
15,3,15014,426,3,187,261,159,37,14,658,2,14,674
15,3,15014,427,3,78,181,116,12,11,398,4,19,421
15,3,15014,428,3,44,220,138,7,5,414,0,7,421
15,3,15014,429,3,180,309,88,23,12,612,1,20,633
15,3,15014,430,3,196,494,99,27,10,826,9,20,855
15,3,15014,431,3,440,714,308,61,18,1541,16,56,1613
15,3,15014,432,3,44,232,98,17,9,400,0,19,419
15,3,15014,433,3,168,463,218,40,19,908,4,17,929
15,3,15014,434,3,210,309,167,34,17,737,7,20,764
15,3,15014,435,3,224,489,168,36,18,935,10,37,982
15,3,15014,436,3,160,293,331,36,16,836,8,47,891
15,3,15014,437,3,287,346,163,53,21,870,2,21,893
15,3,15014,438,3,146,181,109,53,21,510,1,1,512
15,3,15014,439,3,76,108,43,14,5,246,2,3,251
15,3,15014,440,3,217,439,208,65,14,943,11,11,965
15,3,15014,441,3,98,238,134,28,9,507,2,19,528
15,3,15014,442,3,126,315,257,48,10,756,3,20,779
15,3,15014,443,3,115,325,333,35,14,822,1,56,879
15,3,15014,444,3,62,192,85,9,6,354,10,15,379
15,3,15014,445,3,192,479,332,102,21,1126,8,52,1186
15,3,15014,446,3,208,309,142,24,4,687,0,34,721
15,3,15014,447,3,46,409,156,15,8,634,2,19,655
15,3,15014,448,3,32,320,111,10,2,475,4,17,496
15,3,15014,449,3,43,89,35,7,1,175,8,8,191
15,3,15014,450,3,164,280,96,24,8,572,1,25,598
15,3,15014,451,3,25,102,28,4,0,159,0,6,165
15,3,15014,452,3,34,130,64,41,3,272,0,4,276
15,3,15014,453,3,63,183,78,14,2,340,3,38,381
15,3,15014,454,3,67,156,36,9,2,270,4,8,282
15,3,15014,455,3,57,84,37,4,2,184,1,7,192
15,3,15049,2344,3,223,510,123,39,21,916,2,21,939
15,3,15049,2345,3,131,229,55,14,3,432,4,10,446
15,3,15049,2346,3,139,431,102,26,8,706,5,11,722
15,3,15049,2347,3,199,334,110,25,7,675,0,30,705
15,3,15049,2348,3,273,520,197,73,16,1079,6,22,1107
15,3,15049,2349,3,144,281,171,17,7,620,4,15,639
15,3,15049,2350,3,124,675,172,18,9,998,3,44,1045
15,3,15049,2351,3,163,348,110,22,3,646,2,14,662
15,3,15049,2352,3,223,643,215,28,5,1114,2,20,1136
15,3,15049,2353,3,235,388,263,50,9,945,3,19,967
15,3,15049,2354,3,214,381,158,30,14,797,1,3,801
15,3,15049,2355,3,194,325,265,36,11,831,2,27,860
15,3,15049,2356,3,125,452,143,83,17,820,4,28,852
15,3,15049,2357,3,140,473,94,42,23,772,3,32,807
15,3,15049,2358,3,285,412,166,46,14,923,3,37,963
15,3,15049,2359,3,159,515,230,31,10,945,1,40,986
15,3,15049,2360,3,91,163,142,15,3,414,2,11,427
15,3,15049,2361,3,121,311,168,40,8,648,6,26,680
15,3,15049,2362,3,160,378,91,27,3,659,2,22,683
15,3,15049,2363,3,76,188,22,10,4,300,2,6,308
15,3,15049,2364,3,179,352,144,28,8,711,3,13,727
15,3,15049,2365,3,107,142,125,18,8,400,8,7,415
15,3,15049,2366,3,218,432,158,19,8,835,1,21,857
15,3,15049,2367,3,323,667,213,44,13,1260,5,25,1290
15,3,15049,2368,3,150,492,156,31,16,845,2,41,888
15,3,15049,2369,3,271,411,188,45,12,927,5,23,955
15,3,15049,2370,3,190,358,104,45,11,708,1,22,731
15,3,15049,2371,3,167,581,98,28,8,882,5,25,912
15,3,15049,2372,3,127,358,111,13,1,610,7,7,624
15,3,15065,3863,3,115,127,108,21,7,378,0,15,393
15,3,15065,3864,3,295,298,292,47,22,954,2,20,976
15,3,15065,3865,3,201,288,264,43,13,809,5,24,838
15,3,15065,3866,3,315,281,207,34,14,851,6,39,896
15,3,15065,3867,3,320,354,408,38,16,1136,2,36,1174
15,3,15065,3868,3,269,405,231,28,12,945,2,25,972
15,3,15065,3869,3,389,474,231,28,17,1139,5,33,1177
15,3,15065,3870,3,309,371,206,57,14,957,1,37,995
15,3,15065,3871,3,120,131,76,4,5,336,1,32,369
15,3,15065,3872,3,95,95,48,10,0,248,3,15,266
15,3,15065,3873,3,266,178,263,34,8,749,4,18,771
15,3,15065,3874,3,222,267,345,36,11,881,5,66,952
15,3,15065,3875,3,179,300,185,35,11,710,3,7,720
15,3,15065,3876,3,130,179,122,17,4,452,19,24,495
15,3,15065,3877,3,262,143,187,68,4,664,3,28,695
15,3,15065,3878,3,48,30,20,5,1,104,1,5,110
15,3,15065,3879,3,51,43,22,10,1,127,2,5,134
15,3,15124,4027,3,114,170,71,7,3,365,3,20,388
15,3,15124,4028,3,80,240,167,13,2,502,2,40,544
15,3,15124,4029,3,242,174,108,45,0,569,0,59,628
15,3,15124,4030,3,50,143,109,6,0,308,0,15,323
15,3,15124,4031,3,316,413,108,17,10,864,6,42,912
15,3,15124,4033,3,121,153,50,8,3,335,0,25,360
15,3,15124,4044,3,216,200,129,17,2,564,3,27,594
15,3,15124,4045,3,241,322,110,11,10,694,3,38,735
15,3,15124,4046,3,414,432,122,34,13,1015,7,44,1066
15,3,15124,4047,3,278,280,60,9,5,632,3,43,678
15,3,15124,4048,3,226,235,143,17,4,625,1,39,665
15,3,15124,4049,3,323,281,76,25,3,708,2,57,767
15,3,15124,4050,3,108,212,61,5,7,393,7,21,421
15,3,15124,4062,3,199,203,78,8,6,494,0,40,534
15,3,15124,4063,3,190,260,165,5,2,622,0,56,678
15,3,15124,4064,3,220,181,94,3,2,500,0,36,536
15,3,15124,4065,3,217,421,168,16,7,829,2,28,859
15,3,15124,4066,3,225,221,216,11,6,679,7,48,734
15,3,15124,4067,3,139,232,109,4,1,485,4,54,543
15,3,15124,4080,3,420,266,250,8,12,956,3,104,1063
15,3,15124,4081,3,136,158,149,8,4,455,1,32,488
15,3,15124,4082,3,260,168,161,8,5,602,0,35,637
15,3,15124,4083,3,142,73,62,14,2,293,2,15,310
15,3,15124,4084,3,116,196,100,9,0,421,0,56,477
15,3,15124,4085,3,236,253,151,11,7,658,4,55,717
15,3,15124,4091,3,399,339,163,37,4,942,5,57,1004
15,3,15124,4092,3,219,242,60,10,4,535,1,13,549
15,3,15124,4093,3,117,205,51,8,4,385,1,9,395
15,3,15124,4094,3,278,249,75,20,4,626,2,24,652
15,3,15124,4095,3,234,206,109,4,3,556,1,15,572
15,3,15124,4096,3,211,217,179,11,5,623,3,20,646
15,3,15124,4098,3,143,177,87,5,1,413,0,12,425
15,3,15124,4099,3,45,79,28,0,3,155,0,8,163
15,3,15124,4101,3,68,93,23,4,2,190,1,5,196
15,3,15124,4102,3,226,208,61,19,3,517,2,29,548
15,3,15124,4104,3,111,165,145,5,1,427,1,21,449
15,3,15124,4105,3,57,44,43,0,3,147,0,20,167
15,3,15086,4346,3,137,140,318,31,6,632,1,30,663
15,3,15086,4347,3,165,247,145,68,7,632,1,21,654
15,3,15086,4348,3,153,236,289,54,8,740,7,13,760
15,3,15086,4349,3,248,280,229,104,12,873,4,9,886
15,3,15086,4350,3,148,151,163,95,6,563,5,12,580
15,3,15086,4351,3,208,279,423,73,11,994,7,29,1030
15,3,15086,4352,3,77,200,257,32,7,573,2,15,590
15,3,15086,4353,3,125,132,323,15,6,601,0,25,626
15,3,15086,4354,3,192,90,317,15,4,618,22,16,656
15,3,15086,4355,3,55,118,167,49,6,395,0,13,408
15,3,15086,4356,3,183,288,512,59,13,1055,4,33,1092
15,3,15086,4357,3,117,146,218,23,5,509,8,12,529
15,3,15086,4358,3,136,252,298,23,8,717,1,26,744
15,3,15086,4359,3,143,300,394,23,10,870,2,45,917
15,3,15086,4360,3,76,196,338,65,1,676,3,29,708
15,3,15086,4361,3,94,211,236,36,4,581,1,14,596
15,3,15086,4362,3,90,230,258,28,9,615,3,39,657
15,3,15086,4363,3,87,373,307,74,18,859,1,39,899
15,3,15086,4364,3,27,178,212,7,4,428,2,28,458
15,3,15086,4365,3,8,119,163,9,0,299,1,9,309
15,3,15086,4366,3,23,85,148,2,2,260,1,23,284
15,3,15086,4367,3,147,254,280,19,4,704,3,32,739
15,3,15086,4368,3,23,76,135,6,8,248,3,14,265
15,3,15086,4369,3,64,297,285,25,6,677,3,22,702
15,3,15086,4370,3,14,98,119,9,2,242,3,20,265
15,3,15086,4371,3,32,217,227,102,21,599,1,24,624
15,3,15086,4372,3,46,193,257,141,20,657,7,21,685
15,3,15086,4373,3,224,203,380,26,9,842,4,14,860
15,3,15086,4374,3,15,160,106,8,1,290,0,34,324
15,3,15086,4375,3,43,276,282,33,11,645,5,46,696
15,3,15086,4376,3,87,612,467,29,8,1203,0,78,1281
15,3,15086,4377,3,17,164,140,5,5,331,2,10,343
15,3,15086,4378,3,102,225,300,10,4,641,0,23,664
15,3,15086,4379,3,49,100,124,3,1,277,1,4,282
15,3,15124,5932,3,161,209,68,6,4,448,2,21,471
15,3,15124,5933,3,60,81,37,6,2,186,4,17,207
15,3,15124,5934,3,15,50,17,0,0,82,0,7,89
15,3,15124,5935,3,50,49,23,0,1,123,1,26,150
15,3,15124,5936,3,28,41,18,1,0,88,0,9,97
15,3,15124,5937,3,12,96,80,4,0,192,1,11,204
15,4,15025,745,3,209,194,213,59,30,705,0,9,714
15,4,15025,746,3,378,222,307,77,38,1022,2,16,1040
15,4,15025,747,3,312,217,295,85,52,961,3,24,988
15,4,15025,748,3,192,104,181,55,20,552,1,8,561
15,4,15025,755,3,334,204,248,73,40,899,1,10,910
15,4,15025,756,3,287,126,265,55,29,762,2,5,769
15,4,15025,757,3,271,107,180,49,34,641,3,12,656
15,4,15025,758,3,328,348,446,134,49,1305,10,12,1327
15,4,15025,759,3,675,410,1118,223,114,2540,11,33,2584
15,4,15025,760,3,289,233,440,93,45,1100,6,21,1127
15,4,15025,761,3,361,241,491,109,47,1249,3,25,1277
15,4,15025,762,3,358,175,291,111,50,985,0,4,989
15,4,15025,763,3,230,105,169,49,25,578,1,4,583
15,4,15025,771,3,168,124,171,45,27,535,3,8,546
15,4,15025,772,3,110,87,121,31,13,362,0,6,368
15,4,15025,773,3,204,68,123,62,30,487,0,4,491
15,4,15025,774,3,214,70,140,55,22,501,5,9,515
15,4,15025,775,3,135,72,131,31,9,378,1,13,392
15,4,15025,776,3,166,82,159,31,19,457,1,0,458
15,4,15025,777,3,146,68,125,45,24,408,2,0,410
15,4,15025,778,3,183,47,94,36,20,380,3,4,387
15,4,15025,789,3,364,246,446,75,30,1161,4,20,1185
15,4,15025,790,3,280,178,255,40,27,780,7,11,798
15,4,15025,802,3,594,362,597,103,76,1732,2,42,1776
15,4,15025,825,3,508,332,528,96,43,1507,3,31,1541
15,4,15025,826,3,845,448,811,201,98,2403,7,33,2443
15,4,15025,827,3,480,164,244,55,39,982,0,16,998
15,4,15025,876,3,365,115,206,53,22,761,1,8,770
15,4,15025,877,3,560,93,184,35,35,907,3,7,917
15,4,15025,878,3,587,117,201,64,38,1007,2,12,1021
15,4,15025,879,3,777,135,222,59,60,1253,1,2,1256
15,4,15025,880,3,497,121,192,32,35,877,4,8,889
15,4,15025,881,3,567,307,683,125,64,1746,2,42,1790
15,4,15025,906,3,315,364,561,110,47,1397,11,19,1427
15,4,15025,907,3,336,415,689,129,59,1628,5,28,1661
15,4,15025,908,3,228,224,347,74,25,898,4,20,922
15,4,15025,909,3,379,303,412,70,44,1208,3,33,1244
15,4,15025,910,3,544,512,628,160,70,1914,8,40,1962
15,4,15061,3723,3,439,497,376,146,56,1514,8,29,1551
15,4,15061,3724,3,421,289,321,138,41,1210,15,24,1249
15,4,15061,3725,3,325,354,305,128,41,1153,10,23,1186
15,4,15061,3726,3,564,422,486,175,58,1705,4,33,1742
15,4,15061,3727,3,499,425,511,112,52,1599,0,42,1641
15,4,15061,3728,3,541,971,980,206,68,2766,19,86,2871
15,4,15061,3729,3,145,132,179,44,17,517,0,11,528
15,4,15061,3730,3,353,396,468,107,42,1366,6,30,1402
15,4,15061,3731,3,584,510,532,174,68,1868,9,47,1924
15,4,15061,3732,3,255,228,212,82,24,801,6,11,818
15,4,15061,3733,3,337,284,327,67,33,1048,4,23,1075
15,4,15061,3734,3,494,480,458,129,45,1606,13,20,1639
15,4,15061,3735,3,435,309,325,105,42,1216,6,25,1247
15,4,15061,3736,3,369,345,329,83,31,1157,11,28,1196
15,4,15061,3737,3,225,166,160,46,18,615,2,4,621
15,4,15061,3738,3,344,342,365,124,49,1224,2,24,1250
15,4,15061,3739,3,554,442,393,145,37,1571,0,32,1603
15,4,15061,3740,3,597,503,582,138,49,1869,9,28,1906
15,4,15061,3741,3,505,414,435,101,46,1501,14,32,1547
15,4,15061,3742,3,353,360,549,113,40,1415,4,30,1449
15,4,15061,3743,3,392,418,414,114,23,1361,17,20,1398
15,4,15061,3744,3,465,430,453,164,42,1554,1,29,1584
15,4,15061,3745,3,410,325,377,125,26,1263,3,27,1293
15,4,15061,3746,3,260,183,209,63,18,733,0,9,742
15,4,15061,3747,3,274,284,276,94,25,953,8,10,971
15,4,15061,3748,3,546,343,412,138,54,1493,3,23,1519
15,4,15061,3749,3,420,231,391,81,30,1153,9,24,1186
15,4,15061,3750,3,425,383,322,68,34,1232,8,14,1254
15,4,15061,3751,3,470,377,350,100,54,1351,4,12,1367
15,4,15061,3752,3,447,284,461,94,38,1324,8,23,1355
15,4,15061,3753,3,432,430,384,110,31,1387,3,22,1412
15,4,15061,3754,3,484,314,364,126,39,1327,1,14,1342
15,4,15061,3755,3,358,232,435,85,36,1146,5,5,1156
15,4,15061,3756,3,346,193,503,91,47,1180,2,26,1208
15,4,15061,3757,3,464,265,488,127,39,1383,16,26,1425
15,4,15061,3758,3,335,284,438,112,38,1207,6,26,1239
15,4,15061,3759,3,494,400,528,98,63,1583,19,25,1627
15,4,15061,3760,3,519,306,564,115,49,1553,5,37,1595
15,4,15061,3761,3,349,610,615,123,59,1756,15,36,1807
15,4,15061,3762,3,245,199,326,64,29,863,2,16,881
15,4,15061,3763,3,288,201,293,60,25,867,4,18,889
15,4,15061,3764,3,390,287,311,96,37,1121,5,32,1158
15,4,15061,3765,3,348,200,321,77,34,980,6,18,1004
15,4,15061,3766,3,390,324,442,81,38,1275,12,43,1330
15,4,15061,3767,3,323,205,296,91,47,962,11,19,992
15,4,15061,3768,3,338,228,255,64,31,916,2,25,943
15,4,15061,3769,3,266,167,240,81,22,776,2,12,790
15,4,15061,3770,3,448,312,523,142,42,1467,4,28,1499
15,4,15061,3771,3,370,353,395,106,51,1275,8,22,1305
15,4,15061,3772,3,266,244,329,74,17,930,10,19,959
15,4,15061,3773,3,246,186,333,90,27,882,2,20,904
15,4,15061,3774,3,502,367,532,154,50,1605,3,26,1634
15,4,15061,3775,3,543,382,536,122,52,1635,13,32,1680
15,4,15061,3776,3,1034,629,956,219,116,2954,27,47,3028
15,4,15061,3777,3,322,175,235,79,38,849,0,19,868
15,4,15061,3778,3,270,189,230,71,21,781,15,12,808
15,4,15061,3779,3,310,202,331,65,37,945,4,11,960
15,4,15061,3780,3,226,160,348,60,20,814,1,25,840
15,4,15061,3781,3,348,438,412,102,32,1332,10,27,1369
15,4,15061,3782,3,365,488,393,125,29,1400,0,40,1440
15,4,15061,3783,3,314,198,359,67,36,974,2,22,998
15,4,15061,3784,3,290,159,375,125,20,969,6,17,992
15,4,15061,3785,3,423,189,427,81,52,1172,3,28,1203
15,4,15061,3786,3,379,184,400,80,33,1076,0,21,1097
15,4,15061,3787,3,389,360,579,109,47,1484,7,32,1523
15,4,15061,3788,3,320,552,439,95,51,1457,8,36,1501
15,4,15061,3789,3,230,168,212,57,18,685,0,22,707
15,4,15061,3790,3,729,256,604,158,68,1815,10,29,1854
15,4,15061,3791,3,568,285,628,135,63,1679,11,28,1718
15,4,15061,3792,3,1480,714,1294,351,195,4034,18,86,4138
15,4,15061,3793,3,443,486,401,122,24,1476,7,32,1515
15,4,15061,3794,3,497,490,356,100,20,1463,12,24,1499
15,4,15061,3795,3,350,286,186,61,18,901,12,19,932
15,4,15061,3796,3,83,88,33,13,13,230,0,2,232
15,4,15061,3797,3,218,186,109,35,10,558,2,11,571
15,4,15061,3798,3,311,374,157,95,32,969,8,21,998
15,4,15061,3799,3,377,302,245,94,35,1053,5,25,1083
15,4,15061,3800,3,264,308,179,50,21,822,3,22,847
15,4,15061,3801,3,430,343,386,88,48,1295,15,37,1347
15,4,15061,3802,3,253,187,156,61,22,679,1,21,701
15,4,15061,3803,3,152,261,147,51,24,635,1,9,645
15,4,15061,3804,3,585,649,709,137,57,2137,21,51,2209
15,4,15061,3805,3,81,134,103,44,10,372,3,7,382
15,4,15061,3806,3,152,200,150,70,5,577,1,8,586
15,4,15061,3807,3,307,335,249,124,32,1047,3,24,1074
15,4,15061,3808,3,553,465,499,184,54,1755,7,37,1799
15,4,15061,3809,3,310,332,344,114,31,1131,0,21,1152
15,4,15061,3810,3,250,199,147,69,13,678,3,29,710
15,4,15061,3811,3,184,116,130,28,5,463,2,10,475
15,4,15061,3812,3,62,119,57,3,3,244,2,10,256
15,4,15061,3813,3,397,327,398,96,41,1259,10,29,1298
15,4,15061,3814,3,131,128,496,52,20,827,1,11,839
15,4,15061,3815,3,148,172,513,49,20,902,2,13,917
15,4,15061,3816,3,188,184,221,46,31,670,2,15,687
15,4,15061,3817,3,167,238,219,26,7,657,7,8,672
15,4,15061,3818,3,134,211,191,31,8,575,0,20,595
15,4,15061,3819,3,236,266,273,43,36,854,0,33,887
15,4,15061,3820,3,197,168,204,48,21,638,1,22,661
15,4,15061,3821,3,444,362,335,126,39,1306,0,40,1346
15,4,15061,3822,3,474,329,519,90,57,1469,7,20,1496
15,5,15002,33,3,281,379,433,38,17,1148,1,24,1173
15,5,15002,34,3,392,359,425,37,28,1241,0,27,1268
15,5,15002,35,3,323,576,441,38,24,1402,4,35,1441
15,5,15002,36,3,23,54,40,8,1,126,0,1,127
15,5,15002,37,3,136,370,382,38,22,948,8,25,981
15,5,15002,38,3,216,369,430,54,25,1094,5,17,1116
15,5,15002,39,3,18,30,45,6,3,102,1,4,107
15,5,15002,40,3,45,192,162,14,4,417,0,13,430
15,5,15002,41,3,172,320,476,72,15,1055,0,17,1072
15,5,15002,42,3,222,329,378,68,19,1016,0,19,1035
15,5,15002,43,3,182,374,463,49,20,1088,1,36,1125
15,5,15002,44,3,153,315,339,56,16,879,5,13,897
15,5,15002,45,3,212,270,329,43,13,867,8,7,882
15,5,15002,46,3,183,309,518,61,23,1094,4,30,1128
15,5,15002,47,3,153,307,721,51,26,1258,6,23,1287
15,5,15002,48,3,166,357,604,42,32,1201,8,13,1222
15,5,15002,49,3,251,404,857,74,26,1612,4,41,1657
15,5,15002,50,3,195,380,749,53,34,1411,6,18,1435
15,5,15002,51,3,267,561,545,77,45,1495,9,27,1531
15,5,15002,52,3,188,310,524,66,29,1117,4,20,1141
15,5,15002,53,3,297,351,442,61,41,1192,4,20,1216
15,5,15002,54,3,264,350,488,83,37,1222,0,27,1249
15,5,15002,55,3,238,369,605,76,29,1317,7,34,1358
15,5,15002,56,3,191,410,613,49,29,1292,10,26,1328
15,5,15002,57,3,197,349,495,63,22,1126,6,22,1154
15,5,15002,58,3,501,549,1180,132,75,2437,13,47,2497
15,5,15011,233,3,147,217,708,383,114,1569,6,42,1617
15,5,15011,234,3,167,165,699,119,32,1182,4,24,1210
15,5,15011,235,3,139,144,671,207,31,1192,0,27,1219
15,5,15011,236,3,109,171,473,278,23,1054,12,23,1089
15,5,15011,237,3,243,214,935,111,31,1534,11,23,1568
15,5,15011,238,3,204,276,629,72,39,1220,14,40,1274
15,5,15011,239,3,127,211,509,43,20,910,6,12,928
15,5,15011,240,3,217,284,510,51,33,1095,7,27,1129
15,5,15011,241,3,153,124,412,42,29,760,7,29,796
15,5,15011,242,3,271,269,686,89,40,1355,3,35,1393
15,5,15011,243,3,307,279,596,75,43,1300,2,27,1329
15,5,15011,244,3,150,88,295,21,17,571,3,10,584
15,5,15011,245,3,148,173,441,124,38,924,3,15,942
15,5,15011,246,3,23,64,136,42,6,271,0,8,279
15,5,15016,469,3,371,202,285,25,9,892,0,14,906
15,5,15016,470,3,346,210,278,28,14,876,4,18,898
15,5,15016,471,3,89,84,94,13,4,284,3,9,296
15,5,15016,472,3,243,193,199,11,6,652,4,17,673
15,5,15016,473,3,217,150,185,14,4,570,3,15,588
15,5,15016,474,3,65,58,61,7,4,195,0,9,204
15,5,15016,475,3,130,76,109,4,1,320,2,8,330
15,5,15016,476,3,55,45,33,6,2,141,0,6,147
15,5,15016,477,3,30,77,121,4,1,233,0,4,237
15,5,15016,478,3,196,367,416,59,12,1050,0,27,1077
15,5,15016,479,3,61,30,47,4,1,143,1,8,152
15,5,15016,480,3,49,57,31,6,0,143,0,4,147
15,5,15016,481,3,23,56,92,0,1,172,0,5,177
15,5,15016,482,3,127,107,189,11,2,436,1,10,447
15,5,15016,483,3,85,30,114,19,1,249,2,6,257
15,5,15016,484,3,48,80,109,1,2,240,3,5,248
15,5,15016,485,3,90,119,352,16,8,585,2,16,603
15,5,15016,486,3,97,142,268,12,6,525,4,9,538
15,5,15016,487,3,230,194,385,33,14,856,1,17,874
15,5,15016,489,3,23,23,25,11,0,82,0,3,85
15,5,15029,1097,3,334,393,546,91,54,1418,7,10,1435
15,5,15029,1098,3,352,422,607,112,62,1555,1,32,1588
15,5,15029,1099,3,211,166,333,60,22,792,7,11,810
15,5,15029,1100,3,70,74,213,10,7,374,0,10,384
15,5,15029,1101,3,96,193,367,29,20,705,7,12,724
15,5,15029,1102,3,76,52,141,27,8,304,0,8,312
15,5,15029,1103,3,54,192,130,16,7,399,2,2,403
15,5,15029,1104,3,32,60,115,9,0,216,0,2,218
15,5,15029,1105,3,78,88,177,9,14,366,2,3,371
15,5,15029,1106,3,57,143,271,12,8,491,2,10,503
15,5,15029,1107,3,265,328,732,57,28,1410,5,25,1440
15,5,15029,1108,3,176,236,657,47,13,1129,6,13,1148
15,5,15031,1142,3,305,150,474,44,66,1039,0,27,1066
15,5,15031,1143,3,316,220,611,41,36,1224,12,10,1246
15,5,15031,1144,3,259,185,638,64,47,1193,0,25,1218
15,5,15031,1145,3,358,192,733,66,74,1423,4,24,1451
15,5,15031,1146,3,143,139,450,47,23,802,2,12,816
15,5,15031,1147,3,437,181,823,75,67,1583,7,11,1601
15,5,15031,1148,3,171,223,545,63,39,1041,7,11,1059
15,5,15062,3823,3,215,276,250,13,12,766,3,10,779
15,5,15062,3824,3,145,202,197,11,6,561,8,6,575
15,5,15062,3825,3,34,22,21,2,0,79,2,1,82
15,5,15062,3826,3,563,446,352,11,12,1384,8,39,1431
15,5,15062,3827,3,193,226,306,22,10,757,5,13,775
15,5,15066,3880,3,187,266,374,29,23,879,2,10,891
15,5,15066,3881,3,212,290,338,35,21,896,1,21,918
15,5,15066,3882,3,123,180,262,30,10,605,1,5,611
15,5,15066,3883,3,267,306,489,42,21,1125,8,18,1151
15,5,15066,3884,3,45,172,231,9,3,460,2,18,480
15,5,15066,3885,3,80,178,438,18,8,722,0,21,743
15,5,15066,3887,3,145,160,295,12,9,621,1,17,639
15,5,15066,3888,3,76,83,129,13,5,306,0,10,316
15,5,15066,3889,3,87,84,267,8,5,451,1,2,454
15,5,15066,3890,3,142,125,407,20,8,702,6,12,720
15,5,15066,3891,3,76,130,276,6,3,491,0,15,506
15,5,15066,3892,3,176,145,276,24,13,634,3,10,647
15,5,15066,3893,3,16,13,64,3,0,96,0,7,103
15,5,15066,3894,3,28,127,65,7,2,229,0,10,239
15,5,15066,3895,3,199,244,272,22,23,760,4,14,778
15,5,15066,3896,3,293,246,449,33,28,1049,12,29,1090
15,5,15066,3897,3,115,114,304,10,5,548,2,14,564
15,5,15066,3898,3,153,205,287,23,15,683,3,8,694
15,5,15070,3940,3,386,227,334,49,23,1019,1,18,1038
15,5,15070,3941,3,281,250,265,46,33,875,2,17,894
15,5,15076,4106,3,357,182,276,36,9,860,2,21,883
15,5,15076,4107,3,395,201,281,45,15,937,3,25,965
15,5,15076,4108,3,337,246,415,38,35,1071,2,23,1096
15,5,15076,4109,3,539,200,351,40,19,1149,4,24,1177
15,5,15076,4110,3,565,250,349,30,22,1216,3,19,1238
15,5,15076,4111,3,19,13,96,2,0,130,2,2,134
15,5,15076,4112,3,62,36,61,13,4,176,0,1,177
15,5,15076,4113,3,165,71,164,26,9,435,1,14,450
15,5,15076,4114,3,102,75,206,8,0,391,1,7,399
15,5,15076,4115,3,77,41,99,7,6,230,3,7,240
15,5,15076,4116,3,85,134,125,13,7,364,3,6,373
15,5,15076,4117,3,29,36,38,2,0,105,1,6,112
15,5,15076,4118,3,265,93,137,15,4,514,2,7,523
15,5,15076,4119,3,193,136,274,32,9,644,9,16,669
15,5,15085,4331,3,594,356,272,48,33,1303,1,20,1324
15,5,15085,4332,3,489,254,242,46,17,1048,4,13,1065
15,5,15085,4333,3,89,91,60,9,6,255,1,4,260
15,5,15085,4334,3,224,260,200,45,27,756,0,10,766
15,5,15085,4335,3,216,237,198,48,15,714,3,10,727
15,5,15085,4336,3,123,63,94,7,3,290,0,3,293
15,5,15085,4337,3,593,270,557,48,24,1492,0,17,1509
15,5,15085,4338,3,244,150,215,39,17,665,4,7,676
15,5,15085,4339,3,188,54,89,6,3,340,1,8,349
15,5,15085,4340,3,329,243,299,38,21,930,3,21,954
15,5,15085,4341,3,102,65,154,11,11,343,8,7,358
15,5,15085,4342,3,503,418,619,89,23,1652,5,23,1680
15,5,15085,4343,3,239,162,534,27,21,983,15,16,1014
15,5,15085,4344,3,168,148,436,16,6,774,0,17,791
15,5,15085,4345,3,77,111,106,5,1,300,0,2,302
15,5,15093,4523,3,234,511,467,55,20,1287,9,17,1313
15,5,15093,4524,3,265,497,638,83,35,1518,8,38,1564
15,5,15093,4525,3,336,631,494,76,35,1572,1,43,1616
15,5,15093,4526,3,264,475,532,71,41,1383,3,32,1418
15,5,15093,4527,3,338,579,798,92,47,1854,14,33,1901
15,5,15093,4528,3,278,608,613,74,39,1612,12,34,1658
15,5,15093,4529,3,93,62,105,12,5,277,2,5,284
15,5,15093,4530,3,61,198,211,31,14,515,3,12,530
15,5,15093,4531,3,32,87,70,12,6,207,0,1,208
15,5,15093,4532,3,123,158,246,31,18,576,2,22,600
15,5,15093,4533,3,27,72,78,7,7,191,2,2,195
15,5,15093,4534,3,278,228,397,33,23,959,0,11,970
15,5,15093,4535,3,225,268,355,46,16,910,4,10,924
15,5,15093,4536,3,13,53,52,5,2,125,3,4,132
15,5,15093,4537,3,159,220,396,40,26,841,7,21,869
15,5,15093,4538,3,187,324,804,57,25,1397,0,33,1430
15,5,15093,4539,3,225,391,264,31,13,924,2,24,950
15,5,15093,4540,3,42,115,155,24,9,345,5,5,355
15,5,15093,4541,3,63,127,129,10,6,335,0,16,351
15,5,15093,4542,3,179,393,408,59,16,1055,5,30,1090
15,5,15093,4543,3,122,296,415,43,15,891,2,11,904
15,5,15093,4544,3,4,35,24,2,2,67,0,0,67
15,5,15093,4545,3,192,416,350,41,21,1020,9,18,1047
15,5,15094,4546,3,226,340,310,56,37,969,9,27,1005
15,5,15094,4547,3,277,267,393,63,40,1040,11,23,1074
15,5,15094,4548,3,184,222,367,38,31,842,11,16,869
15,5,15094,4549,3,229,219,287,61,28,824,8,8,840
15,5,15094,4550,3,110,341,288,29,16,784,1,21,806
15,5,15094,4551,3,217,231,535,53,30,1066,7,28,1101
15,5,15094,4552,3,177,115,183,32,21,528,5,12,545
15,5,15094,4553,3,273,478,419,57,36,1263,1,40,1304
15,5,15094,4554,3,99,327,742,32,13,1213,3,35,1251
15,5,15094,4555,3,80,175,231,22,4,512,6,15,533
15,5,15101,4691,3,293,245,655,93,40,1326,1,16,1343
15,5,15101,4692,3,271,217,678,102,41,1309,1,28,1338
15,5,15101,4693,3,165,145,331,43,31,715,5,8,728
15,5,15101,4694,3,118,132,367,35,29,681,4,12,697
15,5,15101,4695,3,468,431,1165,154,81,2299,15,39,2353
15,5,15101,4696,3,165,178,472,60,27,902,0,12,914
15,5,15101,4697,3,277,366,1091,82,50,1866,19,30,1915
15,5,15101,4698,3,33,33,69,6,3,144,0,4,148
15,5,15101,4700,3,75,70,187,20,23,375,1,10,386
15,5,15094,6183,3,53,62,131,11,3,260,3,6,269
15,6,15020,523,3,404,544,552,113,70,1683,9,27,1719
15,6,15020,524,3,788,582,800,138,117,2425,21,19,2465
15,6,15020,525,3,390,251,373,68,43,1125,5,12,1142
15,6,15020,526,3,358,304,408,58,44,1172,3,6,1181
15,6,15020,527,3,358,298,428,88,62,1234,2,17,1253
15,6,15020,528,3,404,315,417,97,61,1294,0,17,1311
15,6,15020,529,3,176,207,218,37,30,668,0,11,679
15,6,15020,530,3,129,193,274,57,33,686,3,13,702
15,6,15020,531,3,298,274,405,84,52,1113,7,25,1145
15,6,15020,532,3,157,189,263,51,40,700,10,8,718
15,6,15020,533,3,201,168,260,78,22,729,5,10,744
15,6,15020,534,3,400,366,412,85,50,1313,2,12,1327
15,6,15020,535,3,478,301,453,80,49,1361,4,15,1380
15,6,15020,536,3,920,567,943,186,134,2750,10,28,2788
15,6,15020,537,3,673,472,703,145,119,2112,8,19,2139
15,6,15020,538,3,347,267,328,71,40,1053,5,11,1069
15,6,15020,539,3,341,225,422,63,57,1108,3,13,1124
15,6,15020,540,3,398,378,431,81,71,1359,5,13,1377
15,6,15020,541,3,210,154,214,60,32,670,4,12,686
15,6,15020,542,3,119,114,154,33,21,441,0,3,444
15,6,15020,543,3,250,196,350,62,36,894,0,18,912
15,6,15020,544,3,205,155,258,47,42,707,5,2,714
15,6,15020,545,3,104,121,149,42,12,428,2,7,437
15,6,15020,546,3,207,149,224,63,37,680,0,7,687
15,6,15020,547,3,117,92,138,31,29,407,3,7,417
15,6,15020,548,3,208,168,289,57,31,753,8,12,773
15,6,15020,549,3,520,474,674,111,108,1887,6,24,1917
15,6,15020,550,3,364,317,389,89,56,1215,0,14,1229
15,6,15020,551,3,392,372,399,66,61,1290,4,14,1308
15,6,15020,552,3,672,473,794,145,135,2219,6,24,2249
15,6,15020,553,3,401,553,746,126,88,1914,4,21,1939
15,6,15020,554,3,273,268,456,74,43,1114,4,16,1134
15,6,15020,555,3,218,192,285,57,33,785,1,5,791
15,6,15020,556,3,592,432,701,126,118,1969,5,16,1990
15,6,15020,557,3,572,358,585,102,110,1727,6,17,1750
15,6,15020,558,3,503,450,573,107,87,1720,8,22,1750
15,6,15020,559,3,401,307,374,83,49,1214,0,21,1235
15,6,15020,560,3,358,202,329,58,59,1006,0,10,1016
15,6,15020,561,3,284,248,404,61,55,1052,0,25,1077
15,6,15020,562,3,467,433,564,94,72,1630,1,32,1663
15,6,15020,563,3,193,151,268,51,40,703,4,8,715
15,6,15020,564,3,127,126,182,31,21,487,0,11,498
15,6,15020,565,3,214,167,211,48,28,668,1,0,669
15,6,15020,566,3,171,255,378,58,38,900,12,11,923
15,6,15020,567,3,115,85,152,25,17,394,0,10,404
15,6,15020,568,3,113,62,151,35,18,379,4,5,388
15,6,15020,569,3,1244,1097,1688,355,245,4629,14,48,4691
15,6,15020,570,3,557,370,483,103,64,1577,3,22,1602
15,6,15020,571,3,175,137,241,40,40,633,0,8,641
15,6,15020,572,3,440,314,552,107,58,1471,1,21,1493
15,6,15020,573,3,767,473,735,222,130,2327,10,27,2364
15,6,15020,574,3,459,227,362,80,68,1196,3,13,1212
15,6,15020,575,3,812,801,1102,196,157,3068,13,22,3103
15,6,15020,576,3,401,298,355,86,58,1198,0,8,1206
15,6,15020,577,3,327,209,299,67,64,966,2,19,987
15,6,15020,578,3,599,447,609,113,88,1856,8,18,1882
15,6,15020,579,3,94,67,121,10,17,309,0,2,311
15,6,15020,580,3,83,72,112,16,20,303,0,5,308
15,6,15020,581,3,96,91,201,29,18,435,0,5,440
15,6,15020,582,3,88,85,125,22,26,346,3,0,349
15,6,15020,583,3,102,133,162,43,13,453,1,38,492
15,6,15020,584,3,199,185,276,54,48,762,4,17,783
15,6,15020,585,3,158,146,217,61,25,607,0,7,614
15,6,15020,586,3,134,146,174,43,12,509,4,5,518
15,6,15020,587,3,70,75,90,19,15,269,0,2,271
15,6,15020,588,3,167,155,206,43,32,603,3,1,607
15,6,15020,589,3,364,214,257,57,41,933,0,13,946
15,6,15020,590,3,316,217,324,54,40,951,5,7,963
15,6,15020,591,3,454,237,330,81,67,1169,4,11,1184
15,6,15020,592,3,547,221,415,91,79,1353,2,18,1373
15,6,15020,593,3,286,205,231,59,33,814,1,14,829
15,6,15020,594,3,493,339,439,109,94,1474,8,15,1497
15,6,15020,595,3,420,306,418,108,64,1316,5,23,1344
15,6,15020,596,3,149,123,181,19,21,493,4,12,509
15,6,15020,597,3,162,165,281,50,45,703,5,6,714
15,6,15020,598,3,127,146,214,34,25,546,0,6,552
15,6,15020,599,3,125,110,213,37,36,521,5,6,532
15,6,15020,600,3,227,197,251,67,40,782,3,11,796
15,6,15020,601,3,620,452,597,110,78,1857,7,19,1883
15,6,15020,602,3,307,353,520,65,31,1276,10,13,1299
15,6,15020,603,3,217,169,237,63,34,720,5,11,736
15,6,15020,604,3,573,504,734,115,79,2005,4,37,2046
15,6,15020,605,3,267,401,348,81,35,1132,4,23,1159
15,6,15020,606,3,251,385,419,71,53,1179,6,12,1197
15,6,15020,607,3,239,286,315,74,54,968,2,10,980
15,6,15020,608,3,238,235,277,59,59,868,18,14,900
15,6,15020,609,3,462,239,406,76,46,1229,0,17,1246
15,6,15020,610,3,576,550,863,151,116,2256,6,35,2297
15,6,15020,611,3,347,326,473,97,62,1305,6,16,1327
15,6,15020,612,3,445,551,811,138,104,2049,7,36,2092
15,6,15020,613,3,205,311,381,79,48,1024,8,10,1042
15,6,15020,614,3,417,726,723,117,92,2075,0,49,2124
15,6,15020,615,3,274,430,463,74,42,1283,4,34,1321
15,6,15020,616,3,291,303,438,63,56,1151,2,32,1185
15,6,15020,617,3,328,280,513,107,78,1306,1,17,1324
15,6,15020,618,3,543,244,394,85,70,1336,1,23,1360
15,6,15020,619,3,390,240,303,58,39,1030,1,14,1045
15,6,15020,620,3,350,171,354,83,60,1018,2,11,1031
15,6,15020,621,3,229,274,407,51,28,989,1,17,1007
15,6,15020,622,3,490,479,622,137,98,1826,3,25,1854
15,6,15020,623,3,146,115,161,42,24,488,0,6,494
15,6,15020,624,3,240,162,280,53,43,778,7,10,795
15,6,15020,625,3,109,78,134,22,16,359,4,3,366
15,6,15020,626,3,297,139,279,45,25,785,2,8,795
15,6,15020,627,3,219,150,231,61,37,698,1,5,704
15,6,15020,628,3,155,132,188,29,16,520,2,11,533
15,6,15109,5452,3,262,361,511,63,61,1258,4,18,1280
15,6,15109,5453,3,239,296,665,86,40,1326,3,36,1365
15,6,15109,5454,3,246,296,649,95,54,1340,4,47,1391
15,6,15109,5455,3,239,275,528,84,47,1173,2,24,1199
15,6,15109,5456,3,361,411,1034,143,61,2010,10,36,2056
15,6,15109,5457,3,197,223,705,62,51,1238,9,28,1275
15,6,15109,5458,3,171,225,712,77,40,1225,3,16,1244
15,6,15109,5459,3,204,263,685,71,53,1276,1,30,1307
15,6,15109,5460,3,162,190,385,68,30,835,1,13,849
15,6,15109,5461,3,274,325,701,90,73,1463,10,28,1501
15,6,15109,5462,3,262,227,575,80,62,1206,5,25,1236
15,6,15109,5463,3,257,287,405,71,53,1073,0,19,1092
15,6,15109,5464,3,198,290,420,84,45,1037,6,29,1072
15,6,15109,5465,3,231,280,507,82,50,1150,6,39,1195
15,6,15109,5466,3,237,344,516,89,44,1230,9,26,1265
15,6,15109,5467,3,315,265,487,72,45,1184,8,23,1215
15,6,15109,5468,3,180,314,706,71,49,1320,1,38,1359
15,6,15109,5469,3,44,84,213,19,12,372,8,8,388
15,6,15109,5470,3,28,49,88,11,7,183,2,6,191
15,6,15109,5471,3,136,137,359,76,32,740,4,28,772
15,6,15109,5472,3,1029,702,1260,261,179,3431,12,35,3478
15,6,15109,5473,3,320,367,734,80,65,1566,8,26,1600
15,6,15109,5474,3,520,278,528,86,57,1469,5,13,1487
15,6,15109,5475,3,1419,621,1525,247,197,4009,10,46,4065
15,6,15109,5476,3,188,247,460,93,31,1019,2,26,1047
15,6,15109,5477,3,228,271,1130,90,54,1773,2,38,1813
15,6,15109,5478,3,364,371,724,117,79,1655,5,29,1689
15,6,15109,5479,3,312,315,600,82,76,1385,8,16,1409
15,6,15109,5480,3,337,352,660,98,70,1517,8,17,1542
15,6,15109,5481,3,217,219,403,70,48,957,5,14,976
15,7,15025,692,3,383,164,225,65,59,896,2,7,905
15,7,15025,693,3,605,415,471,109,39,1639,6,24,1669
15,7,15025,694,3,346,268,518,66,39,1237,1,15,1253
15,7,15025,695,3,266,244,366,60,28,964,2,17,983
15,7,15025,696,3,322,244,286,54,31,937,2,7,946
15,7,15025,697,3,340,244,361,60,34,1039,3,13,1055
15,7,15025,698,3,382,234,382,99,38,1135,2,22,1159
15,7,15025,699,3,275,145,260,79,41,800,0,12,812
15,7,15025,700,3,419,156,282,71,40,968,3,11,982
15,7,15025,701,3,784,322,600,159,97,1962,7,20,1989
15,7,15025,702,3,476,176,287,82,43,1064,1,6,1071
15,7,15025,703,3,293,102,191,40,30,656,0,7,663
15,7,15025,704,3,1643,347,745,212,160,3107,11,28,3146
15,7,15025,705,3,381,147,245,74,46,893,4,17,914
15,7,15025,706,3,377,239,319,110,50,1095,2,17,1114
15,7,15025,707,3,220,151,244,45,33,693,5,17,715
15,7,15025,708,3,268,93,178,60,30,629,2,10,641
15,7,15025,709,3,303,138,236,75,43,795,6,12,813
15,7,15025,710,3,308,158,246,72,43,827,1,8,836
15,7,15025,711,3,383,140,294,74,53,944,1,14,959
15,7,15025,712,3,260,126,236,56,38,716,1,14,731
15,7,15025,713,3,175,112,349,53,28,717,0,10,727
15,7,15025,714,3,368,195,328,76,60,1027,4,16,1047
15,7,15025,715,3,261,123,285,68,52,789,4,8,801
15,7,15025,716,3,249,145,213,54,49,710,2,9,721
15,7,15025,717,3,205,91,166,53,34,549,3,12,564
15,7,15025,718,3,428,213,356,113,42,1152,2,19,1173
15,7,15025,719,3,303,285,363,84,36,1071,4,14,1089
15,7,15025,720,3,353,161,265,78,45,902,1,10,913
15,7,15025,721,3,183,95,172,41,26,517,0,6,523
15,7,15025,722,3,335,172,372,90,63,1032,4,12,1048
15,7,15025,723,3,262,174,257,63,34,790,1,13,804
15,7,15025,724,3,345,128,286,62,43,864,1,13,878
15,7,15025,725,3,563,180,407,108,69,1327,1,19,1347
15,7,15025,726,3,202,178,214,48,22,664,4,14,682
15,7,15025,727,3,278,185,325,68,41,897,2,11,910
15,7,15025,728,3,195,116,167,48,23,549,3,6,558
15,7,15025,729,3,266,133,207,45,30,681,1,18,700
15,7,15025,730,3,681,364,717,141,95,1998,6,31,2035
15,7,15025,731,3,525,351,627,125,80,1708,12,19,1739
15,7,15025,732,3,262,141,240,45,25,713,0,17,730
15,7,15025,733,3,202,129,192,42,26,591,0,10,601
15,7,15025,734,3,378,201,298,75,43,995,2,7,1004
15,7,15025,735,3,262,215,276,59,49,861,3,13,877
15,7,15025,736,3,244,194,246,81,30,795,0,19,814
15,7,15025,737,3,279,167,251,48,39,784,4,13,801
15,7,15025,738,3,301,138,259,71,32,801,0,18,819
15,7,15025,739,3,246,127,215,48,33,669,2,10,681
15,7,15025,740,3,158,87,171,40,21,477,2,6,485
15,7,15025,741,3,311,172,278,79,53,893,4,17,914
15,7,15025,742,3,171,127,147,54,36,535,0,15,550
15,7,15025,743,3,188,135,180,66,26,595,2,9,606
15,7,15025,744,3,251,163,260,54,37,765,3,2,770
15,7,15025,749,3,176,122,173,45,32,548,3,7,558
15,7,15025,750,3,242,106,189,46,34,617,3,7,627
15,7,15025,751,3,275,134,160,54,30,653,0,8,661
15,7,15025,752,3,215,142,205,52,48,662,0,6,668
15,7,15025,753,3,242,126,223,65,36,692,2,6,700
15,7,15025,754,3,369,172,282,76,41,940,2,8,950
15,7,15025,764,3,316,111,192,57,27,703,0,7,710
15,7,15025,765,3,454,202,262,88,48,1054,0,18,1072
15,7,15025,766,3,322,177,207,69,23,798,6,14,818
15,7,15025,767,3,520,171,284,71,53,1099,0,12,1111
15,7,15025,768,3,507,157,244,75,56,1039,2,16,1057
15,7,15025,769,3,494,144,235,55,51,979,1,16,996
15,7,15025,770,3,467,174,274,89,59,1063,2,17,1082
15,7,15025,779,3,792,479,652,142,102,2167,11,35,2213
15,7,15025,780,3,412,132,222,50,44,860,2,15,877
15,7,15025,781,3,394,132,222,80,50,878,1,7,886
15,7,15025,782,3,387,139,197,80,38,841,0,19,860
15,7,15025,783,3,605,209,286,71,60,1231,3,14,1248
15,7,15025,784,3,473,165,338,84,57,1117,3,11,1131
15,7,15025,785,3,465,153,232,68,35,953,0,7,960
15,7,15025,786,3,266,93,155,39,30,583,0,9,592
15,7,15025,787,3,532,132,293,79,58,1094,1,11,1106
15,7,15025,788,3,294,105,178,39,40,656,5,6,667
15,7,15025,791,3,615,160,275,70,61,1181,3,13,1197
15,7,15025,792,3,744,223,306,110,70,1453,6,17,1476
15,7,15025,793,3,472,160,189,66,38,925,0,9,934
15,7,15025,794,3,474,168,289,81,50,1062,0,16,1078
15,7,15025,795,3,488,152,239,76,48,1003,4,10,1017
15,7,15025,796,3,392,134,203,63,50,842,0,6,848
15,7,15025,797,3,493,187,272,68,49,1069,5,12,1086
15,7,15025,798,3,1108,261,390,130,89,1978,1,21,2000
15,7,15025,799,3,515,113,273,60,40,1001,1,14,1016
15,7,15025,800,3,558,180,243,69,49,1099,0,14,1113
15,7,15025,801,3,569,149,234,56,50,1058,3,10,1071
15,7,15025,803,3,278,92,141,22,31,564,3,9,576
15,7,15025,804,3,640,175,199,58,20,1092,1,9,1102
15,7,15025,805,3,425,126,162,60,42,815,1,9,825
15,7,15025,806,3,439,116,221,59,66,901,0,9,910
15,7,15025,807,3,370,101,196,48,38,753,1,8,762
15,7,15025,808,3,438,168,264,80,45,995,0,18,1013
15,7,15025,809,3,543,189,364,78,74,1248,1,14,1263
15,7,15025,810,3,172,100,71,29,15,387,0,2,389
15,7,15025,811,3,312,143,127,35,43,660,0,8,668
15,7,15025,812,3,283,148,142,46,42,661,2,12,675
15,7,15025,813,3,642,138,205,64,41,1090,0,11,1101
15,7,15025,814,3,150,51,80,27,16,324,0,5,329
15,7,15025,815,3,504,190,347,83,71,1195,2,3,1200
15,7,15025,816,3,574,193,352,87,63,1269,3,13,1285
15,7,15025,817,3,478,165,270,82,49,1044,0,19,1063
15,7,15025,818,3,636,146,269,73,70,1194,0,15,1209
15,7,15025,819,3,565,151,271,78,58,1123,2,24,1149
15,7,15025,820,3,377,92,196,56,25,746,0,11,757
15,7,15025,821,3,475,137,193,55,31,891,1,10,902
15,7,15025,822,3,462,142,196,54,40,894,5,12,911
15,7,15025,823,3,467,133,212,71,52,935,1,9,945
15,7,15025,824,3,510,122,210,56,33,931,1,8,940
15,7,15025,828,3,375,231,273,67,51,997,3,25,1025
15,7,15025,829,3,313,145,294,49,35,836,3,8,847
15,7,15025,830,3,245,135,214,54,22,670,3,11,684
15,7,15025,831,3,217,111,248,33,23,632,1,16,649
15,7,15025,832,3,269,119,268,48,34,738,8,11,757
15,7,15025,833,3,172,100,156,37,15,480,0,8,488
15,7,15025,834,3,216,114,208,55,53,646,0,11,657
15,7,15025,835,3,202,140,171,49,28,590,3,9,602
15,7,15025,836,3,197,92,130,46,28,493,0,5,498
15,7,15025,837,3,1791,338,642,161,160,3092,1,38,3131
15,7,15025,838,3,179,125,108,35,30,477,6,3,486
15,7,15025,839,3,190,110,127,39,16,482,2,4,488
15,7,15025,840,3,366,184,369,101,61,1081,6,13,1100
15,7,15025,841,3,512,234,394,90,80,1310,2,23,1335
15,7,15025,842,3,146,122,177,48,33,526,0,7,533
15,7,15025,843,3,202,125,206,46,27,606,0,17,623
15,7,15025,844,3,192,94,158,41,27,512,1,10,523
15,7,15025,845,3,245,179,267,69,37,797,5,19,821
15,7,15025,846,3,232,117,242,54,22,667,3,7,677
15,7,15025,847,3,249,137,281,56,30,753,3,13,769
15,7,15025,848,3,473,184,431,84,62,1234,5,23,1262
15,7,15025,849,3,399,243,407,94,125,1268,1,21,1290
15,7,15025,850,3,1554,710,1562,343,219,4388,13,64,4465
15,7,15025,851,3,766,317,623,170,109,1985,5,12,2002
15,7,15025,852,3,297,113,182,58,42,692,1,4,697
15,7,15025,853,3,532,379,523,105,86,1625,4,31,1660
15,7,15025,854,3,407,242,402,88,57,1196,4,17,1217
15,7,15025,855,3,246,213,310,81,38,888,9,12,909
15,7,15025,856,3,303,154,331,53,35,876,3,14,893
15,7,15025,857,3,451,219,546,77,43,1336,7,20,1363
15,7,15025,858,3,278,136,227,40,29,710,2,9,721
15,7,15025,859,3,292,214,278,110,40,934,11,23,968
15,7,15025,860,3,350,235,480,110,41,1216,2,16,1234
15,7,15025,861,3,285,164,301,55,56,861,0,29,890
15,7,15025,862,3,442,161,376,109,47,1135,7,12,1154
15,7,15025,863,3,348,191,246,64,22,871,2,17,890
15,7,15025,864,3,269,215,287,55,44,870,4,18,892
15,7,15025,865,3,243,129,204,52,21,649,3,16,668
15,7,15025,866,3,253,164,317,60,36,830,2,19,851
15,7,15025,867,3,450,254,472,99,68,1343,0,32,1375
15,7,15025,868,3,328,213,456,90,75,1162,3,22,1187
15,7,15025,869,3,423,216,435,91,52,1217,10,15,1242
15,7,15025,870,3,465,228,530,134,45,1402,11,26,1439
15,7,15025,871,3,294,141,264,59,24,782,9,11,802
15,7,15025,872,3,221,171,217,71,25,705,2,18,725
15,7,15025,873,3,335,195,343,88,53,1014,4,9,1027
15,7,15025,874,3,291,143,274,48,44,800,3,12,815
15,7,15025,875,3,339,221,390,91,20,1061,14,19,1094
15,7,15025,882,3,484,426,570,155,77,1712,4,24,1740
15,7,15025,883,3,206,126,263,51,21,667,0,6,673
15,7,15025,884,3,350,256,458,121,57,1242,6,14,1262
15,7,15025,885,3,450,313,556,118,86,1523,5,22,1550
15,7,15025,886,3,231,130,338,80,36,815,5,11,831
15,7,15025,887,3,496,255,501,158,73,1483,10,23,1516
15,7,15025,888,3,256,158,301,48,31,794,1,13,808
15,7,15025,889,3,339,219,387,97,61,1103,3,25,1131
15,7,15025,890,3,583,117,210,90,48,1048,1,6,1055
15,7,15025,891,3,131,42,45,13,9,240,1,2,243
15,7,15025,892,3,158,35,59,18,12,282,1,2,285
15,7,15025,893,3,270,105,307,43,39,764,0,7,771
15,7,15025,894,3,353,130,363,60,46,952,5,9,966
15,7,15025,895,3,327,157,162,52,26,724,3,13,740
15,7,15025,896,3,322,75,227,47,29,700,1,15,716
15,7,15025,897,3,376,112,260,57,32,837,2,9,848
15,7,15025,898,3,236,92,187,39,20,574,2,11,587
15,7,15025,899,3,322,105,188,35,39,689,2,17,708
15,7,15025,900,3,449,103,267,60,47,926,2,7,935
15,7,15025,901,3,279,59,159,45,31,573,0,8,581
15,7,15025,902,3,334,229,406,93,44,1106,3,18,1127
15,7,15025,903,3,293,174,365,46,33,911,2,26,939
15,7,15025,904,3,250,125,325,58,34,792,1,22,815
15,7,15025,905,3,289,187,357,64,21,918,2,13,933
15,7,15025,911,3,3336,997,1967,532,387,7219,7,79,7305
15,8,15110,5482,3,207,344,303,82,38,974,5,19,998
15,8,15110,5483,3,276,416,366,82,49,1189,9,19,1217
15,8,15110,5484,3,277,330,342,78,44,1071,3,39,1113
15,8,15110,5485,3,225,570,225,84,47,1151,8,20,1179
15,8,15110,5486,3,154,330,223,56,38,801,1,25,827
15,8,15110,5487,3,127,190,193,62,27,599,0,10,609
15,8,15110,5488,3,242,425,418,80,51,1216,6,29,1251
15,8,15110,5489,3,73,181,173,27,22,476,0,18,494
15,8,15110,5490,3,300,550,453,87,54,1444,6,23,1473
15,8,15110,5491,3,139,275,266,34,23,737,0,14,751
15,8,15110,5492,3,353,429,392,81,76,1331,0,21,1352
15,8,15110,5493,3,254,408,577,96,77,1412,12,45,1469
15,8,15110,5494,3,145,212,358,61,38,814,1,17,832
15,8,15110,5495,3,166,236,615,60,49,1126,4,17,1147
15,8,15110,5496,3,97,163,172,18,21,471,2,10,483
15,8,15110,5497,3,40,38,61,11,3,153,0,1,154
15,8,15110,5498,3,129,110,201,35,15,490,0,16,506
15,8,15110,5499,3,662,401,719,158,105,2045,18,13,2076
15,8,15110,5500,3,257,350,530,97,34,1268,13,29,1310
15,8,15110,5501,3,196,193,415,69,44,917,11,16,944
15,8,15110,5502,3,162,235,301,43,44,785,0,8,793
15,8,15110,5503,3,186,151,378,43,39,797,1,14,812
15,8,15110,5504,3,99,116,194,39,17,465,2,10,477
15,8,15110,5505,3,142,220,363,58,28,811,3,12,826
15,8,15110,5506,3,137,164,291,51,22,665,4,26,695
15,8,15110,5507,3,200,281,508,87,40,1116,11,25,1152
15,8,15110,5508,3,254,230,400,62,34,980,1,18,999
15,8,15110,5509,3,180,137,300,79,22,718,2,14,734
15,8,15110,5510,3,164,143,356,71,31,765,0,24,789
15,8,15110,5511,3,105,117,376,55,22,675,0,17,692
15,8,15110,5512,3,231,207,472,83,37,1030,5,18,1053
15,8,15110,5513,3,208,229,435,78,46,996,0,38,1034
15,8,15110,5514,3,201,164,462,71,41,939,2,12,953
15,8,15110,5515,3,245,177,618,85,50,1175,4,23,1202
15,8,15110,5516,3,208,170,479,84,49,990,2,22,1014
15,8,15110,5517,3,208,147,533,187,33,1108,3,19,1130
15,8,15110,5518,3,189,203,425,115,52,984,4,0,988
15,8,15110,5519,3,201,260,479,123,59,1122,10,15,1147
15,8,15110,5520,3,144,219,473,70,32,938,3,17,958
15,8,15110,5521,3,36,26,28,8,3,101,0,1,102
15,8,15110,5522,3,339,162,409,69,58,1037,3,15,1055
15,8,15110,5523,3,1071,561,1456,451,192,3731,8,71,3810
15,8,15110,5524,3,180,63,284,77,18,622,0,12,634
15,8,15110,5525,3,239,115,321,67,33,775,2,14,791
15,8,15110,5526,3,238,183,530,95,34,1080,0,11,1091
15,8,15110,5527,3,256,265,438,61,45,1065,1,15,1081
15,8,15110,5528,3,215,265,484,64,42,1070,12,29,1111
15,8,15110,5529,3,210,350,602,70,35,1267,9,23,1299
15,8,15110,5530,3,193,244,377,69,26,909,1,22,932
15,8,15110,5531,3,300,131,380,69,42,922,3,10,935
15,8,15110,5532,3,255,132,391,63,34,875,0,10,885
15,8,15110,5533,3,489,269,559,104,89,1510,10,20,1540
15,8,15110,5534,3,296,82,219,44,38,679,0,11,690
15,8,15110,5535,3,245,110,247,53,38,693,3,8,704
15,8,15110,5536,3,293,144,297,81,49,864,4,12,880
15,8,15110,5537,3,241,141,254,57,36,729,5,6,740
15,8,15110,5538,3,201,180,380,64,40,865,6,13,884
15,8,15110,5539,3,396,521,1011,154,70,2152,22,46,2220
15,8,15110,5540,3,240,248,532,92,38,1150,5,22,1177
15,8,15110,5541,3,273,358,446,74,56,1207,3,21,1231
15,8,15110,5542,3,234,153,230,62,24,703,2,9,714
15,8,15110,5543,3,245,170,563,79,51,1108,5,18,1131
15,8,15110,5544,3,227,272,562,94,48,1203,0,17,1220
15,8,15110,5545,3,234,313,610,80,47,1284,4,21,1309
15,8,15110,5546,3,241,321,605,97,63,1327,12,20,1359
15,8,15110,5547,3,139,278,505,59,27,1008,5,22,1035
15,8,15110,5548,3,390,446,1027,183,79,2125,9,36,2170
15,8,15110,5549,3,107,100,213,52,24,496,9,11,516
15,8,15110,5550,3,464,475,952,175,115,2181,17,32,2230
15,8,15110,5551,3,144,128,230,38,23,563,1,13,577
15,8,15110,5552,3,367,159,393,67,34,1020,2,18,1040
15,8,15110,5553,3,542,178,368,85,56,1229,5,11,1245
15,8,15110,5554,3,354,229,340,70,57,1050,0,17,1067
15,8,15110,5555,3,74,78,179,24,20,375,1,5,381
15,8,15110,5556,3,191,161,329,87,34,802,0,20,822
15,8,15110,5557,3,507,614,1275,329,97,2822,23,33,2878
15,8,15110,5558,3,192,335,598,114,49,1288,15,33,1336
15,8,15110,5559,3,148,245,395,128,30,946,0,19,965
15,8,15110,5560,3,196,209,363,97,44,909,12,18,939
15,8,15110,5561,3,284,267,484,85,49,1169,4,23,1196
15,8,15110,5562,3,438,183,315,59,50,1045,2,6,1053
15,8,15110,5563,3,282,121,320,52,37,812,4,12,828
15,8,15110,5564,3,361,135,307,69,48,920,3,15,938
15,8,15110,5565,3,39,69,108,16,10,242,5,3,250
15,8,15110,5566,3,248,333,525,151,66,1323,7,30,1360
15,8,15110,5567,3,138,157,296,100,25,716,13,20,749
15,8,15110,5626,3,197,111,238,53,42,641,2,4,647
15,8,15110,5627,3,167,112,204,33,37,553,3,9,565
15,8,15110,5628,3,400,209,399,94,72,1174,4,17,1195
15,8,15110,5629,3,191,106,180,38,36,551,3,8,562
15,8,15110,5630,3,100,107,166,32,29,434,1,4,439
15,8,15110,5631,3,167,105,308,48,32,660,6,6,672
15,8,15110,5632,3,94,107,184,43,23,451,5,10,466
15,8,15110,5633,3,177,103,171,78,32,561,1,6,568
15,8,15110,5634,3,106,55,87,25,15,288,2,2,292
15,8,15110,5635,3,76,70,93,19,11,269,0,5,274
15,8,15110,5636,3,301,119,267,73,41,801,3,12,816
15,8,15110,5637,3,177,68,166,30,28,469,0,6,475
15,8,15110,5638,3,322,103,253,59,34,771,2,6,779
15,8,15110,5639,3,203,99,208,51,33,594,0,5,599
15,8,15110,5640,3,192,73,180,36,24,505,2,4,511
15,8,15110,5641,3,168,76,203,39,22,508,4,8,520
15,8,15110,5642,3,183,131,265,77,27,683,1,5,689
15,8,15110,5643,3,149,113,229,61,34,586,0,4,590
15,8,15110,5644,3,151,86,157,40,22,456,4,10,470
15,8,15110,5645,3,81,85,148,32,15,361,0,7,368
15,8,15110,5646,3,50,51,75,30,12,218,3,5,226
15,8,15110,5647,3,70,53,132,25,11,291,0,0,291
15,8,15110,5649,3,261,387,513,112,27,1300,15,23,1338
15,8,15110,5650,3,879,515,1071,291,164,2920,7,41,2968
15,8,15110,5651,3,362,370,567,115,55,1469,7,22,1498
15,8,15110,5652,3,679,914,1549,251,151,3544,30,65,3639
15,8,15110,5653,3,107,208,197,42,31,585,3,21,609
15,8,15110,6171,3,111,62,164,36,19,392,5,6,403
15,8,15110,6172,3,97,48,94,31,20,290,0,1,291
15,8,15110,6173,3,81,33,247,34,26,421,0,51,472
15,8,15110,6174,3,140,106,258,51,41,596,1,3,600
15,8,15110,6175,3,279,148,289,83,39,838,2,0,840
15,8,15110,6176,3,271,176,362,94,48,951,3,9,963
15,8,15110,6177,3,210,115,263,59,42,689,3,10,702
15,8,15110,6178,3,223,143,335,64,39,804,5,6,815
15,8,15110,6179,3,164,124,267,50,46,651,2,6,659
15,8,15110,6180,3,150,99,250,43,46,588,8,16,612
15,8,15110,6181,3,52,55,75,16,18,216,0,5,221
15,8,15110,6182,3,98,97,167,32,29,423,2,7,432
15,9,15043,2188,3,165,422,157,67,22,833,1,16,850
15,9,15043,2189,3,225,424,184,139,30,1002,5,22,1029
15,9,15043,2190,3,291,501,223,91,56,1162,13,36,1211
15,9,15043,2191,3,289,700,218,128,37,1372,2,27,1401
15,9,15043,2192,3,38,129,69,3,3,242,0,3,245
15,9,15043,2193,3,37,334,127,28,5,531,2,17,550
15,9,15043,2194,3,83,418,265,29,5,800,2,40,842
15,9,15043,2195,3,416,548,324,50,18,1356,3,59,1418
15,9,15043,2196,3,426,841,805,93,27,2192,11,111,2314
15,9,15043,2197,3,159,264,187,14,13,637,9,21,667
15,9,15043,2198,3,115,588,308,38,8,1057,6,46,1109
15,9,15043,2199,3,133,691,494,60,18,1396,5,38,1439
15,9,15043,2200,3,198,568,337,68,10,1181,14,55,1250
15,9,15043,2201,3,213,361,168,22,13,777,0,27,804
15,9,15043,2202,3,66,149,99,24,2,340,0,17,357
15,9,15043,2203,3,238,402,318,74,18,1050,19,40,1109
15,9,15043,2204,3,139,371,208,67,6,791,3,16,810
15,9,15043,2205,3,236,337,201,32,20,826,3,34,863
15,9,15043,2206,3,120,440,327,23,8,918,2,53,973
15,9,15043,2207,3,105,415,407,11,9,947,1,77,1025
15,9,15043,2208,3,160,410,283,40,13,906,5,78,989
15,9,15043,2209,3,243,688,297,172,25,1425,13,69,1507
15,9,15043,2210,3,228,521,300,127,30,1206,7,71,1284
15,9,15043,2211,3,263,436,389,146,20,1254,11,62,1327
15,9,15043,2212,3,149,387,235,68,13,852,3,16,871
15,9,15043,2213,3,190,425,308,97,29,1049,5,63,1117
15,9,15043,2214,3,284,419,354,80,21,1158,0,34,1192
15,9,15043,2215,3,278,677,464,50,23,1492,23,44,1559
15,9,15043,2216,3,139,149,148,13,8,457,6,15,478
15,9,15043,2217,3,156,192,201,16,12,577,9,45,631
15,9,15043,2218,3,345,533,413,34,38,1363,20,82,1465
15,9,15043,2219,3,179,511,216,35,20,961,9,37,1007
15,9,15043,2220,3,87,255,374,24,11,751,0,52,803
15,9,15043,2221,3,218,490,398,31,17,1154,7,44,1205
15,9,15043,2222,3,32,170,76,15,2,295,0,12,307
15,9,15043,2223,3,69,231,61,2,1,364,0,15,379
15,9,15043,2224,3,108,284,304,34,14,744,0,38,782
15,9,15043,2225,3,79,189,92,24,5,389,3,19,411
15,9,15043,2226,3,26,212,47,7,10,302,2,9,313
15,9,15043,2227,3,253,554,289,103,60,1259,15,46,1320
15,9,15043,2228,3,420,394,238,40,23,1115,7,24,1146
15,9,15043,2229,3,323,579,453,89,31,1475,15,60,1550
15,9,15043,2230,3,239,331,255,37,18,880,0,41,921
15,9,15043,2231,3,13,105,64,0,1,183,0,7,190
15,9,15043,2232,3,358,575,286,62,31,1312,7,46,1365
15,9,15043,2233,3,227,615,292,91,29,1254,0,50,1304
15,9,15043,2234,3,319,559,286,93,44,1301,2,54,1357
15,9,15043,2235,3,59,101,90,12,3,265,0,13,278
15,9,15068,3903,3,544,310,645,100,48,1647,7,26,1680
15,9,15068,3904,3,650,339,587,87,63,1726,18,30,1774
15,9,15068,3905,3,694,298,561,111,57,1721,5,27,1753
15,9,15068,3906,3,413,268,324,43,20,1068,4,20,1092
15,9,15068,3907,3,329,208,313,59,29,938,9,9,956
15,9,15068,3908,3,310,162,154,20,7,653,3,13,669
15,9,15068,3909,3,372,302,396,22,18,1110,9,39,1158
15,9,15068,3910,3,296,289,339,42,17,983,11,38,1032
15,9,15068,3911,3,63,111,218,16,8,416,2,12,430
15,9,15068,3912,3,142,322,596,43,9,1112,17,63,1192
15,9,15068,3913,3,127,277,425,20,8,857,7,25,889
15,9,15068,3914,3,236,148,181,29,19,613,5,7,625
15,9,15068,3915,3,361,143,229,26,16,775,11,18,804
15,9,15068,3916,3,190,63,72,23,7,355,4,6,365
15,9,15068,3917,3,128,96,182,24,9,439,0,7,446
15,9,15068,3918,3,310,137,291,31,9,778,8,29,815
15,9,15068,3919,3,272,340,829,74,34,1549,6,25,1580
15,9,15068,3920,3,130,73,186,29,13,431,0,5,436
15,9,15068,3921,3,463,312,457,93,32,1357,12,18,1387
15,9,15068,3922,3,286,206,42,7,8,549,0,10,559
15,9,15068,3923,3,143,104,140,19,7,413,7,5,425
15,9,15068,3924,3,342,209,453,55,20,1079,6,31,1116
15,9,15068,3925,3,221,118,167,18,7,531,3,11,545
15,9,15068,3926,3,188,111,90,24,10,423,0,8,431
15,9,15075,4026,3,229,566,540,147,30,1512,7,29,1548
15,9,15075,4032,3,10,87,43,0,2,142,0,6,148
15,9,15075,4034,3,106,272,218,10,3,609,4,29,642
15,9,15075,4035,3,95,469,164,9,2,739,0,31,770
15,9,15075,4036,3,132,456,360,34,13,995,1,48,1044
15,9,15075,4037,3,291,600,777,100,77,1845,19,85,1949
15,9,15075,4038,3,178,292,353,40,12,875,1,36,912
15,9,15075,4039,3,164,266,308,21,6,765,5,25,795
15,9,15075,4040,3,106,215,320,28,3,672,5,27,704
15,9,15075,4041,3,101,338,238,21,12,710,0,41,751
15,9,15075,4042,3,148,385,229,20,5,787,7,66,860
15,9,15075,4043,3,198,310,279,30,13,830,3,59,892
15,9,15075,4051,3,201,266,251,14,3,735,7,46,788
15,9,15075,4052,3,78,158,160,5,1,402,2,25,429
15,9,15075,4053,3,140,336,363,26,9,874,0,48,922
15,9,15075,4054,3,46,210,142,8,5,411,0,39,450
15,9,15075,4055,3,136,238,138,16,9,537,6,29,572
15,9,15075,4056,3,75,159,57,13,4,308,0,32,340
15,9,15075,4057,3,285,440,260,149,5,1139,4,56,1199
15,9,15075,4058,3,111,116,59,13,1,300,2,18,320
15,9,15075,4059,3,312,440,319,161,21,1253,6,63,1322
15,9,15075,4060,3,93,266,180,8,9,556,1,48,605
15,9,15075,4061,3,296,413,323,22,6,1060,2,66,1128
15,9,15075,4068,3,71,125,130,6,4,336,0,11,347
15,9,15075,4069,3,503,496,426,34,4,1463,3,102,1568
15,9,15075,4070,3,89,445,368,5,6,913,3,80,996
15,9,15075,4071,3,58,167,347,5,5,582,1,30,613
15,9,15075,4072,3,78,763,556,16,6,1419,2,51,1472
15,9,15075,4073,3,48,68,58,0,0,174,5,14,193
15,9,15075,4074,3,272,297,161,11,6,747,6,64,817
15,9,15075,4075,3,309,631,250,23,19,1232,19,58,1309
15,9,15075,4076,3,133,389,249,12,8,791,2,42,835
15,9,15075,4077,3,98,449,202,21,10,780,2,38,820
15,9,15075,4078,3,186,435,491,42,8,1162,4,106,1272
15,9,15075,4079,3,184,209,251,14,7,665,4,26,695
15,9,15075,4086,3,7,61,75,1,0,144,0,6,150
15,9,15075,4087,3,145,234,262,31,10,682,1,21,704
15,9,15075,4088,3,110,196,231,7,4,548,1,16,565
15,9,15075,4089,3,214,346,361,95,13,1029,3,41,1073
15,9,15075,4090,3,348,238,205,30,4,825,3,55,883
15,9,15075,4097,3,26,233,77,4,2,342,1,13,356
15,9,15075,4100,3,8,60,54,2,1,125,0,6,131
15,9,15075,4103,3,128,226,145,17,4,520,3,38,561
15,9,15088,4403,3,581,454,341,75,44,1495,13,39,1547
15,9,15088,4404,3,135,130,127,5,4,401,0,13,414
15,9,15088,4405,3,97,223,342,5,2,669,0,32,701
15,9,15088,4406,3,155,451,621,30,11,1268,13,58,1339
15,9,15088,4407,3,110,190,217,15,9,541,2,23,566
15,9,15088,4408,3,245,460,486,37,21,1249,9,64,1322
15,9,15088,4409,3,119,216,270,14,3,622,0,35,657
15,9,15088,4410,3,28,252,299,28,7,614,2,24,640
15,9,15088,4411,3,85,221,215,17,4,542,2,27,571
15,9,15088,4412,3,207,156,99,9,4,475,3,15,493
15,9,15088,4413,3,241,218,368,25,33,885,10,37,932
15,9,15088,4414,3,75,202,363,13,9,662,2,25,689
15,9,15088,4415,3,106,403,429,14,9,961,11,21,993
15,9,15088,4416,3,229,279,318,29,24,879,5,34,918
15,9,15088,4417,3,208,292,555,42,26,1123,13,42,1178
15,9,15088,4418,3,228,313,255,34,19,849,8,26,883
15,9,15088,4419,3,586,365,578,64,50,1643,8,45,1696
15,9,15088,4420,3,210,179,214,17,5,625,7,35,667
15,9,15088,4421,3,504,259,165,30,19,977,23,13,1013
15,9,15088,4422,3,354,298,445,48,34,1179,29,20,1228
15,9,15088,4423,3,565,392,694,77,38,1766,25,41,1832
15,9,15088,4424,3,214,354,434,71,27,1100,14,23,1137
15,9,15088,4425,3,211,181,146,17,11,566,3,28,597
15,9,15088,4426,3,369,344,265,64,39,1081,15,20,1116
15,9,15088,4427,3,210,153,173,33,13,582,2,14,598
15,9,15088,4428,3,154,188,98,17,12,469,6,5,480
15,10,15034,1303,3,1074,1245,2951,337,214,5821,45,86,5952
15,10,15034,1305,3,257,291,787,101,52,1488,7,37,1532
15,10,15034,1306,3,375,364,900,130,80,1849,8,50,1907
15,10,15034,1319,3,198,205,525,52,29,1009,5,12,1026
15,10,15034,1320,3,240,219,530,64,38,1091,7,19,1117
15,10,15034,1321,3,759,688,1968,248,144,3807,18,44,3869
15,10,15034,1735,3,162,195,364,68,38,827,5,17,849
15,10,15034,1736,3,100,163,301,53,19,636,5,14,655
15,10,15034,1737,3,123,163,336,45,25,692,8,16,716
15,10,15034,1738,3,160,162,405,45,33,805,0,14,819
15,10,15034,1739,3,171,190,371,36,37,805,8,20,833
15,10,15034,1740,3,146,177,330,35,29,717,7,9,733
15,10,15034,1741,3,196,176,339,37,19,767,6,17,790
15,10,15034,1742,3,171,163,275,32,26,667,3,14,684
15,10,15034,1743,3,142,142,266,28,20,598,6,20,624
15,10,15034,1744,3,165,142,302,39,15,663,3,16,682
15,10,15034,1745,3,106,117,218,31,15,487,0,2,489
15,10,15034,1746,3,190,167,397,41,28,823,2,19,844
15,10,15034,1747,3,146,162,362,42,18,730,3,17,750
15,10,15034,1748,3,172,155,347,67,23,764,4,9,777
15,10,15034,1749,3,154,200,287,46,16,703,7,5,715
15,10,15034,1750,3,199,179,405,65,19,867,2,13,882
15,10,15034,1751,3,187,169,400,61,41,858,3,29,890
15,10,15034,1752,3,195,165,367,52,24,803,3,23,829
15,10,15034,1753,3,138,173,329,52,25,717,5,11,733
15,10,15034,1754,3,204,169,466,68,35,942,7,25,974
15,10,15034,1755,3,129,133,309,41,17,629,4,12,645
15,10,15034,1756,3,333,336,779,73,37,1558,2,43,1603
15,10,15034,1757,3,308,327,678,76,44,1433,7,35,1475
15,10,15034,1758,3,157,155,377,28,27,744,5,18,767
15,10,15034,1759,3,323,411,673,106,55,1568,6,44,1618
15,10,15034,1760,3,269,214,516,70,39,1108,2,33,1143
15,10,15034,1761,3,241,186,577,66,46,1116,6,14,1136
15,10,15034,1762,3,328,197,589,66,31,1211,10,21,1242
15,10,15034,1763,3,233,162,432,55,35,917,1,23,941
15,10,15034,1764,3,259,204,546,65,30,1104,7,33,1144
15,10,15034,1765,3,150,157,283,31,23,644,1,19,664
15,10,15034,1766,3,314,226,523,71,37,1171,10,24,1205
15,10,15034,1767,3,332,233,537,76,45,1223,17,19,1259
15,10,15034,1768,3,179,115,284,37,21,636,0,21,657
15,10,15034,1769,3,471,135,331,45,29,1011,1,16,1028
15,10,15034,1770,3,983,205,536,73,38,1835,1,39,1875
15,10,15034,1771,3,441,77,317,42,27,904,0,14,918
15,10,15034,1772,3,1250,621,1962,252,159,4244,11,50,4305
15,10,15034,1773,3,320,168,530,43,21,1082,1,22,1105
15,10,15034,1774,3,243,166,428,42,26,905,6,20,931
15,10,15034,1775,3,299,163,351,54,19,886,0,17,903
15,10,15034,1776,3,346,293,794,91,73,1597,6,22,1625
15,10,15034,1777,3,474,389,881,111,96,1951,13,14,1978
15,10,15034,1778,3,205,180,453,32,24,894,2,20,916
15,10,15034,1779,3,320,265,749,78,47,1459,1,25,1485
15,10,15034,1780,3,225,185,240,41,28,719,1,11,731
15,10,15034,1782,3,67,68,122,8,6,271,1,1,273
15,10,15034,1783,3,430,248,838,109,71,1696,5,16,1717
15,10,15034,1784,3,225,279,589,64,40,1197,16,22,1235
15,10,15034,1785,3,402,343,866,97,48,1756,11,49,1816
15,10,15034,1786,3,442,241,781,80,64,1608,3,31,1642
15,10,15034,1787,3,329,213,609,76,48,1275,2,28,1305
15,10,15034,1788,3,440,297,803,90,70,1700,5,34,1739
15,10,15034,1789,3,395,229,638,94,79,1435,8,27,1470
15,10,15034,1790,3,360,256,695,103,60,1474,7,23,1504
15,10,15034,1791,3,581,303,849,160,83,1976,4,35,2015
15,10,15034,1792,3,252,280,747,89,56,1424,9,33,1466
15,10,15034,1793,3,164,155,267,43,23,652,0,5,657
15,10,15034,1794,3,358,263,712,100,66,1499,6,25,1530
15,10,15034,1795,3,237,147,362,60,60,866,3,2,871
15,10,15034,1796,3,386,207,553,73,63,1282,3,21,1306
15,10,15034,1797,3,238,122,475,50,27,912,3,11,926
15,10,15034,1798,3,312,167,479,85,46,1089,8,9,1106
15,10,15034,1799,3,200,134,295,56,30,715,1,8,724
15,10,15034,1800,3,510,258,873,110,81,1832,1,26,1859
15,10,15034,1801,3,144,124,372,42,25,707,1,13,721
15,10,15034,1802,3,350,169,627,92,60,1298,7,10,1315
15,10,15034,1803,3,473,285,934,93,84,1869,18,32,1919
15,10,15034,1804,3,440,281,977,125,66,1889,12,30,1931
15,10,15034,1805,3,371,290,911,98,65,1735,7,25,1767
15,10,15034,1806,3,298,216,592,73,53,1232,9,7,1248
15,10,15034,1807,3,40,50,113,27,14,244,0,4,248
15,10,15034,1808,3,105,88,206,56,26,481,0,11,492
15,10,15034,1809,3,77,69,171,13,7,337,0,8,345
15,10,15034,1810,3,524,199,623,91,45,1482,3,26,1511
15,10,15034,1811,3,377,279,597,82,66,1401,5,24,1430
15,10,15034,1812,3,363,258,585,122,78,1406,1,22,1429
15,10,15034,1813,3,376,213,573,94,56,1312,4,12,1328
15,10,15034,1814,3,255,112,330,50,24,771,4,8,783
15,10,15034,1815,3,273,106,331,54,28,792,3,9,804
15,10,15034,1816,3,171,85,223,49,176,704,6,9,719
15,10,15034,1817,3,135,89,336,35,15,610,0,9,619
15,10,15034,1818,3,248,181,489,72,44,1034,1,18,1053
15,10,15034,1819,3,162,174,424,35,23,818,1,16,835
15,10,15034,1820,3,145,120,355,39,22,681,2,13,696
15,10,15034,1821,3,268,193,451,57,40,1009,4,14,1027
15,10,15034,1823,3,405,228,641,92,49,1415,7,14,1436
15,10,15034,1824,3,443,161,438,69,33,1144,4,13,1161
15,10,15034,1825,3,382,277,714,71,59,1503,2,17,1522
15,10,15034,1826,3,432,288,730,88,61,1599,9,32,1640
15,10,15034,1827,3,236,246,508,56,36,1082,5,15,1102
15,10,15034,1828,3,395,261,706,109,54,1525,5,22,1552
15,10,15034,1829,3,524,310,1020,144,80,2078,21,29,2128
15,10,15034,1830,3,408,268,974,90,63,1803,2,36,1841
15,10,15034,1831,3,283,175,509,52,47,1066,3,23,1092
15,10,15034,1832,3,446,268,703,78,59,1554,0,36,1590
15,10,15034,1833,3,363,199,619,78,88,1347,5,19,1371
15,10,15034,1834,3,392,258,792,105,77,1624,7,15,1646
15,10,15034,1835,3,145,132,288,23,25,613,2,15,630
15,10,15034,5991,3,59,88,206,21,8,382,7,0,389
15,10,15034,5992,3,58,71,180,21,7,337,1,8,346
15,10,15034,5993,3,84,92,282,32,17,507,4,7,518
15,10,15034,5994,3,71,129,236,27,14,477,0,14,491
15,10,15034,5995,3,68,80,176,19,6,349,3,17,369
15,10,15034,5996,3,75,81,236,22,13,427,3,10,440
15,10,15034,5997,3,88,116,195,38,9,446,7,13,466
15,10,15034,5998,3,77,147,230,25,12,491,4,7,502
15,10,15034,5999,3,64,130,217,30,10,451,5,18,474
15,10,15034,6000,3,62,104,306,37,18,527,2,10,539
15,10,15034,6001,3,85,94,181,19,8,387,9,11,407
15,10,15034,6002,3,89,135,232,58,17,531,7,7,545
15,10,15034,6003,3,75,94,234,29,5,437,1,6,444
15,10,15034,6004,3,52,49,174,25,9,309,0,0,309
15,10,15034,6005,3,79,78,194,21,16,388,1,6,395
15,10,15034,6006,3,132,97,242,31,20,522,0,15,537
15,10,15034,6007,3,57,58,137,17,6,275,1,4,280
15,10,15034,6008,3,51,37,112,13,3,216,1,3,220
15,10,15034,6009,3,134,113,263,41,15,566,1,9,576
15,10,15034,6010,3,87,93,140,18,20,358,1,1,360
15,10,15034,6011,3,37,52,108,16,8,221,0,4,225
15,10,15034,6012,3,87,73,187,28,16,391,0,5,396
15,10,15034,6013,3,127,83,195,35,25,465,3,2,470
15,10,15034,6014,3,172,115,291,52,36,666,1,11,678
15,10,15034,6015,3,88,61,164,25,18,356,0,3,359
15,10,15034,6016,3,43,42,94,18,9,206,0,3,209
15,10,15034,6017,3,109,86,215,37,16,463,3,5,471
15,10,15034,6018,3,163,109,270,35,34,611,1,8,620
15,10,15034,6019,3,133,77,188,39,15,452,2,3,457
15,10,15034,6020,3,76,51,237,42,16,422,7,8,437
15,10,15034,6021,3,91,66,234,38,26,455,0,7,462
15,10,15034,6022,3,143,99,293,49,38,622,0,11,633
15,10,15034,6023,3,36,35,81,93,5,250,0,3,253
15,10,15034,6024,3,109,82,202,36,16,445,2,7,454
15,10,15034,6025,3,50,36,81,11,9,187,0,0,187
15,10,15034,6026,3,118,53,167,18,9,365,1,4,370
15,10,15034,6027,3,244,157,386,80,41,908,1,11,920
15,10,15034,6028,3,109,130,300,48,23,610,8,5,623
15,10,15034,6029,3,84,96,192,22,10,404,0,5,409
15,10,15034,6030,3,67,60,256,23,14,420,2,8,430
15,10,15034,6031,3,25,19,60,14,5,123,2,1,126
15,10,15034,6032,3,98,62,159,24,15,358,1,4,363
15,10,15034,6033,3,50,59,150,24,8,291,0,3,294
15,10,15034,6034,3,98,96,287,22,15,518,6,9,533
15,10,15034,6035,3,122,41,140,27,18,348,0,0,348
15,10,15034,6036,3,64,82,245,40,13,444,2,8,454
15,10,15034,6037,3,116,128,326,53,28,651,0,15,666
15,10,15034,6038,3,133,125,235,33,20,546,1,8,555
15,10,15034,6039,3,159,95,211,38,17,520,0,4,524
15,10,15034,6040,3,129,61,243,32,21,486,0,1,487
15,10,15034,6041,3,130,81,274,24,24,533,1,4,538
15,10,15034,6042,3,140,72,278,45,27,562,2,3,567
15,10,15034,6043,3,111,49,152,22,18,352,2,7,361
15,10,15034,6044,3,91,84,284,30,18,507,2,11,520
15,10,15034,6045,3,32,22,70,5,3,132,0,4,136
15,10,15034,6046,3,28,47,147,17,8,247,0,4,251
15,10,15034,6047,3,59,90,211,14,11,385,5,9,399
15,10,15034,6048,3,62,35,106,95,6,304,0,0,304
15,10,15034,6049,3,107,113,292,36,19,567,1,19,587
15,11,15034,1302,3,298,400,614,113,50,1475,11,18,1504
15,11,15034,1307,3,308,257,679,83,78,1405,7,13,1425
15,11,15034,1308,3,381,174,412,61,53,1081,9,9,1099
15,11,15034,1309,3,252,142,311,48,32,785,0,11,796
15,11,15034,1310,3,300,188,299,68,42,897,5,11,913
15,11,15034,1311,3,196,233,359,59,26,873,9,13,895
15,11,15034,1312,3,105,151,210,72,25,563,2,8,573
15,11,15034,1313,3,130,139,235,42,26,572,0,5,577
15,11,15034,1314,3,90,158,267,59,31,605,0,9,614
15,11,15034,1315,3,110,162,273,45,26,616,1,6,623
15,11,15034,1316,3,186,475,463,55,26,1205,5,25,1235
15,11,15034,1317,3,341,427,627,93,49,1537,7,22,1566
15,11,15034,1318,3,267,345,730,80,53,1475,9,27,1511
15,11,15034,1323,3,291,274,487,54,32,1138,2,15,1155
15,11,15034,1324,3,257,266,602,83,56,1264,6,20,1290
15,11,15034,1325,3,156,184,453,50,29,872,8,19,899
15,11,15034,1326,3,132,182,368,61,28,771,9,12,792
15,11,15034,1327,3,211,266,667,63,19,1226,12,24,1262
15,11,15034,1328,3,222,272,572,71,54,1191,13,37,1241
15,11,15034,1329,3,268,272,584,65,46,1235,1,18,1254
15,11,15034,1330,3,325,307,473,53,37,1195,0,14,1209
15,11,15034,1331,3,474,451,494,104,58,1581,5,26,1612
15,11,15034,1332,3,183,207,327,40,21,778,3,17,798
15,11,15034,1333,3,183,234,264,47,26,754,1,20,775
15,11,15034,1334,3,290,345,491,68,52,1246,8,18,1272
15,11,15034,1335,3,432,407,739,132,76,1786,7,26,1819
15,11,15034,1336,3,234,221,475,55,37,1022,7,12,1041
15,11,15034,1337,3,184,253,390,69,31,927,4,13,944
15,11,15034,1338,3,157,246,414,58,30,905,6,19,930
15,11,15034,1339,3,180,318,634,82,44,1258,10,25,1293
15,11,15034,1340,3,192,287,602,86,45,1212,4,28,1244
15,11,15034,1341,3,293,226,459,92,45,1115,3,23,1141
15,11,15034,1342,3,227,200,283,47,43,800,0,11,811
15,11,15034,1343,3,223,146,256,57,33,715,0,4,719
15,11,15034,1344,3,432,236,536,105,50,1359,0,12,1371
15,11,15034,1345,3,469,235,467,97,54,1322,0,13,1335
15,11,15034,1346,3,162,199,395,41,17,814,12,22,848
15,11,15034,1347,3,303,312,609,68,41,1333,5,29,1367
15,11,15034,1348,3,232,271,692,59,48,1302,9,28,1339
15,11,15034,1349,3,154,281,532,45,25,1037,2,29,1068
15,11,15034,1350,3,344,159,369,50,37,959,2,22,983
15,11,15034,1352,3,166,222,426,54,20,888,5,45,938
15,11,15034,1353,3,103,265,274,38,16,696,0,25,721
15,11,15034,1394,3,174,304,519,48,36,1081,6,33,1120
15,11,15034,1395,3,129,251,431,74,24,909,3,29,941
15,11,15034,1396,3,308,326,590,117,56,1397,6,19,1422
15,11,15034,1397,3,312,215,528,93,43,1191,6,16,1213
15,11,15034,1398,3,290,242,590,76,26,1224,6,18,1248
15,11,15034,1399,3,194,186,525,39,33,977,8,20,1005
15,11,15034,1400,3,171,179,410,42,16,818,1,17,836
15,11,15034,1401,3,332,253,529,73,50,1237,5,19,1261
15,11,15034,1402,3,296,245,592,66,41,1240,2,16,1258
15,11,15034,1403,3,152,127,316,33,26,654,1,14,669
15,11,15034,1404,3,161,138,326,48,24,697,4,11,712
15,11,15034,1405,3,256,261,529,59,28,1133,3,9,1145
15,11,15034,1406,3,247,194,372,46,34,893,3,18,914
15,11,15034,1407,3,358,252,665,83,62,1420,4,40,1464
15,11,15034,1509,3,182,146,336,38,21,723,2,9,734
15,11,15034,1510,3,253,209,384,47,30,923,2,5,930
15,11,15034,1511,3,164,163,382,58,35,802,2,8,812
15,11,15034,1512,3,222,262,482,92,44,1102,0,12,1114
15,11,15034,1516,3,217,182,314,45,10,768,3,4,775
15,11,15034,1517,3,301,265,601,70,33,1270,6,24,1300
15,11,15034,1518,3,1076,767,1708,227,177,3955,15,51,4021
15,11,15034,1519,3,156,124,344,45,22,691,0,16,707
15,11,15034,1520,3,191,222,364,31,16,824,1,14,839
15,11,15034,1521,3,115,160,260,19,16,570,1,11,582
15,11,15034,1528,3,316,276,549,64,29,1234,1,21,1256
15,11,15034,1529,3,224,112,275,23,29,663,2,10,675
15,11,15034,1530,3,179,111,262,40,35,627,3,14,644
15,11,15034,1531,3,285,187,412,51,45,980,1,16,997
15,11,15034,1532,3,337,165,442,41,44,1029,2,19,1050
15,11,15034,1535,3,175,137,294,38,20,664,0,14,678
15,11,15034,1538,3,242,178,422,62,50,954,2,18,974
15,11,15034,1539,3,244,148,339,54,23,808,1,8,817
15,11,15034,1540,3,147,149,313,41,28,678,18,9,705
15,11,15034,1551,3,124,137,300,37,18,616,2,19,637
15,11,15034,1552,3,139,131,269,44,25,608,0,7,615
15,11,15034,1553,3,178,112,264,40,33,627,1,8,636
15,11,15034,1554,3,278,184,448,72,67,1049,4,18,1071
15,11,15034,1555,3,260,180,326,38,33,837,7,7,851
15,11,15034,1561,3,362,233,639,63,66,1363,10,11,1384
15,11,15034,1562,3,67,53,147,14,12,293,5,4,302
15,11,15034,1563,3,151,121,281,39,21,613,3,14,630
15,11,15034,1836,3,206,165,295,42,37,745,3,12,760
15,11,15034,1837,3,271,199,271,46,26,813,0,13,826
15,11,15034,1838,3,322,173,340,56,44,935,8,7,950
15,11,15034,1840,3,432,269,491,77,56,1325,2,12,1339
15,11,15034,1841,3,259,155,229,50,21,714,2,7,723
15,11,15034,1842,3,312,259,445,64,47,1127,6,22,1155
15,11,15034,1843,3,212,191,323,38,23,787,2,15,804
15,11,15034,1844,3,177,172,340,55,25,769,0,14,783
15,11,15034,1854,3,284,258,392,57,40,1031,2,16,1049
15,11,15034,1855,3,238,229,296,52,42,857,0,12,869
15,11,15034,1856,3,234,197,256,36,21,744,0,12,756
15,11,15034,1857,3,199,148,183,46,16,592,0,12,604
15,11,15034,1858,3,358,227,346,51,26,1008,3,5,1016
15,11,15034,1859,3,442,218,302,58,45,1065,2,15,1082
15,11,15034,1860,3,260,126,355,41,36,818,3,6,827
15,11,15034,1861,3,369,304,693,79,67,1512,15,29,1556
15,11,15034,1862,3,343,358,805,100,76,1682,6,14,1702
15,11,15034,1863,3,95,131,302,42,18,588,2,14,604
15,11,15034,1870,3,435,266,761,118,77,1657,0,20,1677
15,11,15034,1871,3,442,247,757,99,83,1628,10,23,1661
15,11,15034,1872,3,383,231,617,85,51,1367,7,23,1397
15,11,15034,1873,3,378,228,518,89,56,1269,7,12,1288
15,11,15034,1874,3,297,293,579,85,54,1308,5,13,1326
15,11,15034,1875,3,295,218,464,58,43,1078,1,20,1099
15,11,15034,1876,3,371,234,602,63,59,1329,5,12,1346
15,11,15034,1877,3,412,245,503,66,48,1274,0,15,1289
15,11,15034,1878,3,271,235,432,57,62,1057,3,15,1075
15,11,15034,1879,3,245,199,434,46,37,961,4,3,968
15,11,15034,1880,3,305,278,651,65,56,1355,4,15,1374
15,11,15034,1881,3,189,190,482,54,34,949,2,27,978
15,11,15034,1882,3,282,248,564,66,61,1221,1,16,1238
15,11,15034,1883,3,249,244,538,45,49,1125,5,24,1154
15,11,15034,1884,3,195,134,359,37,30,755,4,6,765
15,11,15034,1895,3,349,201,618,79,46,1293,1,25,1319
15,11,15034,1896,3,179,141,330,40,42,732,3,15,750
15,11,15034,1897,3,192,149,373,29,46,789,1,13,803
15,11,15034,1898,3,233,151,360,46,34,824,2,5,831
15,11,15034,1899,3,231,105,278,37,102,753,0,9,762
15,11,15034,1900,3,210,181,365,54,41,851,1,11,863
15,11,15034,1901,3,170,142,302,34,28,676,1,14,691
15,11,15034,1902,3,200,181,381,45,29,836,4,9,849
15,11,15034,1903,3,250,151,356,37,59,853,4,15,872
15,11,15034,1904,3,436,224,564,67,59,1350,0,14,1364
15,11,15034,1905,3,355,190,618,82,59,1304,3,24,1331
15,11,15034,1906,3,288,170,338,57,44,897,1,8,906
15,11,15034,1907,3,239,170,343,40,38,830,0,11,841
15,11,15034,1914,3,209,147,281,40,31,708,4,14,726
15,11,15034,1915,3,169,123,262,32,36,622,0,8,630
15,11,15034,1916,3,247,148,298,48,55,796,2,12,810
15,11,15034,1917,3,431,199,510,84,61,1285,1,23,1309
15,11,15034,1918,3,283,154,333,54,37,861,2,6,869
15,11,15034,1919,3,255,161,269,23,27,735,0,7,742
15,11,15034,1920,3,526,198,382,83,46,1235,3,13,1251
15,11,15034,1921,3,281,167,328,50,31,857,1,12,870
15,11,15034,1922,3,393,222,465,65,56,1201,3,14,1218
15,11,15034,1923,3,258,157,335,45,38,833,2,12,847
15,11,15034,1924,3,373,220,514,55,51,1213,6,20,1239
15,11,15034,1925,3,352,200,412,68,28,1060,1,13,1074
15,11,15034,1926,3,291,134,293,54,33,805,3,13,821
15,11,15034,1939,3,284,214,526,63,45,1132,6,14,1152
15,11,15034,1940,3,364,292,569,69,58,1352,6,32,1390
15,11,15034,1941,3,322,191,509,61,48,1131,1,19,1151
15,11,15034,1942,3,390,199,479,47,57,1172,1,24,1197
15,11,15034,1943,3,113,177,362,49,25,726,6,15,747
15,11,15034,1944,3,201,228,466,57,38,990,2,23,1015
15,11,15034,1945,3,215,196,532,51,34,1028,1,18,1047
15,11,15034,1951,3,154,177,410,71,30,842,3,27,872
15,12,15026,937,3,298,492,1391,112,102,2395,18,128,2541
15,12,15026,938,3,60,77,183,25,18,363,2,0,365
15,12,15026,966,3,166,189,606,52,44,1057,9,13,1079
15,12,15026,967,3,123,178,519,80,40,940,5,11,956
15,12,15026,986,3,132,162,430,53,33,810,5,20,835
15,12,15026,987,3,191,211,626,59,57,1144,12,28,1184
15,12,15026,988,3,436,456,1339,165,130,2526,12,70,2608
15,12,15026,991,3,267,231,660,113,88,1359,15,18,1392
15,12,15026,992,3,433,328,1076,155,116,2108,20,30,2158
15,12,15026,995,3,551,584,1803,193,186,3317,18,101,3436
15,12,15026,1044,3,279,302,664,82,47,1374,8,24,1406
15,12,15026,1045,3,121,175,280,36,27,639,0,15,654
15,12,15026,1046,3,98,190,301,50,34,673,6,19,698
15,12,15026,1048,3,105,145,200,56,24,530,3,17,550
15,12,15026,1049,3,258,287,424,104,41,1114,4,36,1154
15,12,15026,1050,3,175,225,435,70,36,941,9,11,961
15,12,15040,2073,3,529,789,1452,218,134,3122,19,281,3422
15,12,15040,2074,3,208,330,429,38,36,1041,9,62,1112
15,12,15040,2075,3,187,189,395,59,24,854,8,27,889
15,12,15040,2076,3,158,112,195,46,8,519,2,10,531
15,12,15040,2077,3,448,395,945,81,67,1936,16,36,1988
15,12,15040,2078,3,270,560,711,66,63,1670,18,28,1716
15,12,15040,2079,3,63,168,221,45,33,530,2,45,577
15,12,15040,2080,3,63,135,334,54,36,622,4,63,689
15,12,15040,2082,3,230,362,640,53,50,1335,0,26,1361
15,12,15040,2087,3,128,70,258,49,36,541,0,7,548
15,12,15040,2088,3,315,633,1170,201,131,2450,8,475,2933
15,12,15040,2089,3,233,387,890,96,62,1668,9,30,1707
15,12,15040,2090,3,120,99,400,41,16,676,5,15,696
15,12,15040,2091,3,85,105,394,37,27,648,3,23,674
15,12,15040,2092,3,56,133,237,39,25,490,9,72,571
15,12,15040,2093,3,287,322,549,56,57,1271,9,17,1297
15,12,15040,2094,3,226,479,425,50,19,1199,1,28,1228
15,12,15040,2095,3,393,549,824,113,69,1948,2,52,2002
15,12,15040,2097,3,516,443,1053,128,99,2239,4,19,2262
15,12,15040,2098,3,138,252,302,30,15,737,1,20,758
15,12,15040,2099,3,537,335,670,114,72,1728,1,24,1753
15,12,15040,2100,3,218,328,392,31,32,1001,0,31,1032
15,12,15040,2101,3,229,497,457,54,49,1286,4,51,1341
15,12,15040,2102,3,62,123,224,18,8,435,1,9,445
15,12,15040,2103,3,134,240,486,48,25,933,3,16,952
15,12,15040,2104,3,94,131,315,22,18,580,1,15,596
15,12,15040,2105,3,72,113,207,23,16,431,1,3,435
15,12,15040,2106,3,164,193,582,61,50,1050,4,16,1070
15,12,15040,2107,3,189,260,596,65,42,1152,3,30,1185
15,12,15040,2108,3,166,220,445,59,45,935,1,26,962
15,12,15040,2109,3,177,198,380,52,38,845,1,19,865
15,12,15040,2110,3,211,165,430,67,37,910,2,3,915
15,12,15040,2111,3,194,194,581,82,35,1086,2,22,1110
15,12,15040,2112,3,182,140,401,69,24,816,0,10,826
15,12,15040,2113,3,79,50,184,36,22,371,2,9,382
15,12,15040,2122,3,173,161,383,51,37,805,2,12,819
15,12,15040,2123,3,223,227,658,86,33,1227,4,16,1247
15,12,15040,2124,3,111,166,453,60,41,831,3,17,851
15,12,15040,2125,3,209,169,541,54,40,1013,1,19,1033
15,12,15040,2126,3,114,127,322,24,23,610,3,14,627
15,12,15040,2127,3,179,126,364,42,30,741,2,13,756
15,12,15040,2128,3,211,280,628,64,38,1221,9,21,1251
15,12,15040,2129,3,1286,875,2644,382,298,5485,13,84,5582
15,12,15040,2130,3,160,149,428,55,38,830,4,27,861
15,12,15040,2131,3,178,178,506,45,21,928,5,20,953
15,12,15040,2132,3,162,234,532,61,36,1025,2,16,1043
15,12,15040,2133,3,228,276,757,98,53,1412,0,49,1461
15,12,15040,2134,3,169,147,476,52,33,877,3,8,888
15,12,15040,2135,3,177,230,518,67,53,1045,1,24,1070
15,12,15040,2136,3,204,156,486,63,52,961,8,21,990
15,12,15040,2137,3,116,146,401,53,29,745,0,17,762
15,12,15040,2138,3,87,156,320,30,28,621,6,5,632
15,12,15040,2139,3,147,167,480,59,36,889,2,19,910
15,12,15040,2140,3,157,168,411,51,33,820,3,30,853
15,12,15040,2141,3,114,145,386,48,29,722,7,16,745
15,12,15040,2142,3,84,95,296,31,10,516,2,21,539
15,12,15040,2143,3,171,179,641,72,40,1103,1,30,1134
15,12,15040,2144,3,128,172,431,44,36,811,1,26,838
15,12,15040,2145,3,85,100,342,21,22,570,1,12,583
15,12,15040,2146,3,103,117,289,33,20,562,2,11,575
15,12,15040,2147,3,73,129,350,52,34,638,0,18,656
15,12,15040,2148,3,76,154,323,37,30,620,0,21,641
15,12,15040,2149,3,224,217,855,150,35,1481,8,34,1523
15,12,15040,2150,3,281,221,891,187,58,1638,10,25,1673
15,12,15040,2151,3,186,645,419,27,10,1287,3,41,1331
15,12,15040,2152,3,171,494,330,15,13,1023,19,25,1067
15,12,15040,2153,3,86,353,479,64,6,988,4,32,1024
15,12,15040,2154,3,189,347,679,127,50,1392,5,38,1435
15,12,15040,2155,3,330,497,1121,169,80,2197,9,79,2285
15,12,15040,2156,3,137,285,386,98,26,932,4,25,961
15,12,15040,2157,3,93,246,328,70,9,746,1,21,768
15,12,15040,2158,3,180,274,484,151,37,1126,0,25,1151
15,12,15040,2159,3,202,448,754,104,34,1542,3,62,1607
15,12,15040,2160,3,78,224,236,21,8,567,1,20,588
15,12,15040,2161,3,98,262,374,34,12,780,2,16,798
15,12,15040,2162,3,170,436,812,51,47,1516,1,33,1550
15,12,15040,2163,3,722,813,1971,296,234,4036,15,315,4366
15,12,15040,6050,3,26,49,162,12,13,262,0,23,285
15,12,15040,6051,3,23,99,143,20,18,303,1,55,359
15,12,15040,6052,3,41,167,147,22,19,396,6,54,456
15,12,15040,6053,3,16,84,82,20,8,210,2,24,236
15,12,15040,6054,3,33,82,122,25,16,278,1,22,301
15,12,15040,6055,3,38,139,199,24,17,417,1,43,461
15,12,15040,6056,3,44,145,183,31,26,429,1,42,472
15,12,15040,6057,3,36,200,156,38,26,456,1,43,500
15,12,15040,6058,3,30,100,137,22,9,298,9,43,350
15,12,15040,6059,3,40,163,192,50,19,464,0,16,480
15,12,15040,6060,3,35,91,175,23,16,340,2,7,349
15,12,15040,6061,3,70,114,184,49,27,444,9,18,471
15,12,15040,6062,3,36,125,139,22,23,345,2,33,380
15,12,15040,6063,3,52,103,265,25,21,466,0,14,480
15,12,15040,6064,3,39,92,266,28,22,447,0,8,455
15,12,15040,6065,3,68,80,159,15,15,337,0,0,337
15,12,15040,6066,3,58,71,142,15,19,305,1,4,310
15,12,15040,6067,3,64,56,127,16,15,278,1,2,281
15,12,15040,6068,3,53,46,98,12,11,220,2,5,227
15,12,15040,6069,3,88,66,211,24,25,414,0,0,414
15,12,15040,6070,3,21,25,88,13,12,159,0,4,163
15,12,15040,6071,3,31,37,110,19,14,211,0,5,216
15,12,15040,6072,3,44,30,114,13,10,211,0,6,217
15,12,15040,6073,3,62,58,144,14,0,278,2,0,280
15,12,15040,6074,3,49,47,121,21,15,253,0,6,259
15,12,15040,6075,3,57,64,170,19,21,331,0,4,335
15,12,15040,6076,3,76,68,170,12,14,340,0,5,345
15,12,15040,6077,3,62,87,155,21,13,338,0,7,345
15,12,15040,6078,3,116,67,215,25,27,450,1,2,453
15,12,15040,6079,3,91,78,199,37,27,432,2,6,440
15,12,15040,6080,3,50,36,143,21,9,259,0,1,260
15,12,15040,6081,3,69,62,236,25,27,419,1,4,424
15,12,15040,6082,3,68,52,229,32,17,398,1,4,403
15,12,15040,6083,3,49,47,141,18,10,265,0,6,271
15,12,15040,6084,3,54,52,151,25,12,294,0,4,298
15,12,15040,6085,3,35,30,84,5,5,159,0,0,159
15,12,15040,6086,3,71,24,141,13,8,257,1,4,262
15,12,15040,6087,3,113,108,276,38,25,560,0,21,581
15,12,15040,6088,3,131,100,222,45,19,517,0,1,518
15,12,15040,6089,3,81,80,229,34,23,447,0,5,452
15,12,15040,6090,3,39,44,98,18,13,212,0,5,217
15,12,15040,6091,3,76,38,151,14,16,295,0,4,299
15,12,15040,6092,3,72,46,184,15,21,338,0,2,340
15,12,15040,6093,3,83,70,213,21,32,419,0,8,427
15,12,15040,6094,3,73,33,109,11,11,237,0,9,246
15,12,15040,6095,3,71,59,195,32,21,378,1,6,385
15,12,15040,6096,3,54,42,172,26,20,314,0,1,315
15,12,15040,6097,3,99,79,297,27,30,532,1,6,539
15,12,15040,6098,3,73,103,264,34,13,487,2,3,492
15,12,15040,6099,3,75,56,188,27,15,361,1,8,370
15,12,15040,6100,3,34,34,58,10,7,143,0,3,146
15,12,15040,6101,3,45,68,144,23,6,286,2,1,289
15,12,15040,6102,3,86,53,192,24,20,375,2,1,378
15,12,15040,6103,3,73,49,176,33,13,344,0,4,348
15,12,15040,6104,3,71,42,166,19,18,316,0,5,321
15,12,15040,6105,3,35,21,62,8,7,133,0,4,137
15,12,15040,6106,3,48,67,112,16,8,251,0,6,257
15,12,15040,6107,3,95,111,158,19,13,396,1,10,407
15,12,15040,6108,3,80,66,193,17,18,374,0,15,389
15,12,15040,6109,3,34,17,52,9,3,115,0,1,116
15,12,15040,6110,3,71,35,138,21,20,285,0,0,285
15,12,15040,6111,3,59,70,140,23,11,303,0,4,307
15,12,15040,6112,3,110,49,178,29,21,387,0,4,391
15,12,15040,6113,3,62,30,106,23,18,239,0,3,242
15,12,15040,6114,3,67,70,133,20,13,303,2,3,308
15,12,15040,6115,3,48,28,65,17,12,170,1,4,175
15,12,15040,6116,3,37,23,82,15,13,170,2,4,176
15,12,15040,6117,3,52,49,119,22,22,264,0,3,267
15,12,15040,6118,3,51,34,99,23,9,216,0,0,216
15,12,15040,6119,3,51,24,112,17,12,216,0,2,218
15,12,15040,6120,3,51,50,196,32,19,348,0,3,351
15,12,15040,6121,3,107,66,181,29,23,406,0,6,412
15,12,15040,6122,3,27,39,77,11,4,158,0,0,158
15,12,15040,6123,3,49,42,130,18,11,250,0,3,253
15,12,15040,6124,3,61,37,125,18,11,252,0,6,258
15,12,15040,6125,3,82,67,200,24,22,395,0,7,402
15,12,15040,6126,3,79,45,151,25,19,319,1,2,322
15,12,15040,6127,3,144,90,290,38,20,582,2,8,592
15,12,15040,6128,3,45,52,94,15,7,213,1,3,217
15,12,15040,6129,3,86,45,162,31,21,345,4,1,350
15,12,15040,6130,3,37,12,68,7,5,129,0,3,132
15,12,15040,6131,3,50,28,75,25,17,195,0,1,196
15,12,15040,6132,3,139,85,256,72,26,578,2,8,588
15,12,15040,6133,3,116,50,186,45,14,411,0,7,418
15,12,15040,6134,3,53,43,173,31,16,316,1,3,320
15,12,15040,6135,3,104,66,204,45,33,452,0,2,454
15,12,15040,6136,3,87,64,178,39,10,378,0,7,385
15,12,15040,6137,3,126,50,165,29,30,400,0,6,406
15,12,15040,6138,3,41,24,68,21,14,168,0,0,168
15,12,15040,6139,3,48,25,49,18,6,146,0,1,147
15,12,15040,6140,3,49,21,110,11,8,199,0,2,201
15,12,15040,6141,3,62,43,176,24,14,319,0,5,324
15,12,15040,6142,3,37,41,92,16,21,207,2,3,212
15,12,15040,6143,3,37,51,124,26,9,247,0,1,248
15,12,15040,6144,3,32,35,120,21,6,214,0,0,214
15,12,15040,6145,3,59,42,149,19,15,284,0,5,289
15,12,15040,6146,3,75,60,192,37,21,385,1,6,392
15,12,15040,6147,3,125,102,311,41,30,609,1,9,619
15,12,15040,6148,3,77,188,289,33,28,615,4,88,707
15,12,15040,6149,3,56,61,194,31,21,363,0,6,369
15,12,15040,6150,3,34,29,90,10,9,172,0,2,174
15,12,15040,6151,3,74,52,218,28,18,390,2,3,395
15,12,15040,6152,3,49,55,134,15,15,268,1,3,272
15,12,15040,6153,3,34,46,89,5,6,180,0,2,182
15,12,15040,6154,3,32,20,99,13,7,171,0,5,176
15,12,15040,6155,3,44,62,101,14,9,230,1,5,236
15,12,15040,6156,3,29,18,114,12,9,182,0,3,185
15,12,15040,6157,3,27,24,97,9,9,166,3,0,169
15,12,15040,6158,3,31,41,127,11,4,214,0,0,214
15,12,15040,6159,3,41,46,122,11,7,227,1,0,228
15,12,15040,6160,3,79,57,232,27,18,413,3,9,425
15,12,15040,6161,3,85,129,361,42,26,643,3,11,657
15,12,15040,6162,3,69,64,125,17,6,281,2,4,287
15,12,15040,6163,3,36,47,119,22,9,233,1,4,238
15,12,15040,6164,3,38,43,120,9,5,215,4,1,220
15,12,15040,6165,3,75,79,214,26,26,420,2,8,430
15,12,15040,6166,3,54,53,136,11,22,276,2,3,281
15,12,15040,6167,3,36,47,154,16,12,265,2,0,267
15,12,15040,6168,3,40,33,110,22,8,213,0,0,213
15,12,15040,6169,3,64,34,220,4,16,338,8,1,347
15,12,15040,6170,3,36,31,89,6,10,172,1,2,175
15,13,15034,1408,3,292,304,757,112,66,1531,6,38,1575
15,13,15034,1409,3,129,165,381,49,31,755,0,14,769
15,13,15034,1410,3,226,186,453,54,32,951,10,28,989
15,13,15034,1411,3,326,230,628,83,48,1315,2,32,1349
15,13,15034,1412,3,292,265,572,55,41,1225,6,35,1266
15,13,15034,1413,3,337,152,420,55,33,997,2,16,1015
15,13,15034,1414,3,133,105,249,41,11,539,5,8,552
15,13,15034,1415,3,113,123,222,27,11,496,3,4,503
15,13,15034,1416,3,269,164,507,53,25,1018,7,16,1041
15,13,15034,1417,3,256,167,407,50,43,923,5,13,941
15,13,15034,1418,3,250,196,582,60,51,1139,3,16,1158
15,13,15034,1419,3,289,203,646,63,50,1251,0,18,1269
15,13,15034,1420,3,118,95,295,32,28,568,0,12,580
15,13,15034,1421,3,254,209,682,79,58,1282,11,15,1308
15,13,15034,1422,3,217,215,570,64,23,1089,3,17,1109
15,13,15034,1423,3,374,169,635,76,55,1309,8,20,1337
15,13,15034,1424,3,151,182,418,47,34,832,0,18,850
15,13,15034,1425,3,147,125,329,40,20,661,3,9,673
15,13,15034,1426,3,364,160,472,85,52,1133,0,13,1146
15,13,15034,1430,3,209,85,267,47,34,642,6,6,654
15,13,15034,1431,3,380,144,506,67,59,1156,0,8,1164
15,13,15034,1432,3,218,162,494,58,29,961,4,20,985
15,13,15034,1433,3,240,192,460,55,33,980,1,17,998
15,13,15034,1434,3,190,144,331,41,24,730,3,13,746
15,13,15034,1435,3,167,107,313,30,17,634,2,5,641
15,13,15034,1436,3,187,137,266,32,23,645,0,22,667
15,13,15034,1437,3,187,148,306,28,26,695,6,13,714
15,13,15034,1438,3,153,123,375,38,22,711,8,13,732
15,13,15034,1439,3,202,176,484,66,47,975,5,12,992
15,13,15034,1440,3,165,162,479,43,23,872,0,21,893
15,13,15034,1441,3,237,169,450,48,21,925,13,24,962
15,13,15034,1442,3,134,141,305,44,27,651,1,9,661
15,13,15034,1443,3,351,185,500,84,48,1168,2,16,1186
15,13,15034,1444,3,373,147,524,66,47,1157,0,12,1169
15,13,15034,1445,3,219,206,533,85,40,1083,6,21,1110
15,13,15034,1446,3,158,133,413,49,30,783,2,12,797
15,13,15034,1447,3,227,143,569,66,52,1057,8,10,1075
15,13,15034,1448,3,496,309,923,114,78,1920,10,30,1960
15,13,15034,1449,3,235,212,623,54,44,1168,6,9,1183
15,13,15034,1450,3,296,176,461,55,45,1033,1,24,1058
15,13,15034,1451,3,161,105,216,40,17,539,3,18,560
15,13,15034,1452,3,156,147,319,35,29,686,3,8,697
15,13,15034,1453,3,125,117,304,34,26,606,2,9,617
15,13,15034,1454,3,245,151,494,68,40,998,5,18,1021
15,13,15034,1455,3,264,157,431,53,48,953,3,14,970
15,13,15034,1456,3,199,153,428,45,39,864,3,16,883
15,13,15034,1457,3,275,111,289,51,37,763,3,12,778
15,13,15034,1458,3,294,110,356,55,51,866,4,12,882
15,13,15034,1459,3,186,67,197,33,29,512,1,9,522
15,13,15034,1460,3,186,70,186,33,18,493,0,8,501
15,13,15034,1463,3,228,110,384,47,25,794,6,15,815
15,13,15034,1464,3,170,110,343,44,33,700,1,10,711
15,13,15034,1465,3,222,164,420,34,28,868,1,18,887
15,13,15034,1466,3,225,142,504,69,36,976,4,19,999
15,13,15034,1467,3,142,134,388,28,31,723,0,20,743
15,13,15034,1468,3,240,178,528,36,45,1027,3,27,1057
15,13,15034,1469,3,183,147,345,30,16,721,3,8,732
15,13,15034,1470,3,221,122,424,47,46,860,7,28,895
15,13,15034,1471,3,152,129,367,24,31,703,3,10,716
15,13,15034,1472,3,190,137,451,46,40,864,0,12,876
15,13,15034,1473,3,195,138,411,41,34,819,2,9,830
15,13,15034,1474,3,193,149,458,56,43,899,2,17,918
15,13,15034,1475,3,301,181,547,65,33,1127,6,17,1150
15,13,15034,1476,3,235,118,422,23,38,836,4,22,862
15,13,15034,1477,3,193,139,471,66,29,898,1,33,932
15,13,15034,1478,3,211,171,538,106,54,1080,6,17,1103
15,13,15034,1479,3,422,187,599,67,68,1343,1,16,1360
15,13,15034,1486,3,330,187,294,79,41,931,2,8,941
15,13,15034,1487,3,192,88,399,36,18,733,4,14,751
15,13,15034,1488,3,201,106,409,39,17,772,2,16,790
15,13,15034,1489,3,161,74,224,18,13,490,3,9,502
15,13,15034,1490,3,135,114,256,24,24,553,1,9,563
15,13,15034,1491,3,177,157,291,38,27,690,1,22,713
15,13,15034,1492,3,193,256,403,55,37,944,1,24,969
15,13,15034,1493,3,144,78,303,29,20,574,1,6,581
15,13,15034,1494,3,248,94,331,34,26,733,2,14,749
15,13,15034,1495,3,232,142,351,30,29,784,2,9,795
15,13,15034,1496,3,345,160,357,37,25,924,0,9,933
15,13,15034,1497,3,199,78,365,32,25,699,2,15,716
15,13,15034,1498,3,198,131,497,49,45,920,5,18,943
15,13,15034,1533,3,254,117,374,49,47,841,5,9,855
15,13,15034,1534,3,315,220,574,55,47,1211,4,17,1232
15,13,15034,1536,3,336,180,628,70,47,1261,0,31,1292
15,13,15034,1537,3,329,184,463,80,48,1104,11,27,1142
15,13,15034,1556,3,217,158,630,60,38,1103,6,6,1115
15,13,15034,1557,3,233,199,618,51,40,1141,2,18,1161
15,13,15034,1558,3,252,212,701,65,46,1276,4,25,1305
15,13,15034,1559,3,212,155,595,50,47,1059,5,15,1079
15,13,15034,1560,3,181,167,425,65,35,873,3,5,881
15,13,15034,1570,3,281,235,524,64,34,1138,5,32,1175
15,13,15034,1571,3,250,167,435,47,48,947,6,17,970
15,13,15034,1572,3,159,124,450,51,26,810,8,8,826
15,13,15034,1573,3,209,125,475,70,27,906,1,22,929
15,13,15034,1574,3,305,161,457,78,32,1033,2,18,1053
15,13,15034,1575,3,269,176,408,52,41,946,5,14,965
15,13,15034,1576,3,181,154,353,29,30,747,8,4,759
15,13,15034,1577,3,105,92,286,21,15,519,1,3,523
15,13,15034,1578,3,217,168,437,54,37,913,6,10,929
15,13,15034,1579,3,224,154,408,38,49,873,5,13,891
15,13,15034,1580,3,291,185,532,60,45,1113,3,19,1135
15,13,15034,1591,3,203,152,513,40,43,951,8,17,976
15,13,15034,1592,3,220,194,408,61,46,929,3,17,949
15,13,15034,1593,3,109,110,203,26,23,471,1,11,483
15,13,15034,1594,3,192,84,215,28,29,548,4,11,563
15,13,15034,1595,3,182,139,321,47,39,728,3,7,738
15,13,15034,1596,3,176,142,349,32,35,734,2,5,741
15,13,15034,1597,3,166,211,442,63,50,932,2,9,943
15,13,15034,1598,3,207,140,436,53,32,868,3,18,889
15,13,15034,1599,3,132,92,249,35,21,529,1,11,541
15,13,15034,1600,3,87,80,182,17,13,379,1,13,393
15,13,15034,1601,3,83,51,141,13,10,298,1,3,302
15,13,15034,1602,3,177,134,355,41,24,731,2,17,750
15,13,15034,1603,3,147,105,294,51,17,614,0,11,625
15,13,15034,1604,3,190,166,441,51,36,884,3,22,909
15,13,15034,1605,3,180,216,497,59,40,992,1,20,1013
15,13,15034,1606,3,244,209,541,56,58,1108,7,29,1144
15,13,15034,1607,3,255,215,531,49,41,1091,2,19,1112
15,13,15034,1608,3,99,91,187,29,15,421,4,6,431
15,13,15034,1609,3,200,170,371,57,24,822,0,16,838
15,13,15034,1610,3,129,131,284,43,19,606,6,7,619
15,13,15034,1611,3,112,94,209,37,24,476,2,8,486
15,13,15034,1612,3,201,190,461,49,45,946,1,22,969
15,13,15034,1613,3,228,173,493,58,27,979,1,21,1001
15,13,15034,1614,3,184,147,287,35,20,673,6,13,692
15,13,15034,1615,3,137,127,361,37,24,686,1,8,695
15,13,15034,1616,3,148,109,304,40,13,614,2,11,627
15,13,15034,1617,3,111,91,257,22,25,506,4,8,518
15,13,15034,1618,3,185,151,478,41,22,877,5,19,901
15,13,15034,1642,3,178,111,351,40,44,724,2,3,729
15,13,15034,1643,3,220,147,418,68,47,900,1,15,916
15,13,15034,1644,3,176,149,410,58,35,828,1,39,868
15,13,15034,1645,3,198,184,409,58,43,892,6,12,910
15,13,15034,1646,3,197,126,384,33,19,759,3,11,773
15,13,15034,1647,3,253,308,502,97,63,1223,5,11,1239
15,13,15034,1648,3,221,134,441,40,40,876,2,9,887
15,13,15034,1649,3,220,199,546,57,51,1073,3,19,1095
15,13,15034,1650,3,243,139,527,51,30,990,5,24,1019
15,13,15034,1651,3,173,123,267,32,16,611,0,13,624
15,13,15034,1652,3,124,78,279,35,20,536,1,12,549
15,13,15034,1653,3,145,83,287,31,32,578,2,12,592
15,13,15034,1654,3,105,111,294,34,22,566,2,6,574
15,13,15034,1655,3,273,154,451,54,30,962,2,30,994
15,13,15034,1656,3,150,146,306,31,26,659,0,13,672
15,13,15034,1657,3,113,141,289,32,21,596,4,7,607
15,13,15034,1658,3,249,245,468,58,34,1054,6,17,1077
15,13,15034,1659,3,215,217,528,59,32,1051,5,28,1084
15,13,15034,1660,3,244,116,386,64,37,847,2,16,865
15,13,15034,1661,3,235,149,409,52,58,903,2,21,926
15,13,15034,1662,3,197,155,378,56,58,844,1,6,851
15,13,15034,1663,3,188,160,399,64,37,848,1,11,860
15,13,15034,1664,3,123,104,236,33,36,532,2,2,536
15,13,15034,1665,3,172,95,261,45,38,611,6,11,628
15,13,15034,1688,3,181,141,408,47,36,813,0,7,820
15,13,15034,1689,3,150,103,326,23,29,631,1,6,638
15,13,15034,1690,3,171,108,295,30,27,631,1,13,645
15,13,15034,1691,3,279,187,615,80,45,1206,4,19,1229
15,13,15034,1692,3,226,178,533,50,38,1025,3,22,1050
15,13,15034,1693,3,200,197,421,38,37,893,1,18,912
15,13,15034,1694,3,220,174,599,76,58,1127,2,27,1156
15,13,15034,1695,3,212,125,439,53,41,870,4,8,882
15,13,15034,1696,3,224,130,563,60,16,993,12,20,1025
15,13,15034,1697,3,211,168,494,58,37,968,2,15,985
15,13,15034,1698,3,192,130,468,66,44,900,7,18,925
15,13,15034,1710,3,144,188,451,40,52,875,6,12,893
15,13,15034,1711,3,166,196,586,52,35,1035,9,10,1054
15,13,15034,1946,3,401,197,525,81,56,1260,4,19,1283
15,13,15034,1947,3,372,174,488,52,42,1128,3,16,1147
15,13,15034,1948,3,313,163,527,67,30,1100,2,19,1121
15,13,15034,1949,3,379,176,411,69,45,1080,0,4,1084
15,13,15034,1950,3,194,98,240,26,25,583,2,8,593
15,14,15013,251,3,392,261,369,51,50,1123,1,26,1150
15,14,15013,252,3,434,344,377,66,60,1281,12,27,1320
15,14,15013,253,3,351,251,367,55,51,1075,3,18,1096
15,14,15013,254,3,513,330,425,74,55,1397,2,27,1426
15,14,15013,255,3,471,361,508,81,62,1483,0,22,1505
15,14,15013,256,3,709,401,549,107,63,1829,7,29,1865
15,14,15013,257,3,505,324,542,101,64,1536,6,22,1564
15,14,15013,258,3,864,475,844,122,106,2411,6,47,2464
15,14,15013,259,3,345,109,187,54,40,735,0,4,739
15,14,15013,260,3,547,68,163,55,61,894,1,7,902
15,14,15013,261,3,740,359,761,150,98,2108,2,51,2161
15,14,15013,262,3,925,678,966,145,67,2781,23,53,2857
15,14,15013,263,3,615,395,672,105,81,1868,11,17,1896
15,14,15013,264,3,416,186,394,83,57,1136,4,21,1161
15,14,15013,265,3,625,106,184,57,50,1022,2,9,1033
15,14,15013,266,3,363,54,156,31,37,641,0,2,643
15,14,15013,267,3,481,104,140,39,47,811,0,3,814
15,14,15013,268,3,296,131,198,54,60,739,1,8,748
15,14,15013,269,3,219,45,75,17,16,372,0,2,374
15,14,15013,270,3,489,256,473,74,57,1349,4,28,1381
15,14,15013,271,3,594,365,627,96,64,1746,12,35,1793
15,14,15013,272,3,1306,939,1569,169,116,4099,38,78,4215
15,14,15013,273,3,323,333,440,50,38,1184,16,20,1220
15,14,15013,274,3,519,352,507,74,55,1507,10,27,1544
15,14,15013,275,3,445,295,506,91,52,1389,8,19,1416
15,14,15013,276,3,835,470,707,126,104,2242,8,51,2301
15,14,15013,277,3,380,283,335,48,50,1096,2,37,1135
15,14,15013,278,3,574,322,664,90,63,1713,3,16,1732
15,14,15013,280,3,1324,173,177,60,66,1800,0,14,1814
15,14,15013,281,3,1709,252,194,81,73,2309,2,9,2320
15,14,15013,282,3,629,374,569,87,49,1708,7,57,1772
15,14,15013,283,3,573,394,486,88,68,1609,6,46,1661
15,14,15013,284,3,220,111,207,36,33,607,20,4,631
15,14,15013,285,3,327,148,261,54,31,821,0,12,833
15,14,15013,286,3,159,90,143,31,14,437,3,5,445
15,14,15013,287,3,506,463,645,91,65,1770,7,68,1845
15,14,15013,288,3,648,543,714,97,59,2061,3,61,2125
15,14,15013,289,3,665,337,571,92,59,1724,3,22,1749
15,14,15013,290,3,551,275,581,81,61,1549,6,24,1579
15,14,15013,291,3,446,88,205,42,61,842,1,7,850
15,14,15013,292,3,607,112,200,53,54,1026,0,12,1038
15,14,15013,293,3,301,56,98,31,34,520,0,5,525
15,14,15013,294,3,532,335,541,113,70,1591,8,25,1624
15,14,15013,295,3,548,370,673,94,72,1757,4,46,1807
15,14,15013,296,3,357,319,396,73,43,1188,1,23,1212
15,14,15013,297,3,507,270,479,99,50,1405,8,40,1453
15,14,15013,298,3,633,232,443,90,90,1488,8,13,1509
15,14,15013,299,3,450,245,475,71,50,1291,0,18,1309
15,14,15013,300,3,486,259,455,63,32,1295,8,17,1320
15,14,15013,301,3,528,397,471,85,60,1541,11,40,1592
15,14,15013,302,3,644,462,687,99,61,1953,5,30,1988
15,14,15013,303,3,285,156,221,31,23,716,2,11,729
15,14,15013,304,3,218,127,200,31,23,599,1,8,608
15,14,15013,305,3,214,115,252,43,37,661,0,14,675
15,14,15013,306,3,330,226,301,55,52,964,6,14,984
15,14,15013,307,3,540,303,491,70,60,1464,8,14,1486
15,14,15013,308,3,328,167,231,45,24,795,3,13,811
15,14,15013,309,3,195,131,165,48,24,563,5,18,586
15,14,15013,310,3,512,274,423,65,61,1335,7,37,1379
15,14,15013,311,3,378,138,286,55,42,899,3,18,920
15,14,15013,312,3,636,619,1042,119,64,2480,5,46,2531
15,14,15013,313,3,528,396,566,101,61,1652,1,49,1702
15,14,15013,314,3,630,301,551,83,66,1631,4,34,1669
15,14,15013,315,3,429,98,247,32,47,853,0,3,856
15,14,15013,316,3,475,255,512,113,44,1399,3,24,1426
15,14,15013,317,3,363,288,416,75,58,1200,2,36,1238
15,14,15013,318,3,461,325,472,101,73,1432,1,33,1466
15,14,15013,319,3,430,274,404,69,46,1223,2,22,1247
15,14,15013,320,3,538,321,345,93,49,1346,8,31,1385
15,14,15013,321,3,1148,204,307,91,56,1806,4,15,1825
15,14,15013,322,3,597,270,397,54,44,1362,2,33,1397
15,14,15013,323,3,454,200,349,52,41,1096,5,22,1123
15,14,15013,324,3,472,407,1014,87,50,2030,4,41,2075
15,14,15013,325,3,320,151,222,49,33,775,5,14,794
15,14,15013,326,3,565,226,286,57,67,1201,8,17,1226
15,14,15013,327,3,545,122,230,56,45,998,0,11,1009
15,14,15013,328,3,262,134,130,31,23,580,3,8,591
15,14,15013,329,3,513,256,326,57,48,1200,1,19,1220
15,14,15013,330,3,837,260,524,81,72,1774,8,24,1806
15,14,15013,331,3,663,144,289,80,62,1238,5,31,1274
15,14,15013,332,3,880,269,425,110,87,1771,3,27,1801
15,14,15013,333,3,849,424,487,120,85,1965,2,25,1992
15,14,15013,334,3,271,138,157,37,28,631,2,14,647
15,14,15013,335,3,624,151,253,65,41,1134,1,13,1148
15,14,15013,336,3,705,293,293,61,59,1411,4,17,1432
15,14,15013,337,3,557,195,302,53,58,1165,3,16,1184
15,14,15013,338,3,514,158,302,55,39,1068,0,10,1078
15,14,15013,339,3,405,163,240,48,46,902,1,8,911
15,14,15013,340,3,475,181,430,77,55,1218,9,20,1247
15,14,15013,341,3,373,279,356,79,37,1124,0,19,1143
15,14,15013,342,3,452,246,425,66,54,1243,5,18,1266
15,14,15013,343,3,386,265,473,87,46,1257,12,29,1298
15,14,15013,344,3,164,107,223,21,26,541,0,9,550
15,14,15013,350,3,268,211,364,66,23,932,2,16,950
15,14,15013,351,3,569,264,511,95,45,1484,0,18,1502
15,14,15013,352,3,574,283,476,88,46,1467,1,38,1506
15,14,15013,353,3,508,272,462,72,46,1360,2,15,1377
15,14,15013,354,3,577,223,460,88,48,1396,4,39,1439
15,14,15013,355,3,242,99,672,58,57,1128,2,9,1139
15,14,15013,356,3,608,158,599,57,51,1473,1,22,1496
15,14,15013,357,3,439,141,622,61,51,1314,0,10,1324
15,14,15013,358,3,354,188,216,41,48,847,4,16,867
15,14,15013,359,3,736,283,334,95,61,1509,1,21,1531
15,14,15013,360,3,501,326,482,82,64,1455,6,30,1491
15,14,15013,361,3,532,342,349,77,53,1353,0,27,1380
15,14,15013,373,3,327,163,167,51,33,741,3,9,753
15,14,15013,375,3,433,138,764,64,59,1458,0,10,1468
15,14,15013,376,3,328,42,120,23,34,547,1,5,553
15,14,15013,377,3,419,97,862,77,58,1513,0,13,1526
15,14,15013,378,3,199,101,756,55,51,1162,0,8,1170
15,14,15013,400,3,965,147,232,68,55,1467,1,9,1477
15,14,15013,414,3,648,105,90,29,42,914,0,6,920
15,14,15013,415,3,126,165,269,32,24,616,1,14,631
15,14,15013,416,3,1124,208,150,61,56,1599,1,16,1616
15,15,15013,250,3,447,233,339,62,49,1130,4,16,1150
15,15,15013,279,3,634,135,78,28,29,904,0,12,916
15,15,15013,345,3,583,386,328,98,42,1437,3,37,1477
15,15,15013,346,3,346,295,361,80,54,1136,1,27,1164
15,15,15013,347,3,413,210,397,71,47,1138,6,17,1161
15,15,15013,348,3,326,214,454,72,38,1104,2,27,1133
15,15,15013,349,3,681,237,305,64,45,1332,5,15,1352
15,15,15013,362,3,518,201,261,54,41,1075,2,12,1089
15,15,15013,363,3,802,148,112,44,38,1144,0,6,1150
15,15,15013,364,3,754,118,253,42,31,1198,2,18,1218
15,15,15013,365,3,335,179,484,77,34,1109,6,14,1129
15,15,15013,366,3,269,166,402,43,29,909,2,19,930
15,15,15013,367,3,413,77,150,19,31,690,1,7,698
15,15,15013,368,3,663,110,202,37,44,1056,1,11,1068
15,15,15013,369,3,977,186,162,55,51,1431,0,4,1435
15,15,15013,370,3,674,146,175,43,38,1076,2,8,1086
15,15,15013,371,3,493,95,86,19,24,717,0,8,725
15,15,15013,372,3,607,206,317,68,51,1249,2,19,1270
15,15,15013,374,3,905,142,267,54,48,1416,2,17,1435
15,15,15013,379,3,869,156,475,73,75,1648,0,7,1655
15,15,15013,380,3,549,116,190,51,37,943,0,11,954
15,15,15013,381,3,1321,283,404,93,80,2181,1,20,2202
15,15,15013,382,3,724,175,230,59,44,1232,0,9,1241
15,15,15013,383,3,694,211,330,87,49,1371,4,25,1400
15,15,15013,384,3,229,44,68,19,19,379,0,13,392
15,15,15013,385,3,519,111,123,52,34,839,1,10,850
15,15,15013,386,3,461,179,303,72,29,1044,4,23,1071
15,15,15013,387,3,660,119,166,34,45,1024,5,7,1036
15,15,15013,388,3,362,171,238,55,22,848,2,17,867
15,15,15013,389,3,434,138,182,85,39,878,1,6,885
15,15,15013,390,3,650,149,262,64,36,1161,0,14,1175
15,15,15013,391,3,305,73,111,25,13,527,0,1,528
15,15,15013,392,3,821,123,375,60,40,1419,1,20,1440
15,15,15013,393,3,663,279,479,127,55,1603,7,33,1643
15,15,15013,394,3,465,321,364,69,37,1256,7,17,1280
15,15,15013,395,3,519,297,376,92,58,1342,7,27,1376
15,15,15013,396,3,561,236,450,109,46,1402,7,18,1427
15,15,15013,397,3,426,228,418,73,40,1185,3,17,1205
15,15,15013,398,3,572,254,486,98,61,1471,7,23,1501
15,15,15013,399,3,771,267,494,135,45,1712,15,44,1771
15,15,15013,401,3,472,196,339,66,42,1115,7,18,1140
15,15,15013,402,3,627,325,560,86,62,1660,15,25,1700
15,15,15013,403,3,734,117,217,60,47,1175,0,12,1187
15,15,15013,404,3,822,149,264,63,56,1354,5,8,1367
15,15,15013,405,3,544,205,285,60,24,1118,3,19,1140
15,15,15013,406,3,681,171,220,65,30,1167,0,12,1179
15,15,15013,407,3,243,113,184,35,23,598,1,13,612
15,15,15013,408,3,659,201,470,103,55,1488,3,32,1523
15,15,15013,409,3,677,182,214,43,48,1164,1,17,1182
15,15,15013,410,3,586,285,514,109,51,1545,10,42,1597
15,15,15013,411,3,696,287,361,85,41,1470,10,32,1512
15,15,15013,412,3,769,141,101,29,31,1071,0,8,1079
15,15,15013,413,3,793,131,169,47,32,1172,0,3,1175
15,15,15105,4836,3,774,145,252,63,34,1268,2,16,1286
15,15,15105,4837,3,794,191,195,62,47,1289,0,14,1303
15,15,15105,4838,3,831,143,234,55,65,1328,2,11,1341
15,15,15105,4839,3,797,185,221,62,42,1307,2,4,1313
15,15,15105,4840,3,586,99,231,39,37,992,1,11,1004
15,15,15105,4841,3,878,156,223,52,47,1356,0,14,1370
15,15,15105,4842,3,676,274,262,63,51,1326,2,19,1347
15,15,15105,4843,3,888,150,302,63,47,1450,2,16,1468
15,15,15105,4844,3,633,75,89,40,20,857,1,4,862
15,15,15105,4845,3,1122,170,179,67,51,1589,7,12,1608
15,15,15105,4846,3,902,150,271,52,59,1434,1,10,1445
15,15,15105,4847,3,423,114,260,42,34,873,1,19,893
15,15,15105,4848,3,520,124,263,54,42,1003,0,9,1012
15,15,15105,4849,3,710,163,298,81,42,1294,3,8,1305
15,15,15105,4850,3,602,112,216,37,37,1004,1,8,1013
15,15,15105,4851,3,758,153,313,61,54,1339,2,13,1354
15,15,15105,4852,3,733,197,279,58,52,1319,2,11,1332
15,15,15105,4853,3,640,151,310,56,55,1212,2,17,1231
15,15,15105,4854,3,619,238,256,42,52,1207,1,14,1222
15,15,15105,4855,3,446,98,209,39,29,821,1,17,839
15,15,15105,4856,3,526,140,202,56,32,956,0,6,962
15,15,15105,4857,3,410,151,237,37,35,870,4,18,892
15,15,15105,4858,3,480,196,364,81,44,1165,1,25,1191
15,15,15105,4859,3,267,131,175,46,13,632,3,17,652
15,15,15105,4860,3,232,133,231,60,20,676,3,7,686
15,15,15105,4861,3,344,149,444,71,45,1053,1,18,1072
15,15,15105,4862,3,497,151,373,67,35,1123,0,21,1144
15,15,15105,4863,3,295,100,222,37,21,675,3,8,686
15,15,15105,4864,3,272,90,130,34,27,553,1,12,566
15,15,15105,4865,3,763,138,209,41,40,1191,0,14,1205
15,15,15105,4866,3,626,162,281,53,39,1161,1,19,1181
15,15,15105,4867,3,289,143,201,33,20,686,5,7,698
15,15,15105,4963,3,711,141,255,83,51,1241,1,6,1248
15,15,15105,4964,3,867,145,258,57,57,1384,0,11,1395
15,15,15105,4965,3,641,132,177,59,49,1058,0,7,1065
15,15,15105,4966,3,655,114,165,67,91,1092,1,4,1097
15,15,15105,4967,3,515,84,126,56,24,805,1,6,812
15,15,15105,4973,3,709,131,146,47,57,1090,3,8,1101
15,15,15105,4974,3,726,161,178,55,53,1173,2,10,1185
15,15,15105,4975,3,563,245,283,64,41,1196,1,16,1213
15,15,15105,4976,3,532,121,203,40,38,934,3,19,956
15,15,15105,4977,3,711,129,216,64,54,1174,4,13,1191
15,15,15105,4978,3,925,194,295,71,47,1532,3,11,1546
15,15,15105,4979,3,755,114,174,55,42,1140,3,12,1155
15,15,15105,4980,3,734,144,196,57,45,1176,2,8,1186
15,15,15105,4981,3,534,104,116,40,11,805,3,15,823
15,15,15105,4982,3,709,145,236,44,34,1168,1,14,1183
15,15,15105,4983,3,498,151,315,78,42,1084,1,19,1104
15,15,15105,4984,3,237,130,136,35,19,557,0,12,569
15,15,15105,4985,3,504,270,457,66,51,1348,6,12,1366
15,15,15105,4986,3,461,186,373,62,37,1119,2,19,1140
15,15,15105,4987,3,491,205,357,78,52,1183,11,27,1221
15,15,15105,4988,3,425,222,424,75,43,1189,3,22,1214
15,15,15105,4989,3,420,243,407,73,58,1201,3,22,1226
15,15,15105,4990,3,413,245,435,67,56,1216,8,19,1243
15,15,15105,4991,3,459,187,319,63,36,1064,6,11,1081
15,15,15105,4992,3,331,152,210,36,36,765,3,11,779
15,15,15105,4993,3,275,130,221,41,21,688,1,18,707
15,15,15105,4996,3,652,140,162,40,31,1025,0,11,1036
15,15,15105,4997,3,807,190,215,70,58,1340,1,12,1353
15,15,15105,4998,3,769,144,274,69,53,1309,1,11,1321
15,15,15105,4999,3,749,123,196,53,52,1173,0,13,1186
15,15,15105,5000,3,705,135,219,65,31,1155,3,15,1173
15,15,15105,5001,3,696,151,223,52,39,1161,0,9,1170
15,15,15105,5011,3,722,151,223,53,64,1213,1,19,1233
15,15,15105,5012,3,714,154,276,61,37,1242,2,11,1255
15,15,15105,5013,3,574,137,223,39,46,1019,4,11,1034
15,15,15105,5014,3,658,134,227,56,50,1125,0,16,1141
15,15,15105,5015,3,672,144,189,66,42,1113,0,9,1122
15,15,15105,5016,3,295,147,180,47,22,691,2,5,698
15,15,15105,5017,3,254,95,135,45,12,541,3,9,553
15,15,15105,5029,3,243,54,91,27,25,440,2,2,444
15,15,15105,5030,3,352,64,138,42,31,627,0,4,631
15,15,15105,5031,3,334,77,144,45,25,625,0,3,628
15,15,15105,5032,3,352,94,138,45,29,658,1,2,661
15,15,15105,5092,3,262,149,277,57,33,778,0,15,793
15,15,15105,5093,3,280,138,192,33,22,665,2,10,677
15,15,15105,5094,3,241,141,256,49,33,720,1,18,739
15,15,15105,5095,3,262,163,269,57,37,788,5,9,802
15,15,15105,5096,3,274,171,298,60,25,828,0,20,848
15,15,15105,5097,3,191,161,240,70,13,675,1,13,689
15,15,15105,5098,3,198,109,142,32,13,494,1,6,501
15,15,15105,5099,3,370,94,155,34,17,670,3,13,686
15,15,15105,5100,3,353,104,112,22,19,610,1,10,621
15,15,15105,5101,3,406,103,166,45,43,763,0,6,769
15,15,15105,5102,3,394,109,188,47,35,773,2,8,783
15,15,15105,5103,3,451,104,169,51,38,813,0,13,826
15,15,15105,5104,3,292,137,268,46,26,769,4,17,790
15,15,15105,5105,3,84,24,50,25,4,187,0,0,187
15,15,15105,5106,3,418,228,402,70,38,1156,4,33,1193
15,15,15105,5107,3,314,234,421,52,29,1050,2,29,1081
15,15,15105,5108,3,332,105,233,58,40,768,0,8,776
15,15,15105,5109,3,330,128,298,70,48,874,1,7,882
15,15,15105,5110,3,300,240,421,59,33,1053,1,19,1073
15,15,15105,5111,3,177,128,242,25,20,592,3,19,614
15,15,15105,5112,3,215,176,355,40,39,825,4,11,840
15,15,15105,5113,3,328,203,408,64,48,1051,7,16,1074
15,15,15105,5114,3,296,167,288,60,23,834,5,15,854
15,15,15105,5115,3,402,100,242,48,34,826,0,11,837
15,15,15105,5116,3,237,120,209,32,24,622,2,8,632
15,15,15105,5117,3,405,131,401,68,41,1046,4,26,1076
15,15,15105,5118,3,361,147,295,70,41,914,4,11,929
15,15,15105,5119,3,364,127,307,53,29,880,5,12,897
15,15,15105,5120,3,258,167,336,69,53,883,6,15,904
15,15,15105,5122,3,442,316,379,59,41,1237,5,20,1262
15,15,15105,5123,3,233,141,245,45,35,699,8,9,716
15,15,15105,5124,3,290,287,448,58,48,1131,4,18,1153
15,15,15105,5125,3,259,148,292,63,24,786,3,14,803
15,15,15105,5126,3,193,174,299,53,23,742,6,12,760
15,15,15105,5128,3,216,125,226,46,25,638,0,17,655
15,15,15105,5129,3,442,337,469,65,52,1365,1,28,1394
15,15,15105,5130,3,177,423,361,58,18,1037,3,30,1070
15,15,15105,5136,3,286,92,229,41,22,670,0,14,684
15,16,15034,1351,3,390,183,442,82,56,1153,3,15,1171
15,16,15034,1354,3,289,359,488,89,41,1266,6,32,1304
15,16,15034,1355,3,263,318,591,103,42,1317,7,16,1340
15,16,15034,1356,3,294,207,482,98,32,1113,3,17,1133
15,16,15034,1357,3,280,550,768,167,60,1825,9,68,1902
15,16,15034,1358,3,239,296,403,120,26,1084,7,42,1133
15,16,15034,1359,3,114,162,211,30,25,542,2,11,555
15,16,15034,1360,3,250,282,456,44,33,1065,5,39,1109
15,16,15034,1361,3,314,429,663,96,39,1541,7,40,1588
15,16,15034,1362,3,544,617,1010,327,60,2558,5,83,2646
15,16,15034,1363,3,432,588,1038,220,70,2348,6,99,2453
15,16,15034,1364,3,283,351,479,133,30,1276,3,47,1326
15,16,15034,1365,3,297,269,671,188,45,1470,3,56,1529
15,16,15034,1366,3,298,294,693,128,50,1463,4,25,1492
15,16,15034,1367,3,279,244,663,135,49,1370,5,35,1410
15,16,15034,1368,3,239,168,561,150,42,1160,2,23,1185
15,16,15034,1369,3,185,155,458,111,22,931,2,22,955
15,16,15034,1370,3,417,307,852,229,61,1866,6,47,1919
15,16,15034,1371,3,294,251,544,123,45,1257,6,33,1296
15,16,15034,1372,3,258,269,611,109,40,1287,1,24,1312
15,16,15034,1373,3,311,225,478,139,32,1185,0,27,1212
15,16,15034,1374,3,246,316,578,178,37,1355,13,24,1392
15,16,15034,1375,3,362,439,757,192,51,1801,6,70,1877
15,16,15034,1376,3,249,240,578,133,29,1229,3,34,1266
15,16,15034,1377,3,201,235,519,93,29,1077,1,25,1103
15,16,15034,1378,3,224,336,800,127,51,1538,2,57,1597
15,16,15034,1379,3,267,262,667,114,53,1363,2,26,1391
15,16,15034,1380,3,272,237,458,97,46,1110,6,32,1148
15,16,15034,1381,3,220,370,474,94,29,1187,0,16,1203
15,16,15034,1382,3,194,368,456,180,28,1226,1,39,1266
15,16,15034,1383,3,419,590,1017,184,46,2256,12,56,2324
15,16,15034,1384,3,249,287,602,97,35,1270,2,50,1322
15,16,15034,1385,3,282,358,569,148,50,1407,12,41,1460
15,16,15034,1386,3,262,229,518,126,30,1165,7,36,1208
15,16,15034,1387,3,275,266,417,104,21,1083,4,20,1107
15,16,15034,1388,3,281,228,452,111,33,1105,2,28,1135
15,16,15034,1389,3,283,399,416,176,17,1291,3,18,1312
15,16,15034,1390,3,219,390,501,192,27,1329,5,23,1357
15,16,15034,1391,3,329,269,369,75,32,1074,1,37,1112
15,16,15034,1392,3,261,284,467,132,25,1169,7,22,1198
15,16,15034,1393,3,292,565,1015,147,74,2093,8,51,2152
15,16,15034,1501,3,208,331,515,91,33,1178,5,24,1207
15,16,15034,1502,3,185,223,475,73,29,985,2,16,1003
15,16,15034,1503,3,326,311,724,101,50,1512,7,20,1539
15,16,15034,1504,3,199,163,398,59,24,843,1,18,862
15,16,15034,1505,3,179,142,353,56,28,758,3,12,773
15,16,15034,1506,3,163,159,344,62,31,759,2,0,761
15,16,15034,1507,3,256,231,634,126,39,1286,9,19,1314
15,16,15034,1508,3,192,147,386,70,25,820,5,21,846
15,16,15034,1513,3,223,306,618,99,47,1293,8,39,1340
15,16,15034,1514,3,222,230,385,65,36,938,9,23,970
15,16,15034,1515,3,308,235,752,134,50,1479,9,28,1516
15,16,15034,1522,3,417,481,1165,226,64,2353,5,51,2409
15,16,15034,1523,3,254,375,613,152,34,1428,4,41,1473
15,16,15034,1524,3,95,84,212,66,8,465,1,26,492
15,16,15034,1525,3,213,248,346,101,22,930,4,39,973
15,16,15034,1526,3,191,447,437,89,24,1188,7,38,1233
15,16,15034,1527,3,223,303,462,156,26,1170,6,32,1208
15,16,15105,4757,3,728,399,949,142,58,2276,17,76,2369
15,16,15105,4758,3,356,159,394,60,17,986,6,23,1015
15,16,15105,4759,3,384,100,276,58,14,832,0,37,869
15,16,15105,4760,3,490,166,243,56,29,984,0,12,996
15,16,15105,4761,3,206,149,196,63,20,634,1,24,659
15,16,15105,4762,3,217,168,285,101,27,798,2,22,822
15,16,15105,4763,3,232,153,171,77,15,648,3,27,678
15,16,15105,4764,3,393,207,537,175,36,1348,5,29,1382
15,16,15105,4765,3,369,314,702,190,42,1617,9,29,1655
15,16,15105,4766,3,287,191,419,131,24,1052,1,31,1084
15,16,15105,4767,3,285,194,344,91,25,939,0,19,958
15,16,15105,4768,3,347,313,488,161,38,1347,8,32,1387
15,16,15105,4769,3,395,176,349,89,23,1032,1,41,1074
15,16,15105,4770,3,251,187,397,76,36,947,1,16,964
15,16,15105,4771,3,217,141,214,58,26,656,0,18,674
15,16,15105,4772,3,254,128,278,66,24,750,5,15,770
15,16,15105,4773,3,291,148,268,59,26,792,2,33,827
15,16,15105,4774,3,267,144,269,54,18,752,0,19,771
15,16,15105,4775,3,287,202,384,57,31,961,1,21,983
15,16,15105,4776,3,280,129,247,101,19,776,6,26,808
15,16,15105,4777,3,296,144,253,131,20,844,7,29,880
15,16,15105,4778,3,274,196,326,58,31,885,3,19,907
15,16,15105,4779,3,378,281,533,100,37,1329,8,39,1376
15,16,15105,4780,3,253,180,408,108,33,982,0,24,1006
15,16,15105,4781,3,227,144,313,144,31,859,0,19,878
15,16,15105,4782,3,251,164,294,104,31,844,2,17,863
15,16,15105,4783,3,252,210,284,108,23,877,0,10,887
15,16,15105,4784,3,223,139,250,128,20,760,4,17,781
15,16,15105,4785,3,192,104,194,85,9,584,2,13,599
15,16,15105,4786,3,314,140,453,147,39,1093,0,22,1115
15,16,15105,4787,3,521,313,554,140,41,1569,18,39,1626
15,16,15105,4788,3,569,305,653,112,42,1681,10,44,1735
15,16,15105,4789,3,266,74,220,94,11,665,0,35,700
15,16,15105,4790,3,234,155,226,114,13,742,4,22,768
15,16,15105,4791,3,508,188,465,92,48,1301,5,34,1340
15,16,15105,4792,3,300,117,381,92,25,915,2,33,950
15,16,15105,4793,3,293,133,310,57,28,821,0,14,835
15,16,15105,4794,3,218,163,243,72,14,710,1,15,726
15,16,15105,4795,3,266,147,248,93,22,776,3,9,788
15,16,15105,4796,3,201,147,251,76,12,687,0,15,702
15,16,15105,4797,3,422,192,430,63,22,1129,7,23,1159
15,16,15105,4798,3,344,257,421,105,29,1156,5,34,1195
15,16,15105,4799,3,400,214,415,129,48,1206,3,30,1239
15,16,15105,4800,3,251,151,329,79,27,837,0,16,853
15,16,15105,4801,3,159,129,349,55,28,720,7,21,748
15,16,15105,4802,3,361,170,326,91,29,977,4,26,1007
15,16,15105,4803,3,328,156,340,120,32,976,3,25,1004
15,16,15105,4804,3,442,226,508,134,52,1362,12,30,1404
15,16,15105,4805,3,441,290,439,155,38,1363,8,41,1412
15,16,15105,4806,3,235,122,312,68,17,754,2,17,773
15,16,15105,4807,3,210,184,250,86,19,749,0,23,772
15,16,15105,4808,3,409,222,563,118,52,1364,12,33,1409
15,16,15105,4809,3,240,163,313,62,30,808,3,15,826
15,16,15105,4810,3,184,125,266,60,21,656,0,13,669
15,16,15105,4811,3,128,67,162,25,16,398,1,7,406
15,16,15105,4812,3,354,159,320,98,20,951,5,23,979
15,16,15105,4813,3,360,83,206,89,13,751,1,11,763
15,16,15105,4814,3,351,148,364,84,25,972,5,16,993
15,16,15105,4815,3,397,152,454,143,32,1178,0,50,1228
15,16,15105,4816,3,446,186,390,74,35,1131,3,20,1154
15,16,15105,4817,3,244,117,263,64,24,712,1,12,725
15,16,15105,4818,3,226,118,279,66,24,713,6,16,735
15,16,15105,4819,3,245,109,263,43,17,677,2,14,693
15,16,15105,4820,3,206,153,191,30,11,591,0,9,600
15,16,15105,4821,3,173,112,335,42,19,681,0,15,696
15,16,15105,4822,3,266,119,320,40,27,772,6,7,785
15,16,15105,4823,3,250,154,406,53,31,894,1,17,912
15,16,15105,4824,3,382,198,380,38,49,1047,2,16,1065
15,16,15105,4825,3,253,119,329,87,23,811,4,12,827
15,16,15105,4826,3,346,189,382,74,24,1015,2,21,1038
15,16,15105,4827,3,353,195,339,105,25,1017,3,35,1055
15,16,15105,4828,3,300,144,321,61,38,864,8,12,884
15,16,15105,4829,3,182,129,217,56,21,605,1,18,624
15,16,15105,4830,3,465,223,493,104,34,1319,7,24,1350
15,16,15105,4831,3,330,181,499,118,31,1159,0,39,1198
15,16,15105,4832,3,384,207,384,142,28,1145,3,28,1176
15,16,15105,4833,3,279,175,368,100,30,952,3,27,982
15,16,15105,4834,3,280,194,431,144,35,1084,5,31,1120
15,16,15105,4835,3,184,168,265,116,25,758,0,39,797
15,17,15034,1427,3,225,97,523,78,49,972,7,17,996
15,17,15034,1428,3,181,113,259,33,20,606,0,12,618
15,17,15034,1429,3,358,180,627,67,59,1291,0,16,1307
15,17,15034,1461,3,295,250,612,82,47,1286,4,22,1312
15,17,15034,1462,3,251,253,625,88,46,1263,1,22,1286
15,17,15034,1480,3,394,171,576,86,66,1293,2,18,1313
15,17,15034,1481,3,336,231,575,85,66,1293,1,25,1319
15,17,15034,1482,3,165,148,343,61,37,754,0,17,771
15,17,15034,1483,3,124,110,203,26,25,488,2,10,500
15,17,15034,1484,3,163,185,377,52,36,813,2,24,839
15,17,15034,1485,3,128,166,297,45,24,660,1,10,671
15,17,15034,1499,3,155,114,314,48,31,662,0,11,673
15,17,15034,1500,3,460,205,621,89,54,1429,1,21,1451
15,17,15034,1541,3,300,195,504,59,51,1109,0,11,1120
15,17,15034,1542,3,130,116,303,44,35,628,3,14,645
15,17,15034,1543,3,165,239,400,50,54,908,0,21,929
15,17,15034,1544,3,41,47,119,17,13,237,1,3,241
15,17,15034,1545,3,159,168,537,52,28,944,0,16,960
15,17,15034,1546,3,117,118,365,32,51,683,4,14,701
15,17,15034,1547,3,184,150,578,51,27,990,1,30,1021
15,17,15034,1548,3,123,120,482,48,28,801,4,11,816
15,17,15034,1549,3,209,98,274,22,26,629,1,9,639
15,17,15034,1550,3,152,74,203,23,25,477,0,6,483
15,17,15034,1564,3,205,191,391,58,42,887,3,8,898
15,17,15034,1565,3,240,292,606,91,49,1278,0,18,1296
15,17,15034,1566,3,239,196,530,65,44,1074,6,13,1093
15,17,15034,1567,3,261,226,559,62,32,1140,3,20,1163
15,17,15034,1568,3,416,212,508,57,72,1265,0,18,1283
15,17,15034,1569,3,333,158,470,75,46,1082,10,11,1103
15,17,15034,1581,3,190,141,359,57,29,776,2,10,788
15,17,15034,1582,3,145,154,537,44,27,907,3,13,923
15,17,15034,1583,3,171,149,533,73,47,973,3,25,1001
15,17,15034,1584,3,225,254,556,68,38,1141,1,18,1160
15,17,15034,1585,3,240,284,543,62,42,1171,7,17,1195
15,17,15034,1586,3,78,104,217,32,25,456,0,5,461
15,17,15034,1587,3,135,137,405,64,38,779,8,9,796
15,17,15034,1588,3,304,283,751,91,64,1493,3,28,1524
15,17,15034,1589,3,193,139,327,50,25,734,3,5,742
15,17,15034,1590,3,158,76,205,44,34,517,3,4,524
15,17,15034,1619,3,95,73,162,26,19,375,1,0,376
15,17,15034,1620,3,145,89,236,54,17,541,0,6,547
15,17,15034,1621,3,183,87,265,35,31,601,3,6,610
15,17,15034,1622,3,167,90,249,36,32,574,3,7,584
15,17,15034,1623,3,167,86,228,36,29,546,4,4,554
15,17,15034,1624,3,220,130,331,63,26,770,1,10,781
15,17,15034,1625,3,218,180,466,75,39,978,2,16,996
15,17,15034,1626,3,271,167,485,72,42,1037,5,15,1057
15,17,15034,1627,3,249,228,530,72,48,1127,8,20,1155
15,17,15034,1628,3,125,133,294,35,23,610,0,14,624
15,17,15034,1629,3,212,231,550,62,42,1097,5,23,1125
15,17,15034,1630,3,133,109,236,51,16,545,5,9,559
15,17,15034,1631,3,214,226,498,62,43,1043,2,17,1062
15,17,15034,1632,3,129,138,431,51,34,783,2,14,799
15,17,15034,1633,3,174,196,450,55,47,922,5,9,936
15,17,15034,1634,3,189,116,322,60,41,728,2,14,744
15,17,15034,1635,3,103,104,216,41,33,497,1,7,505
15,17,15034,1636,3,95,92,190,35,24,436,1,6,443
15,17,15034,1637,3,140,129,255,40,29,593,0,6,599
15,17,15034,1638,3,191,71,304,53,29,648,5,11,664
15,17,15034,1639,3,181,82,246,36,21,566,0,6,572
15,17,15034,1640,3,173,100,290,48,39,650,2,11,663
15,17,15034,1641,3,137,54,175,21,23,410,0,6,416
15,17,15034,1666,3,213,133,468,69,36,919,0,15,934
15,17,15034,1667,3,164,122,384,52,35,757,0,9,766
15,17,15034,1668,3,212,123,369,59,32,795,1,14,810
15,17,15034,1669,3,197,105,266,68,28,664,1,14,679
15,17,15034,1670,3,170,120,371,59,29,749,0,16,765
15,17,15034,1671,3,236,200,577,75,48,1136,6,14,1156
15,17,15034,1672,3,108,159,250,35,36,588,1,13,602
15,17,15034,1673,3,148,178,362,62,25,775,4,17,796
15,17,15034,1674,3,101,142,282,53,17,595,2,12,609
15,17,15034,1675,3,132,146,269,41,24,612,0,16,628
15,17,15034,1676,3,103,139,311,60,22,635,2,14,651
15,17,15034,1677,3,116,105,319,51,27,618,0,8,626
15,17,15034,1678,3,119,163,309,46,28,665,2,20,687
15,17,15034,1679,3,179,115,387,50,17,748,1,11,760
15,17,15034,1680,3,217,265,587,90,46,1205,0,12,1217
15,17,15034,1681,3,184,177,418,56,47,882,2,11,895
15,17,15034,1682,3,190,197,534,62,37,1020,4,14,1038
15,17,15034,1683,3,239,294,770,83,47,1433,6,18,1457
15,17,15034,1684,3,109,111,288,62,25,595,0,8,603
15,17,15034,1685,3,148,109,336,46,29,668,0,15,683
15,17,15034,1686,3,151,153,347,72,31,754,0,6,760
15,17,15034,1687,3,252,250,426,66,44,1038,0,25,1063
15,17,15034,1699,3,288,236,523,55,35,1137,6,14,1157
15,17,15034,1700,3,673,442,1100,181,128,2524,6,35,2565
15,17,15034,1701,3,252,218,543,81,37,1131,1,19,1151
15,17,15034,1702,3,198,217,602,85,49,1151,2,19,1172
15,17,15034,1703,3,399,274,710,134,83,1600,6,16,1622
15,17,15034,1704,3,234,188,497,67,37,1023,6,10,1039
15,17,15034,1705,3,136,157,473,65,30,861,1,27,889
15,17,15034,1706,3,176,256,653,54,34,1173,5,19,1197
15,17,15034,1707,3,158,159,366,70,46,799,1,16,816
15,17,15034,1708,3,271,232,600,96,47,1246,7,14,1267
15,17,15034,1709,3,228,190,585,67,48,1118,0,23,1141
15,17,15034,1712,3,308,280,858,114,53,1613,1,21,1635
15,17,15034,1713,3,105,102,222,11,17,457,1,3,461
15,17,15034,1714,3,186,189,509,60,32,976,0,20,996
15,17,15034,1715,3,155,202,447,50,28,882,0,20,902
15,17,15034,1716,3,171,167,404,77,26,845,1,0,846
15,17,15034,1717,3,180,252,513,80,37,1062,3,23,1088
15,17,15034,1718,3,170,236,557,86,44,1093,4,34,1131
15,17,15034,1719,3,141,129,381,83,27,761,2,14,777
15,17,15034,1720,3,243,288,714,117,65,1427,1,22,1450
15,17,15034,1721,3,305,208,495,85,78,1171,6,20,1197
15,17,15034,1722,3,314,253,655,77,62,1361,7,30,1398
15,17,15034,1723,3,160,168,478,67,25,898,4,18,920
15,17,15034,1724,3,232,197,541,82,48,1100,6,20,1126
15,17,15034,1725,3,64,49,79,15,13,220,0,3,223
15,17,15034,1726,3,41,36,92,13,7,189,0,1,190
15,17,15034,1727,3,76,50,137,16,10,289,2,2,293
15,17,15034,1729,3,157,91,288,44,23,603,5,4,612
15,17,15034,1730,3,25,69,86,13,7,200,2,2,204
15,17,15034,1732,3,348,366,1048,136,70,1968,3,37,2008
15,17,15034,1733,3,257,289,628,79,67,1320,0,33,1353
15,17,15034,1734,3,351,252,607,70,56,1336,2,12,1350
15,17,15034,1822,3,461,247,628,98,62,1496,4,12,1512
15,17,15034,1839,3,147,93,231,38,17,526,2,6,534
15,17,15034,1845,3,162,120,366,46,29,723,6,10,739
15,17,15034,1846,3,161,157,312,49,41,720,2,14,736
15,17,15034,1847,3,432,347,824,100,83,1786,13,27,1826
15,17,15034,1848,3,215,208,524,86,40,1073,15,11,1099
15,17,15034,1849,3,250,273,483,109,48,1163,15,24,1202
15,17,15034,1850,3,234,270,585,87,33,1209,3,30,1242
15,17,15034,1851,3,374,323,732,124,58,1611,2,25,1638
15,17,15034,1852,3,191,171,345,62,49,818,2,7,827
15,17,15034,1853,3,157,190,312,49,43,751,3,8,762
15,17,15034,1864,3,347,288,902,126,67,1730,1,21,1752
15,17,15034,1865,3,206,233,663,86,43,1231,5,16,1252
15,17,15034,1866,3,334,202,510,91,53,1190,0,17,1207
15,17,15034,1867,3,314,166,369,98,46,993,1,11,1005
15,17,15034,1868,3,155,119,265,38,25,602,0,8,610
15,17,15034,1869,3,292,167,505,87,42,1093,3,14,1110
15,17,15034,1885,3,243,154,349,52,27,825,1,2,828
15,17,15034,1886,3,281,183,460,94,50,1068,4,12,1084
15,17,15034,1887,3,340,193,459,68,43,1103,3,20,1126
15,17,15034,1888,3,271,168,405,59,46,949,0,7,956
15,17,15034,1889,3,257,175,436,69,42,979,4,25,1008
15,17,15034,1890,3,194,144,331,51,42,762,0,8,770
15,17,15034,1891,3,137,137,263,33,26,596,2,9,607
15,17,15034,1892,3,271,115,474,57,34,951,7,9,967
15,17,15034,1893,3,316,199,543,102,61,1221,1,16,1238
15,17,15034,1894,3,398,250,653,89,46,1436,1,23,1460
15,17,15034,1908,3,327,239,598,62,59,1285,1,23,1309
15,17,15034,1909,3,200,172,414,50,45,881,0,12,893
15,17,15034,1910,3,216,136,369,46,19,786,3,11,800
15,17,15034,1911,3,237,124,414,42,36,853,2,17,872
15,17,15034,1912,3,220,156,369,55,35,835,2,11,848
15,17,15034,1913,3,259,149,316,53,35,812,3,15,830
15,17,15034,1927,3,274,138,376,42,39,869,6,14,889
15,17,15034,1928,3,323,225,418,80,45,1091,2,20,1113
15,17,15034,1929,3,246,151,341,40,26,804,2,15,821
15,17,15034,1930,3,279,173,440,62,37,991,1,19,1011
15,17,15034,1931,3,350,154,473,77,43,1097,2,16,1115
15,17,15034,1932,3,204,197,435,53,27,916,0,15,931
15,17,15034,1933,3,141,119,382,36,33,711,0,8,719
15,17,15034,1934,3,395,231,445,55,61,1187,0,18,1205
15,17,15034,1935,3,439,181,469,79,61,1229,3,19,1251
15,17,15034,1936,3,279,123,303,49,39,793,4,11,808
15,17,15034,1937,3,180,89,235,35,22,561,4,6,571
15,17,15034,1938,3,292,149,535,69,38,1083,3,9,1095
15,18,15038,1992,3,315,437,224,67,34,1077,8,19,1104
15,18,15038,1993,3,174,350,139,87,38,788,3,8,799
15,18,15038,1994,3,265,337,175,60,18,855,3,13,871
15,18,15038,1995,3,464,620,379,95,38,1596,5,42,1643
15,18,15038,1996,3,543,766,361,101,50,1821,0,56,1877
15,18,15038,1997,3,485,645,568,89,53,1840,10,41,1891
15,18,15038,1998,3,446,316,290,56,35,1143,3,16,1162
15,18,15038,1999,3,509,561,547,53,51,1721,18,48,1787
15,18,15038,2000,3,544,436,519,69,44,1612,11,37,1660
15,18,15038,2001,3,319,258,247,55,32,911,2,14,927
15,18,15038,2002,3,702,134,62,45,33,976,0,4,980
15,18,15038,2003,3,822,137,45,43,35,1082,0,6,1088
15,18,15038,2004,3,663,133,59,21,22,898,0,1,899
15,18,15038,2005,3,679,140,73,28,29,949,1,2,952
15,18,15038,2006,3,629,383,555,93,55,1715,5,40,1760
15,18,15038,2007,3,543,444,1196,122,80,2385,12,74,2471
15,18,15038,2008,3,619,357,505,86,45,1612,7,33,1652
15,18,15038,2009,3,714,130,50,32,35,961,1,5,967
15,18,15038,2010,3,968,164,88,38,19,1277,1,3,1281
15,18,15038,2011,3,731,169,48,25,18,991,0,5,996
15,18,15038,2012,3,689,178,49,27,19,962,0,7,969
15,18,15038,2013,3,579,155,50,22,18,824,0,4,828
15,18,15038,2014,3,741,239,34,35,18,1067,0,11,1078
15,18,15038,2015,3,792,238,69,23,37,1159,1,5,1165
15,18,15038,2016,3,1287,266,80,48,39,1720,4,9,1733
15,18,15038,2017,3,723,156,41,24,21,965,0,1,966
15,18,15038,2018,3,516,227,284,60,36,1123,1,22,1146
15,18,15038,2019,3,562,413,469,78,45,1567,8,24,1599
15,18,15038,2020,3,415,395,584,73,40,1507,10,30,1547
15,18,15038,2021,3,391,319,211,49,27,997,5,14,1016
15,18,15038,2022,3,308,286,349,45,40,1028,6,28,1062
15,18,15038,2023,3,336,282,375,47,34,1074,4,28,1106
15,18,15038,2024,3,996,534,480,91,63,2164,2,21,2187
15,18,15038,2025,3,513,647,414,169,68,1811,14,51,1876
15,18,15038,2026,3,277,381,399,81,29,1167,13,22,1202
15,18,15038,2027,3,765,690,867,142,81,2545,4,56,2605
15,18,15038,2028,3,610,660,686,112,63,2131,10,35,2176
15,18,15038,2029,3,235,262,267,48,29,841,7,16,864
15,18,15038,2030,3,243,440,384,48,31,1146,5,42,1193
15,18,15038,2031,3,231,490,392,34,12,1159,7,21,1187
15,18,15038,2032,3,90,136,80,12,5,323,0,7,330
15,18,15038,2033,3,241,205,464,68,33,1011,1,22,1034
15,18,15038,2034,3,525,533,951,172,81,2262,23,29,2314
15,18,15038,2035,3,238,35,16,1,6,296,0,1,297
15,18,15038,2036,3,1705,382,120,80,71,2358,1,1,2360
15,18,15038,2037,3,726,159,64,28,20,997,0,4,1001
15,18,15038,2038,3,619,125,57,25,21,847,1,9,857
15,18,15038,2039,3,415,340,626,77,66,1524,2,50,1576
15,18,15038,2040,3,443,235,183,39,25,925,1,14,940
15,18,15038,2041,3,309,137,260,34,32,772,4,32,808
15,18,15038,2042,3,257,232,458,62,50,1059,0,27,1086
15,18,15038,2043,3,186,205,289,35,30,745,7,15,767
15,18,15038,2044,3,224,139,364,45,40,812,0,18,830
15,18,15038,2045,3,152,118,246,34,29,579,1,14,594
15,18,15038,2046,3,359,295,528,80,61,1323,3,32,1358
15,18,15038,2047,3,311,279,629,83,60,1362,0,35,1397
15,18,15038,2048,3,140,141,269,35,15,600,0,22,622
15,18,15038,2049,3,282,175,384,67,41,949,5,11,965
15,18,15038,2050,3,340,233,509,62,58,1202,0,23,1225
15,18,15038,2051,3,277,184,306,48,30,845,1,20,866
15,18,15038,2052,3,197,164,339,44,28,772,0,15,787
15,18,15038,2053,3,424,210,316,44,56,1050,1,17,1068
15,18,15038,2054,3,214,145,290,42,37,728,0,19,747
15,18,15038,2055,3,257,119,271,53,34,734,0,12,746
15,18,15038,2056,3,198,69,78,11,11,367,0,9,376
15,18,15038,2057,3,384,445,344,59,33,1265,1,31,1297
15,18,15038,2058,3,228,359,302,41,22,952,0,20,972
15,18,15038,2059,3,176,178,206,22,14,596,2,11,609
15,18,15038,2060,3,646,694,578,93,36,2047,6,45,2098
15,18,15038,2061,3,267,596,442,40,19,1364,6,46,1416
15,18,15038,2062,3,152,243,76,20,13,504,2,16,522
15,18,15038,2063,3,297,269,485,63,39,1153,3,37,1193
15,18,15038,2064,3,277,259,348,37,29,950,0,14,964
15,18,15038,2065,3,389,435,604,105,46,1579,8,52,1639
15,18,15038,2066,3,408,322,539,80,36,1385,9,30,1424
15,18,15038,2067,3,437,744,328,79,38,1626,8,37,1671
15,18,15039,2068,3,178,387,375,38,19,997,4,19,1020
15,18,15039,2069,3,190,346,395,31,31,993,3,12,1008
15,18,15039,2070,3,171,298,329,43,25,866,11,9,886
15,18,15039,2071,3,51,92,72,8,5,228,1,2,231
15,18,15039,2072,3,8,33,7,1,0,49,0,1,50
15,18,15047,2304,3,190,256,192,22,16,676,0,11,687
15,18,15047,2305,3,44,104,47,7,3,205,0,9,214
15,18,15047,2306,3,127,170,199,21,20,537,1,14,552
15,18,15047,2307,3,121,144,172,13,11,461,1,11,473
15,18,15047,2308,3,448,311,608,67,41,1475,12,21,1508
15,18,15047,2309,3,45,113,109,17,9,293,0,7,300
15,18,15047,2310,3,249,196,432,26,26,929,3,21,953
15,18,15047,2311,3,217,220,305,38,21,801,12,18,831
15,18,15047,2312,3,84,114,189,13,11,411,1,5,417
15,18,15047,2313,3,149,192,232,30,17,620,0,15,635
15,18,15052,2386,3,269,303,343,75,27,1017,5,14,1036
15,18,15052,2387,3,833,485,845,159,113,2435,10,47,2492
15,18,15052,2388,3,807,612,588,127,76,2210,11,31,2252
15,18,15052,2389,3,356,402,334,68,27,1187,6,16,1209
15,18,15052,2390,3,384,386,306,51,35,1162,4,25,1191
15,18,15052,2391,3,116,175,190,9,15,505,1,7,513
15,18,15052,2392,3,47,110,65,5,5,232,2,2,236
15,18,15052,2393,3,108,182,161,10,17,478,3,5,486
15,18,15052,2394,3,192,167,202,26,14,601,7,11,619
15,18,15052,2395,3,249,198,391,40,20,898,1,25,924
15,18,15052,2396,3,121,125,169,19,13,447,5,8,460
15,18,15052,2397,3,248,174,238,28,14,702,1,19,722
15,18,15052,2398,3,266,182,293,42,17,800,9,26,835
15,18,15052,2399,3,219,178,230,35,9,671,0,21,692
15,18,15052,2400,3,165,160,245,31,19,620,1,26,647
15,18,15052,2401,3,128,82,205,19,9,443,0,13,456
15,18,15052,2402,3,204,82,412,14,16,728,1,22,751
15,18,15052,2403,3,77,74,144,12,7,314,0,7,321
15,18,15052,2404,3,335,269,566,56,17,1243,6,39,1288
15,18,15052,2405,3,328,267,386,65,26,1072,2,37,1111
15,18,15052,2406,3,177,92,216,36,20,541,0,21,562
15,18,15052,2407,3,193,132,245,33,23,626,4,29,659
15,18,15052,2408,3,208,188,456,47,16,915,4,22,941
15,18,15052,2409,3,192,213,398,35,17,855,5,17,877
15,18,15052,2410,3,93,42,36,5,2,178,1,1,180
15,18,15052,2411,3,209,260,316,25,15,825,4,17,846
15,18,15052,2412,3,299,266,251,26,11,853,4,8,865
15,18,15052,2413,3,435,243,599,73,41,1391,10,51,1452
15,18,15052,2414,3,261,193,185,26,17,682,0,10,692
15,18,15052,2415,3,520,231,304,65,33,1153,9,27,1189
15,18,15052,2416,3,471,327,323,74,25,1220,7,37,1264
15,18,15052,2417,3,665,311,332,73,51,1432,5,30,1467
15,18,15052,2418,3,580,342,456,99,41,1518,1,39,1558
15,18,15052,2419,3,817,401,413,69,52,1752,18,41,1811
15,18,15052,2420,3,438,306,322,63,22,1151,14,23,1188
15,18,15052,2421,3,402,300,325,75,34,1136,4,44,1184
15,18,15052,2422,3,162,231,184,14,13,604,1,8,613
15,18,15052,2423,3,61,22,56,3,5,147,0,0,147
15,18,15052,2424,3,462,335,472,85,35,1389,6,50,1445
15,18,15052,2425,3,458,213,427,70,32,1200,3,28,1231
15,18,15052,2426,3,99,217,408,20,9,753,9,10,772
15,18,15052,2427,3,256,334,766,47,13,1416,5,16,1437
15,18,15052,2428,3,258,374,597,45,20,1294,5,18,1317
15,18,15052,2429,3,209,359,614,37,19,1238,4,23,1265
15,18,15052,2430,3,179,112,107,23,6,427,6,16,449
15,18,15052,2431,3,343,153,58,21,16,591,0,9,600
15,18,15116,5791,3,392,304,308,40,31,1075,8,11,1094
15,18,15116,5792,3,360,259,391,49,24,1083,3,9,1095
15,18,15116,5793,3,609,358,547,89,54,1657,4,38,1699
15,18,15116,5794,3,433,263,569,66,39,1370,7,25,1402
15,18,15116,5795,3,395,236,296,61,32,1020,0,17,1037
15,18,15116,5796,3,375,252,402,54,38,1121,6,22,1149
15,18,15116,5797,3,643,386,647,76,58,1810,16,32,1858
15,18,15116,5798,3,293,155,225,26,26,725,6,14,745
15,18,15116,5799,3,280,306,314,37,51,988,12,33,1033
15,18,15116,5800,3,135,270,380,18,11,814,0,22,836
15,18,15116,5801,3,232,256,379,48,22,937,4,32,973
15,18,15116,5802,3,478,530,821,79,42,1950,7,26,1983
15,18,15116,5803,3,437,346,716,49,36,1584,1,36,1621
15,18,15116,5804,3,317,273,521,52,29,1192,3,19,1214
15,19,15105,4868,3,375,277,506,67,24,1249,4,16,1269
15,19,15105,4869,3,234,158,221,44,23,680,2,10,692
15,19,15105,4870,3,458,396,569,96,61,1580,9,30,1619
15,19,15105,4871,3,282,120,211,45,24,682,2,9,693
15,19,15105,4872,3,542,204,440,77,29,1292,3,11,1306
15,19,15105,4873,3,365,140,318,59,27,909,0,9,918
15,19,15105,4874,3,366,100,342,47,25,880,1,9,890
15,19,15105,4875,3,357,162,319,63,38,939,0,16,955
15,19,15105,4876,3,470,269,352,65,48,1204,4,15,1223
15,19,15105,4877,3,293,313,372,54,25,1057,4,17,1078
15,19,15105,4878,3,285,365,439,94,33,1216,1,21,1238
15,19,15105,4879,3,122,47,97,14,12,292,0,6,298
15,19,15105,4880,3,81,47,74,16,10,228,0,4,232
15,19,15105,4881,3,144,76,179,28,30,457,0,13,470
15,19,15105,4882,3,143,243,317,50,15,768,8,14,790
15,19,15105,4883,3,204,213,289,78,17,801,9,14,824
15,19,15105,4884,3,257,112,245,51,18,683,2,16,701
15,19,15105,4885,3,255,130,289,69,24,767,2,10,779
15,19,15105,4886,3,320,135,354,43,25,877,2,19,898
15,19,15105,4887,3,266,131,241,39,16,693,0,7,700
15,19,15105,4888,3,265,86,356,44,19,770,1,20,791
15,19,15105,4889,3,160,100,247,31,5,543,0,13,556
15,19,15105,4890,3,354,178,389,80,21,1022,0,15,1037
15,19,15105,4891,3,218,80,221,46,21,586,0,13,599
15,19,15105,4892,3,174,94,185,37,13,503,0,9,512
15,19,15105,4893,3,179,107,252,23,14,575,2,14,591
15,19,15105,4894,3,369,201,393,70,26,1059,1,27,1087
15,19,15105,4895,3,237,172,305,66,25,805,1,15,821
15,19,15105,4896,3,193,126,223,48,19,609,0,20,629
15,19,15105,4897,3,174,100,256,38,14,582,2,7,591
15,19,15105,4898,3,293,154,342,45,25,859,4,20,883
15,19,15105,4899,3,174,136,244,40,26,620,1,8,629
15,19,15105,4900,3,142,98,174,41,18,473,4,11,488
15,19,15105,4901,3,282,118,207,62,22,691,0,7,698
15,19,15105,4902,3,119,60,129,18,14,340,0,1,341
15,19,15105,4903,3,152,59,157,21,20,409,0,6,415
15,19,15105,4904,3,172,83,183,39,14,491,0,4,495
15,19,15105,4905,3,353,138,354,61,43,949,1,18,968
15,19,15105,4906,3,1146,289,676,140,82,2333,3,19,2355
15,19,15105,4907,3,326,141,247,42,22,778,0,8,786
15,19,15105,4908,3,309,150,289,57,30,835,4,13,852
15,19,15105,4909,3,435,184,414,71,46,1150,1,25,1176
15,19,15105,4910,3,356,142,402,64,42,1006,2,16,1024
15,19,15105,4911,3,324,116,272,37,25,774,0,5,779
15,19,15105,4912,3,551,159,375,80,43,1208,2,14,1224
15,19,15105,4913,3,134,106,139,21,17,417,0,8,425
15,19,15105,4914,3,421,261,318,78,30,1108,1,17,1126
15,19,15105,4915,3,545,238,301,71,44,1199,3,18,1220
15,19,15105,4916,3,259,140,224,42,24,689,2,10,701
15,19,15105,4917,3,323,306,339,67,36,1071,2,15,1088
15,19,15105,4918,3,208,174,257,57,28,724,0,18,742
15,19,15105,4919,3,253,219,276,67,34,849,1,22,872
15,19,15105,4920,3,334,183,387,59,28,991,8,15,1014
15,19,15105,4921,3,316,112,362,57,33,880,0,19,899
15,19,15105,4922,3,167,161,191,32,19,570,1,8,579
15,19,15105,4923,3,329,184,260,51,37,861,1,5,867
15,19,15105,4924,3,165,118,136,22,15,456,2,16,474
15,19,15105,4925,3,521,181,354,57,45,1158,1,12,1171
15,19,15105,4926,3,604,159,417,94,58,1332,4,13,1349
15,19,15105,4927,3,423,97,242,55,29,846,4,15,865
15,19,15105,4928,3,453,114,378,55,41,1041,2,8,1051
15,19,15105,4929,3,468,143,488,76,77,1252,2,13,1267
15,19,15105,4930,3,228,151,351,65,36,831,1,22,854
15,19,15105,4931,3,218,95,248,47,34,642,2,5,649
15,19,15105,4932,3,105,54,205,34,26,424,0,7,431
15,19,15105,4933,3,185,107,220,35,15,562,1,7,570
15,19,15105,4934,3,132,74,199,29,17,451,0,1,452
15,19,15105,4935,3,356,211,386,66,32,1051,4,22,1077
15,19,15105,4936,3,165,104,190,38,13,510,2,12,524
15,19,15105,4937,3,313,221,450,55,29,1068,4,28,1100
15,19,15105,4938,3,283,212,438,69,34,1036,2,18,1056
15,19,15105,4939,3,239,98,256,26,20,639,2,9,650
15,19,15105,4940,3,167,90,232,43,16,548,2,14,564
15,19,15105,4941,3,276,133,378,45,30,862,0,10,872
15,19,15105,4942,3,271,163,424,49,31,938,4,21,963
15,19,15105,4943,3,347,164,354,34,30,929,3,9,941
15,19,15105,4944,3,356,153,301,38,19,867,2,11,880
15,19,15105,4945,3,334,108,394,52,43,931,0,8,939
15,19,15105,4946,3,479,291,423,101,48,1342,4,23,1369
15,19,15105,4947,3,419,138,279,51,41,928,1,9,938
15,19,15105,4948,3,489,154,362,65,58,1128,1,13,1142
15,19,15105,4949,3,484,146,373,48,39,1090,1,17,1108
15,19,15105,4950,3,243,193,229,39,23,727,2,13,742
15,19,15105,4951,3,154,138,208,25,22,547,0,12,559
15,19,15105,4952,3,208,85,206,115,16,630,0,9,639
15,19,15105,4953,3,441,96,282,43,25,887,3,9,899
15,19,15105,4954,3,341,139,377,64,34,955,2,24,981
15,19,15105,4955,3,341,144,318,67,34,904,2,11,917
15,19,15105,4956,3,289,125,292,62,29,797,0,27,824
15,19,15105,4957,3,247,99,290,36,33,705,5,13,723
15,19,15105,4958,3,260,120,421,54,20,875,2,11,888
15,19,15105,4959,3,341,125,367,57,21,911,0,12,923
15,19,15105,4960,3,209,109,328,38,15,699,4,12,715
15,19,15105,4961,3,305,143,397,47,25,917,1,18,936
15,19,15105,4962,3,292,123,358,45,25,843,0,16,859
15,19,15105,4968,3,231,83,176,31,19,540,0,7,547
15,19,15105,4969,3,173,68,250,21,24,536,1,8,545
15,19,15105,4970,3,225,79,235,34,16,589,2,5,596
15,19,15105,4971,3,269,84,221,37,13,624,1,5,630
15,19,15105,4972,3,282,75,258,35,21,671,0,8,679
15,19,15105,4994,3,276,59,98,26,29,488,0,7,495
15,19,15105,4995,3,188,122,228,31,12,581,1,14,596
15,19,15105,5002,3,244,143,313,60,34,794,0,8,802
15,19,15105,5003,3,355,173,345,65,47,985,3,10,998
15,19,15105,5004,3,438,131,307,85,40,1001,0,12,1013
15,19,15105,5005,3,489,167,376,96,46,1174,1,19,1194
15,19,15105,5006,3,306,151,283,57,29,826,0,10,836
15,19,15105,5007,3,164,71,120,33,14,402,1,11,414
15,19,15105,5008,3,380,129,261,34,30,834,3,11,848
15,19,15105,5009,3,340,143,263,62,39,847,9,11,867
15,19,15105,5010,3,239,101,170,36,23,569,0,9,578
15,19,15105,5018,3,278,90,167,34,24,593,5,4,602
15,19,15105,5019,3,223,198,172,54,17,664,1,10,675
15,19,15105,5020,3,303,93,230,37,26,689,0,14,703
15,19,15105,5021,3,220,112,245,44,31,652,2,12,666
15,19,15105,5022,3,490,157,490,85,39,1261,2,14,1277
15,19,15105,5023,3,329,79,209,43,28,688,0,12,700
15,19,15105,5024,3,328,83,226,58,33,728,0,8,736
15,19,15105,5025,3,465,136,389,60,33,1083,0,17,1100
15,19,15105,5026,3,226,133,257,41,28,685,2,9,696
15,19,15105,5027,3,248,94,218,32,27,619,2,4,625
15,19,15105,5028,3,504,145,386,97,41,1173,0,10,1183
15,19,15105,5033,3,147,60,160,25,10,402,1,6,409
15,19,15105,5034,3,367,154,356,50,31,958,3,14,975
15,19,15105,5035,3,401,151,340,75,33,1000,3,10,1013
15,19,15105,5036,3,411,183,428,51,55,1128,1,11,1140
15,19,15105,5037,3,240,149,390,63,46,888,2,7,897
15,19,15105,5038,3,466,188,291,65,34,1044,0,28,1072
15,19,15105,5039,3,413,174,372,87,48,1094,0,17,1111
15,19,15105,5040,3,274,102,272,43,26,717,8,0,725
15,19,15105,5041,3,189,83,206,26,11,515,2,9,526
15,19,15105,5042,3,491,202,525,58,55,1331,2,22,1355
15,19,15105,5043,3,334,121,271,54,43,823,0,11,834
15,19,15105,5044,3,521,152,388,64,50,1175,1,12,1188
15,19,15105,5045,3,394,115,292,50,37,888,0,21,909
15,19,15105,5046,3,334,87,351,76,38,886,2,12,900
15,19,15105,5047,3,237,77,273,39,24,650,0,11,661
15,19,15105,5048,3,325,117,373,83,31,929,3,13,945
15,19,15105,5049,3,263,109,317,57,34,780,0,11,791
15,19,15105,5050,3,305,91,195,36,31,658,1,7,666
15,19,15105,5051,3,278,96,306,60,29,769,1,3,773
15,19,15105,5052,3,430,141,455,57,39,1122,4,8,1134
15,19,15105,5053,3,366,136,424,57,50,1033,0,17,1050
15,19,15105,5054,3,403,134,358,58,57,1010,4,13,1027
15,19,15105,5055,3,519,142,489,69,55,1274,3,12,1289
15,19,15105,5056,3,396,151,514,62,41,1164,3,17,1184
15,19,15105,5057,3,305,143,351,57,39,895,3,17,915
15,19,15105,5058,3,152,116,244,27,20,559,1,5,565
15,19,15105,5059,3,437,141,418,66,50,1112,0,18,1130
15,19,15105,5060,3,312,154,362,53,44,925,1,13,939
15,19,15105,5061,3,343,193,433,92,54,1115,4,16,1135
15,19,15105,5062,3,228,91,314,45,37,715,6,4,725
15,19,15105,5063,3,251,97,321,44,37,750,0,21,771
15,19,15105,5064,3,313,168,446,87,29,1043,2,12,1057
15,19,15105,5065,3,388,157,392,72,34,1043,3,11,1057
15,19,15105,5066,3,562,235,707,96,46,1646,3,35,1684
15,19,15105,5067,3,378,151,429,59,29,1046,0,15,1061
15,19,15105,5068,3,397,159,413,65,50,1084,2,19,1105
15,19,15105,5069,3,438,131,290,60,37,956,0,15,971
15,19,15105,5070,3,264,184,339,56,40,883,0,15,898
15,19,15105,5071,3,372,79,221,29,24,725,0,6,731
15,19,15105,5072,3,600,166,275,52,35,1128,2,10,1140
15,19,15105,5073,3,503,147,252,61,38,1001,0,15,1016
15,19,15105,5074,3,256,117,292,58,39,762,1,7,770
15,19,15105,5075,3,199,143,274,76,23,715,1,6,722
15,19,15105,5076,3,353,163,508,55,42,1121,0,22,1143
15,19,15105,5077,3,248,146,396,40,32,862,1,19,882
15,19,15105,5078,3,362,157,387,56,41,1003,2,12,1017
15,19,15105,5079,3,584,156,425,61,59,1285,2,17,1304
15,19,15105,5080,3,274,128,267,43,28,740,1,12,753
15,19,15105,5081,3,155,85,291,39,22,592,2,10,604
15,19,15105,5082,3,152,77,247,31,13,520,0,5,525
15,19,15105,5083,3,168,89,277,44,18,596,1,9,606
15,19,15105,5084,3,145,64,286,30,21,546,2,14,562
15,19,15105,5085,3,205,100,236,32,21,594,0,16,610
15,19,15105,5086,3,156,58,265,36,18,533,1,12,546
15,19,15105,5087,3,238,123,283,21,17,682,0,11,693
15,19,15105,5088,3,315,126,310,75,47,873,3,13,889
15,19,15105,5089,3,243,114,312,46,29,744,2,11,757
15,19,15105,5090,3,342,145,400,58,38,983,2,10,995
15,19,15105,5091,3,246,130,316,41,35,768,0,17,785
15,19,15105,5121,3,143,115,123,24,19,424,0,0,424
15,19,15105,5127,3,184,138,252,42,20,636,1,17,654
15,19,15105,5131,3,249,253,411,55,26,994,3,26,1023
15,19,15105,5132,3,257,259,412,45,22,995,2,29,1026
15,19,15105,5133,3,316,294,422,52,40,1124,3,28,1155
15,19,15105,5134,3,402,324,496,70,66,1358,3,13,1374
15,19,15105,5135,3,326,131,271,55,25,808,1,10,819
15,20,15060,3107,3,263,191,371,79,26,930,2,15,947
15,20,15060,3108,3,306,241,427,76,43,1093,1,15,1109
15,20,15060,3109,3,240,125,386,67,37,855,2,11,868
15,20,15060,3110,3,270,156,383,60,37,906,2,7,915
15,20,15060,3111,3,326,178,395,78,46,1023,1,17,1041
15,20,15060,3112,3,272,211,288,54,43,868,1,9,878
15,20,15060,3113,3,242,138,297,69,29,775,2,14,791
15,20,15060,3114,3,294,171,408,85,38,996,4,18,1018
15,20,15060,3115,3,256,162,390,69,37,914,1,8,923
15,20,15060,3116,3,289,183,479,84,59,1094,5,11,1110
15,20,15060,3117,3,309,125,434,55,42,965,2,13,980
15,20,15060,3118,3,191,130,251,40,26,638,4,12,654
15,20,15060,3119,3,158,88,267,35,32,580,0,9,589
15,20,15060,3120,3,220,115,294,45,47,721,1,18,740
15,20,15060,3121,3,349,209,586,110,63,1317,3,22,1342
15,20,15060,3122,3,405,278,690,81,61,1515,4,11,1530
15,20,15060,3123,3,279,231,619,104,68,1301,1,14,1316
15,20,15060,3124,3,339,154,381,58,44,976,5,15,996
15,20,15060,3125,3,278,127,396,47,39,887,3,8,898
15,20,15060,3126,3,211,149,257,36,32,685,0,11,696
15,20,15060,3127,3,263,156,319,54,27,819,0,8,827
15,20,15060,3128,3,232,114,328,54,23,751,0,12,763
15,20,15060,3129,3,295,191,415,132,44,1077,2,15,1094
15,20,15060,3130,3,354,173,409,77,37,1050,5,14,1069
15,20,15060,3131,3,215,96,363,43,33,750,2,9,761
15,20,15060,3132,3,163,112,275,59,26,635,0,5,640
15,20,15060,3133,3,141,107,204,28,20,500,1,0,501
15,20,15060,3134,3,263,129,395,56,31,874,4,9,887
15,20,15060,3135,3,225,100,374,49,42,790,3,11,804
15,20,15060,3136,3,284,132,355,76,34,881,6,10,897
15,20,15060,3137,3,228,134,338,65,31,796,0,15,811
15,20,15060,3138,3,248,147,406,84,34,919,1,8,928
15,20,15060,3139,3,215,241,573,75,48,1152,4,22,1178
15,20,15060,3140,3,174,99,402,56,34,765,3,4,772
15,20,15060,3141,3,194,111,404,54,23,786,0,15,801
15,20,15060,3142,3,124,98,280,39,29,570,2,26,598
15,20,15060,3143,3,155,125,315,42,21,658,1,11,670
15,20,15060,3144,3,183,136,458,53,50,880,1,18,899
15,20,15060,3145,3,193,118,283,41,26,661,0,8,669
15,20,15060,3146,3,66,112,257,66,20,521,2,13,536
15,20,15060,3147,3,81,104,311,33,13,542,1,9,552
15,20,15060,3148,3,72,132,272,31,16,523,1,16,540
15,20,15060,3149,3,103,170,431,57,21,782,7,12,801
15,20,15060,3150,3,40,106,214,35,14,409,3,10,422
15,20,15060,3151,3,302,143,627,85,54,1211,1,14,1226
15,20,15060,3152,3,205,115,389,65,49,823,3,10,836
15,20,15060,3153,3,158,135,335,56,36,720,0,6,726
15,20,15060,3154,3,129,125,305,46,34,639,2,19,660
15,20,15060,3155,3,153,113,353,47,26,692,2,11,705
15,20,15060,3156,3,121,114,296,50,28,609,1,3,613
15,20,15060,3157,3,185,161,553,63,39,1001,3,24,1028
15,20,15060,3158,3,153,86,311,38,33,621,0,17,638
15,20,15060,3159,3,188,191,533,61,28,1001,4,15,1020
15,20,15060,3160,3,157,148,430,64,22,821,5,22,848
15,20,15060,3161,3,108,95,341,41,17,602,2,14,618
15,20,15060,3162,3,172,209,634,95,50,1160,2,16,1178
15,20,15060,3163,3,199,161,489,48,30,927,4,16,947
15,20,15060,3164,3,125,174,449,47,23,818,4,25,847
15,20,15060,3165,3,124,103,359,38,24,648,4,12,664
15,20,15060,3166,3,180,157,464,56,34,891,9,10,910
15,20,15060,3167,3,245,230,742,81,31,1329,6,20,1355
15,20,15060,3168,3,147,117,405,47,25,741,2,10,753
15,20,15060,3169,3,206,167,602,93,44,1112,2,14,1128
15,20,15060,3170,3,135,136,361,45,30,707,1,19,727
15,20,15060,3171,3,175,119,515,67,24,900,3,19,922
15,20,15060,3172,3,179,104,462,22,21,788,6,10,804
15,20,15060,3173,3,130,120,333,27,12,622,1,10,633
15,20,15060,3174,3,191,139,459,52,36,877,0,11,888
15,20,15060,3175,3,243,143,513,51,32,982,5,21,1008
15,20,15060,3176,3,176,126,321,46,40,709,0,6,715
15,20,15060,3177,3,279,167,580,91,33,1150,6,20,1176
15,20,15060,3178,3,191,143,452,59,27,872,3,12,887
15,20,15060,3179,3,90,127,377,32,23,649,2,6,657
15,20,15060,3180,3,157,152,388,58,31,786,3,17,806
15,20,15060,3181,3,84,141,301,36,20,582,0,4,586
15,20,15060,3182,3,240,160,474,46,30,950,4,20,974
15,20,15060,3183,3,162,141,405,40,24,772,1,18,791
15,20,15060,3184,3,142,143,416,39,21,761,3,15,779
15,20,15060,3185,3,161,133,409,31,31,765,1,13,779
15,20,15060,3186,3,145,208,446,43,29,871,1,15,887
15,20,15060,3194,3,388,162,327,38,47,962,0,3,965
15,20,15060,3195,3,348,158,372,81,52,1011,0,4,1015
15,20,15060,3196,3,399,520,1394,162,80,2555,6,41,2602
15,20,15060,3197,3,252,130,323,50,22,777,3,12,792
15,20,15060,3198,3,215,175,367,66,44,867,2,15,884
15,20,15060,3199,3,241,192,412,71,48,964,5,17,986
15,20,15060,3200,3,222,88,289,41,38,678,1,4,683
15,20,15060,3201,3,207,145,259,31,23,665,7,4,676
15,20,15060,3202,3,424,161,387,52,40,1064,2,14,1080
15,20,15060,3203,3,477,149,411,78,52,1167,2,18,1187
15,20,15060,3204,3,476,188,414,57,57,1192,2,15,1209
15,20,15060,3205,3,378,216,433,56,47,1130,0,9,1139
15,20,15060,3206,3,432,165,394,26,41,1058,0,5,1063
15,20,15060,3207,3,242,173,325,57,36,833,0,9,842
15,20,15060,3208,3,227,151,348,45,35,806,0,5,811
15,20,15060,3209,3,218,132,318,40,34,742,2,2,746
15,20,15060,3210,3,170,201,611,65,49,1096,1,16,1113
15,20,15060,3211,3,184,95,195,21,26,521,2,6,529
15,20,15060,3212,3,418,227,414,72,43,1174,1,17,1192
15,20,15060,3213,3,533,216,386,53,54,1242,0,15,1257
15,20,15060,3214,3,403,232,297,54,53,1039,8,15,1062
15,20,15060,3215,3,362,129,237,39,35,802,0,12,814
15,20,15060,3216,3,306,176,226,41,31,780,1,11,792
15,20,15060,3217,3,524,210,382,58,52,1226,4,7,1237
15,20,15060,3218,3,481,180,405,61,40,1167,1,9,1177
15,20,15060,3219,3,361,154,315,30,24,884,4,8,896
15,20,15060,3220,3,230,252,843,86,54,1465,4,22,1491
15,20,15060,3221,3,162,201,620,56,41,1080,2,17,1099
15,20,15060,3222,3,164,181,718,75,28,1166,0,26,1192
15,20,15060,3223,3,213,160,599,50,87,1109,0,10,1119
15,20,15060,3224,3,192,145,545,40,37,959,2,14,975
15,20,15060,3225,3,137,160,442,58,26,823,11,17,851
15,20,15060,3226,3,221,208,652,77,52,1210,8,23,1241
15,20,15060,3227,3,184,241,505,53,50,1033,5,25,1063
15,20,15060,3228,3,133,124,452,52,22,783,0,26,809
15,20,15060,3229,3,249,168,598,73,39,1127,2,20,1149
15,20,15060,3230,3,97,66,280,26,23,492,3,1,496
15,20,15060,3231,3,133,201,475,56,31,896,0,14,910
15,20,15060,3232,3,236,339,706,85,59,1425,5,25,1455
15,20,15060,3233,3,231,291,613,43,88,1266,2,20,1288
15,20,15060,3234,3,210,306,543,76,58,1193,6,24,1223
15,20,15060,3235,3,159,180,464,57,30,890,2,7,899
15,20,15060,3236,3,144,172,480,47,38,881,3,20,904
15,20,15060,3237,3,140,149,454,53,33,829,7,12,848
15,20,15060,3238,3,130,122,383,40,44,719,10,28,757
15,20,15060,3239,3,180,168,548,52,32,980,5,10,995
15,20,15060,3240,3,190,156,525,68,46,985,12,18,1015
15,20,15060,3241,3,198,192,475,47,28,940,7,10,957
15,20,15060,3242,3,194,207,449,56,39,945,3,11,959
15,20,15060,3243,3,139,139,369,46,28,721,5,13,739
15,20,15060,3244,3,192,194,501,65,40,992,4,25,1021
15,20,15060,3245,3,161,192,524,63,42,982,3,19,1004
15,20,15060,3246,3,143,209,514,48,26,940,4,16,960
15,20,15060,3247,3,154,200,484,48,42,928,0,14,942
15,20,15060,3248,3,117,192,383,43,39,774,3,10,787
15,20,15060,3249,3,157,188,409,66,36,856,7,23,886
15,20,15060,3250,3,171,191,428,73,29,892,2,17,911
15,20,15060,3251,3,177,204,475,54,44,954,0,31,985
15,20,15060,3252,3,182,154,394,45,27,802,6,12,820
15,20,15060,3253,3,184,170,412,57,32,855,2,18,875
15,20,15060,3254,3,93,109,325,30,11,568,3,39,610
15,20,15060,3255,3,174,126,414,45,28,787,5,13,805
15,20,15060,3256,3,163,152,414,32,29,790,2,14,806
15,20,15060,3257,3,107,107,308,33,19,574,0,7,581
15,20,15060,3258,3,139,125,333,49,22,668,2,11,681
15,20,15060,3259,3,175,161,570,72,52,1030,2,25,1057
15,20,15060,3260,3,171,140,538,63,38,950,3,12,965
15,20,15060,3261,3,160,136,382,33,35,746,3,3,752
15,20,15060,3262,3,95,98,329,33,18,573,3,5,581
15,20,15060,3263,3,145,136,468,52,37,838,3,8,849
15,20,15060,3264,3,172,143,380,50,32,777,0,8,785
15,20,15060,3265,3,132,177,430,46,32,817,1,15,833
15,20,15060,3266,3,143,114,342,34,17,650,0,9,659
15,20,15060,3267,3,169,173,470,55,31,898,3,14,915
15,20,15060,3268,3,190,182,569,74,37,1052,5,24,1081
15,21,15058,2723,3,627,100,151,37,24,939,2,6,947
15,21,15058,2724,3,669,126,148,41,36,1020,0,10,1030
15,21,15058,2725,3,449,108,105,37,30,729,0,5,734
15,21,15058,2726,3,331,61,85,25,13,515,0,4,519
15,21,15058,2727,3,414,76,110,26,22,648,0,9,657
15,21,15058,2728,3,454,105,82,29,36,706,0,8,714
15,21,15058,2729,3,679,210,103,32,33,1057,0,6,1063
15,21,15058,2730,3,701,141,133,34,44,1053,1,11,1065
15,21,15058,2731,3,471,128,138,31,29,797,6,17,820
15,21,15058,2732,3,473,93,88,19,28,701,0,4,705
15,21,15058,2733,3,399,77,100,31,21,628,1,3,632
15,21,15058,2734,3,815,120,146,30,41,1152,1,8,1161
15,21,15058,2735,3,467,82,74,18,28,669,0,7,676
15,21,15058,2742,3,915,159,127,32,41,1274,0,9,1283
15,21,15058,2743,3,589,110,83,26,28,836,1,8,845
15,21,15058,2744,3,645,79,95,28,30,877,0,4,881
15,21,15058,2745,3,513,67,77,23,19,699,0,2,701
15,21,15058,2746,3,466,114,168,46,21,815,0,12,827
15,21,15058,2747,3,637,170,179,39,36,1061,2,11,1074
15,21,15058,2748,3,468,64,82,23,25,662,1,3,666
15,21,15058,2749,3,666,215,110,34,27,1052,0,9,1061
15,21,15058,2750,3,203,47,40,18,15,323,0,2,325
15,21,15058,2751,3,293,109,187,28,29,646,1,6,653
15,21,15058,2752,3,381,46,51,14,16,508,0,1,509
15,21,15058,2753,3,750,138,164,98,50,1200,0,9,1209
15,21,15058,2754,3,457,78,129,42,33,739,0,2,741
15,21,15058,2755,3,693,113,119,31,40,996,0,3,999
15,21,15058,2756,3,489,108,109,24,29,759,0,6,765
15,21,15058,2757,3,372,49,46,16,18,501,0,2,503
15,21,15058,2758,3,804,121,131,39,48,1143,0,4,1147
15,21,15058,2759,3,888,129,140,35,31,1223,1,9,1233
15,21,15058,2760,3,833,137,155,32,51,1208,1,5,1214
15,21,15058,2761,3,553,394,460,72,65,1544,4,26,1574
15,21,15058,2762,3,549,236,398,66,58,1307,5,17,1329
15,21,15058,2763,3,445,278,395,76,41,1235,5,26,1266
15,21,15058,2764,3,306,268,296,61,47,978,7,21,1006
15,21,15058,2765,3,294,251,244,34,20,843,2,15,860
15,21,15058,2766,3,196,177,252,42,22,689,4,3,696
15,21,15058,2767,3,217,149,217,47,24,654,5,11,670
15,21,15058,2768,3,518,464,567,99,71,1719,6,50,1775
15,21,15058,2769,3,498,281,483,91,50,1403,7,32,1442
15,21,15058,2770,3,419,304,410,69,49,1251,14,16,1281
15,21,15058,2771,3,250,214,240,31,31,766,7,13,786
15,21,15058,2772,3,305,496,358,78,31,1268,5,41,1314
15,21,15058,2773,3,395,576,542,93,50,1656,5,48,1709
15,21,15058,2774,3,375,328,383,62,42,1190,5,30,1225
15,21,15058,2775,3,413,297,411,77,44,1242,3,16,1261
15,21,15058,2776,3,391,408,442,66,40,1347,3,33,1383
15,21,15058,2777,3,691,237,269,53,40,1290,2,15,1307
15,21,15058,2778,3,369,268,312,46,31,1026,1,19,1046
15,21,15058,2779,3,584,239,218,47,36,1124,2,15,1141
15,21,15058,2780,3,851,127,153,52,41,1224,0,14,1238
15,21,15058,2781,3,643,104,88,26,27,888,1,14,903
15,21,15058,2782,3,811,153,106,33,26,1129,1,9,1139
15,21,15058,2794,3,217,39,49,7,10,322,0,1,323
15,21,15058,2796,3,679,184,237,44,43,1187,0,10,1197
15,21,15058,2797,3,879,178,190,43,33,1323,1,12,1336
15,21,15058,2798,3,404,69,87,27,19,606,0,5,611
15,21,15058,2799,3,482,113,125,31,25,776,0,10,786
15,21,15058,2800,3,350,95,123,21,31,620,1,4,625
15,21,15058,2801,3,340,259,291,73,63,1026,0,17,1043
15,21,15058,2802,3,207,220,338,38,18,821,5,11,837
15,21,15058,2803,3,272,271,361,57,40,1001,14,28,1043
15,21,15058,2804,3,309,306,451,67,45,1178,6,15,1199
15,21,15058,2805,3,594,409,635,94,75,1807,19,43,1869
15,21,15058,2806,3,450,114,152,23,29,768,1,11,780
15,21,15058,2807,3,611,162,190,45,47,1055,0,9,1064
15,21,15058,2808,3,605,97,150,28,31,911,0,7,918
15,21,15058,2809,3,712,141,128,37,46,1064,1,8,1073
15,21,15058,2832,3,182,36,38,13,9,278,1,2,281
15,21,15058,2840,3,718,112,240,57,48,1175,3,9,1187
15,21,15058,2841,3,482,64,127,27,29,729,0,7,736
15,21,15058,2888,3,454,207,362,55,51,1129,2,29,1160
15,21,15058,2889,3,446,272,476,73,53,1320,0,18,1338
15,21,15058,2890,3,488,179,302,48,44,1061,1,10,1072
15,21,15058,2891,3,403,84,210,37,35,769,2,3,774
15,21,15058,2892,3,329,130,244,26,28,757,2,11,770
15,21,15058,2893,3,591,121,150,35,40,937,0,10,947
15,21,15058,2894,3,683,108,134,41,42,1008,0,7,1015
15,21,15058,2895,3,1723,268,276,76,86,2429,2,19,2450
15,21,15058,2896,3,970,241,219,67,62,1559,0,18,1577
15,21,15058,2897,3,243,169,204,34,35,685,3,13,701
15,21,15058,2898,3,385,325,532,100,76,1418,8,22,1448
15,21,15058,2899,3,340,225,419,57,48,1089,3,30,1122
15,21,15058,2900,3,270,163,275,48,27,783,2,14,799
15,21,15058,2901,3,239,151,297,42,12,741,1,23,765
15,21,15058,2902,3,345,269,425,56,69,1164,7,28,1199
15,21,15058,2906,3,246,192,313,63,33,847,3,13,863
15,21,15058,2907,3,442,262,510,68,54,1336,8,14,1358
15,21,15058,2908,3,487,331,524,77,84,1503,3,34,1540
15,21,15058,2909,3,360,255,484,65,53,1217,4,27,1248
15,21,15058,2910,3,458,270,584,77,65,1454,4,26,1484
15,21,15058,2911,3,462,301,481,55,65,1364,5,33,1402
15,21,15058,2912,3,412,376,561,80,60,1489,8,22,1519
15,21,15058,2913,3,397,237,509,62,62,1267,18,19,1304
15,21,15058,2914,3,282,211,344,47,48,932,7,29,968
15,21,15058,2915,3,281,240,492,62,31,1106,8,23,1137
15,21,15058,2916,3,337,201,446,64,44,1092,4,18,1114
15,21,15058,2919,3,317,257,376,68,47,1065,1,21,1087
15,21,15058,2920,3,131,87,129,39,9,395,0,16,411
15,21,15058,2921,3,426,351,564,78,60,1479,4,25,1508
15,21,15058,2922,3,315,244,397,71,45,1072,4,25,1101
15,21,15058,2923,3,336,393,592,79,55,1455,3,34,1492
15,21,15058,2924,3,322,332,541,62,46,1303,7,17,1327
15,21,15058,2925,3,441,272,602,72,46,1433,13,25,1471
15,21,15058,2926,3,339,297,571,53,54,1314,6,58,1378
15,21,15058,2927,3,339,457,524,68,48,1436,5,38,1479
15,21,15058,2928,3,323,256,418,70,18,1085,7,9,1101
15,21,15058,2929,3,287,257,402,59,32,1037,3,22,1062
15,21,15058,2933,3,90,121,169,12,10,402,0,10,412
15,21,15058,2934,3,294,273,515,77,52,1211,6,27,1244
15,21,15058,2935,3,202,125,267,36,36,666,0,13,679
15,21,15058,2936,3,293,165,355,57,44,914,5,16,935
15,21,15058,2937,3,290,156,346,54,38,884,2,17,903
15,21,15058,2938,3,245,102,272,37,20,676,3,15,694
15,21,15058,2939,3,296,161,310,50,29,846,5,14,865
15,21,15058,2940,3,335,275,385,64,46,1105,4,23,1132
15,21,15058,2941,3,350,168,461,51,37,1067,0,22,1089
15,21,15058,2942,3,295,163,310,39,19,826,4,15,845
15,21,15058,2961,3,323,273,580,67,48,1291,3,29,1323
15,21,15058,2962,3,315,274,467,51,53,1160,3,26,1189
15,21,15058,2963,3,331,238,485,69,53,1176,5,23,1204
15,21,15058,3000,3,404,416,503,92,64,1479,15,38,1532
15,21,15058,3001,3,196,199,270,46,24,735,5,22,762
15,21,15058,3002,3,288,287,335,47,20,977,3,35,1015
15,21,15058,3003,3,309,247,353,65,32,1006,9,34,1049
15,21,15058,3033,3,251,312,306,34,32,935,1,16,952
15,21,15058,3034,3,311,292,340,63,38,1044,3,22,1069
15,21,15058,3035,3,1070,821,1398,183,131,3603,14,70,3687
15,22,15058,2572,3,248,236,219,48,30,781,1,14,796
15,22,15058,2573,3,397,83,175,24,29,708,0,10,718
15,22,15058,2574,3,460,109,221,29,33,852,0,9,861
15,22,15058,2575,3,519,120,156,39,35,869,0,11,880
15,22,15058,2576,3,513,137,222,52,51,975,0,27,1002
15,22,15058,2577,3,479,98,160,28,27,792,1,8,801
15,22,15058,2578,3,261,154,190,47,29,681,2,17,700
15,22,15058,2579,3,457,105,154,26,23,765,1,8,774
15,22,15058,2580,3,299,163,186,27,28,703,1,14,718
15,22,15058,2581,3,354,110,159,20,30,673,0,12,685
15,22,15058,2582,3,296,159,309,47,44,855,6,24,885
15,22,15058,2583,3,321,181,295,42,40,879,0,31,910
15,22,15058,2584,3,274,181,230,39,31,755,2,8,765
15,22,15058,2585,3,170,124,165,28,21,508,1,17,526
15,22,15058,2586,3,164,68,121,16,11,380,0,4,384
15,22,15058,2587,3,357,149,289,41,35,871,3,9,883
15,22,15058,2588,3,294,208,310,48,45,905,1,21,927
15,22,15058,2589,3,276,193,255,44,47,815,1,18,834
15,22,15058,2590,3,331,271,225,47,34,908,1,11,920
15,22,15058,2591,3,428,158,189,43,54,872,1,2,875
15,22,15058,2592,3,302,157,225,39,22,745,2,6,753
15,22,15058,2593,3,288,208,236,39,22,793,1,15,809
15,22,15058,2594,3,169,169,199,29,19,585,4,11,600
15,22,15058,2595,3,428,269,249,59,43,1048,2,21,1071
15,22,15058,2596,3,372,192,247,58,40,909,0,17,926
15,22,15058,2597,3,135,128,139,24,14,440,2,13,455
15,22,15058,2598,3,89,78,113,23,14,317,0,4,321
15,22,15058,2599,3,358,94,152,24,24,652,0,8,660
15,22,15058,2600,3,284,121,120,21,26,572,2,6,580
15,22,15058,2601,3,270,130,284,48,42,774,1,8,783
15,22,15058,2602,3,208,231,212,45,28,724,4,12,740
15,22,15058,2603,3,331,239,348,40,41,999,3,25,1027
15,22,15058,2604,3,210,147,195,29,24,605,1,10,616
15,22,15058,2605,3,194,154,234,30,34,646,4,14,664
15,22,15058,2606,3,338,167,338,38,34,915,4,13,932
15,22,15058,2607,3,264,128,243,26,20,681,5,20,706
15,22,15058,2608,3,302,176,235,32,27,772,4,18,794
15,22,15058,2609,3,227,156,300,42,22,747,0,13,760
15,22,15058,2610,3,269,181,302,49,35,836,4,12,852
15,22,15058,2611,3,279,156,278,38,35,786,3,19,808
15,22,15058,2612,3,137,127,170,31,14,479,1,10,490
15,22,15058,2613,3,219,173,327,50,35,804,0,16,820
15,22,15058,2614,3,212,97,209,28,30,576,2,10,588
15,22,15058,2615,3,329,232,373,57,34,1025,3,26,1054
15,22,15058,2616,3,309,104,218,46,27,704,2,7,713
15,22,15058,2617,3,238,115,189,13,30,585,4,7,596
15,22,15058,2618,3,452,179,263,42,29,965,7,8,980
15,22,15058,2619,3,292,158,319,41,34,844,3,6,853
15,22,15058,2620,3,244,155,310,37,39,785,3,6,794
15,22,15058,2621,3,327,225,307,60,36,955,2,13,970
15,22,15058,2622,3,229,163,288,30,30,740,0,12,752
15,22,15058,2623,3,204,128,212,37,33,614,0,9,623
15,22,15058,2624,3,162,107,177,18,13,477,1,28,506
15,22,15058,2625,3,301,180,315,38,35,869,6,25,900
15,22,15058,2626,3,263,176,282,37,42,800,6,14,820
15,22,15058,2627,3,315,210,343,67,53,988,0,17,1005
15,22,15058,2628,3,150,190,174,40,17,571,2,11,584
15,22,15058,2629,3,169,289,305,48,43,854,4,28,886
15,22,15058,2630,3,103,148,210,23,13,497,0,0,497
15,22,15058,2631,3,147,118,214,36,22,537,1,20,558
15,22,15058,2632,3,135,157,208,43,25,568,1,14,583
15,22,15058,2633,3,137,125,185,35,28,510,1,7,518
15,22,15058,2634,3,220,187,335,39,36,817,0,23,840
15,22,15058,2635,3,240,173,334,52,25,824,3,13,840
15,22,15058,2636,3,315,185,416,62,34,1012,3,18,1033
15,22,15058,2708,3,515,691,639,121,73,2039,4,45,2088
15,22,15058,2709,3,45,110,66,7,3,231,0,3,234
15,22,15058,2712,3,18,27,16,3,0,64,0,1,65
15,22,15058,2713,3,32,73,42,6,1,154,2,3,159
15,22,15058,2715,3,55,137,81,12,7,292,0,8,300
15,22,15058,2719,3,80,144,103,11,3,341,2,8,351
15,22,15058,2720,3,70,183,115,15,9,392,0,11,403
15,22,15058,2721,3,15,60,25,2,3,105,0,1,106
15,22,15058,2736,3,717,148,147,47,42,1101,1,6,1108
15,22,15058,2737,3,984,187,229,53,54,1507,1,2,1510
15,22,15058,2738,3,559,95,120,31,34,839,3,12,854
15,22,15058,2739,3,667,107,133,30,33,970,0,12,982
15,22,15058,2740,3,678,113,128,34,26,979,0,16,995
15,22,15058,2741,3,813,136,110,34,30,1123,1,9,1133
15,22,15058,2783,3,819,150,125,46,36,1176,2,6,1184
15,22,15058,2784,3,590,102,72,23,32,819,2,5,826
15,22,15058,2785,3,630,89,83,40,17,859,2,12,873
15,22,15058,2786,3,487,86,72,20,29,694,1,5,700
15,22,15058,2787,3,493,87,91,24,32,727,0,4,731
15,22,15058,2788,3,583,84,85,23,29,804,0,6,810
15,22,15058,2789,3,239,74,133,21,30,497,2,7,506
15,22,15058,2790,3,640,114,101,22,19,896,2,7,905
15,22,15058,2791,3,372,80,95,18,16,581,1,2,584
15,22,15058,2792,3,508,94,119,14,12,747,1,9,757
15,22,15058,2793,3,784,129,179,45,33,1170,3,13,1186
15,22,15058,2795,3,531,84,93,31,35,774,0,3,777
15,22,15058,2810,3,769,143,169,43,38,1162,2,9,1173
15,22,15058,2811,3,908,147,134,34,39,1262,0,7,1269
15,22,15058,2812,3,551,75,93,24,44,787,0,9,796
15,22,15058,2813,3,454,250,240,55,41,1040,6,12,1058
15,22,15058,2814,3,762,116,147,24,38,1087,2,10,1099
15,22,15058,2815,3,877,122,126,43,46,1214,1,10,1225
15,22,15058,2816,3,763,118,158,37,27,1103,0,9,1112
15,22,15058,2817,3,670,150,127,24,32,1003,1,15,1019
15,22,15058,2818,3,365,62,70,24,26,547,0,7,554
15,22,15058,2819,3,227,151,282,32,28,720,2,8,730
15,22,15058,2820,3,290,177,325,43,44,879,0,17,896
15,22,15058,2821,3,238,87,265,31,25,646,3,3,652
15,22,15058,2822,3,186,88,235,24,27,560,0,15,575
15,22,15058,2823,3,210,131,263,44,32,680,6,16,702
15,22,15058,2824,3,247,117,254,34,36,688,4,13,705
15,22,15058,2825,3,633,103,98,23,23,880,1,6,887
15,22,15058,2826,3,781,112,142,30,27,1092,1,7,1100
15,22,15058,2827,3,720,103,140,24,36,1023,3,5,1031
15,22,15058,2828,3,472,114,91,23,8,708,0,10,718
15,22,15058,2829,3,475,84,84,26,28,697,1,7,705
15,22,15058,2830,3,705,147,104,27,30,1013,1,7,1021
15,22,15058,2831,3,972,143,189,62,46,1412,1,7,1420
15,22,15058,2833,3,106,27,23,8,5,169,1,3,173
15,22,15058,2834,3,374,310,228,57,30,999,0,14,1013
15,22,15058,2835,3,444,338,421,54,25,1282,1,18,1301
15,22,15058,2836,3,313,53,75,20,24,485,0,9,494
15,22,15058,2837,3,686,283,298,39,30,1336,1,21,1358
15,22,15058,2838,3,604,198,175,49,42,1068,0,8,1076
15,22,15058,2839,3,483,279,276,77,67,1182,5,16,1203
15,22,15058,2842,3,291,60,94,19,19,483,1,3,487
15,22,15058,2843,3,171,47,48,16,10,292,0,4,296
15,22,15058,2844,3,241,89,227,33,18,608,1,5,614
15,22,15058,2845,3,191,103,135,21,16,466,2,6,474
15,22,15058,2846,3,456,131,241,48,42,918,1,17,936
15,22,15058,2847,3,324,67,147,16,20,574,0,6,580
15,22,15058,2848,3,233,67,79,25,19,423,0,4,427
15,22,15058,2849,3,264,84,106,18,19,491,1,8,500
15,22,15058,2850,3,298,77,117,25,22,539,0,6,545
15,22,15058,2851,3,334,98,161,32,24,649,1,3,653
15,22,15058,2852,3,268,90,116,20,23,517,1,8,526
15,22,15058,2853,3,160,129,148,44,14,495,2,8,505
15,22,15058,2854,3,55,68,64,10,5,202,2,6,210
15,22,15058,2855,3,96,99,186,17,8,406,1,12,419
15,22,15058,2856,3,241,142,319,49,32,783,0,14,797
15,22,15058,2857,3,83,76,142,18,9,328,0,12,340
15,22,15058,2858,3,85,64,153,14,8,324,0,8,332
15,22,15058,2859,3,129,95,189,17,19,449,2,8,459
15,22,15058,2860,3,101,85,164,30,16,396,1,2,399
15,22,15058,2861,3,84,78,110,22,9,303,0,6,309
15,22,15058,2862,3,92,47,89,12,9,249,1,60,310
15,22,15058,2863,3,177,138,240,21,19,595,0,6,601
15,22,15058,2864,3,175,117,174,22,18,506,1,5,512
15,22,15058,2865,3,171,115,169,35,21,511,1,7,519
15,22,15058,2866,3,212,165,267,40,31,715,1,14,730
15,22,15058,2867,3,202,178,301,38,35,754,3,16,773
15,22,15058,2868,3,146,66,90,21,9,332,0,15,347
15,22,15058,2869,3,190,121,174,25,31,541,2,12,555
15,22,15058,2870,3,183,101,127,22,21,454,1,9,464
15,22,15058,2871,3,131,74,71,23,17,316,0,10,326
15,22,15058,2872,3,260,139,235,35,28,697,2,15,714
15,22,15058,2873,3,330,93,90,29,28,570,0,4,574
15,22,15058,2874,3,250,179,257,50,23,759,4,15,778
15,22,15058,2875,3,143,158,173,26,14,514,2,10,526
15,22,15058,2876,3,55,85,64,5,5,214,0,0,214
15,22,15058,2877,3,156,148,145,35,13,497,2,6,505
15,22,15058,2878,3,275,149,211,44,18,697,1,7,705
15,22,15058,2879,3,172,108,142,25,17,464,0,8,472
15,22,15058,2880,3,293,165,363,45,30,896,1,19,916
15,22,15058,2881,3,107,128,127,15,16,393,0,10,403
15,22,15058,2882,3,284,91,96,33,11,515,0,4,519
15,22,15058,2883,3,94,104,93,24,11,326,2,5,333
15,22,15058,2884,3,73,48,89,12,11,233,5,4,242
15,22,15058,2885,3,92,111,158,24,24,409,2,5,416
15,22,15058,2886,3,138,64,51,7,16,276,1,0,277
15,22,15058,2887,3,153,56,70,13,9,301,0,3,304
15,22,15058,2903,3,113,121,96,18,3,351,0,11,362
15,22,15058,2904,3,157,190,173,26,16,562,0,12,574
15,22,15058,2905,3,180,194,269,35,20,698,2,26,726
15,22,15058,2917,3,208,165,324,53,19,769,4,14,787
15,22,15058,2918,3,227,113,198,30,36,604,0,12,616
15,22,15058,2946,3,205,118,170,18,12,523,5,6,534
15,22,15058,2947,3,182,141,215,25,22,585,2,10,597
15,22,15058,2948,3,245,105,230,33,19,632,0,2,634
15,22,15058,2980,3,293,191,357,31,42,914,7,21,942
15,22,15058,2981,3,311,177,268,42,35,833,6,28,867
15,22,15058,2982,3,153,103,160,30,20,466,0,4,470
15,22,15058,2983,3,218,177,261,34,20,710,8,22,740
15,22,15058,2984,3,228,122,192,28,18,588,1,16,605
15,22,15058,2985,3,205,140,203,35,17,600,0,15,615
15,22,15058,2986,3,239,204,282,34,26,785,3,8,796
15,22,15058,2987,3,287,202,249,43,33,814,3,7,824
15,22,15058,2988,3,203,149,247,25,26,650,5,19,674
15,22,15058,3014,3,412,221,333,52,48,1066,3,19,1088
15,22,15058,3015,3,178,144,227,38,29,616,5,5,626
15,22,15058,3016,3,303,201,313,51,32,900,5,22,927
15,22,15058,3017,3,248,233,323,53,22,879,23,34,936
15,22,15058,3018,3,229,220,319,50,38,856,5,26,887
15,22,15058,3019,3,161,175,234,42,28,640,4,14,658
15,22,15058,3020,3,218,219,216,35,26,714,5,17,736
15,22,15058,3021,3,122,130,105,12,9,378,6,7,391
15,22,15058,3022,3,236,190,293,56,38,813,0,18,831
15,22,15058,3023,3,153,112,181,23,14,483,3,6,492
15,22,15058,3024,3,94,90,139,25,20,368,2,10,380
15,22,15058,3026,3,185,135,225,33,20,598,2,15,615
15,22,15058,3027,3,106,109,209,31,15,470,8,8,486
15,22,15058,3032,3,187,169,264,49,21,690,4,16,710
15,23,15005,94,3,519,535,299,62,29,1444,4,28,1476
15,23,15005,95,3,78,255,101,12,2,448,7,9,464
15,23,15005,96,3,129,243,131,6,2,511,1,18,530
15,23,15005,97,3,169,468,233,8,6,884,7,37,928
15,23,15005,98,3,27,82,57,6,2,174,2,4,180
15,23,15005,99,3,99,126,127,7,15,374,1,3,378
15,23,15005,100,3,260,434,276,26,14,1010,11,25,1046
15,23,15005,101,3,394,265,228,30,12,929,8,49,986
15,23,15005,102,3,583,269,277,36,17,1182,25,44,1251
15,23,15005,103,3,149,62,75,14,8,308,0,5,313
15,23,15005,104,3,71,67,37,5,4,184,3,9,196
15,23,15005,105,3,138,124,130,16,13,421,6,23,450
15,23,15005,106,3,205,282,182,18,18,705,15,30,750
15,23,15005,107,3,197,477,316,20,8,1018,12,40,1070
15,23,15005,108,3,63,58,72,0,3,196,1,11,208
15,23,15005,109,3,118,234,120,12,3,487,0,13,500
15,23,15005,110,3,147,199,285,33,8,672,6,31,709
15,23,15005,111,3,136,127,125,12,7,407,3,13,423
15,23,15005,112,3,374,318,341,34,10,1077,4,26,1107
15,23,15005,113,3,338,303,166,32,15,854,14,33,901
15,23,15005,114,3,183,254,156,16,14,623,3,34,660
15,23,15005,115,3,185,186,210,19,9,609,5,21,635
15,23,15005,116,3,97,124,155,13,3,392,2,10,404
15,23,15005,117,3,161,154,336,34,4,689,14,22,725
15,23,15005,118,3,141,295,204,29,10,679,9,17,705
15,23,15005,119,3,220,229,193,30,16,688,4,16,708
15,23,15005,120,3,291,290,233,46,17,877,13,24,914
15,23,15005,121,3,412,386,372,71,28,1269,9,36,1314
15,23,15005,122,3,220,246,121,30,6,623,0,22,645
15,23,15005,123,3,442,396,265,69,25,1197,5,31,1233
15,23,15005,124,3,304,229,278,38,21,870,14,16,900
15,23,15005,125,3,363,316,362,60,22,1123,14,23,1160
15,23,15005,126,3,350,238,268,36,23,915,7,46,968
15,23,15005,127,3,204,138,184,16,10,552,4,22,578
15,23,15005,128,3,487,218,450,33,41,1229,11,29,1269
15,23,15005,129,3,187,182,191,27,8,595,7,25,627
15,23,15005,130,3,233,360,133,46,10,782,14,18,814
15,23,15005,131,3,259,289,126,30,15,719,6,18,743
15,23,15005,132,3,464,209,185,52,28,938,4,40,982
15,23,15005,133,3,501,303,210,44,17,1075,16,32,1123
15,23,15005,134,3,112,267,165,8,1,553,1,15,569
15,23,15005,135,3,96,227,138,7,5,473,8,24,505
15,23,15005,136,3,258,173,172,15,2,620,9,18,647
15,23,15005,137,3,148,223,158,10,4,543,5,15,563
15,23,15005,138,3,274,412,240,32,15,973,1,32,1006
15,23,15005,139,3,252,155,204,41,14,666,17,16,699
15,23,15005,140,3,592,369,338,82,36,1417,2,32,1451
15,23,15005,141,3,438,318,251,64,26,1097,8,21,1126
15,23,15005,142,3,492,280,314,70,24,1180,5,12,1197
15,23,15005,143,3,329,183,202,50,29,793,9,23,825
15,23,15005,144,3,476,304,258,118,54,1210,17,23,1250
15,23,15005,145,3,231,175,206,20,9,641,6,14,661
15,23,15005,146,3,77,207,134,15,6,439,4,29,472
15,23,15005,147,3,111,164,106,4,1,386,0,19,405
15,23,15005,148,3,51,143,113,4,5,316,5,11,332
15,23,15005,149,3,150,169,51,17,10,397,7,9,413
15,23,15005,150,3,143,98,69,1,3,314,1,15,330
15,23,15007,156,3,87,211,148,32,4,482,4,13,499
15,23,15007,157,3,60,187,101,11,26,385,1,19,405
15,23,15007,158,3,36,184,157,6,3,386,2,19,407
15,23,15007,159,3,20,261,78,5,0,364,0,6,370
15,23,15007,160,3,50,379,592,20,6,1047,8,40,1095
15,23,15007,161,3,168,277,446,11,6,908,2,38,948
15,23,15007,162,3,43,246,394,16,3,702,3,37,742
15,23,15007,163,3,297,337,344,25,7,1010,12,48,1070
15,23,15007,164,3,100,352,291,13,8,764,6,27,797
15,23,15007,165,3,101,392,287,11,9,800,10,38,848
15,23,15033,1286,3,66,180,118,50,4,418,0,9,427
15,23,15033,1287,3,29,144,288,9,3,473,0,13,486
15,23,15033,1288,3,75,191,245,11,9,531,3,13,547
15,23,15033,1289,3,49,166,214,3,1,433,0,13,446
15,23,15033,1290,3,112,267,556,12,3,950,6,41,997
15,23,15033,1291,3,46,68,97,5,0,216,0,5,221
15,23,15033,1292,3,70,380,309,31,8,798,6,39,843
15,23,15033,1293,3,47,219,504,16,2,788,2,31,821
15,23,15033,1294,3,58,247,375,24,3,707,2,37,746
15,23,15033,1295,3,42,223,341,31,5,642,8,16,666
15,23,15033,1296,3,52,262,280,38,4,636,2,27,665
15,23,15033,1297,3,35,275,254,4,1,569,0,5,574
15,23,15033,1298,3,137,156,525,7,1,826,1,30,857
15,23,15033,1299,3,133,151,312,5,0,601,3,33,637
15,23,15033,1300,3,128,326,720,68,7,1249,0,25,1274
15,23,15033,1301,3,17,232,117,12,0,378,2,5,385
15,23,15042,2183,3,104,219,264,21,2,610,1,27,638
15,23,15042,2184,3,200,242,259,4,2,707,0,28,735
15,23,15042,2185,3,78,100,131,2,1,312,2,17,331
15,23,15042,2186,3,40,116,182,3,0,341,1,7,349
15,23,15042,2187,3,60,232,248,6,0,546,1,7,554
15,23,15111,5654,3,191,203,138,92,19,643,6,15,664
15,23,15111,5655,3,412,697,384,196,55,1744,3,33,1780
15,23,15111,5656,3,236,265,201,51,66,819,0,18,837
15,23,15111,5657,3,393,448,348,170,47,1406,9,35,1450
15,23,15111,5658,3,397,408,340,111,45,1301,2,23,1326
15,23,15111,5659,3,190,358,229,82,29,888,3,33,924
15,23,15111,5660,3,174,247,171,60,17,669,2,20,691
15,23,15111,5661,3,256,282,266,87,20,911,5,24,940
15,23,15111,5662,3,234,200,225,49,23,731,3,9,743
15,23,15111,5663,3,130,91,118,28,12,379,5,0,384
15,23,15111,5664,3,187,161,138,45,15,546,0,12,558
15,23,15111,5665,3,120,116,108,32,8,384,0,8,392
15,23,15111,5666,3,169,121,189,46,12,537,2,7,546
15,23,15111,5667,3,402,324,371,46,20,1163,2,45,1210
15,23,15111,5668,3,259,294,169,67,30,819,0,25,844
15,23,15111,5669,3,270,315,308,65,22,980,8,42,1030
15,23,15111,5670,3,91,97,91,12,4,295,1,10,306
15,23,15111,5671,3,121,123,140,24,4,412,1,15,428
15,23,15111,5672,3,210,295,162,27,6,700,4,31,735
15,23,15111,5673,3,343,414,315,70,30,1172,14,35,1221
15,23,15111,5674,3,177,219,132,20,4,552,0,16,568
15,23,15111,5675,3,219,146,159,80,15,619,2,19,640
15,23,15111,5676,3,91,241,69,22,2,425,1,3,429
15,23,15111,5677,3,216,280,293,63,16,868,8,21,897
15,23,15111,5678,3,131,199,167,14,6,517,8,19,544
15,23,15111,5679,3,183,306,202,72,13,776,3,13,792
15,23,15111,5680,3,241,349,243,90,17,940,0,10,950
15,23,15111,5681,3,216,273,243,81,11,824,2,19,845
15,23,15112,5682,3,349,212,143,50,9,763,0,27,790
15,23,15112,5683,3,164,142,198,9,6,519,13,24,556
15,23,15112,5684,3,252,148,129,22,5,556,9,42,607
15,23,15112,5685,3,158,297,255,22,4,736,10,33,779
15,23,15112,5686,3,71,102,19,5,2,199,5,4,208
15,23,15112,5687,3,199,125,99,27,8,458,1,13,472
15,23,15112,5688,3,388,451,355,45,11,1250,7,43,1300
15,23,15112,5689,3,169,137,120,18,12,456,0,52,508
15,23,15112,5690,3,121,127,105,10,7,370,4,20,394
15,23,15112,5691,3,262,238,127,28,3,658,3,49,710
15,23,15112,5692,3,233,256,252,13,5,759,14,39,812
15,23,15112,5693,3,86,95,160,17,1,359,0,12,371
15,23,15112,5694,3,246,144,66,15,7,478,4,18,500
15,23,15112,5695,3,211,202,124,8,3,548,2,51,601
15,23,15112,5696,3,370,228,151,14,6,769,3,17,789
15,23,15112,5697,3,318,334,271,17,11,951,7,41,999
15,23,15112,5698,3,61,114,89,7,1,272,0,7,279
15,23,15112,5699,3,156,118,91,7,2,374,4,10,388
15,23,15112,5700,3,154,121,94,21,5,395,4,19,418
15,23,15112,5701,3,175,120,113,12,9,429,1,6,436
15,23,15112,5702,3,104,35,45,4,0,188,0,9,197
15,23,15112,5703,3,316,239,231,18,2,806,11,55,872
15,23,15115,5748,3,181,248,153,47,7,636,4,30,670
15,23,15115,5749,3,171,144,161,47,10,533,0,19,552
15,23,15115,5750,3,64,228,181,9,7,489,1,40,530
15,23,15115,5751,3,84,399,277,16,2,778,1,24,803
15,23,15115,5752,3,38,169,156,8,5,376,0,24,400
15,23,15115,5753,3,39,149,142,5,3,338,1,22,361
15,23,15115,5754,3,123,564,634,9,6,1336,2,42,1380
15,23,15115,5755,3,65,159,259,16,7,506,11,45,562
15,23,15115,5756,3,60,316,377,11,6,770,5,52,827
15,23,15115,5757,3,41,107,71,3,1,223,0,13,236
15,23,15115,5758,3,53,113,67,11,1,245,1,11,257
15,23,15115,5759,3,101,163,157,29,3,453,3,9,465
15,23,15115,5760,3,46,132,34,10,2,224,2,19,245
15,23,15115,5761,3,155,378,205,14,8,760,4,81,845
15,23,15115,5762,3,38,197,110,6,1,352,2,22,376
15,23,15115,5763,3,255,309,234,27,8,833,16,37,886
15,23,15115,5764,3,94,130,116,8,5,353,0,35,388
15,23,15115,5765,3,37,197,111,3,1,349,0,6,355
15,23,15115,5766,3,269,409,246,16,13,953,2,70,1025
15,23,15115,5767,3,127,190,181,33,4,535,4,10,549
15,23,15115,5768,3,89,176,123,23,6,417,4,29,450
15,23,15115,5769,3,50,142,80,6,5,283,1,15,299
15,23,15115,5770,3,154,270,182,13,4,623,0,32,655
15,23,15115,5771,3,154,227,149,26,10,566,8,33,607
15,23,15115,5772,3,215,398,286,72,20,991,13,45,1049
15,23,15115,5773,3,102,286,185,20,3,596,4,34,634
15,23,15115,5774,3,108,228,157,19,6,518,3,32,553
15,23,15115,5775,3,123,227,141,38,9,538,6,38,582
15,23,15115,5776,3,55,116,150,24,5,350,0,12,362
15,23,15115,5777,3,25,123,95,2,0,245,1,9,255
15,23,15115,5778,3,60,75,100,8,5,248,2,7,257
15,23,15115,5779,3,57,177,173,3,2,412,3,16,431
15,23,15115,5780,3,174,349,105,11,7,646,7,40,693
15,23,15115,5781,3,113,369,280,20,2,784,4,45,833
15,23,15115,5782,3,26,144,146,2,1,319,2,12,333
15,23,15115,5783,3,204,215,140,54,5,618,1,26,645
15,23,15115,5784,3,79,232,180,7,4,502,1,38,541
15,23,15115,5785,3,75,106,20,1,1,203,2,12,217
15,23,15115,5786,3,55,107,99,7,3,271,6,6,283
15,23,15115,5787,3,104,188,104,12,2,410,0,12,422
15,23,15115,5788,3,79,72,109,1,3,264,0,20,284
15,23,15115,5789,3,88,137,141,9,3,378,6,19,403
15,23,15115,5790,3,68,163,145,9,3,388,4,13,405
15,24,15058,2637,3,286,224,381,71,33,995,8,11,1014
15,24,15058,2638,3,243,250,469,67,44,1073,11,23,1107
15,24,15058,2639,3,232,236,460,59,33,1020,6,15,1041
15,24,15058,2640,3,297,290,538,75,50,1250,6,28,1284
15,24,15058,2641,3,241,164,442,63,42,952,6,12,970
15,24,15058,2642,3,236,208,400,73,43,960,4,19,983
15,24,15058,2643,3,253,167,341,74,30,865,5,20,890
15,24,15058,2644,3,275,163,359,44,33,874,0,24,898
15,24,15058,2645,3,256,250,446,78,43,1073,2,40,1115
15,24,15058,2646,3,204,189,363,53,34,843,5,22,870
15,24,15058,2647,3,306,276,485,78,37,1182,4,27,1213
15,24,15058,2648,3,213,289,395,71,31,999,11,22,1032
15,24,15058,2649,3,380,359,502,84,45,1370,8,21,1399
15,24,15058,2650,3,342,423,657,74,59,1555,8,47,1610
15,24,15058,2651,3,205,199,397,45,33,879,1,10,890
15,24,15058,2652,3,165,255,320,47,24,811,6,4,821
15,24,15058,2653,3,171,234,505,61,40,1011,0,24,1035
15,24,15058,2654,3,251,306,422,70,41,1090,0,81,1171
15,24,15058,2655,3,204,223,436,54,37,954,10,21,985
15,24,15058,2656,3,376,277,532,95,61,1341,3,31,1375
15,24,15058,2657,3,243,229,451,70,46,1039,8,24,1071
15,24,15058,2658,3,319,233,522,84,42,1200,6,11,1217
15,24,15058,2659,3,154,135,311,33,22,655,2,12,669
15,24,15058,2660,3,156,131,260,39,18,604,1,18,623
15,24,15058,2661,3,275,229,492,57,57,1110,3,30,1143
15,24,15058,2662,3,225,281,546,73,48,1173,12,5,1190
15,24,15058,2663,3,216,176,283,39,24,738,6,13,757
15,24,15058,2664,3,206,280,422,46,36,990,11,19,1020
15,24,15058,2665,3,241,242,256,47,26,812,12,15,839
15,24,15058,2666,3,246,246,392,57,39,980,5,8,993
15,24,15058,2667,3,218,270,360,50,32,930,6,19,955
15,24,15058,2668,3,258,183,322,50,29,842,4,15,861
15,24,15058,2669,3,403,240,371,65,30,1109,2,21,1132
15,24,15058,2670,3,161,171,348,47,47,774,3,28,805
15,24,15058,2671,3,165,120,283,39,18,625,3,5,633
15,24,15058,2672,3,235,208,392,41,35,911,8,12,931
15,24,15058,2673,3,168,146,351,37,34,736,1,20,757
15,24,15058,2674,3,197,199,290,41,24,751,7,18,776
15,24,15058,2675,3,270,285,525,62,54,1196,8,23,1227
15,24,15058,2676,3,331,281,521,74,43,1250,14,27,1291
15,24,15058,2677,3,248,382,446,52,30,1158,6,15,1179
15,24,15058,2678,3,512,351,638,103,54,1658,7,38,1703
15,24,15058,2679,3,323,289,413,60,42,1127,7,24,1158
15,24,15058,2680,3,250,346,447,72,31,1146,1,23,1170
15,24,15058,2681,3,417,273,470,64,36,1260,3,23,1286
15,24,15058,2682,3,382,273,511,71,34,1271,1,16,1288
15,24,15058,2683,3,374,263,326,68,44,1075,10,20,1105
15,24,15058,2684,3,122,50,129,21,18,340,0,4,344
15,24,15058,2685,3,163,127,162,32,18,502,1,3,506
15,24,15058,2686,3,470,172,353,66,52,1113,0,27,1140
15,24,15058,2687,3,480,154,363,60,47,1104,3,21,1128
15,24,15058,2688,3,274,136,217,32,25,684,2,15,701
15,24,15058,2689,3,209,133,176,29,25,572,2,6,580
15,24,15058,2690,3,617,324,259,51,54,1305,1,11,1317
15,24,15058,2691,3,411,189,164,38,36,838,0,4,842
15,24,15058,2692,3,333,142,116,25,24,640,0,15,655
15,24,15058,2693,3,178,85,61,9,7,340,1,1,342
15,24,15058,2694,3,399,86,111,26,26,648,0,4,652
15,24,15058,2695,3,532,80,45,15,17,689,1,3,693
15,24,15058,2696,3,506,137,92,26,19,780,0,1,781
15,24,15058,2697,3,346,169,112,26,19,672,0,6,678
15,24,15058,2698,3,575,132,36,15,25,783,0,4,787
15,24,15058,2699,3,401,105,29,9,18,562,0,2,564
15,24,15058,2700,3,614,231,115,34,33,1027,1,12,1040
15,24,15058,2701,3,328,304,276,48,35,991,2,11,1004
15,24,15058,2702,3,581,125,45,11,17,779,0,2,781
15,24,15058,2703,3,437,104,52,13,21,627,2,1,630
15,24,15058,2704,3,354,98,27,12,0,491,0,8,499
15,24,15058,2705,3,305,162,319,41,33,860,0,18,878
15,24,15058,2706,3,345,176,106,30,21,678,0,10,688
15,24,15058,2717,3,27,58,34,11,4,134,1,3,138
15,24,15058,2718,3,25,33,28,6,4,96,2,0,98
15,24,15058,2930,3,189,147,192,31,17,576,1,8,585
15,24,15058,2931,3,201,139,199,39,16,594,3,10,607
15,24,15058,2932,3,309,185,348,48,37,927,1,10,938
15,24,15058,2943,3,180,92,212,17,17,518,4,7,529
15,24,15058,2944,3,308,170,327,48,24,877,7,27,911
15,24,15058,2945,3,176,225,289,40,21,751,1,17,769
15,24,15058,2949,3,223,255,438,64,39,1019,7,21,1047
15,24,15058,2950,3,179,119,321,36,18,673,3,6,682
15,24,15058,2951,3,218,189,347,22,40,816,5,15,836
15,24,15058,2952,3,198,156,288,44,20,706,10,13,729
15,24,15058,2953,3,242,234,525,72,41,1114,5,39,1158
15,24,15058,2954,3,226,148,334,39,40,787,11,15,813
15,24,15058,2955,3,223,110,294,27,22,676,1,5,682
15,24,15058,2956,3,280,183,352,42,32,889,6,14,909
15,24,15058,2957,3,270,164,267,35,28,764,2,19,785
15,24,15058,2958,3,375,277,521,70,64,1307,6,6,1319
15,24,15058,2959,3,350,190,453,46,38,1077,6,19,1102
15,24,15058,2960,3,409,209,364,61,27,1070,7,17,1094
15,24,15058,2964,3,243,183,367,53,32,878,2,21,901
15,24,15058,2965,3,241,159,235,38,20,693,3,9,705
15,24,15058,2966,3,341,227,459,56,49,1132,7,23,1162
15,24,15058,2967,3,325,201,479,71,43,1119,8,16,1143
15,24,15058,2968,3,419,223,472,67,65,1246,6,12,1264
15,24,15058,2969,3,262,228,633,65,41,1229,7,29,1265
15,24,15058,2970,3,150,175,444,39,20,828,7,13,848
15,24,15058,2971,3,283,245,464,63,35,1090,4,21,1115
15,24,15058,2972,3,253,176,343,52,38,862,10,21,893
15,24,15058,2973,3,186,184,348,52,20,790,9,20,819
15,24,15058,2974,3,182,144,194,41,16,577,1,11,589
15,24,15058,2975,3,197,179,328,60,16,780,1,16,797
15,24,15058,2976,3,198,183,386,50,39,856,1,19,876
15,24,15058,2977,3,210,177,339,28,38,792,7,19,818
15,24,15058,2978,3,392,220,718,80,46,1456,5,25,1486
15,24,15058,2979,3,285,195,392,51,33,956,2,26,984
15,24,15058,2989,3,314,255,401,55,33,1058,3,17,1078
15,24,15058,2990,3,201,182,335,42,32,792,4,27,823
15,24,15058,2991,3,157,118,252,40,22,589,3,15,607
15,24,15058,2992,3,222,237,425,73,38,995,6,24,1025
15,24,15058,2993,3,128,159,274,33,22,616,2,7,625
15,24,15058,2994,3,237,245,469,68,39,1058,8,30,1096
15,24,15058,2995,3,400,154,403,89,64,1110,3,16,1129
15,24,15058,2996,3,335,139,362,65,47,948,12,18,978
15,24,15058,2997,3,254,153,311,38,34,790,2,9,801
15,24,15058,2998,3,255,191,347,66,47,906,8,20,934
15,24,15058,2999,3,508,350,613,86,41,1598,10,22,1630
15,24,15058,3004,3,364,340,466,56,53,1279,11,17,1307
15,24,15058,3005,3,355,236,469,67,46,1173,0,26,1199
15,24,15058,3006,3,344,257,433,71,54,1159,7,24,1190
15,24,15058,3007,3,429,173,365,77,38,1082,6,11,1099
15,24,15058,3008,3,210,82,233,30,39,594,1,8,603
15,24,15058,3009,3,441,163,416,47,45,1112,1,19,1132
15,24,15058,3010,3,193,115,276,35,47,666,6,16,688
15,24,15058,3011,3,218,188,352,40,29,827,7,21,855
15,24,15058,3012,3,137,200,264,38,20,659,5,12,676
15,24,15058,3013,3,137,98,169,39,12,455,0,0,455
15,24,15058,3025,3,161,142,263,42,22,630,2,12,644
15,24,15058,3028,3,152,128,278,40,15,613,1,17,631
15,24,15058,3029,3,208,186,401,51,35,881,3,30,914
15,24,15058,3030,3,152,180,349,43,28,752,2,14,768
15,24,15058,3031,3,165,206,324,65,30,790,6,19,815
15,25,15032,1168,3,143,412,348,61,28,992,3,21,1016
15,25,15032,1169,3,136,435,457,46,40,1114,23,37,1174
15,25,15032,1170,3,221,531,636,56,39,1483,11,13,1507
15,25,15032,1173,3,308,527,706,60,67,1668,23,43,1734
15,25,15032,1174,3,202,466,530,66,41,1305,10,24,1339
15,25,15032,1175,3,151,415,338,48,34,986,6,33,1025
15,25,15032,1176,3,160,391,372,78,33,1034,9,34,1077
15,25,15032,1177,3,152,399,461,61,36,1109,1,33,1143
15,25,15032,1178,3,129,298,466,43,23,959,6,33,998
15,25,15032,1185,3,135,365,408,59,23,990,11,30,1031
15,25,15032,1186,3,117,323,349,64,18,871,2,16,889
15,25,15032,1187,3,122,312,433,51,26,944,2,30,976
15,25,15032,1188,3,108,262,303,41,15,729,0,22,751
15,25,15032,1189,3,155,436,346,31,38,1006,2,25,1033
15,25,15032,1190,3,142,405,365,44,19,975,3,19,997
15,25,15032,1191,3,213,520,533,71,44,1381,12,35,1428
15,25,15032,1192,3,533,1006,1180,153,93,2965,11,81,3057
15,25,15032,1193,3,435,775,1102,161,75,2548,12,48,2608
15,25,15032,1194,3,332,597,711,212,42,1894,5,35,1934
15,25,15032,1195,3,183,394,477,71,26,1151,3,32,1186
15,25,15032,1196,3,90,340,334,45,30,839,9,16,864
15,25,15032,1197,3,122,330,370,36,28,886,9,11,906
15,25,15032,1198,3,137,316,401,52,24,930,11,29,970
15,25,15032,1199,3,135,304,398,65,46,948,9,16,973
15,25,15032,1200,3,158,282,488,52,36,1016,8,35,1059
15,25,15032,1204,3,156,397,509,61,40,1163,9,39,1211
15,25,15032,1205,3,146,312,444,47,33,982,1,25,1008
15,25,15032,1206,3,165,244,380,58,32,879,4,14,897
15,25,15032,1207,3,122,292,401,49,39,903,6,9,918
15,25,15032,1208,3,177,399,427,79,38,1120,0,38,1158
15,25,15032,1209,3,418,360,487,170,50,1485,7,35,1527
15,25,15032,1210,3,367,670,950,89,58,2134,14,51,2199
15,25,15032,1211,3,252,295,363,70,27,1007,0,28,1035
15,25,15032,1212,3,357,413,419,75,27,1291,3,30,1324
15,25,15032,1213,3,353,403,461,77,37,1331,2,25,1358
15,25,15032,1214,3,242,158,175,65,13,653,0,21,674
15,25,15032,1215,3,239,323,376,72,25,1035,4,26,1065
15,25,15032,1216,3,123,761,370,37,25,1316,4,39,1359
15,25,15032,1217,3,240,505,504,116,34,1399,7,25,1431
15,25,15032,1218,3,325,463,707,160,55,1710,14,32,1756
15,25,15032,1219,3,210,343,578,106,33,1270,8,29,1307
15,25,15032,1220,3,69,173,319,29,24,614,5,13,632
15,25,15032,1222,3,128,245,438,54,29,894,3,17,914
15,25,15032,1223,3,152,320,406,60,30,968,0,24,992
15,25,15032,1224,3,239,267,477,82,46,1111,13,26,1150
15,25,15032,1225,3,205,326,437,83,28,1079,4,14,1097
15,25,15032,1226,3,86,176,271,43,16,592,1,22,615
15,25,15032,1227,3,170,352,383,84,39,1028,5,31,1064
15,25,15032,1228,3,131,202,428,66,36,863,0,17,880
15,25,15032,1229,3,135,344,338,44,28,889,2,24,915
15,25,15032,1230,3,137,277,443,45,30,932,5,26,963
15,25,15032,1231,3,124,292,432,31,28,907,6,20,933
15,25,15032,1232,3,137,289,509,52,26,1013,7,11,1031
15,25,15032,1233,3,125,270,497,52,33,977,8,19,1004
15,25,15032,1234,3,153,329,469,43,46,1040,3,26,1069
15,25,15032,1235,3,193,222,496,67,50,1028,7,37,1072
15,25,15032,1236,3,588,920,1332,213,107,3160,18,48,3226
15,25,15032,1237,3,362,344,445,151,48,1350,4,30,1384
15,25,15032,1238,3,81,327,477,62,40,987,6,17,1010
15,25,15032,1239,3,135,177,217,54,22,605,1,11,617
15,25,15032,1240,3,167,253,388,51,43,902,5,16,923
15,25,15032,1241,3,208,287,446,34,42,1017,6,28,1051
15,25,15032,1242,3,99,343,366,63,25,896,3,15,914
15,25,15032,1243,3,139,329,481,85,37,1071,5,24,1100
15,25,15032,1244,3,99,372,362,33,24,890,7,21,918
15,25,15032,1245,3,85,379,443,40,33,980,7,21,1008
15,25,15032,1246,3,199,379,668,69,50,1365,3,12,1380
15,25,15032,1247,3,55,150,157,16,16,394,3,13,410
15,25,15032,1248,3,181,307,533,51,46,1118,8,34,1160
15,25,15032,1249,3,243,320,578,92,45,1278,9,32,1319
15,25,15032,1250,3,190,303,545,42,21,1101,10,16,1127
15,25,15032,1251,3,214,367,683,82,52,1398,4,36,1438
15,25,15032,1252,3,124,228,410,46,25,833,4,4,841
15,25,15032,1255,3,232,462,1002,84,68,1848,25,12,1885
15,25,15032,1256,3,238,412,813,71,54,1588,5,35,1628
15,25,15032,1257,3,188,412,770,80,45,1495,6,36,1537
15,25,15032,1266,3,245,437,730,68,44,1524,15,30,1569
15,25,15032,1267,3,327,897,992,75,48,2339,14,69,2422
15,25,15032,1268,3,500,1342,1612,176,94,3724,15,100,3839
15,25,15032,1270,3,93,296,454,26,11,880,5,12,897
15,25,15032,1278,3,158,210,264,50,14,696,9,14,719
15,25,15032,1279,3,136,324,281,31,20,792,3,13,808
15,25,15032,1280,3,203,288,315,81,22,909,2,32,943
15,25,15032,1281,3,226,495,578,61,41,1401,9,29,1439
15,25,15032,1282,3,83,159,265,57,18,582,3,16,601
15,25,15032,1283,3,55,105,135,16,12,323,0,8,331
15,25,15032,1284,3,78,218,189,30,18,533,3,22,558
15,25,15032,1285,3,66,230,296,25,16,633,7,10,650
15,25,15032,5954,3,70,174,227,31,20,522,0,12,534
15,25,15032,5955,3,91,181,269,27,17,585,2,11,598
15,25,15032,5956,3,45,173,197,14,5,434,2,14,450
15,25,15032,5957,3,16,156,104,6,3,285,4,6,295
15,25,15032,5958,3,26,130,161,8,0,325,4,10,339
15,25,15032,5959,3,48,113,193,21,12,387,0,8,395
15,25,15032,5960,3,43,141,250,26,8,468,2,12,482
15,25,15032,5961,3,35,111,102,16,6,270,2,3,275
15,25,15032,5962,3,75,135,305,25,13,553,1,6,560
15,25,15032,5963,3,44,131,278,19,13,485,1,13,499
15,25,15032,5964,3,41,109,161,11,7,329,5,9,343
15,25,15032,5965,3,29,94,104,11,4,242,1,10,253
15,25,15032,5966,3,59,135,202,28,12,436,2,13,451
15,25,15032,5967,3,71,198,215,24,12,520,1,8,529
15,25,15032,5968,3,53,146,254,25,10,488,2,2,492
15,25,15032,5969,3,55,234,252,22,9,572,4,19,595
15,25,15032,5970,3,27,87,146,10,2,272,4,15,291
15,26,15107,5175,3,570,223,180,71,27,1071,3,11,1085
15,26,15107,5176,3,767,340,240,88,47,1482,0,22,1504
15,26,15107,5177,3,658,315,249,65,31,1318,2,18,1338
15,26,15107,5178,3,691,317,226,104,47,1385,0,17,1402
15,26,15107,5179,3,615,307,243,93,34,1292,0,18,1310
15,26,15107,5180,3,589,358,175,67,39,1228,0,17,1245
15,26,15107,5181,3,340,231,197,50,31,849,1,19,869
15,26,15107,5198,3,594,286,212,68,32,1192,1,28,1221
15,26,15107,5199,3,337,138,101,32,17,625,1,5,631
15,26,15107,5200,3,373,216,146,50,27,812,0,12,824
15,26,15107,5201,3,515,239,222,46,47,1069,1,20,1090
15,26,15107,5202,3,559,240,169,53,28,1049,0,6,1055
15,26,15107,5203,3,873,400,294,122,56,1745,7,19,1771
15,26,15107,5204,3,72,31,19,12,4,138,1,1,140
15,26,15107,5205,3,364,175,106,54,19,718,6,10,734
15,26,15107,5206,3,379,235,143,52,33,842,0,18,860
15,26,15107,5207,3,304,177,121,32,22,656,3,4,663
15,26,15107,5227,3,540,255,155,63,42,1055,2,26,1083
15,26,15107,5228,3,437,213,134,54,24,862,0,5,867
15,26,15107,5229,3,333,203,157,33,24,750,0,12,762
15,26,15107,5230,3,319,174,89,69,21,672,1,11,684
15,26,15107,5246,3,297,140,167,41,16,661,2,7,670
15,26,15107,5247,3,287,145,100,31,19,582,1,7,590
15,26,15107,5248,3,880,245,225,76,39,1465,1,14,1480
15,26,15107,5249,3,423,182,160,68,29,862,1,8,871
15,26,15107,5250,3,342,147,164,64,22,739,4,9,752
15,26,15107,5266,3,488,631,148,56,54,1377,2,53,1432
15,26,15107,5267,3,444,505,157,64,40,1210,15,35,1260
15,26,15107,5268,3,409,487,142,51,29,1118,6,27,1151
15,26,15107,5269,3,668,750,262,74,57,1811,3,68,1882
15,26,15107,5270,3,564,501,159,59,24,1307,14,38,1359
15,26,15107,5271,3,1134,750,472,150,87,2593,2,61,2656
15,26,15107,5272,3,870,369,371,99,71,1780,8,14,1802
15,26,15107,5277,3,571,276,268,59,26,1200,0,13,1213
15,26,15107,5278,3,891,446,381,237,48,2003,12,27,2042
15,26,15107,5279,3,358,219,100,55,17,749,8,13,770
15,26,15107,5280,3,1064,372,346,116,85,1983,3,12,1998
15,26,15107,5281,3,459,134,136,46,31,806,3,4,813
15,26,15107,5282,3,246,208,94,32,10,590,3,9,602
15,26,15107,5283,3,573,285,195,61,41,1155,6,22,1183
15,26,15107,5284,3,602,238,181,72,30,1123,4,9,1136
15,26,15107,5289,3,509,234,127,47,27,944,6,15,965
15,26,15107,5290,3,425,217,143,50,11,846,2,11,859
15,26,15107,5291,3,884,390,363,96,54,1787,2,21,1810
15,26,15107,5292,3,715,269,313,147,45,1489,13,11,1513
15,26,15107,5293,3,722,303,248,78,41,1392,3,15,1410
15,26,15107,5294,3,619,274,204,81,38,1216,1,12,1229
15,26,15107,5295,3,877,512,349,82,35,1855,9,33,1897
15,26,15107,5296,3,1553,535,425,152,61,2726,27,24,2777
15,26,15107,5297,3,608,249,188,58,48,1151,8,24,1183
15,26,15107,5298,3,956,498,334,105,78,1971,16,41,2028
15,26,15107,5299,3,301,125,122,53,22,623,2,9,634
15,26,15107,5300,3,488,229,140,59,25,941,5,19,965
15,26,15107,5301,3,397,204,126,36,25,788,0,16,804
15,26,15107,5307,3,443,215,164,54,34,910,1,22,933
15,26,15107,5308,3,461,239,155,47,28,930,1,10,941
15,26,15107,5309,3,1012,357,372,107,68,1916,1,47,1964
15,26,15107,5310,3,625,275,240,58,35,1233,7,20,1260
15,26,15107,5311,3,569,395,203,61,16,1244,2,35,1281
15,26,15107,5312,3,478,184,172,57,29,920,1,15,936
15,26,15107,5313,3,595,262,163,48,35,1103,2,21,1126
15,26,15107,5314,3,704,315,198,74,45,1336,1,22,1359
15,26,15107,5315,3,296,162,91,36,20,605,2,7,614
15,26,15107,5321,3,520,236,214,53,29,1052,7,8,1067
15,26,15107,5322,3,483,299,208,49,32,1071,1,22,1094
15,26,15107,5323,3,992,417,367,109,69,1954,13,31,1998
15,26,15107,5324,3,602,248,278,74,42,1244,6,10,1260
15,26,15107,5325,3,487,187,185,44,21,924,3,14,941
15,26,15107,5326,3,693,247,266,64,37,1307,1,16,1324
15,26,15107,5327,3,447,192,211,37,22,909,1,12,922
15,26,15107,5328,3,304,165,97,47,24,637,2,10,649
15,26,15107,5355,3,692,526,270,36,19,1543,6,56,1605
15,26,15107,5356,3,615,520,156,26,25,1342,2,31,1375
15,26,15107,5357,3,396,122,31,5,3,557,3,21,581
15,26,15107,5358,3,485,323,70,14,7,899,4,26,929
15,26,15107,5359,3,578,420,158,62,21,1239,8,35,1282
15,26,15107,5361,3,384,249,69,22,15,739,4,15,758
15,26,15107,5362,3,405,388,104,21,9,927,9,21,957
15,26,15107,5363,3,451,298,209,20,34,1012,8,19,1039
15,26,15107,5364,3,522,407,282,43,25,1279,3,27,1309
15,26,15107,5365,3,342,237,99,28,14,720,3,9,732
15,26,15107,5366,3,2877,1144,1074,321,213,5629,26,85,5740
15,26,15107,5367,3,376,202,151,30,11,770,4,14,788
15,26,15107,5368,3,351,475,117,25,19,987,2,38,1027
15,26,15107,5369,3,363,284,105,28,21,801,12,40,853
15,26,15107,5370,3,281,475,94,36,18,904,12,36,952
15,26,15107,5374,3,459,289,124,18,19,909,4,38,951
15,26,15107,5375,3,475,395,134,40,15,1059,18,21,1098
15,26,15107,5376,3,756,533,220,66,54,1629,14,36,1679
15,26,15107,5377,3,319,228,73,20,25,665,3,33,701
15,26,15107,5378,3,619,430,206,51,55,1361,1,46,1408
15,26,15107,5379,3,550,385,200,38,38,1211,9,18,1238
15,26,15107,5380,3,483,353,170,42,41,1089,0,38,1127
15,26,15107,5381,3,764,540,202,71,49,1626,5,21,1652
15,26,15107,5382,3,721,432,235,54,43,1485,16,35,1536
15,26,15107,5383,3,417,331,124,41,24,937,8,23,968
15,26,15107,5384,3,595,443,158,54,63,1313,11,34,1358
15,26,15107,5385,3,149,253,61,16,12,491,5,15,511
15,26,15107,5386,3,297,381,188,29,10,905,3,26,934
15,26,15107,5387,3,328,217,154,21,8,728,3,16,747
15,26,15107,5388,3,598,354,185,51,16,1204,8,45,1257
15,26,15107,5389,3,565,545,251,44,30,1435,8,61,1504
15,26,15107,5390,3,785,471,224,51,31,1562,7,47,1616
15,26,15107,5391,3,363,373,172,45,16,969,7,17,993
15,26,15107,5392,3,266,333,131,32,23,785,8,13,806
15,26,15107,5393,3,334,283,222,32,33,904,4,18,926
15,26,15107,5394,3,697,339,171,56,44,1307,11,29,1347
15,26,15107,5395,3,232,177,54,14,7,484,3,12,499
15,26,15107,5396,3,348,220,153,29,20,770,19,26,815
15,26,15107,5397,3,457,563,164,32,17,1233,14,44,1291
15,26,15107,5404,3,521,375,180,48,44,1168,11,24,1203
15,26,15107,5405,3,674,312,245,64,23,1318,17,30,1365
15,26,15107,5406,3,548,301,195,46,23,1113,6,26,1145
15,26,15107,5407,3,515,323,254,61,30,1183,12,26,1221
15,26,15107,5408,3,501,309,224,37,28,1099,6,26,1131
15,26,15107,5409,3,342,223,132,26,17,740,17,17,774
15,26,15107,5410,3,640,461,231,54,24,1410,14,25,1449
15,26,15107,5411,3,503,448,224,56,20,1251,9,36,1296
15,26,15107,5412,3,556,398,174,38,22,1188,9,30,1227
15,26,15107,5413,3,249,99,63,20,7,438,0,9,447
15,26,15107,5414,3,964,528,338,83,53,1966,4,24,1994
15,26,15107,5415,3,737,417,257,76,40,1527,4,17,1548
15,26,15107,5416,3,864,450,325,70,39,1748,2,32,1782
15,26,15107,5417,3,906,395,272,103,52,1728,9,33,1770
15,26,15107,5418,3,565,262,180,57,20,1084,1,18,1103
15,26,15107,5439,3,457,306,173,41,36,1013,6,29,1048
15,26,15107,5441,3,332,332,74,11,4,753,0,18,771
15,26,15107,5442,3,316,293,95,29,12,745,2,25,772
15,27,15018,495,3,231,182,191,57,7,668,0,14,682
15,27,15018,496,3,225,172,224,35,17,673,0,22,695
15,27,15018,497,3,240,172,198,72,16,698,2,17,717
15,27,15018,498,3,188,162,247,46,12,655,2,11,668
15,27,15018,499,3,442,257,155,53,17,924,2,25,951
15,27,15018,500,3,584,419,317,77,24,1421,8,52,1481
15,27,15018,501,3,332,300,326,52,17,1027,1,10,1038
15,27,15018,502,3,323,222,406,60,31,1042,2,27,1071
15,27,15018,503,3,147,150,179,27,12,515,8,19,542
15,27,15018,504,3,349,147,243,43,17,799,1,30,830
15,27,15018,505,3,300,254,325,43,19,941,6,32,979
15,27,15018,506,3,216,252,251,33,10,762,4,29,795
15,27,15018,507,3,210,117,249,15,12,603,2,20,625
15,27,15018,508,3,365,219,387,57,24,1052,10,15,1077
15,27,15018,509,3,293,240,379,40,23,975,6,18,999
15,27,15018,510,3,131,86,80,15,2,314,0,8,322
15,27,15028,1095,3,543,590,344,61,25,1563,2,45,1610
15,27,15028,1096,3,362,377,268,26,9,1042,3,21,1066
15,27,15055,2464,3,876,336,321,92,47,1672,5,22,1699
15,27,15055,2465,3,624,203,158,43,33,1061,1,8,1070
15,27,15055,2466,3,542,232,201,59,23,1057,3,14,1074
15,27,15055,2467,3,357,193,194,41,32,817,3,11,831
15,27,15055,2468,3,281,137,167,25,19,629,0,10,639
15,27,15055,2469,3,269,177,198,62,10,716,5,19,740
15,27,15055,2470,3,1033,226,272,75,61,1667,4,14,1685
15,27,15055,2471,3,574,294,290,52,28,1238,0,23,1261
15,27,15055,2472,3,414,183,186,55,23,861,0,23,884
15,27,15055,2473,3,463,234,188,43,26,954,1,23,978
15,27,15055,2474,3,457,173,149,40,34,853,2,15,870
15,27,15055,2475,3,618,209,205,52,42,1126,3,19,1148
15,27,15055,2476,3,830,230,227,82,45,1414,0,29,1443
15,27,15055,2477,3,487,264,244,64,31,1090,2,12,1104
15,27,15055,2478,3,538,272,240,79,33,1162,10,27,1199
15,27,15055,2479,3,776,330,302,90,65,1563,0,24,1587
15,27,15055,2480,3,1285,586,558,188,91,2708,3,37,2748
15,27,15055,2481,3,720,232,287,57,46,1342,1,17,1360
15,27,15055,2482,3,449,141,167,58,32,847,0,11,858
15,27,15055,2483,3,357,99,129,41,17,643,0,8,651
15,27,15055,2484,3,489,178,216,88,23,994,1,20,1015
15,27,15055,2485,3,453,181,265,71,40,1010,0,17,1027
15,27,15055,2486,3,466,149,252,62,30,959,0,15,974
15,27,15055,2487,3,450,148,231,47,39,915,1,21,937
15,27,15055,2488,3,640,269,332,72,41,1354,3,23,1380
15,27,15055,2489,3,532,248,302,56,29,1167,3,10,1180
15,27,15055,2490,3,1043,557,690,122,66,2478,5,41,2524
15,27,15055,2491,3,595,244,181,55,27,1102,0,9,1111
15,27,15055,2492,3,1287,361,165,61,27,1901,0,9,1910
15,27,15055,2493,3,412,171,148,47,23,801,3,17,821
15,27,15055,2494,3,285,153,145,35,26,644,5,12,661
15,27,15055,2495,3,327,172,147,43,13,702,3,11,716
15,27,15055,2496,3,353,133,124,40,12,662,5,11,678
15,27,15055,2497,3,484,268,177,55,36,1020,7,18,1045
15,27,15055,2498,3,826,299,289,88,37,1539,0,32,1571
15,27,15055,2499,3,742,305,229,72,33,1381,0,22,1403
15,27,15055,2500,3,177,77,109,34,13,410,0,7,417
15,27,15055,2501,3,416,219,350,63,31,1079,0,12,1091
15,27,15055,2502,3,743,255,266,84,36,1384,2,14,1400
15,27,15055,2503,3,318,125,110,53,19,625,0,51,676
15,27,15055,2504,3,574,127,123,31,40,895,0,8,903
15,27,15055,2505,3,108,87,109,72,5,381,0,3,384
15,27,15055,2506,3,632,243,310,74,45,1304,0,20,1324
15,27,15055,2507,3,636,250,325,73,38,1322,8,13,1343
15,27,15055,2508,3,553,262,277,68,27,1187,2,14,1203
15,27,15055,2509,3,336,162,174,50,15,737,1,8,746
15,27,15055,2510,3,265,119,217,35,23,659,0,13,672
15,27,15055,2511,3,426,228,253,75,20,1002,2,16,1020
15,27,15055,2512,3,302,216,209,23,15,765,7,9,781
15,27,15055,2513,3,337,220,352,55,27,991,2,21,1014
15,27,15055,2514,3,992,182,230,55,42,1501,2,11,1514
15,27,15055,2515,3,513,254,232,67,38,1104,0,13,1117
15,27,15055,2516,3,240,138,171,57,19,625,2,16,643
15,27,15055,2517,3,244,109,176,51,18,598,1,10,609
15,27,15055,2518,3,443,239,212,54,24,972,2,17,991
15,27,15055,2519,3,196,83,149,36,8,472,0,6,478
15,27,15055,2520,3,632,345,438,66,41,1522,5,21,1548
15,27,15055,2521,3,494,289,370,70,23,1246,2,14,1262
15,27,15055,2522,3,198,92,75,11,8,384,0,14,398
15,27,15055,2523,3,100,76,66,17,12,271,1,4,276
15,27,15055,2524,3,517,275,234,116,27,1169,0,14,1183
15,27,15055,2525,3,567,306,247,112,43,1275,1,24,1300
15,27,15055,2526,3,196,133,115,51,19,514,0,3,517
15,27,15055,2527,3,487,248,265,105,33,1138,2,12,1152
15,27,15055,2528,3,648,270,251,83,25,1277,0,13,1290
15,27,15055,2529,3,517,239,331,69,28,1184,2,20,1206
15,27,15055,2530,3,442,202,222,45,29,940,1,13,954
15,27,15055,2531,3,484,308,333,59,33,1217,0,21,1238
15,27,15055,2532,3,608,310,464,74,45,1501,3,28,1532
15,27,15055,2533,3,377,250,386,44,55,1112,0,20,1132
15,27,15055,2534,3,643,380,544,76,37,1680,9,34,1723
15,27,15055,2535,3,225,153,266,36,15,695,2,28,725
15,27,15055,2536,3,357,172,221,80,23,853,0,25,878
15,27,15055,2537,3,335,139,193,72,23,762,2,21,785
15,27,15055,2538,3,628,428,506,75,49,1686,3,55,1744
15,27,15055,2539,3,740,453,432,96,47,1768,7,61,1836
15,27,15055,2540,3,26,32,13,4,3,78,1,2,81
15,27,15055,2541,3,419,437,367,42,39,1304,12,49,1365
15,27,15055,2542,3,362,310,316,45,17,1050,14,43,1107
15,27,15055,2543,3,83,203,186,16,10,498,1,9,508
15,27,15055,2544,3,516,353,459,57,42,1427,2,43,1472
15,27,15055,2545,3,368,186,301,40,24,919,3,26,948
15,27,15055,2546,3,252,177,205,23,13,670,2,19,691
15,27,15055,2547,3,503,333,314,97,32,1279,13,50,1342
15,27,15055,2548,3,536,342,390,106,29,1403,2,45,1450
15,27,15055,2549,3,373,218,378,63,35,1067,4,29,1100
15,27,15056,2550,3,218,140,242,27,13,640,0,8,648
15,27,15056,2551,3,377,311,339,38,19,1084,3,25,1112
15,27,15056,2552,3,288,179,223,29,11,730,0,18,748
15,27,15056,2553,3,305,212,256,37,18,828,10,12,850
15,27,15074,4022,3,488,282,187,44,16,1017,0,23,1040
15,27,15074,4023,3,559,466,202,47,15,1289,1,35,1325
15,27,15074,4024,3,552,273,266,49,17,1157,0,25,1182
15,27,15074,4025,3,387,233,152,23,6,801,1,19,821
15,27,15077,4121,3,348,200,308,72,34,962,3,31,996
15,27,15077,4122,3,486,245,309,62,34,1136,1,33,1170
15,27,15077,4123,3,348,271,260,76,41,996,1,33,1030
15,27,15077,4124,3,653,192,247,66,56,1214,1,16,1231
15,27,15077,4125,3,588,171,300,81,40,1180,2,14,1196
15,27,15077,4126,3,510,403,563,146,54,1676,4,59,1739
15,27,15077,4127,3,385,247,403,58,32,1125,0,11,1136
15,27,15077,4128,3,334,315,330,57,26,1062,1,26,1089
15,27,15077,4129,3,456,440,545,96,26,1563,2,30,1595
15,27,15077,4130,3,607,477,570,103,55,1812,4,36,1852
15,27,15077,4131,3,430,285,429,72,29,1245,2,37,1284
15,27,15077,4132,3,360,270,356,64,25,1075,0,21,1096
15,27,15077,4133,3,293,285,261,54,21,914,1,15,930
15,27,15077,4134,3,482,488,517,102,46,1635,2,38,1675
15,27,15077,4135,3,655,516,573,243,64,2051,4,39,2094
15,27,15077,4136,3,280,198,305,57,24,864,5,19,888
15,27,15077,4137,3,323,208,387,62,19,999,4,29,1032
15,27,15077,4138,3,308,277,332,53,22,992,18,16,1026
15,27,15077,4139,3,312,210,215,71,20,828,5,17,850
15,27,15077,4140,3,391,284,235,92,26,1028,7,27,1062
15,27,15077,4141,3,480,299,296,104,55,1234,4,29,1267
15,27,15077,4142,3,409,335,255,76,27,1102,7,29,1138
15,27,15077,4143,3,132,71,59,10,7,279,3,2,284
15,28,15037,1976,3,104,551,715,27,16,1413,0,31,1444
15,28,15037,1977,3,42,194,284,20,3,543,1,20,564
15,28,15037,1978,3,133,456,291,24,11,915,2,27,944
15,28,15037,1979,3,80,300,509,33,13,935,6,31,972
15,28,15037,1980,3,125,476,466,41,22,1130,4,32,1166
15,28,15037,1981,3,180,573,461,49,19,1282,2,29,1313
15,28,15037,1982,3,16,127,80,1,2,226,0,1,227
15,28,15037,1983,3,157,492,693,62,26,1430,11,105,1546
15,28,15037,1984,3,177,450,631,69,27,1354,19,96,1469
15,28,15037,1985,3,95,422,401,34,18,970,9,65,1044
15,28,15037,1986,3,13,65,53,10,0,141,0,5,146
15,28,15037,1987,3,118,426,193,19,1,757,7,33,797
15,28,15037,1988,3,35,135,117,21,3,311,1,8,320
15,28,15037,1989,3,171,409,218,38,12,848,1,14,863
15,28,15037,1990,3,208,426,380,46,12,1072,3,21,1096
15,28,15037,1991,3,143,329,260,30,11,773,11,19,803
15,28,15082,4188,3,295,215,304,55,24,893,2,12,907
15,28,15082,4189,3,322,393,376,65,39,1195,1,34,1230
15,28,15082,4190,3,500,407,338,74,37,1356,5,18,1379
15,28,15082,4191,3,440,420,449,94,35,1438,16,25,1479
15,28,15082,4192,3,309,307,231,61,32,940,3,18,961
15,28,15082,4193,3,332,251,387,53,37,1060,3,20,1083
15,28,15082,4194,3,242,416,129,28,15,830,6,6,842
15,28,15082,4195,3,470,335,260,54,25,1144,6,29,1179
15,28,15082,4196,3,186,213,187,26,16,628,2,12,642
15,28,15082,4197,3,577,478,452,83,51,1641,12,31,1684
15,28,15082,4198,3,372,311,321,81,39,1124,7,17,1148
15,28,15082,4199,3,382,263,307,90,34,1076,10,15,1101
15,28,15082,4200,3,205,184,158,34,10,591,4,16,611
15,28,15082,4201,3,361,332,306,81,33,1113,3,19,1135
15,28,15082,4202,3,343,211,167,39,19,779,5,19,803
15,28,15082,4203,3,428,334,301,95,34,1192,0,21,1213
15,28,15082,4204,3,656,562,469,90,45,1822,15,25,1862
15,28,15082,4205,3,576,491,439,88,57,1651,15,40,1706
15,28,15082,4206,3,413,491,368,76,62,1410,13,24,1447
15,28,15082,4207,3,555,521,491,99,48,1714,11,20,1745
15,28,15082,4208,3,277,381,219,39,38,954,14,9,977
15,28,15082,4209,3,546,523,404,89,67,1629,5,18,1652
15,28,15082,4210,3,27,37,4,2,3,73,0,4,77
15,28,15082,4211,3,342,228,314,48,30,962,7,27,996
15,28,15082,4212,3,525,466,504,101,44,1640,4,31,1675
15,28,15082,4213,3,1666,1158,1631,356,207,5018,12,73,5103
15,28,15082,4214,3,290,312,337,52,27,1018,1,18,1037
15,28,15082,4215,3,346,329,317,44,26,1062,3,20,1085
15,28,15082,4216,3,357,593,415,72,46,1483,12,30,1525
15,28,15082,4217,3,236,313,258,56,28,891,11,15,917
15,28,15082,4218,3,441,329,418,47,50,1285,7,25,1317
15,28,15082,4219,3,246,282,275,55,20,878,1,24,903
15,28,15082,4220,3,297,252,342,83,28,1002,3,23,1028
15,28,15082,4221,3,241,127,232,40,29,669,2,26,697
15,28,15082,4222,3,163,202,262,30,13,670,4,18,692
15,28,15082,4223,3,531,598,456,98,57,1740,7,27,1774
15,28,15082,4224,3,273,263,309,60,27,932,1,16,949
15,28,15082,4225,3,212,219,242,55,22,750,8,25,783
15,28,15082,4226,3,628,733,614,114,47,2136,9,49,2194
15,28,15082,4227,3,938,516,794,146,130,2524,10,20,2554
15,28,15082,4228,3,1261,771,940,201,161,3334,7,40,3381
15,28,15082,4229,3,603,448,399,114,70,1634,8,32,1674
15,28,15082,4230,3,423,327,364,66,30,1210,11,22,1243
15,28,15082,4231,3,423,338,416,88,38,1303,4,26,1333
15,28,15082,4232,3,451,141,242,42,38,914,0,9,923
15,28,15082,4233,3,506,381,411,99,46,1443,9,14,1466
15,28,15082,4234,3,362,284,358,68,42,1114,5,17,1136
15,28,15082,4235,3,244,220,269,51,55,839,2,14,855
15,28,15082,4236,3,396,153,301,48,39,937,6,11,954
15,28,15082,4237,3,507,216,391,78,42,1234,1,13,1248
15,28,15082,4238,3,434,166,314,53,39,1006,3,7,1016
15,28,15082,4239,3,440,107,259,44,44,894,3,24,921
15,28,15082,4240,3,410,130,269,47,28,884,3,8,895
15,28,15082,4241,3,397,174,296,44,52,963,2,3,968
15,28,15082,4242,3,220,259,293,42,34,848,2,13,863
15,28,15082,4243,3,422,236,283,40,50,1031,3,6,1040
15,28,15082,4244,3,439,188,289,60,48,1024,1,14,1039
15,28,15082,4245,3,409,160,358,76,40,1043,0,9,1052
15,28,15082,4246,3,433,302,283,54,36,1108,4,19,1131
15,28,15082,4247,3,603,348,388,64,41,1444,4,27,1475
15,28,15082,4248,3,492,429,316,60,42,1339,1,30,1370
15,28,15082,4249,3,396,310,254,55,48,1063,13,32,1108
15,28,15082,4250,3,466,320,400,59,53,1298,7,26,1331
15,28,15082,4251,3,1568,1585,1559,244,129,5085,30,105,5220
15,28,15082,4252,3,1581,1299,1973,326,233,5412,21,50,5483
15,28,15082,4253,3,363,402,364,55,30,1214,3,28,1245
15,28,15082,4254,3,119,102,125,25,10,381,2,10,393
15,28,15082,4255,3,240,282,306,47,35,910,8,9,927
15,28,15121,5880,3,377,591,357,161,36,1522,2,36,1560
15,28,15121,5881,3,320,673,413,118,41,1565,8,26,1599
15,28,15121,5882,3,320,696,511,230,50,1807,4,57,1868
15,28,15121,5883,3,338,825,464,142,54,1823,11,25,1859
15,28,15121,5884,3,377,865,545,146,47,1980,6,48,2034
15,28,15121,5885,3,292,558,313,146,30,1339,4,28,1371
15,28,15121,5886,3,230,514,264,115,34,1157,2,29,1188
15,28,15121,5887,3,293,555,314,132,34,1328,0,44,1372
15,28,15121,5888,3,325,494,336,192,38,1385,1,29,1415
15,28,15121,5889,3,264,423,365,92,23,1167,11,34,1212
15,28,15121,5890,3,199,451,389,109,32,1180,5,20,1205
15,28,15121,5891,3,198,468,510,98,38,1312,5,18,1335
15,28,15121,5892,3,170,531,504,55,20,1280,10,35,1325
15,28,15121,5893,3,10,112,41,5,1,169,2,5,176
15,28,15121,5894,3,50,246,128,16,8,448,3,16,467
15,28,15121,5895,3,79,361,108,40,12,600,3,20,623
15,28,15121,5896,3,125,467,203,46,7,848,0,21,869
15,28,15121,5897,3,51,239,160,39,2,491,3,17,511
15,28,15121,5898,3,122,340,99,19,8,588,2,8,598
15,28,15121,5899,3,164,198,322,29,16,729,5,20,754
15,28,15121,5900,3,230,535,335,82,32,1214,6,14,1234
15,28,15121,5901,3,266,550,351,66,28,1261,5,26,1292
15,28,15121,5902,3,333,540,370,76,34,1353,6,35,1394
15,28,15121,5903,3,23,115,88,5,4,235,0,8,243
15,28,15121,5904,3,28,203,31,6,2,270,2,6,278
15,28,15121,5905,3,70,142,156,26,6,400,5,10,415
15,28,15121,5906,3,325,576,738,100,41,1780,3,20,1803
15,28,15121,5907,3,275,407,463,71,43,1259,0,28,1287
15,28,15121,5908,3,341,395,458,79,38,1311,2,25,1338
15,28,15121,5909,3,269,385,476,54,44,1228,1,23,1252
15,28,15121,5910,3,363,467,540,70,42,1482,3,15,1500
15,28,15121,5911,3,289,427,416,70,26,1228,3,22,1253
15,28,15121,5912,3,78,157,47,21,7,310,4,6,320
15,28,15121,5913,3,20,26,11,6,2,65,0,0,65
15,28,15121,5914,3,100,185,103,27,5,420,1,23,444
15,28,15121,5915,3,187,499,291,70,25,1072,9,20,1101
15,28,15121,5916,3,163,492,309,43,10,1017,1,23,1041
15,28,15121,5917,3,161,373,187,40,10,771,1,32,804
15,28,15121,5918,3,25,82,6,3,2,118,3,6,127
15,28,15121,5919,3,75,145,140,42,12,414,4,10,428
15,28,15121,5920,3,23,96,81,5,0,205,7,5,217
15,28,15121,5921,3,247,670,451,73,48,1489,7,48,1544
15,28,15121,5922,3,111,97,67,16,15,306,1,7,314
15,28,15121,5923,3,174,403,256,34,25,892,5,5,902
15,29,15060,3269,3,181,152,554,54,46,987,4,22,1013
15,29,15060,3270,3,123,134,436,52,30,775,8,20,803
15,29,15060,3271,3,204,159,503,53,46,965,1,16,982
15,29,15060,3272,3,158,116,504,54,42,874,1,23,898
15,29,15060,3273,3,115,127,304,33,11,590,1,9,600
15,29,15060,3274,3,153,103,259,36,20,571,1,8,580
15,29,15060,3275,3,91,98,278,29,26,522,0,19,541
15,29,15060,3276,3,173,152,515,63,38,941,2,17,960
15,29,15060,3277,3,129,112,408,59,44,752,4,15,771
15,29,15060,3278,3,133,95,291,53,27,599,0,13,612
15,29,15060,3279,3,125,106,286,42,18,577,2,12,591
15,29,15060,3280,3,75,81,214,36,12,418,0,14,432
15,29,15060,3281,3,100,96,391,38,22,647,2,16,665
15,29,15060,3282,3,87,115,313,20,30,565,2,10,577
15,29,15060,3283,3,71,114,254,27,14,480,0,10,490
15,29,15060,3284,3,161,180,570,46,37,994,7,22,1023
15,29,15060,3285,3,105,279,555,59,38,1036,7,26,1069
15,29,15060,3286,3,129,211,550,41,40,971,6,18,995
15,29,15060,3287,3,147,217,477,53,36,930,6,21,957
15,29,15060,3288,3,142,245,520,60,39,1006,2,17,1025
15,29,15060,3289,3,104,178,399,37,30,748,4,15,767
15,29,15060,3290,3,77,128,345,24,19,593,0,17,610
15,29,15060,3291,3,126,173,432,36,34,801,0,22,823
15,29,15060,3292,3,174,131,436,58,33,832,2,24,858
15,29,15060,3293,3,89,103,308,35,22,557,0,13,570
15,29,15060,3294,3,180,123,395,50,22,770,2,18,790
15,29,15060,3295,3,148,129,391,46,34,748,5,23,776
15,29,15060,3296,3,80,79,308,22,16,505,0,11,516
15,29,15060,3297,3,91,100,346,37,27,601,0,14,615
15,29,15060,3298,3,137,188,455,58,22,860,0,18,878
15,29,15060,3299,3,101,168,298,22,19,608,2,15,625
15,29,15060,3300,3,81,90,234,23,25,453,0,9,462
15,29,15060,3301,3,124,149,335,29,29,666,2,2,670
15,29,15060,3302,3,117,152,438,48,24,779,3,16,798
15,29,15060,3303,3,134,149,448,48,23,802,2,17,821
15,29,15060,3304,3,117,142,477,48,36,820,1,24,845
15,29,15060,3305,3,139,108,384,38,19,688,0,13,701
15,29,15060,3306,3,121,153,352,50,23,699,2,21,722
15,29,15060,3307,3,128,135,358,30,26,677,1,12,690
15,29,15060,3308,3,91,128,261,36,17,533,3,11,547
15,29,15060,3309,3,195,235,532,56,40,1058,5,28,1091
15,29,15060,3310,3,121,125,298,37,20,601,1,10,612
15,29,15060,3311,3,87,118,311,37,20,573,6,10,589
15,29,15060,3312,3,183,199,542,57,39,1020,4,34,1058
15,29,15060,3313,3,154,201,588,53,57,1053,2,24,1079
15,29,15060,3314,3,176,146,526,54,44,946,2,15,963
15,29,15060,3315,3,187,166,493,68,36,950,3,10,963
15,29,15060,3316,3,191,185,388,40,32,836,1,21,858
15,29,15060,3317,3,165,135,404,42,38,784,0,19,803
15,29,15060,3318,3,190,179,509,59,43,980,7,21,1008
15,29,15060,3319,3,134,144,286,36,19,619,0,9,628
15,29,15060,3320,3,93,119,284,35,26,557,1,14,572
15,29,15060,3321,3,108,120,260,34,16,538,1,13,552
15,29,15060,3322,3,134,92,322,29,23,600,1,17,618
15,29,15060,3323,3,160,180,464,61,39,904,0,13,917
15,29,15060,3324,3,124,154,358,55,32,723,0,19,742
15,29,15060,3325,3,145,194,355,57,20,771,0,19,790
15,29,15060,3326,3,90,151,322,37,21,621,0,7,628
15,29,15060,3327,3,95,126,269,32,16,538,2,12,552
15,29,15060,3328,3,133,100,276,35,16,560,2,8,570
15,29,15060,3329,3,125,120,368,41,34,688,2,9,699
15,29,15060,3330,3,130,149,397,42,23,741,3,15,759
15,29,15060,3331,3,108,100,346,34,11,599,2,4,605
15,29,15060,3332,3,204,187,529,61,40,1021,6,18,1045
15,29,15060,3333,3,196,153,555,68,37,1009,3,11,1023
15,29,15060,3334,3,99,113,257,20,15,504,1,6,511
15,29,15060,3335,3,179,142,548,72,28,969,2,4,975
15,29,15060,3336,3,144,183,438,45,46,856,8,15,879
15,29,15060,3337,3,161,153,413,43,37,807,6,16,829
15,29,15060,3338,3,156,172,531,58,42,959,1,21,981
15,29,15060,3339,3,158,166,507,65,30,926,5,24,955
15,29,15060,3340,3,135,141,378,52,18,724,0,11,735
15,29,15060,3341,3,116,136,392,49,23,716,3,15,734
15,29,15060,3342,3,115,131,437,50,25,758,6,9,773
15,29,15060,3343,3,114,152,418,21,25,730,0,15,745
15,29,15060,3344,3,87,122,266,23,22,520,1,5,526
15,29,15060,3345,3,146,98,294,32,16,586,2,4,592
15,29,15060,3346,3,112,113,311,33,18,587,3,5,595
15,29,15060,3347,3,93,99,305,34,27,558,1,2,561
15,29,15060,3348,3,113,104,285,36,28,566,3,11,580
15,29,15060,3349,3,148,141,352,51,36,728,7,15,750
15,29,15060,3350,3,129,96,352,44,21,642,0,22,664
15,29,15060,3351,3,166,141,436,50,28,821,3,17,841
15,29,15060,3352,3,155,150,507,62,33,907,3,22,932
15,29,15060,3353,3,126,127,409,44,24,730,0,12,742
15,29,15060,3354,3,109,95,355,43,30,632,5,13,650
15,29,15060,3355,3,121,144,490,37,34,826,4,12,842
15,29,15060,3356,3,168,131,515,46,30,890,5,14,909
15,29,15060,3357,3,244,170,508,58,36,1016,0,28,1044
15,29,15060,3358,3,89,80,265,19,10,463,5,7,475
15,29,15060,3359,3,129,123,422,40,32,746,11,8,765
15,29,15060,3360,3,139,86,313,61,29,628,2,24,654
15,29,15060,3361,3,132,131,277,28,35,603,2,9,614
15,29,15060,3362,3,95,97,295,48,36,571,1,7,579
15,29,15060,3363,3,109,102,261,33,29,534,0,13,547
15,29,15060,3364,3,81,80,315,41,17,534,1,14,549
15,29,15060,3365,3,228,235,585,42,47,1137,3,29,1169
15,29,15060,3366,3,146,148,425,40,31,790,1,16,807
15,29,15060,3367,3,127,95,244,35,23,524,1,20,545
15,29,15060,3368,3,244,192,550,79,46,1111,3,22,1136
15,29,15060,3369,3,158,90,343,29,39,659,10,15,684
15,29,15060,3370,3,115,88,248,36,31,518,3,11,532
15,29,15060,3371,3,179,112,446,42,38,817,4,20,841
15,29,15060,3372,3,154,111,426,43,36,770,1,18,789
15,29,15060,3373,3,111,69,302,25,20,527,2,14,543
15,29,15060,3374,3,125,142,387,52,30,736,0,17,753
15,29,15060,3375,3,163,135,389,58,27,772,4,8,784
15,29,15060,3376,3,209,134,500,64,51,958,1,15,974
15,29,15060,3377,3,132,114,363,36,30,675,4,6,685
15,29,15060,3378,3,116,84,320,38,21,579,0,9,588
15,29,15060,3379,3,157,80,274,28,24,563,4,6,573
15,29,15060,3380,3,176,125,370,32,23,726,4,9,739
15,29,15060,3381,3,111,127,384,51,30,703,1,14,718
15,29,15060,3382,3,177,107,354,41,26,705,0,23,728
15,29,15060,3383,3,144,125,465,58,32,824,0,15,839
15,29,15060,3384,3,159,137,384,46,51,777,2,18,797
15,29,15060,3385,3,213,142,470,57,25,907,0,13,920
15,29,15060,3386,3,122,72,231,23,13,461,2,3,466
15,29,15060,3387,3,230,165,511,73,55,1034,10,19,1063
15,29,15060,3388,3,149,107,340,62,22,680,1,16,697
15,29,15060,3389,3,190,114,447,52,48,851,6,9,866
15,29,15060,3390,3,164,132,492,61,37,886,3,6,895
15,29,15060,3391,3,125,66,218,32,10,451,1,11,463
15,29,15060,3392,3,166,107,355,67,17,712,0,25,737
15,29,15060,3393,3,93,73,244,39,19,468,4,8,480
15,29,15060,3394,3,146,170,441,54,37,848,4,8,860
15,29,15060,3395,3,245,94,407,55,35,836,4,12,852
15,29,15060,3396,3,94,114,267,31,23,529,1,12,542
15,29,15060,3397,3,164,121,357,43,22,707,0,15,722
15,29,15060,3398,3,236,168,491,55,41,991,0,26,1017
15,29,15060,3399,3,161,107,403,38,16,725,2,15,742
15,29,15060,3400,3,166,151,391,64,27,799,0,14,813
15,29,15060,3401,3,171,135,366,64,35,771,6,13,790
15,29,15060,3402,3,197,165,496,48,32,938,4,15,957
15,29,15060,3403,3,246,178,542,47,47,1060,15,22,1097
15,29,15060,3404,3,166,139,299,42,22,668,3,12,683
15,29,15060,3405,3,198,149,398,56,29,830,15,18,863
15,29,15060,3406,3,126,119,305,63,21,634,3,13,650
15,29,15060,3407,3,118,66,296,35,25,540,12,12,564
15,29,15060,3408,3,236,120,479,33,31,899,0,13,912
15,29,15060,3409,3,159,105,305,23,35,627,3,18,648
15,29,15060,3410,3,184,150,533,47,30,944,6,19,969
15,29,15060,3411,3,169,99,318,43,20,649,2,12,663
15,29,15060,3412,3,176,125,458,75,37,871,6,18,895
15,29,15060,3413,3,268,167,694,80,53,1262,1,19,1282
15,29,15060,3414,3,175,90,392,57,24,738,3,13,754
15,29,15060,3415,3,233,151,491,68,38,981,0,17,998
15,29,15060,3416,3,190,111,358,51,28,738,6,9,753
15,29,15060,3417,3,140,106,331,52,28,657,16,13,686
15,29,15060,3418,3,241,166,493,80,36,1016,7,16,1039
15,29,15060,3419,3,252,187,534,65,38,1076,4,12,1092
15,29,15060,3420,3,271,147,456,70,41,985,2,18,1005
15,29,15060,3421,3,152,94,296,33,23,598,2,10,610
15,29,15060,3422,3,229,156,397,68,43,893,6,19,918
15,29,15060,3423,3,173,112,408,60,23,776,5,17,798
15,29,15060,3424,3,159,93,324,42,32,650,1,4,655
15,29,15060,3425,3,224,155,503,73,35,990,9,21,1020
15,29,15060,3426,3,190,161,333,33,25,742,5,12,759
15,29,15060,3427,3,295,127,480,48,48,998,0,11,1009
15,29,15060,3428,3,143,71,286,44,22,566,0,18,584
15,29,15060,3429,3,194,92,405,32,35,758,3,4,765
15,29,15060,3430,3,138,102,343,40,29,652,0,15,667
15,29,15060,3431,3,118,94,204,28,25,469,0,5,474
15,29,15060,3432,3,191,124,409,44,33,801,0,12,813
15,29,15060,3433,3,216,167,450,47,34,914,7,8,929
15,29,15060,3434,3,171,102,395,49,25,742,3,10,755
15,29,15060,3435,3,234,188,470,50,43,985,3,13,1001
15,29,15060,3436,3,92,109,244,33,17,495,1,15,511
15,29,15060,3437,3,131,132,297,46,25,631,2,7,640
15,29,15060,3438,3,137,105,271,32,33,578,4,9,591
15,29,15060,3439,3,228,154,556,61,54,1053,1,21,1075
15,29,15060,3440,3,169,142,414,48,31,804,10,19,833
15,29,15060,3441,3,130,97,277,37,14,555,4,9,568
15,29,15060,3442,3,108,106,322,36,18,590,0,12,602
15,29,15060,3443,3,227,116,413,43,38,837,3,20,860
15,29,15060,3444,3,169,83,348,30,21,651,3,14,668
15,29,15060,3445,3,109,79,257,37,24,506,1,8,515
15,29,15060,3446,3,124,147,438,35,37,781,5,17,803
15,29,15060,3447,3,255,183,498,50,48,1034,2,17,1053
15,29,15060,3448,3,116,103,274,32,28,553,1,13,567
15,29,15060,3449,3,211,167,444,58,48,928,2,19,949
15,29,15060,3450,3,210,128,479,61,43,921,4,17,942
15,29,15060,3451,3,141,170,415,56,31,813,1,16,830
15,30,15060,3046,3,173,149,440,62,23,847,1,21,869
15,30,15060,3047,3,127,130,428,71,39,795,10,7,812
15,30,15060,3048,3,191,139,468,58,42,898,1,21,920
15,30,15060,3049,3,156,111,326,35,25,653,1,13,667
15,30,15060,3050,3,209,209,456,50,28,952,6,22,980
15,30,15060,3051,3,89,152,327,43,22,633,3,20,656
15,30,15060,3052,3,121,126,255,31,25,558,2,24,584
15,30,15060,3053,3,212,266,592,65,36,1171,2,31,1204
15,30,15060,3059,3,154,247,438,77,42,958,4,12,974
15,30,15060,3060,3,131,180,429,41,39,820,0,22,842
15,30,15060,3061,3,191,212,592,56,42,1093,2,20,1115
15,30,15060,3062,3,212,221,489,82,31,1035,6,16,1057
15,30,15060,3063,3,226,159,460,67,52,964,5,25,994
15,30,15060,3064,3,198,195,468,76,40,977,4,27,1008
15,30,15060,3065,3,182,205,478,66,40,971,4,22,997
15,30,15060,3073,3,227,181,450,62,34,954,6,12,972
15,30,15060,3074,3,157,178,403,45,32,815,0,15,830
15,30,15060,3075,3,182,163,392,45,37,819,6,19,844
15,30,15060,3076,3,137,160,328,60,22,707,1,11,719
15,30,15060,3077,3,169,179,358,49,42,797,3,25,825
15,30,15060,3078,3,136,103,302,42,15,598,1,16,615
15,30,15060,3079,3,133,105,333,45,15,631,1,15,647
15,30,15060,3080,3,144,103,268,43,17,575,3,13,591
15,30,15060,3081,3,132,93,248,27,23,523,0,17,540
15,30,15060,3082,3,267,162,496,68,33,1026,2,18,1046
15,30,15060,3083,3,167,114,339,39,22,681,5,4,690
15,30,15060,3084,3,124,107,224,33,24,512,3,9,524
15,30,15060,3085,3,244,177,451,73,35,980,2,12,994
15,30,15060,3086,3,182,160,303,42,22,709,6,3,718
15,30,15060,3087,3,219,161,402,62,28,872,2,12,886
15,30,15060,3088,3,161,170,373,48,48,800,2,21,823
15,30,15060,3089,3,179,161,404,54,25,823,2,19,844
15,30,15060,3090,3,186,170,419,55,37,867,3,17,887
15,30,15060,3098,3,303,192,604,87,60,1246,4,19,1269
15,30,15060,3099,3,156,67,285,41,22,571,1,4,576
15,30,15060,3100,3,174,109,301,39,29,652,5,14,671
15,30,15060,3101,3,226,96,222,29,20,593,1,10,604
15,30,15060,3102,3,123,93,320,34,20,590,0,9,599
15,30,15060,3103,3,133,106,289,41,27,596,1,14,611
15,30,15060,3104,3,176,110,316,27,27,656,0,14,670
15,30,15060,3105,3,188,88,328,26,20,650,3,11,664
15,30,15060,3106,3,133,102,349,37,32,653,2,11,666
15,30,15060,3452,3,202,186,438,69,42,937,3,28,968
15,30,15060,3453,3,151,152,414,65,22,804,0,12,816
15,30,15060,3454,3,221,153,496,68,39,977,8,12,997
15,30,15060,3455,3,215,171,535,74,35,1030,2,21,1053
15,30,15060,3456,3,192,186,583,51,33,1045,4,31,1080
15,30,15060,3457,3,178,177,452,50,34,891,2,30,923
15,30,15060,3458,3,134,113,316,48,28,639,2,15,656
15,30,15060,3459,3,146,89,278,27,17,557,0,14,571
15,30,15060,3460,3,130,87,273,37,22,549,0,12,561
15,30,15060,3461,3,142,95,365,60,28,690,2,16,708
15,30,15060,3462,3,105,155,327,40,24,651,0,23,674
15,30,15060,3463,3,170,147,410,46,28,801,4,21,826
15,30,15060,3464,3,237,151,525,53,40,1006,1,11,1018
15,30,15060,3465,3,138,115,407,55,30,745,2,21,768
15,30,15060,3466,3,137,111,456,71,41,816,0,19,835
15,30,15060,3467,3,148,96,393,73,33,743,1,18,762
15,30,15060,3468,3,92,124,312,55,23,606,0,4,610
15,30,15060,3469,3,147,127,286,42,22,624,0,17,641
15,30,15060,3470,3,131,98,313,46,22,610,1,14,625
15,30,15060,3471,3,152,124,280,33,27,616,4,13,633
15,30,15060,3472,3,157,99,341,28,22,647,3,8,658
15,30,15060,3473,3,158,109,368,49,16,700,0,13,713
15,30,15060,3474,3,179,132,432,49,47,839,0,21,860
15,30,15060,3475,3,166,125,303,42,31,667,0,22,689
15,30,15060,3476,3,153,115,342,42,21,673,1,14,688
15,30,15060,3477,3,130,104,283,37,28,582,1,13,596
15,30,15060,3478,3,134,84,378,66,21,683,3,14,700
15,30,15060,3479,3,157,144,378,91,35,805,1,17,823
15,30,15060,3480,3,150,168,506,58,32,914,15,23,952
15,30,15060,3481,3,181,124,441,51,32,829,3,16,848
15,30,15060,3482,3,151,141,450,43,39,824,0,7,831
15,30,15060,3483,3,134,137,329,32,15,647,2,20,669
15,30,15060,3484,3,136,91,410,47,32,716,3,7,726
15,30,15060,3485,3,110,175,380,78,21,764,0,27,791
15,30,15060,3486,3,131,118,348,76,23,696,2,22,720
15,30,15060,3487,3,126,100,273,34,26,559,2,11,572
15,30,15060,3488,3,175,186,494,64,47,966,3,26,995
15,30,15060,3489,3,175,193,482,71,46,967,0,21,988
15,30,15060,3490,3,193,140,355,35,35,758,2,14,774
15,30,15060,3491,3,200,167,427,52,27,873,0,20,893
15,30,15060,3492,3,159,116,435,47,35,792,0,19,811
15,30,15060,3493,3,218,118,310,51,190,887,6,21,914
15,30,15060,3494,3,172,165,410,52,24,823,2,16,841
15,30,15060,3495,3,146,116,403,52,32,749,2,16,767
15,30,15060,3496,3,106,123,413,34,30,706,3,12,721
15,30,15060,3497,3,181,146,499,58,31,915,0,25,940
15,30,15060,3498,3,186,114,476,66,34,876,5,22,903
15,30,15060,3499,3,192,225,532,74,32,1055,1,26,1082
15,30,15060,3500,3,163,139,344,74,36,756,2,19,777
15,30,15060,3501,3,162,108,427,56,44,797,1,10,808
15,30,15060,3502,3,152,125,385,48,41,751,1,11,763
15,30,15060,3503,3,179,173,407,51,40,850,1,14,865
15,30,15060,3504,3,171,134,420,48,27,800,1,16,817
15,30,15060,3505,3,180,144,387,49,33,793,2,11,806
15,30,15060,3506,3,165,148,371,39,32,755,1,17,773
15,30,15060,3507,3,158,122,345,37,30,692,0,0,692
15,30,15060,3508,3,100,127,249,35,17,528,0,5,533
15,30,15060,3509,3,105,60,257,26,17,465,2,11,478
15,30,15060,3510,3,206,126,441,50,22,845,3,21,869
15,30,15060,3511,3,173,158,490,63,40,924,4,13,941
15,30,15060,3512,3,145,101,362,40,26,674,3,10,687
15,30,15060,3513,3,147,101,369,41,37,695,7,19,721
15,30,15060,3530,3,101,90,269,21,17,498,2,16,516
15,30,15060,3531,3,129,97,262,36,37,561,6,3,570
15,30,15060,3532,3,130,108,424,39,19,720,2,11,733
15,30,15060,3533,3,125,108,451,61,35,780,3,18,801
15,30,15060,3534,3,143,146,443,41,29,802,5,15,822
15,30,15060,3548,3,223,130,611,62,35,1061,1,22,1084
15,30,15060,3549,3,187,111,475,48,35,856,0,16,872
15,30,15060,3550,3,181,138,506,56,38,919,4,23,946
15,30,15060,3551,3,161,101,341,39,22,664,0,16,680
15,30,15060,3552,3,143,128,489,60,31,851,2,21,874
15,30,15060,3553,3,97,134,368,38,23,660,0,6,666
15,30,15060,3554,3,126,92,316,36,28,598,3,21,622
15,30,15060,3555,3,115,66,278,35,18,512,3,12,527
15,30,15060,3556,3,122,96,464,45,15,742,23,8,773
15,30,15060,3566,3,124,84,463,83,28,782,1,11,794
15,30,15060,3567,3,144,111,301,36,25,617,4,10,631
15,30,15060,3568,3,185,168,603,75,29,1060,5,24,1089
15,30,15060,3569,3,96,96,337,39,16,584,1,7,592
15,30,15060,3570,3,116,122,455,38,26,757,0,10,767
15,30,15060,3571,3,122,129,411,35,36,733,5,13,751
15,30,15060,3572,3,99,71,409,62,18,659,1,16,676
15,30,15060,3573,3,118,94,376,39,26,653,3,10,666
15,30,15060,3574,3,142,157,572,63,44,978,0,20,998
15,30,15060,3578,3,95,100,316,28,31,570,0,12,582
15,30,15060,3579,3,278,210,455,71,51,1065,0,19,1084
15,30,15060,3580,3,106,70,271,30,22,499,0,15,514
15,30,15060,3581,3,154,92,275,39,30,590,1,5,596
15,30,15060,3582,3,138,98,214,33,17,500,1,6,507
15,30,15060,3583,3,188,84,293,54,16,635,0,9,644
15,30,15060,3584,3,242,141,591,62,46,1082,3,20,1105
15,30,15060,3585,3,137,64,265,31,21,518,0,13,531
15,30,15060,3586,3,174,83,348,40,30,675,1,5,681
15,30,15060,3587,3,234,137,531,61,29,992,2,15,1009
15,30,15060,3588,3,264,161,530,72,39,1066,5,19,1090
15,30,15060,3589,3,150,139,476,45,34,844,9,11,864
15,30,15060,3590,3,229,145,473,75,39,961,3,25,989
15,30,15060,3591,3,239,141,554,80,53,1067,4,23,1094
15,30,15060,3592,3,206,172,602,67,32,1079,3,20,1102
15,30,15060,3593,3,97,81,407,36,29,650,5,18,673
15,30,15060,3594,3,104,136,446,51,25,762,1,14,777
15,30,15060,3595,3,146,110,380,45,22,703,4,14,721
15,30,15060,3596,3,85,118,425,49,22,699,1,21,721
15,30,15060,3597,3,169,153,522,51,50,945,2,19,966
15,30,15060,3610,3,201,156,532,35,33,957,2,15,974
15,30,15060,3611,3,150,169,496,61,48,924,3,23,950
15,30,15060,3612,3,121,117,501,63,30,832,1,17,850
15,30,15060,3613,3,181,167,537,54,37,976,2,18,996
15,30,15060,3614,3,260,171,599,78,36,1144,1,14,1159
15,30,15060,3615,3,152,132,380,50,33,747,7,14,768
15,30,15060,3616,3,179,84,279,45,23,610,2,2,614
15,30,15060,3617,3,164,109,305,41,28,647,1,17,665
15,30,15060,3618,3,206,117,399,44,33,799,2,12,813
15,30,15060,3619,3,220,116,378,59,31,804,0,17,821
15,30,15060,3620,3,183,121,446,43,28,821,0,8,829
15,30,15060,3621,3,214,166,464,61,37,942,1,13,956
15,30,15060,3622,3,168,127,380,48,38,761,1,17,779
15,30,15060,3635,3,142,151,613,65,58,1029,1,20,1050
15,30,15060,3636,3,92,102,313,39,10,556,0,16,572
15,30,15060,3637,3,104,84,315,33,16,552,1,4,557
15,30,15060,3638,3,95,68,331,37,35,566,0,17,583
15,30,15060,3639,3,101,133,304,41,22,601,6,8,615
15,30,15060,3640,3,213,111,526,42,46,938,4,18,960
15,30,15060,3641,3,216,228,369,68,36,917,0,27,944
15,30,15060,3642,3,172,176,438,55,31,872,4,22,898
15,30,15060,3643,3,248,131,545,58,39,1021,1,9,1031
15,30,15060,3644,3,307,105,440,65,46,963,3,16,982
15,30,15060,3645,3,192,93,391,41,28,745,1,13,759
15,30,15060,3646,3,202,122,405,51,35,815,1,15,831
15,30,15060,3647,3,173,112,391,55,45,776,2,12,790
15,30,15060,3648,3,155,89,383,44,29,700,2,18,720
15,30,15060,3649,3,100,41,165,27,23,356,0,7,363
15,31,15060,1253,3,107,140,305,45,29,626,5,20,651
15,31,15060,1254,3,155,150,432,48,36,821,4,11,836
15,31,15060,1258,3,150,126,450,52,32,810,6,4,820
15,31,15060,1259,3,141,152,512,39,37,881,0,30,911
15,31,15060,1260,3,136,122,327,55,42,682,3,23,708
15,31,15060,1261,3,133,141,312,58,35,679,3,15,697
15,31,15060,1262,3,133,179,396,39,29,776,2,15,793
15,31,15060,1263,3,109,127,447,51,25,759,10,5,774
15,31,15060,1264,3,145,138,438,50,33,804,2,18,824
15,31,15060,1265,3,312,346,1181,107,74,2020,16,33,2069
15,31,15060,3054,3,202,158,495,51,38,944,12,19,975
15,31,15060,3055,3,107,143,318,35,23,626,3,3,632
15,31,15060,3056,3,193,229,551,81,56,1110,9,34,1153
15,31,15060,3057,3,93,109,400,44,20,666,9,17,692
15,31,15060,3058,3,97,111,217,44,15,484,2,7,493
15,31,15060,3066,3,137,144,459,47,36,823,9,9,841
15,31,15060,3067,3,137,173,325,45,19,699,9,11,719
15,31,15060,3068,3,165,162,493,54,40,914,4,24,942
15,31,15060,3069,3,122,154,344,34,39,693,4,10,707
15,31,15060,3070,3,74,101,335,40,33,583,1,16,600
15,31,15060,3071,3,143,135,464,49,40,831,6,13,850
15,31,15060,3072,3,151,155,478,57,27,868,4,17,889
15,31,15060,3091,3,97,85,321,26,28,557,10,13,580
15,31,15060,3092,3,228,170,472,58,32,960,8,19,987
15,31,15060,3093,3,122,134,318,39,24,637,3,11,651
15,31,15060,3094,3,113,86,261,24,28,512,4,14,530
15,31,15060,3095,3,200,184,506,38,44,972,4,13,989
15,31,15060,3096,3,152,107,312,46,26,643,7,11,661
15,31,15060,3097,3,322,219,621,80,62,1304,0,25,1329
15,31,15060,3514,3,211,115,484,39,33,882,3,14,899
15,31,15060,3515,3,172,142,343,40,30,727,7,11,745
15,31,15060,3516,3,163,117,511,38,29,858,2,16,876
15,31,15060,3517,3,173,142,508,53,22,898,3,20,921
15,31,15060,3518,3,154,150,481,63,31,879,4,19,902
15,31,15060,3519,3,132,112,419,39,25,727,4,20,751
15,31,15060,3520,3,90,110,403,33,26,662,3,9,674
15,31,15060,3521,3,112,127,313,34,27,613,4,14,631
15,31,15060,3522,3,141,205,581,38,37,1002,3,29,1034
15,31,15060,3523,3,138,136,471,39,29,813,4,19,836
15,31,15060,3524,3,95,74,193,26,14,402,1,11,414
15,31,15060,3525,3,141,124,549,41,30,885,3,22,910
15,31,15060,3526,3,135,150,432,37,26,780,2,22,804
15,31,15060,3527,3,146,159,402,47,32,786,6,16,808
15,31,15060,3528,3,115,119,389,40,29,692,7,12,711
15,31,15060,3529,3,128,111,421,35,31,726,8,12,746
15,31,15060,3535,3,226,172,579,42,39,1058,2,49,1109
15,31,15060,3536,3,167,125,541,52,35,920,5,10,935
15,31,15060,3537,3,104,103,294,19,33,553,3,5,561
15,31,15060,3538,3,81,93,352,30,12,568,1,14,583
15,31,15060,3539,3,111,106,352,54,22,645,0,11,656
15,31,15060,3540,3,95,88,248,26,11,468,0,12,480
15,31,15060,3541,3,145,176,322,46,23,712,1,19,732
15,31,15060,3542,3,150,164,477,44,25,860,6,11,877
15,31,15060,3543,3,116,136,427,54,19,752,2,20,774
15,31,15060,3544,3,74,93,314,45,24,550,4,11,565
15,31,15060,3545,3,119,128,389,44,39,719,4,8,731
15,31,15060,3546,3,119,150,479,33,29,810,2,18,830
15,31,15060,3547,3,111,129,460,33,30,763,4,12,779
15,31,15060,3557,3,179,138,504,58,28,907,3,12,922
15,31,15060,3558,3,132,114,526,42,28,842,3,15,860
15,31,15060,3559,3,157,159,554,40,28,938,6,18,962
15,31,15060,3560,3,138,123,437,57,23,778,4,13,795
15,31,15060,3561,3,162,126,432,28,29,777,2,16,795
15,31,15060,3562,3,162,129,350,30,27,698,0,14,712
15,31,15060,3563,3,168,110,470,51,37,836,9,16,861
15,31,15060,3564,3,110,127,368,29,25,659,0,10,669
15,31,15060,3565,3,181,103,533,43,25,885,5,18,908
15,31,15060,3575,3,205,160,507,53,46,971,3,21,995
15,31,15060,3576,3,163,157,451,55,33,859,3,19,881
15,31,15060,3577,3,151,127,424,40,40,782,1,20,803
15,31,15060,3598,3,124,107,240,30,23,524,2,14,540
15,31,15060,3599,3,128,112,452,33,37,762,5,11,778
15,31,15060,3600,3,91,111,371,19,12,604,3,12,619
15,31,15060,3601,3,82,64,292,29,11,478,2,8,488
15,31,15060,3602,3,139,134,572,49,20,914,0,15,929
15,31,15060,3603,3,116,108,481,32,38,775,8,22,805
15,31,15060,3604,3,134,113,257,40,19,563,6,0,569
15,31,15060,3605,3,95,94,367,30,34,620,0,8,628
15,31,15060,3606,3,182,146,672,39,34,1073,1,27,1101
15,31,15060,3607,3,105,106,424,37,24,696,1,7,704
15,31,15060,3608,3,74,81,275,22,17,469,2,10,481
15,31,15060,3609,3,69,78,256,22,11,436,2,4,442
15,31,15060,3623,3,167,160,473,45,32,877,1,16,894
15,31,15060,3624,3,102,116,389,37,24,668,0,11,679
15,31,15060,3625,3,182,165,605,65,35,1052,7,15,1074
15,31,15060,3626,3,88,85,364,20,24,581,4,13,598
15,31,15060,3627,3,102,111,430,44,36,723,1,9,733
15,31,15060,3628,3,111,137,437,55,25,765,2,19,786
15,31,15060,3629,3,125,86,333,25,20,589,2,14,605
15,31,15060,3630,3,102,98,342,33,17,592,4,14,610
15,31,15060,3631,3,97,108,326,30,28,589,0,4,593
15,31,15060,3632,3,141,228,627,38,41,1075,3,18,1096
15,31,15060,3633,3,174,132,490,35,29,860,0,13,873
15,31,15060,3634,3,123,112,484,35,29,783,1,18,802
15,31,15060,3650,3,136,141,405,46,22,750,1,13,764
15,31,15060,3651,3,224,157,541,59,46,1027,3,27,1057
15,31,15060,3652,3,152,149,455,50,26,832,1,24,857
15,31,15060,3653,3,129,179,385,48,33,774,3,22,799
15,31,15060,3654,3,89,82,296,24,18,509,1,8,518
15,31,15060,3655,3,221,171,348,54,43,837,3,20,860
15,31,15060,3656,3,70,110,314,32,21,547,0,16,563
15,31,15060,3657,3,103,96,301,28,17,545,8,5,558
15,31,15060,3658,3,138,127,373,39,25,702,4,18,724
15,31,15060,3659,3,93,111,429,40,24,697,0,16,713
15,31,15060,3660,3,110,95,370,50,23,648,0,15,663
15,31,15060,3661,3,131,124,358,35,25,673,6,9,688
15,31,15060,3662,3,123,103,378,24,27,655,1,12,668
15,31,15060,3663,3,100,106,363,26,15,610,7,13,630
15,31,15060,3664,3,138,105,409,37,26,715,3,18,736
15,31,15060,3665,3,118,97,357,36,26,634,4,4,642
15,31,15060,3666,3,187,153,433,55,34,862,4,12,878
15,31,15060,3667,3,163,128,339,41,35,706,1,19,726
15,31,15060,3668,3,231,191,665,69,43,1199,3,22,1224
15,31,15060,3669,3,218,185,588,75,53,1119,6,9,1134
15,31,15060,3670,3,192,217,681,54,44,1188,8,28,1224
15,31,15060,3671,3,181,159,475,46,30,891,3,15,909
15,31,15060,3672,3,107,236,431,23,24,821,4,16,841
15,31,15060,3673,3,174,179,400,44,31,828,7,13,848
15,31,15060,3674,3,143,122,503,72,21,861,4,17,882
15,31,15060,3675,3,115,98,325,30,15,583,3,12,598
15,31,15060,3676,3,121,94,297,29,28,569,5,3,577
15,31,15060,3677,3,252,144,546,60,44,1046,4,16,1066
15,31,15060,3678,3,116,110,340,41,14,621,4,5,630
15,31,15060,3679,3,214,148,654,68,24,1108,8,23,1139
15,31,15060,3680,3,212,168,549,75,58,1062,6,18,1086
15,31,15060,3681,3,176,200,422,49,41,888,8,7,903
15,31,15060,3682,3,213,171,528,54,28,994,5,24,1023
15,31,15060,3683,3,167,117,398,35,31,748,3,12,763
15,31,15060,3684,3,206,153,535,72,20,986,1,14,1001
15,31,15060,3685,3,128,118,390,30,25,691,4,9,704
15,31,15060,3686,3,131,119,379,40,19,688,5,7,700
15,31,15060,3687,3,146,140,461,59,29,835,2,18,855
15,31,15060,3688,3,185,150,581,61,45,1022,6,28,1056
15,31,15060,3689,3,146,125,439,39,27,776,3,7,786
15,31,15060,3690,3,120,104,331,40,20,615,1,11,627
15,31,15060,3691,3,91,90,320,29,22,552,9,15,576
15,31,15060,3692,3,119,131,355,32,19,656,2,12,670
15,31,15060,3693,3,122,120,389,46,27,704,0,10,714
15,31,15060,3694,3,140,92,396,36,31,695,2,11,708
15,31,15060,3695,3,96,64,368,27,20,575,4,9,588
15,31,15060,3696,3,86,124,459,45,34,748,3,13,764
15,31,15060,3697,3,106,110,435,37,22,710,1,13,724
15,31,15060,3698,3,204,154,636,69,51,1114,5,13,1132
15,31,15060,3699,3,205,155,681,81,46,1168,9,17,1194
15,31,15060,3700,3,157,104,375,42,25,703,4,17,724
15,31,15060,3701,3,90,66,320,31,36,543,6,9,558
15,31,15060,3702,3,124,113,388,45,27,697,0,4,701
15,31,15060,3703,3,137,101,438,62,30,768,5,10,783
15,31,15060,3704,3,150,120,485,54,21,830,7,18,855
15,31,15060,3705,3,193,125,493,59,36,906,3,27,936
15,31,15060,3706,3,62,113,427,24,18,644,4,10,658
15,31,15060,3707,3,124,97,330,33,33,617,6,7,630
15,31,15060,3708,3,135,159,628,61,22,1005,6,17,1028
15,31,15060,3709,3,98,91,424,29,33,675,2,11,688
15,31,15060,3710,3,197,152,659,73,47,1128,3,18,1149
15,31,15060,3711,3,151,103,523,59,36,872,3,14,889
15,31,15060,3712,3,149,147,488,54,19,857,5,10,872
15,31,15060,3713,3,119,135,589,55,28,926,3,13,942
15,31,15060,3714,3,176,173,520,81,42,992,3,16,1011
15,31,15060,3715,3,131,149,576,47,33,936,11,13,960
15,31,15060,3716,3,139,137,410,56,22,764,3,12,779
15,31,15060,3717,3,139,159,522,35,34,889,2,17,908
15,31,15060,3718,3,86,128,281,26,22,543,0,17,560
15,31,15060,3719,3,92,129,380,39,22,662,2,14,678
15,31,15060,3720,3,154,165,533,73,33,958,3,9,970
15,31,15060,3721,3,93,116,300,29,22,560,4,12,576
15,31,15060,3722,3,104,111,344,34,22,615,7,10,632
15,32,15122,912,3,137,199,492,57,52,937,7,37,981
15,32,15122,913,3,167,235,566,64,34,1066,9,25,1100
15,32,15122,914,3,112,177,512,67,45,913,5,20,938
15,32,15122,915,3,118,261,593,51,24,1047,7,12,1066
15,32,15122,916,3,166,212,528,56,29,991,3,21,1015
15,32,15122,917,3,123,144,388,30,32,717,5,17,739
15,32,15122,918,3,71,100,280,29,23,503,5,8,516
15,32,15122,919,3,196,226,514,38,34,1008,2,22,1032
15,32,15122,920,3,155,209,341,68,37,810,0,23,833
15,32,15122,921,3,104,159,339,41,35,678,4,11,693
15,32,15122,922,3,123,141,359,51,32,706,0,16,722
15,32,15122,923,3,174,197,490,85,37,983,0,29,1012
15,32,15122,924,3,231,207,608,80,62,1188,6,17,1211
15,32,15122,925,3,184,287,492,50,42,1055,9,32,1096
15,32,15122,926,3,213,263,604,74,54,1208,8,18,1234
15,32,15122,927,3,114,136,364,37,19,670,3,13,686
15,32,15122,928,3,98,168,315,38,26,645,2,12,659
15,32,15122,929,3,180,194,409,65,32,880,2,38,920
15,32,15122,930,3,124,138,470,35,24,791,8,25,824
15,32,15122,931,3,151,255,552,68,31,1057,6,24,1087
15,32,15122,932,3,165,246,496,77,50,1034,9,30,1073
15,32,15122,933,3,165,201,515,79,37,997,11,19,1027
15,32,15122,934,3,194,240,592,83,50,1159,7,17,1183
15,32,15122,935,3,108,142,364,42,12,668,1,17,686
15,32,15122,936,3,151,192,503,73,35,954,4,25,983
15,32,15122,939,3,217,215,505,69,44,1050,3,25,1078
15,32,15122,940,3,167,205,456,59,38,925,2,28,955
15,32,15122,941,3,113,243,556,98,51,1061,14,23,1098
15,32,15122,942,3,171,246,603,87,41,1148,14,29,1191
15,32,15122,943,3,151,222,538,54,38,1003,6,14,1023
15,32,15122,944,3,126,170,387,58,39,780,8,12,800
15,32,15122,945,3,95,141,362,41,23,662,10,22,694
15,32,15122,946,3,140,212,483,63,38,936,18,26,980
15,32,15122,947,3,186,444,788,98,74,1590,12,21,1623
15,32,15122,948,3,166,311,644,82,55,1258,8,31,1297
15,32,15122,949,3,143,282,427,73,40,965,4,25,994
15,32,15122,950,3,89,235,406,78,40,848,0,21,869
15,32,15122,951,3,148,308,743,82,42,1323,2,32,1357
15,32,15122,952,3,181,246,559,52,40,1078,15,11,1104
15,32,15122,953,3,96,236,394,36,22,784,2,15,801
15,32,15122,954,3,122,177,367,64,24,754,2,14,770
15,32,15122,955,3,72,259,463,65,31,890,0,24,914
15,32,15122,956,3,90,152,365,50,31,688,9,13,710
15,32,15122,957,3,120,204,445,53,27,849,0,21,870
15,32,15122,958,3,187,186,521,73,30,997,11,21,1029
15,32,15122,959,3,106,215,478,44,42,885,6,19,910
15,32,15122,960,3,144,279,495,70,48,1036,15,21,1072
15,32,15122,961,3,159,287,575,86,60,1167,3,31,1201
15,32,15122,962,3,156,260,535,66,47,1064,9,32,1105
15,32,15122,963,3,124,237,659,50,46,1116,9,28,1153
15,32,15122,964,3,169,218,494,41,51,973,3,5,981
15,32,15122,965,3,96,150,441,54,25,766,0,21,787
15,32,15122,968,3,148,228,534,58,41,1009,9,20,1038
15,32,15122,969,3,146,301,601,58,34,1140,7,31,1178
15,32,15122,970,3,129,247,472,47,45,940,6,34,980
15,32,15122,971,3,220,358,839,64,63,1544,5,52,1601
15,32,15122,972,3,170,360,789,80,70,1469,10,33,1512
15,32,15122,973,3,119,227,541,65,27,979,4,35,1018
15,32,15122,974,3,339,649,1424,162,115,2689,17,71,2777
15,32,15122,975,3,108,340,491,45,46,1030,3,24,1057
15,32,15122,976,3,213,261,638,74,53,1239,2,16,1257
15,32,15122,977,3,163,385,642,98,52,1340,2,48,1390
15,32,15122,978,3,128,209,488,43,33,901,11,21,933
15,32,15122,979,3,159,234,464,40,31,928,6,25,959
15,32,15122,980,3,135,211,533,63,31,973,13,29,1015
15,32,15122,981,3,166,260,560,73,36,1095,0,47,1142
15,32,15122,982,3,153,231,500,54,39,977,9,41,1027
15,32,15122,983,3,159,226,547,56,50,1038,6,22,1066
15,32,15122,984,3,337,256,617,68,54,1332,8,32,1372
15,32,15122,985,3,145,178,396,56,29,804,7,16,827
15,32,15122,997,3,118,160,328,61,35,702,3,24,729
15,32,15122,998,3,158,156,288,56,21,679,5,18,702
15,32,15122,999,3,160,296,433,74,51,1014,4,16,1034
15,32,15122,1000,3,174,269,542,83,51,1119,4,28,1151
15,32,15122,1001,3,160,245,524,62,52,1043,6,31,1080
15,32,15122,1002,3,150,284,610,58,41,1143,7,37,1187
15,32,15122,1003,3,178,321,781,78,56,1414,4,32,1450
15,32,15122,1004,3,131,194,503,56,38,922,3,18,943
15,32,15122,1005,3,116,247,428,47,40,878,7,32,917
15,32,15122,1006,3,150,323,561,65,43,1142,1,31,1174
15,32,15122,1007,3,226,361,726,91,49,1453,7,37,1497
15,32,15122,1008,3,148,202,477,60,40,927,9,28,964
15,32,15122,1009,3,185,324,650,73,37,1269,5,49,1323
15,32,15122,1010,3,142,287,638,67,55,1189,4,42,1235
15,32,15122,1011,3,161,263,637,78,68,1207,8,41,1256
15,32,15122,1012,3,150,271,566,93,60,1140,3,23,1166
15,32,15122,1013,3,150,240,556,94,57,1097,3,35,1135
15,32,15122,1014,3,143,238,466,61,40,948,4,30,982
15,32,15122,1015,3,125,264,438,58,36,921,6,14,941
15,32,15122,1016,3,111,377,461,57,43,1049,5,16,1070
15,32,15122,1028,3,140,228,447,68,29,912,1,27,940
15,32,15122,1029,3,194,272,643,82,49,1240,7,24,1271
15,32,15122,1030,3,179,247,761,78,59,1324,5,32,1361
15,32,15122,1031,3,139,278,659,80,47,1203,1,16,1220
15,32,15122,1032,3,177,254,606,54,58,1149,4,318,1471
15,32,15122,1033,3,153,231,505,49,42,980,1,19,1000
15,32,15122,1034,3,164,422,621,74,53,1334,1,25,1360
15,32,15122,1061,3,144,245,423,42,32,886,0,17,903
15,32,15122,2083,3,401,526,1287,179,120,2513,7,45,2565
15,32,15122,2084,3,103,147,316,37,20,623,0,8,631
15,32,15122,2085,3,99,148,230,36,20,533,0,12,545
15,32,15122,2086,3,172,241,632,80,54,1179,3,33,1215
15,32,15122,2114,3,166,168,565,64,60,1023,6,17,1046
15,32,15122,2115,3,140,107,339,48,23,657,2,4,663
15,32,15122,2116,3,153,167,423,69,37,849,4,20,873
15,32,15122,2117,3,203,212,601,95,55,1166,8,31,1205
15,32,15122,2118,3,189,234,629,77,65,1194,4,16,1214
15,32,15122,2119,3,122,165,468,52,20,827,3,15,845
15,32,15122,2120,3,128,205,552,70,49,1004,0,30,1034
15,32,15122,2121,3,123,194,488,55,39,899,0,22,921
15,32,15122,5924,3,65,74,162,29,19,349,1,7,357
15,32,15122,5925,3,31,19,105,13,6,174,1,0,175
15,32,15122,5926,3,39,48,131,19,16,253,0,3,256
15,32,15122,5927,3,68,146,357,37,31,639,4,40,683
15,32,15122,5928,3,10,140,24,2,0,176,0,9,185
15,33,15009,193,3,169,174,221,88,25,677,5,11,693
15,33,15009,194,3,142,119,258,118,35,672,5,16,693
15,33,15009,195,3,167,142,336,70,34,749,6,25,780
15,33,15009,196,3,179,118,313,76,42,728,2,22,752
15,33,15009,197,3,161,156,236,77,34,664,6,12,682
15,33,15009,198,3,150,100,181,42,28,501,0,9,510
15,33,15009,199,3,141,110,141,19,23,434,0,12,446
15,33,15009,200,3,150,126,181,52,21,530,4,9,543
15,33,15009,201,3,193,165,320,74,37,789,2,12,803
15,33,15009,202,3,157,176,346,84,32,795,5,28,828
15,33,15009,203,3,96,102,217,34,15,464,7,12,483
15,33,15009,204,3,167,108,265,30,32,602,15,13,630
15,33,15009,205,3,203,132,224,58,21,638,8,15,661
15,33,15009,206,3,187,117,259,72,32,667,3,17,687
15,33,15009,207,3,247,169,433,66,31,946,7,29,982
15,33,15009,208,3,263,183,335,67,51,899,8,29,936
15,33,15009,209,3,166,142,336,51,35,730,11,21,762
15,33,15009,210,3,223,188,353,52,32,848,15,25,888
15,33,15009,211,3,209,150,319,60,53,791,12,16,819
15,33,15009,212,3,331,267,492,79,43,1212,13,20,1245
15,33,15009,213,3,186,133,338,59,49,765,18,23,806
15,33,15009,214,3,116,196,229,34,27,602,9,21,632
15,33,15009,215,3,233,209,563,74,66,1145,2,33,1180
15,33,15009,216,3,134,202,254,54,21,665,5,16,686
15,33,15009,217,3,122,309,281,31,22,765,3,18,786
15,33,15009,218,3,122,252,206,22,15,617,12,19,648
15,33,15015,456,3,242,293,425,31,15,1006,0,9,1015
15,33,15015,457,3,193,186,261,25,11,676,1,12,689
15,33,15015,458,3,188,192,299,22,19,720,0,18,738
15,33,15015,459,3,197,198,224,18,25,662,0,14,676
15,33,15015,460,3,293,248,273,24,15,853,1,15,869
15,33,15015,461,3,58,41,76,10,10,195,1,2,198
15,33,15015,462,3,128,79,159,16,16,398,0,18,416
15,33,15015,463,3,183,198,499,47,36,963,7,29,999
15,33,15015,464,3,243,262,680,80,35,1300,7,41,1348
15,33,15015,465,3,122,121,235,12,8,498,2,20,520
15,33,15015,466,3,101,111,332,11,3,558,0,10,568
15,33,15015,467,3,89,126,426,9,6,656,3,12,671
15,33,15015,468,3,102,109,197,13,6,427,0,13,440
15,33,15017,490,3,175,310,314,66,17,882,3,20,905
15,33,15017,491,3,115,233,278,40,17,683,0,16,699
15,33,15017,492,3,37,80,54,11,3,185,0,5,190
15,33,15017,493,3,78,87,135,13,11,324,4,12,340
15,33,15017,494,3,122,178,214,21,11,546,0,8,554
15,33,15022,648,3,249,212,319,88,17,885,10,23,918
15,33,15022,649,3,203,245,389,56,37,930,6,17,953
15,33,15022,650,3,246,202,421,60,35,964,9,19,992
15,33,15022,651,3,147,213,309,43,32,744,4,14,762
15,33,15022,652,3,263,222,433,77,32,1027,11,20,1058
15,33,15022,653,3,208,141,282,51,32,714,8,30,752
15,33,15026,989,3,121,150,195,41,14,521,4,15,540
15,33,15026,990,3,197,168,317,47,45,774,7,13,794
15,33,15026,993,3,278,189,426,88,56,1037,0,38,1075
15,33,15026,994,3,332,325,617,100,62,1436,0,23,1459
15,33,15026,996,3,375,682,1277,160,100,2594,11,84,2689
15,33,15026,1017,3,131,175,465,72,44,887,5,13,905
15,33,15026,1018,3,157,204,486,91,41,979,1,29,1009
15,33,15026,1019,3,235,254,638,107,68,1302,9,42,1353
15,33,15026,1020,3,129,204,402,75,45,855,7,40,902
15,33,15026,1021,3,137,198,267,61,44,707,0,22,729
15,33,15026,1022,3,297,273,314,81,42,1007,5,27,1039
15,33,15026,1023,3,279,238,292,65,43,917,7,18,942
15,33,15026,1024,3,188,227,278,79,51,823,0,26,849
15,33,15026,1025,3,530,366,461,123,93,1573,14,36,1623
15,33,15026,1026,3,300,246,225,62,42,875,7,34,916
15,33,15026,1027,3,262,252,319,97,53,983,6,11,1000
15,33,15026,1035,3,116,192,541,68,47,964,8,28,1000
15,33,15026,1036,3,267,316,846,115,69,1613,11,40,1664
15,33,15026,1037,3,275,370,874,168,102,1789,14,54,1857
15,33,15026,1038,3,165,192,423,70,46,896,4,26,926
15,33,15026,1039,3,204,353,675,121,79,1432,11,33,1476
15,33,15026,1040,3,494,466,621,156,106,1843,13,55,1911
15,33,15026,1041,3,270,165,293,39,52,819,5,14,838
15,33,15026,1042,3,532,339,412,105,65,1453,0,29,1482
15,33,15026,1043,3,559,349,1041,192,134,2275,26,26,2327
15,33,15026,1047,3,262,309,550,113,40,1274,9,23,1306
15,33,15026,1051,3,150,138,271,68,26,653,14,0,667
15,33,15026,1052,3,172,144,219,65,18,618,2,12,632
15,33,15026,1053,3,235,248,526,91,32,1132,9,20,1161
15,33,15026,1054,3,230,187,342,67,42,868,1,22,891
15,33,15026,1055,3,272,253,426,66,46,1063,12,28,1103
15,33,15026,1056,3,81,183,270,22,9,565,10,0,575
15,33,15026,1057,3,76,153,381,30,8,648,10,16,674
15,33,15026,1058,3,74,169,304,20,24,591,4,14,609
15,33,15026,1059,3,134,151,360,25,15,685,8,10,703
15,33,15026,1060,3,118,249,470,36,17,890,12,11,913
15,33,15026,1062,3,147,365,422,67,37,1038,1,33,1072
15,33,15026,1063,3,174,319,494,79,47,1113,4,30,1147
15,33,15026,1064,3,148,298,426,68,40,980,7,21,1008
15,33,15026,1065,3,267,313,599,93,37,1309,6,35,1350
15,33,15026,1066,3,107,173,240,43,30,593,5,14,612
15,33,15026,1067,3,185,327,462,78,40,1092,1,21,1114
15,33,15026,1068,3,179,253,459,69,59,1019,2,31,1052
15,33,15026,1069,3,147,186,367,68,34,802,11,22,835
15,33,15026,1070,3,193,219,345,71,65,893,8,15,916
15,33,15026,1071,3,191,182,395,54,53,875,1,24,900
15,33,15026,1072,3,189,207,538,96,62,1092,10,24,1126
15,33,15026,1073,3,348,242,684,108,86,1468,7,41,1516
15,33,15026,1074,3,139,157,306,47,21,670,1,14,685
15,33,15026,1075,3,171,193,633,86,35,1118,4,34,1156
15,33,15026,1076,3,253,350,784,105,54,1546,11,52,1609
15,33,15026,1077,3,138,265,465,53,26,947,3,19,969
15,33,15026,1078,3,127,351,429,65,36,1008,4,24,1036
15,33,15026,1079,3,193,432,809,85,41,1560,4,28,1592
15,33,15026,1080,3,191,321,549,81,45,1187,3,37,1227
15,33,15035,1952,3,367,343,351,32,14,1107,8,19,1134
15,33,15035,1953,3,335,302,288,32,14,971,3,23,997
15,33,15035,1954,3,97,109,171,9,0,386,1,1,388
15,33,15035,1955,3,63,99,90,2,3,257,3,10,270
15,33,15051,2378,3,205,184,314,39,33,775,4,20,799
15,33,15051,2379,3,212,223,286,35,21,777,12,8,797
15,33,15051,2380,3,351,376,600,84,31,1442,1,38,1481
15,33,15051,2381,3,336,277,506,52,38,1209,11,27,1247
15,33,15051,2382,3,256,210,328,37,20,851,0,26,877
15,33,15051,2383,3,176,265,448,47,16,952,5,18,975
15,33,15051,2384,3,125,285,576,37,14,1037,7,27,1071
15,33,15051,2385,3,143,256,456,35,13,903,1,28,932
15,33,15069,3927,3,109,172,260,31,15,587,4,10,601
15,33,15069,3928,3,47,82,110,12,10,261,0,11,272
15,33,15069,3929,3,161,280,448,37,26,952,0,17,969
15,33,15069,3930,3,189,258,447,44,28,966,0,19,985
15,33,15069,3931,3,144,227,354,40,30,795,1,21,817
15,33,15069,3932,3,152,328,300,57,34,871,0,15,886
15,33,15069,3933,3,210,289,332,40,31,902,2,12,916
15,33,15069,3934,3,107,129,257,31,15,539,4,8,551
15,33,15069,3935,3,122,80,271,37,20,530,7,6,543
15,33,15069,3936,3,166,202,368,58,12,806,13,9,828
15,33,15069,3937,3,84,61,157,17,4,323,4,10,337
15,33,15069,3938,3,131,112,250,19,11,523,0,26,549
15,33,15069,3939,3,28,26,82,5,2,143,0,3,146
15,33,15084,4326,3,213,244,320,48,24,849,8,16,873
15,33,15084,4327,3,261,410,430,88,58,1247,17,43,1307
15,33,15084,4328,3,223,182,352,51,24,832,3,7,842
15,33,15084,4329,3,156,144,91,12,15,418,0,6,424
15,33,15084,4330,3,114,222,90,24,7,457,0,10,467
15,33,15090,4466,3,173,343,213,41,23,793,4,19,816
15,33,15090,4467,3,164,267,243,38,21,733,1,21,755
15,33,15090,4468,3,156,411,181,32,25,805,1,8,814
15,33,15090,4469,3,141,234,449,65,36,925,0,29,954
15,33,15090,4470,3,94,242,357,29,22,744,0,19,763
15,33,15095,4556,3,166,211,385,22,10,794,6,10,810
15,33,15095,4557,3,127,181,228,41,15,592,0,7,599
15,33,15095,4558,3,161,197,444,32,20,854,3,15,872
15,33,15095,4559,3,210,240,460,23,18,951,3,8,962
15,33,15095,4560,3,130,136,235,24,8,533,2,12,547
15,33,15095,4561,3,101,136,317,27,7,588,2,8,598
15,33,15095,4562,3,34,187,225,11,3,460,0,4,464
15,33,15095,4563,3,148,206,432,33,35,854,6,14,874
15,33,15104,4736,3,164,160,380,47,29,780,4,11,795
15,33,15104,4737,3,324,230,556,92,54,1256,13,27,1296
15,33,15104,4738,3,203,149,465,54,47,918,10,22,950
15,33,15104,4739,3,192,180,346,64,29,811,4,8,823
15,33,15104,4740,3,253,193,483,83,40,1052,0,35,1087
15,33,15104,4741,3,257,250,591,86,44,1228,16,28,1272
15,33,15104,4742,3,147,190,413,55,15,820,10,11,841
15,33,15104,4743,3,196,251,452,57,34,990,6,17,1013
15,33,15104,4744,3,166,272,410,62,37,947,7,13,967
15,33,15104,4745,3,168,261,544,54,33,1060,7,19,1086
15,33,15104,4746,3,86,111,249,35,14,495,2,6,503
15,33,15104,4747,3,78,141,319,54,21,613,12,10,635
15,33,15104,4748,3,62,142,252,39,16,511,9,12,532
15,33,15104,4749,3,117,205,345,40,22,729,9,19,757
15,33,15104,4750,3,144,339,499,89,37,1108,8,30,1146
15,33,15104,4751,3,102,177,312,56,21,668,1,29,698
15,33,15104,4752,3,162,175,263,54,23,677,0,19,696
15,33,15104,4753,3,183,174,394,64,23,838,2,9,849
15,33,15104,4754,3,191,163,369,46,42,811,3,11,825
15,33,15104,4755,3,144,119,375,21,20,679,2,25,706
15,33,15104,4756,3,111,99,352,49,34,645,1,19,665
15,34,15107,5169,3,476,331,240,80,41,1168,16,26,1210
15,34,15107,5170,3,593,385,275,91,51,1395,10,25,1430
15,34,15107,5171,3,438,328,148,51,34,999,3,10,1012
15,34,15107,5172,3,266,179,107,36,19,607,7,16,630
15,34,15107,5173,3,419,368,155,43,28,1013,5,28,1046
15,34,15107,5174,3,720,338,205,102,31,1396,5,14,1415
15,34,15107,5182,3,127,121,69,16,20,353,3,15,371
15,34,15107,5183,3,320,233,104,51,18,726,8,6,740
15,34,15107,5184,3,443,281,151,51,26,952,6,19,977
15,34,15107,5185,3,655,426,256,81,54,1472,14,12,1498
15,34,15107,5186,3,594,341,230,66,51,1282,5,29,1316
15,34,15107,5187,3,403,226,156,62,21,868,6,17,891
15,34,15107,5188,3,879,416,341,70,45,1751,9,20,1780
15,34,15107,5189,3,505,277,179,50,34,1045,4,14,1063
15,34,15107,5190,3,549,405,218,63,47,1282,5,26,1313
15,34,15107,5191,3,645,298,217,91,52,1303,0,28,1331
15,34,15107,5192,3,595,224,189,46,36,1090,1,11,1102
15,34,15107,5193,3,565,244,174,67,26,1076,1,17,1094
15,34,15107,5194,3,152,107,57,25,12,353,0,6,359
15,34,15107,5195,3,75,19,28,5,3,130,0,2,132
15,34,15107,5196,3,140,91,55,17,14,317,1,3,321
15,34,15107,5197,3,189,84,54,18,10,355,3,10,368
15,34,15107,5208,3,93,44,42,19,13,211,0,5,216
15,34,15107,5209,3,151,57,49,13,11,281,0,2,283
15,34,15107,5210,3,230,91,57,27,15,420,2,4,426
15,34,15107,5211,3,210,116,60,27,14,427,1,2,430
15,34,15107,5212,3,163,59,60,26,13,321,2,3,326
15,34,15107,5213,3,391,173,111,42,24,741,0,10,751
15,34,15107,5214,3,597,245,162,74,32,1110,4,16,1130
15,34,15107,5215,3,366,175,87,32,15,675,1,11,687
15,34,15107,5216,3,428,173,97,44,22,764,2,6,772
15,34,15107,5217,3,449,178,125,60,23,835,1,14,850
15,34,15107,5218,3,533,272,203,63,35,1106,2,21,1129
15,34,15107,5219,3,574,362,202,64,35,1237,3,18,1258
15,34,15107,5220,3,452,248,157,61,26,944,0,20,964
15,34,15107,5221,3,324,174,99,40,22,659,0,19,678
15,34,15107,5222,3,417,224,122,40,41,844,4,12,860
15,34,15107,5223,3,389,178,194,61,31,853,2,22,877
15,34,15107,5224,3,493,173,128,50,30,874,0,15,889
15,34,15107,5225,3,431,232,126,45,25,859,2,11,872
15,34,15107,5226,3,565,255,189,56,41,1106,3,15,1124
15,34,15107,5231,3,676,316,209,101,49,1351,0,17,1368
15,34,15107,5232,3,793,361,183,80,36,1453,2,22,1477
15,34,15107,5233,3,464,237,57,93,15,866,0,10,876
15,34,15107,5234,3,423,249,93,42,18,825,8,8,841
15,34,15107,5235,3,398,234,136,77,43,888,6,21,915
15,34,15107,5236,3,626,370,209,84,49,1338,2,23,1363
15,34,15107,5237,3,589,240,169,77,24,1099,0,17,1116
15,34,15107,5238,3,391,212,119,52,22,796,7,7,810
15,34,15107,5239,3,369,178,118,42,32,739,0,12,751
15,34,15107,5240,3,551,337,182,79,42,1191,5,12,1208
15,34,15107,5241,3,536,253,151,59,32,1031,3,11,1045
15,34,15107,5242,3,618,267,138,69,32,1124,0,22,1146
15,34,15107,5243,3,503,220,155,71,26,975,1,22,998
15,34,15107,5244,3,572,251,190,80,26,1119,1,20,1140
15,34,15107,5245,3,701,348,230,65,45,1389,3,15,1407
15,34,15107,5251,3,515,259,159,56,27,1016,3,16,1035
15,34,15107,5252,3,503,315,131,52,30,1031,5,24,1060
15,34,15107,5253,3,444,300,164,49,23,980,3,13,996
15,34,15107,5254,3,511,248,183,41,23,1006,4,9,1019
15,34,15107,5255,3,507,283,243,71,43,1147,0,23,1170
15,34,15107,5256,3,470,271,200,53,29,1023,5,19,1047
15,34,15107,5257,3,351,264,172,64,32,883,5,29,917
15,34,15107,5258,3,504,215,192,72,32,1015,2,18,1035
15,34,15107,5259,3,376,246,227,56,25,930,4,14,948
15,34,15107,5260,3,360,214,144,61,37,816,7,13,836
15,34,15107,5261,3,577,393,313,92,37,1412,10,34,1456
15,34,15107,5262,3,441,224,222,32,36,955,2,8,965
15,34,15107,5263,3,595,263,257,68,40,1223,5,21,1249
15,34,15107,5264,3,573,233,250,84,34,1174,8,22,1204
15,34,15107,5265,3,581,246,244,64,41,1176,1,19,1196
15,34,15107,5273,3,313,126,135,41,16,631,3,15,649
15,34,15107,5274,3,725,274,251,70,36,1356,12,23,1391
15,34,15107,5275,3,483,244,176,37,26,966,5,25,996
15,34,15107,5276,3,381,215,138,48,25,807,6,23,836
15,34,15107,5285,3,896,494,304,100,48,1842,10,33,1885
15,34,15107,5286,3,725,340,208,92,27,1392,10,28,1430
15,34,15107,5287,3,771,427,302,124,55,1679,5,25,1709
15,34,15107,5288,3,512,186,144,55,45,942,8,11,961
15,34,15107,5302,3,545,384,197,68,36,1230,0,19,1249
15,34,15107,5303,3,1255,582,493,188,71,2589,38,45,2672
15,34,15107,5304,3,848,367,289,78,29,1611,7,26,1644
15,34,15107,5305,3,1138,445,356,116,42,2097,5,22,2124
15,34,15107,5306,3,615,324,239,78,41,1297,4,18,1319
15,34,15107,5316,3,574,277,281,61,31,1224,11,15,1250
15,34,15107,5317,3,889,475,443,112,60,1979,7,28,2014
15,34,15107,5318,3,758,425,367,104,46,1700,15,28,1743
15,34,15107,5319,3,503,289,280,70,44,1186,4,30,1220
15,34,15107,5320,3,724,330,258,82,27,1421,3,70,1494
15,34,15107,5329,3,641,300,243,79,49,1312,5,28,1345
15,34,15107,5330,3,947,462,377,116,56,1958,13,20,1991
15,34,15107,5331,3,430,192,142,45,23,832,8,13,853
15,34,15107,5332,3,380,185,136,38,21,760,3,10,773
15,34,15107,5333,3,485,221,158,108,38,1010,7,13,1030
15,34,15107,5334,3,578,287,203,56,37,1161,7,15,1183
15,34,15107,5335,3,1054,472,368,122,70,2086,10,43,2139
15,34,15107,5336,3,689,332,298,83,52,1454,10,21,1485
15,34,15107,5337,3,622,347,384,77,33,1463,3,30,1496
15,34,15107,5338,3,357,231,225,43,21,877,2,13,892
15,34,15107,5339,3,493,334,298,65,37,1227,7,31,1265
15,34,15107,5340,3,335,136,182,51,21,725,0,9,734
15,34,15107,5341,3,548,238,291,100,56,1233,0,18,1251
15,34,15107,5342,3,574,281,268,66,33,1222,0,24,1246
15,34,15107,5343,3,618,321,296,67,48,1350,1,26,1377
15,34,15107,5344,3,395,188,132,48,29,792,6,21,819
15,34,15107,5345,3,891,351,327,118,73,1760,6,20,1786
15,34,15107,5346,3,729,287,211,84,41,1352,3,11,1366
15,34,15107,5347,3,840,261,202,52,27,1382,0,34,1416
15,34,15107,5348,3,863,313,268,85,44,1573,1,23,1597
15,34,15107,5349,3,978,577,521,152,74,2302,15,57,2374
15,34,15107,5350,3,1217,467,395,133,59,2271,5,37,2313
15,34,15107,5351,3,908,347,260,79,44,1638,6,23,1667
15,34,15107,5352,3,198,108,100,53,21,480,3,8,491
15,34,15107,5353,3,284,132,150,56,21,643,2,9,654
15,34,15107,5354,3,879,458,381,129,44,1891,11,39,1941
15,34,15107,5360,3,427,221,112,39,11,810,12,32,854
15,34,15107,5371,3,216,171,51,19,10,467,5,9,481
15,34,15107,5372,3,597,305,216,42,24,1184,7,35,1226
15,34,15107,5373,3,565,305,169,58,22,1119,11,15,1145
15,34,15107,5398,3,698,320,383,67,42,1510,3,30,1543
15,34,15107,5399,3,890,416,336,58,31,1731,8,24,1763
15,34,15107,5400,3,592,240,266,60,14,1172,3,25,1200
15,34,15107,5401,3,707,467,192,76,12,1454,10,42,1506
15,34,15107,5402,3,544,224,188,32,17,1005,5,33,1043
15,34,15107,5403,3,602,212,249,48,36,1147,3,25,1175
15,34,15107,5419,3,406,229,142,42,10,829,6,15,850
15,34,15107,5420,3,428,167,137,28,20,780,2,20,802
15,34,15107,5421,3,446,207,119,38,26,836,1,20,857
15,34,15107,5422,3,682,278,221,75,22,1278,5,30,1313
15,34,15107,5423,3,501,255,196,59,25,1036,6,31,1073
15,34,15107,5424,3,412,209,122,36,11,790,3,27,820
15,34,15107,5425,3,830,330,215,70,49,1494,6,30,1530
15,34,15107,5426,3,152,172,33,14,9,380,5,13,398
15,34,15107,5427,3,64,46,11,6,0,127,0,8,135
15,34,15107,5428,3,394,251,133,41,25,844,6,13,863
15,34,15107,5429,3,376,134,140,49,17,716,1,3,720
15,34,15107,5430,3,455,263,186,57,25,986,5,22,1013
15,34,15107,5431,3,529,254,158,63,29,1033,3,27,1063
15,34,15107,5432,3,338,175,100,49,23,685,0,21,706
15,34,15107,5433,3,805,285,249,73,32,1444,4,34,1482
15,34,15107,5434,3,667,329,240,69,53,1358,5,16,1379
15,34,15107,5435,3,556,220,183,80,23,1062,1,11,1074
15,34,15107,5436,3,552,259,215,74,33,1133,0,31,1164
15,34,15107,5437,3,651,376,262,90,35,1414,4,35,1453
15,34,15107,5438,3,578,344,213,77,27,1239,13,35,1287
15,34,15107,5440,3,1034,627,509,142,62,2374,17,54,2445
15,35,15006,151,3,219,364,162,108,18,871,2,19,892
15,35,15006,152,3,167,264,198,77,14,720,4,17,741
15,35,15006,153,3,225,283,213,52,9,782,6,21,809
15,35,15006,154,3,178,338,194,82,6,798,0,21,819
15,35,15006,155,3,126,294,249,52,6,727,3,26,756
15,35,15012,247,3,329,335,234,95,16,1009,4,19,1032
15,35,15012,248,3,293,369,265,121,21,1069,0,47,1116
15,35,15012,249,3,321,386,264,96,12,1079,7,35,1121
15,35,15019,511,3,161,236,380,77,23,877,8,17,902
15,35,15019,512,3,180,248,426,88,26,968,9,12,989
15,35,15019,513,3,205,308,439,80,20,1052,10,11,1073
15,35,15019,514,3,221,271,299,70,16,877,7,11,895
15,35,15019,515,3,200,200,407,71,18,896,3,27,926
15,35,15019,516,3,180,173,273,64,21,711,3,13,727
15,35,15019,517,3,124,156,229,38,17,564,3,10,577
15,35,15019,518,3,324,437,364,112,25,1262,3,33,1298
15,35,15019,519,3,49,87,110,33,14,293,2,3,298
15,35,15019,520,3,127,221,218,62,19,647,5,12,664
15,35,15019,521,3,64,124,181,52,5,426,0,15,441
15,35,15019,522,3,111,196,288,56,23,674,0,15,689
15,35,15044,2236,3,224,304,425,117,14,1084,2,39,1125
15,35,15044,2237,3,208,439,392,146,18,1203,9,28,1240
15,35,15044,2238,3,166,235,291,102,16,810,5,21,836
15,35,15044,2239,3,289,454,408,114,23,1288,1,39,1328
15,35,15044,2240,3,116,270,233,89,9,717,1,18,736
15,35,15044,2241,3,42,162,169,47,5,425,0,10,435
15,35,15044,2242,3,18,30,15,4,0,67,0,1,68
15,35,15050,2373,3,239,188,278,28,11,744,3,25,772
15,35,15050,2374,3,396,245,384,30,19,1074,0,25,1099
15,35,15050,2375,3,177,390,175,133,13,888,0,19,907
15,35,15050,2376,3,130,458,183,68,6,845,4,27,876
15,35,15050,2377,3,97,188,155,8,3,451,0,14,465
15,35,15053,2432,3,250,156,133,27,10,576,2,9,587
15,35,15053,2433,3,210,219,228,43,18,718,0,15,733
15,35,15053,2434,3,228,240,179,52,11,710,2,17,729
15,35,15053,2435,3,189,174,149,32,9,553,3,21,577
15,35,15053,2436,3,79,227,372,108,26,812,1,8,821
15,35,15053,2437,3,232,230,113,27,10,612,1,12,625
15,35,15053,2438,3,140,284,243,29,15,711,10,12,733
15,35,15053,2439,3,376,264,108,82,14,844,7,214,1065
15,35,15053,2440,3,20,161,19,3,2,205,1,12,218
15,35,15053,2441,3,5,63,7,1,0,76,0,6,82
15,35,15053,2442,3,30,71,124,6,1,232,1,7,240
15,35,15053,2443,3,90,210,213,19,6,538,2,18,558
15,35,15053,2444,3,73,196,29,0,1,299,1,7,307
15,35,15053,2445,3,28,79,68,7,1,183,0,8,191
15,35,15053,2446,3,138,169,221,21,7,556,2,12,570
15,35,15053,2447,3,26,77,43,5,1,152,0,1,153
15,35,15063,3828,3,291,287,327,55,34,994,11,13,1018
15,35,15063,3829,3,269,214,229,33,20,765,5,14,784
15,35,15063,3830,3,340,297,401,55,23,1116,5,12,1133
15,35,15063,3831,3,329,275,452,76,45,1177,0,26,1203
15,35,15063,3832,3,237,261,373,50,39,960,2,20,982
15,35,15063,3833,3,249,362,474,74,32,1191,10,13,1214
15,35,15063,3834,3,233,292,379,75,38,1017,5,16,1038
15,35,15063,3835,3,310,309,398,53,41,1111,7,15,1133
15,35,15063,3836,3,107,131,115,16,9,378,2,2,382
15,35,15063,3837,3,301,362,385,48,38,1134,9,16,1159
15,35,15063,3838,3,394,390,340,95,37,1256,2,16,1274
15,35,15063,3839,3,326,136,167,53,28,710,2,14,726
15,35,15063,3840,3,158,186,281,61,24,710,6,16,732
15,35,15063,3841,3,127,123,162,25,14,451,2,22,475
15,35,15063,3842,3,344,540,517,65,44,1510,5,32,1547
15,35,15063,3843,3,234,240,223,47,20,764,1,9,774
15,35,15063,3844,3,243,258,303,47,25,876,7,18,901
15,35,15063,3845,3,576,517,578,101,68,1840,14,36,1890
15,35,15063,3846,3,110,192,561,40,12,915,2,31,948
15,35,15063,3847,3,94,228,376,38,21,757,4,29,790
15,35,15063,3848,3,97,170,269,77,7,620,4,15,639
15,35,15063,3849,3,134,270,332,71,23,830,5,16,851
15,35,15064,3850,3,75,197,711,33,9,1025,6,28,1059
15,35,15064,3851,3,8,43,42,4,0,97,0,3,100
15,35,15064,3852,3,91,592,452,32,7,1174,3,31,1208
15,35,15064,3853,3,60,287,495,14,8,864,2,16,882
15,35,15064,3854,3,104,330,812,75,7,1328,1,34,1363
15,35,15064,3855,3,37,129,399,36,5,606,2,35,643
15,35,15064,3856,3,46,248,455,32,4,785,5,30,820
15,35,15064,3857,3,41,80,135,7,1,264,0,13,277
15,35,15064,3858,3,47,155,185,20,3,410,5,15,430
15,35,15064,3859,3,125,219,239,41,6,630,2,18,650
15,35,15064,3860,3,45,157,156,8,2,368,3,4,375
15,35,15064,3861,3,84,161,199,11,7,462,2,20,484
15,35,15064,3862,3,120,381,113,22,3,639,3,11,653
15,35,15089,4429,3,216,193,351,65,25,850,4,19,873
15,35,15089,4430,3,385,265,337,62,45,1094,0,20,1114
15,35,15089,4431,3,354,171,274,85,26,910,1,21,932
15,35,15089,4432,3,432,435,593,185,60,1705,0,48,1753
15,35,15089,4433,3,13,37,23,2,2,77,0,1,78
15,35,15089,4434,3,168,269,236,84,22,779,0,16,795
15,35,15089,4435,3,241,260,287,120,24,932,2,17,951
15,35,15089,4436,3,302,176,344,87,21,930,2,21,953
15,35,15089,4437,3,380,288,467,95,33,1263,1,27,1291
15,35,15089,4438,3,323,220,392,79,30,1044,2,22,1068
15,35,15089,4439,3,301,183,340,60,25,909,5,26,940
15,35,15089,4440,3,263,166,311,61,27,828,3,14,845
15,35,15089,4441,3,315,245,364,155,41,1120,7,28,1155
15,35,15089,4442,3,153,242,470,59,26,950,10,30,990
15,35,15089,4443,3,524,280,254,43,20,1121,3,39,1163
15,35,15089,4444,3,27,56,91,11,3,188,0,8,196
15,35,15089,4445,3,51,87,358,20,9,525,5,16,546
15,35,15089,4446,3,230,144,196,21,58,649,7,22,678
15,35,15089,4447,3,246,96,96,34,13,485,2,26,513
15,35,15089,4448,3,416,219,247,61,14,957,2,15,974
15,35,15089,4449,3,83,70,105,18,3,279,0,12,291
15,35,15089,4450,3,200,163,199,54,24,640,0,13,653
15,35,15089,4451,3,163,295,441,114,12,1025,0,27,1052
15,35,15089,4452,3,151,177,143,42,18,531,0,20,544
15,35,15089,4453,3,66,70,100,24,4,264,3,3,270
15,35,15089,4454,3,115,128,202,61,10,516,6,23,545
15,35,15089,4455,3,253,146,267,61,10,737,2,26,765
15,35,15089,4456,3,106,267,310,247,16,946,5,27,978
15,35,15089,4457,3,51,40,34,26,3,154,0,3,157
15,35,15089,4458,3,223,268,418,114,38,1061,19,40,1120
15,35,15089,4459,3,204,160,122,112,21,619,8,34,661
15,35,15089,4460,3,247,206,248,76,15,792,7,23,822
15,35,15089,4461,3,226,128,116,50,11,531,3,32,566
15,35,15089,4462,3,55,113,93,9,5,275,0,9,284
15,35,15089,4463,3,69,79,111,14,2,275,5,16,296
15,35,15089,4464,3,34,28,68,7,1,138,1,7,146
15,35,15089,4465,3,96,52,54,21,6,229,0,5,234
15,35,15099,4609,3,113,350,302,89,5,859,0,20,879
15,35,15099,4610,3,154,305,389,83,16,947,3,19,969
15,35,15102,4701,3,546,708,206,281,39,1780,0,49,1829
15,35,15102,4702,3,318,414,151,135,15,1033,0,18,1051
15,35,15102,4703,3,460,632,267,226,41,1626,0,36,1662
15,35,15102,4704,3,490,491,344,208,34,1567,7,47,1621
15,35,15102,4705,3,382,417,254,204,36,1293,5,32,1330
15,35,15102,4706,3,347,442,198,116,24,1127,8,15,1150
15,35,15102,4707,3,273,228,112,38,19,670,4,20,694
15,35,15102,4708,3,178,271,140,104,17,710,0,18,728
15,35,15102,4709,3,436,646,189,194,16,1481,1,40,1522
15,35,15102,4710,3,299,468,123,97,16,1003,0,25,1028
15,35,15102,4711,3,259,386,152,131,12,940,2,19,961
15,35,15102,4712,3,59,66,25,25,1,176,0,0,176
15,35,15102,4713,3,82,367,112,27,5,593,1,14,608
15,35,15102,4714,3,101,152,167,42,4,466,0,9,475
15,35,15102,4715,3,295,434,360,94,15,1198,2,27,1227
15,35,15102,4716,3,249,297,266,81,15,908,3,19,930
15,35,15102,4717,3,159,379,146,66,11,761,1,24,786
15,35,15102,4718,3,261,331,287,97,16,992,3,17,1012
15,35,15102,4719,3,156,312,250,58,10,786,2,35,823
15,35,15102,4720,3,217,596,448,140,16,1417,7,67,1491
15,35,15102,4721,3,137,248,144,23,19,571,3,11,585
15,35,15102,4722,3,200,461,219,45,18,943,2,55,1000
15,35,15102,4723,3,87,333,121,11,4,556,3,25,584
15,35,15102,4724,3,91,382,135,33,8,649,10,34,693
15,36,15004,82,3,169,271,86,6,7,539,0,10,549
15,36,15004,83,3,217,164,152,16,5,554,2,13,569
15,36,15004,84,3,104,212,207,18,5,546,4,19,569
15,36,15004,85,3,125,155,123,3,0,406,2,9,417
15,36,15004,86,3,305,293,189,21,12,820,5,18,843
15,36,15004,87,3,71,211,81,3,3,369,0,19,388
15,36,15004,88,3,111,127,101,3,3,345,0,13,358
15,36,15004,89,3,62,119,153,11,5,350,1,10,361
15,36,15004,90,3,8,69,49,0,0,126,0,3,129
15,36,15004,91,3,15,55,34,0,0,104,0,0,104
15,36,15004,92,3,113,183,199,26,6,527,0,17,544
15,36,15004,93,3,100,86,67,2,2,257,0,8,265
15,36,15008,166,3,192,476,352,18,5,1043,0,50,1093
15,36,15008,167,3,166,497,271,19,4,957,0,39,996
15,36,15008,168,3,30,126,41,4,0,201,0,5,206
15,36,15008,169,3,44,110,45,0,0,199,0,3,202
15,36,15008,170,3,38,247,171,8,0,464,0,16,480
15,36,15008,171,3,106,395,385,17,6,909,1,31,941
15,36,15008,172,3,28,125,69,4,1,227,0,9,236
15,36,15008,173,3,61,208,94,4,3,370,0,12,382
15,36,15008,174,3,15,97,81,0,0,193,0,3,196
15,36,15008,175,3,112,390,316,7,4,829,1,31,861
15,36,15008,176,3,79,301,297,4,5,686,1,29,716
15,36,15008,177,3,29,27,23,0,0,79,0,1,80
15,36,15008,178,3,13,113,106,0,0,232,0,3,235
15,36,15008,179,3,27,92,88,0,0,207,0,6,213
15,36,15008,180,3,42,375,150,2,4,573,0,15,588
15,36,15008,181,3,25,95,128,0,1,249,2,6,257
15,36,15008,182,3,2,80,80,0,1,163,0,3,166
15,36,15008,183,3,54,107,105,4,0,270,0,9,279
15,36,15008,184,3,112,325,221,6,5,669,0,27,696
15,36,15008,185,3,23,59,21,0,1,104,0,7,111
15,36,15008,186,3,34,209,136,1,2,382,0,13,395
15,36,15008,187,3,21,215,103,1,2,342,0,11,353
15,36,15008,188,3,7,80,14,0,0,101,0,1,102
15,36,15008,189,3,42,103,87,2,1,235,0,5,240
15,36,15008,190,3,24,192,163,0,0,379,0,11,390
15,36,15008,191,3,20,127,95,1,0,243,0,0,243
15,36,15008,192,3,15,125,90,0,1,231,0,6,237
15,36,15021,629,3,267,237,257,15,8,784,0,27,811
15,36,15021,630,3,279,294,269,16,12,870,3,24,897
15,36,15021,631,3,200,275,177,20,16,688,0,12,700
15,36,15021,632,3,247,340,207,14,12,820,3,9,832
15,36,15021,633,3,53,139,58,1,4,255,1,3,259
15,36,15021,634,3,81,73,51,3,1,209,1,8,218
15,36,15021,635,3,53,125,31,9,1,219,3,4,226
15,36,15021,636,3,132,118,176,14,4,444,1,20,465
15,36,15021,637,3,209,177,77,13,5,481,3,14,498
15,36,15021,638,3,85,125,8,4,3,225,0,9,234
15,36,15021,639,3,224,150,37,17,7,435,0,19,454
15,36,15021,640,3,193,136,52,4,0,385,1,13,399
15,36,15021,641,3,225,139,174,4,9,551,0,13,564
15,36,15021,642,3,99,160,89,8,8,364,3,5,372
15,36,15021,643,3,133,86,76,12,4,311,0,27,338
15,36,15021,644,3,197,137,127,16,9,486,1,12,499
15,36,15021,645,3,180,128,56,3,6,373,0,16,389
15,36,15021,646,3,156,146,150,5,11,468,2,34,504
15,36,15021,647,3,77,84,58,1,2,222,0,7,229
15,36,15067,3899,3,245,176,351,3,5,780,0,42,822
15,36,15067,3900,3,62,106,107,4,0,279,0,10,289
15,36,15067,3901,3,64,176,82,3,3,328,2,10,340
15,36,15067,3902,3,169,93,230,2,2,496,0,16,512
15,36,15078,4144,3,135,494,265,13,9,916,2,21,939
15,36,15078,4145,3,71,132,103,2,0,308,1,12,321
15,36,15078,4146,3,50,122,161,8,2,343,0,20,363
15,36,15078,4147,3,47,278,170,8,2,505,2,15,522
15,36,15079,4148,3,189,143,188,8,2,530,0,1,531
15,36,15079,4149,3,108,124,151,16,2,401,4,11,416
15,36,15079,4150,3,27,14,41,1,1,84,0,0,84
15,36,15079,4151,3,144,105,318,6,2,575,2,21,598
15,36,15079,4152,3,4,40,82,0,0,126,0,2,128
15,36,15079,4153,3,17,41,73,0,0,131,0,3,134
15,36,15079,4154,3,13,23,88,0,0,124,0,1,125
15,36,15079,4155,3,93,49,165,5,0,312,0,11,323
15,36,15079,4156,3,19,24,32,0,1,76,0,1,77
15,36,15079,4157,3,113,219,306,22,13,673,1,23,697
15,36,15081,4165,3,192,186,111,12,6,507,0,12,519
15,36,15081,4166,3,341,254,171,25,6,797,0,19,816
15,36,15081,4167,3,339,307,182,27,3,858,0,24,882
15,36,15081,4168,3,84,77,69,0,1,231,0,22,253
15,36,15081,4169,3,327,269,60,4,3,663,0,29,692
15,36,15081,4170,3,150,357,197,14,5,723,0,45,768
15,36,15081,4171,3,12,84,32,1,0,129,0,8,137
15,36,15081,4172,3,17,146,14,2,0,179,0,2,181
15,36,15081,4173,3,47,70,14,0,0,131,0,9,140
15,36,15081,4174,3,192,197,96,3,6,494,0,11,505
15,36,15081,4175,3,102,192,72,2,0,368,1,5,374
15,36,15081,4176,3,199,183,25,2,1,410,0,9,419
15,36,15081,4177,3,47,117,72,0,0,236,0,16,252
15,36,15081,4178,3,48,365,167,5,2,587,1,22,610
15,36,15081,4179,3,77,166,101,1,2,347,0,5,352
15,36,15081,4180,3,44,187,81,2,2,316,0,7,323
15,36,15081,4181,3,45,247,102,5,3,402,1,10,413
15,36,15081,4182,3,57,142,28,0,0,227,0,8,235
15,36,15081,4183,3,107,107,84,6,1,305,0,13,318
15,36,15081,4184,3,48,89,63,1,0,201,0,12,213
15,36,15081,4185,3,85,150,13,0,2,250,0,7,257
15,36,15081,4186,3,93,85,34,0,1,213,0,8,221
15,36,15081,4187,3,113,67,17,1,0,198,0,9,207
15,36,15083,4256,3,210,304,175,9,6,704,1,15,720
15,36,15083,4257,3,213,418,132,32,8,803,1,23,827
15,36,15083,4258,3,330,687,320,35,17,1389,6,58,1453
15,36,15083,4259,3,308,620,248,34,16,1226,8,52,1286
15,36,15083,4260,3,223,444,197,26,6,896,0,29,925
15,36,15083,4261,3,135,294,133,18,5,585,0,24,609
15,36,15083,4262,3,263,440,213,21,27,964,0,11,975
15,36,15083,4263,3,223,380,246,11,24,884,1,40,925
15,36,15083,4264,3,159,313,140,10,4,626,2,21,649
15,36,15083,4265,3,276,674,292,38,30,1310,1,59,1370
15,36,15123,4266,3,24,23,38,0,0,85,0,10,95
15,36,15123,4267,3,63,89,83,1,1,237,1,26,264
15,36,15123,4268,3,55,165,120,2,3,345,0,15,360
15,36,15123,4269,3,69,35,55,0,0,159,0,9,168
15,36,15123,4270,3,244,218,152,2,3,619,0,33,652
15,36,15123,4271,3,257,252,109,2,3,623,0,36,659
15,36,15123,4272,3,148,141,128,1,5,423,0,14,437
15,36,15123,4273,3,62,126,50,1,0,239,0,12,251
15,36,15083,4274,3,89,166,133,3,2,393,1,20,414
15,36,15083,4275,3,133,152,229,7,4,525,1,10,536
15,36,15083,4276,3,63,136,83,1,0,283,1,12,296
15,36,15083,4277,3,36,47,29,1,0,113,0,4,117
15,36,15123,4278,3,120,257,115,2,2,496,0,13,509
15,36,15083,4279,3,79,106,71,0,1,257,0,19,276
15,36,15083,4280,3,98,117,116,0,4,335,1,19,355
15,36,15123,4281,3,191,153,54,3,1,402,0,29,431
15,36,15123,4282,3,86,100,48,0,3,237,0,9,246
15,36,15083,4283,3,104,162,134,3,0,403,1,18,422
15,36,15123,4284,3,165,245,125,8,4,547,1,33,581
15,36,15123,4285,3,292,245,146,6,7,696,1,34,731
15,36,15123,4286,3,200,375,188,11,6,780,1,45,826
15,36,15123,4287,3,187,343,187,6,7,730,1,26,757
15,36,15123,4288,3,64,28,23,0,1,116,0,11,127
15,36,15123,4289,3,132,98,69,3,3,305,1,20,326
15,36,15123,4290,3,204,162,100,3,2,471,0,20,491
15,36,15083,4291,3,126,248,162,7,2,545,0,20,565
15,36,15083,4292,3,58,312,179,1,0,550,1,25,576
15,36,15083,4293,3,38,210,184,8,1,441,0,12,453
15,36,15083,4294,3,336,621,352,33,7,1349,1,77,1427
15,36,15083,4295,3,62,85,197,7,2,353,1,9,363
15,36,15123,4296,3,33,20,30,1,0,84,0,2,86
15,36,15083,4297,3,23,161,68,1,0,253,0,9,262
15,36,15083,4298,3,65,378,265,6,0,714,1,38,753
15,36,15083,4299,3,27,154,97,2,2,282,0,15,297
15,36,15083,4300,3,147,272,207,7,3,636,0,27,663
15,36,15123,4301,3,81,149,48,8,3,289,2,23,314
15,36,15123,4302,3,12,115,112,1,0,240,0,1,241
15,36,15083,4303,3,9,122,77,0,0,208,0,9,217
15,36,15083,4304,3,17,158,114,0,2,291,0,32,323
15,36,15083,4305,3,24,64,53,0,1,142,0,8,150
15,36,15123,4306,3,8,57,38,0,2,105,0,1,106
15,36,15083,4307,3,26,52,78,1,0,157,0,4,161
15,36,15083,4308,3,64,63,90,1,1,219,2,8,229
15,36,15083,4309,3,158,323,257,7,7,752,0,41,793
15,36,15083,4310,3,28,31,52,0,0,111,0,4,115
15,36,15083,4312,3,28,68,71,0,0,167,0,3,170
15,36,15083,4313,3,20,42,71,0,1,134,0,0,134
15,36,15083,4314,3,84,287,219,9,4,603,0,16,619
15,36,15083,4315,3,96,243,254,16,3,612,0,23,635
15,36,15083,4316,3,150,128,319,1,2,600,2,34,636
15,36,15123,4317,3,74,63,23,1,0,161,0,4,165
15,36,15123,4318,3,197,129,111,1,0,438,0,20,458
15,36,15083,4319,3,24,127,151,0,1,303,1,7,311
15,36,15123,4320,3,1,21,47,0,1,70,0,2,72
15,36,15083,4321,3,46,119,25,1,0,191,0,6,197
15,36,15083,4322,3,18,67,42,0,1,128,0,6,134
15,36,15083,4323,3,170,297,128,6,7,608,1,10,619
15,36,15083,4324,3,87,87,85,7,0,266,0,14,280
15,36,15083,4325,3,152,136,97,3,2,390,0,0,390
15,36,15087,4380,3,321,268,176,16,13,794,4,24,822
15,36,15087,4381,3,170,163,111,10,7,461,2,12,475
15,36,15087,4382,3,260,256,56,10,6,588,4,20,612
15,36,15087,4383,3,152,266,59,9,7,493,6,10,509
15,36,15087,4384,3,108,273,150,5,2,538,1,20,559
15,36,15087,4385,3,175,225,124,22,11,557,8,16,581
15,36,15087,4386,3,142,174,79,20,7,422,6,10,438
15,36,15087,4387,3,199,205,80,5,7,496,1,12,509
15,36,15087,4388,3,234,138,24,1,1,398,2,5,405
15,36,15087,4389,3,160,183,78,14,5,440,4,23,467
15,36,15087,4390,3,199,334,93,20,6,652,0,29,681
15,36,15087,4391,3,109,113,61,16,3,302,2,14,318
15,36,15087,4392,3,164,107,22,2,0,295,3,4,302
15,36,15087,4393,3,125,189,74,31,5,424,2,10,436
15,36,15087,4394,3,292,314,134,11,12,763,6,31,800
15,36,15087,4395,3,405,222,63,7,5,702,1,19,722
15,36,15087,4396,3,113,62,16,2,0,193,0,13,206
15,36,15087,4397,3,44,174,18,6,2,244,4,11,259
15,36,15087,4398,3,103,50,15,0,0,168,1,3,172
15,36,15087,4399,3,21,68,11,2,0,102,0,5,107
15,36,15087,4400,3,64,86,15,0,0,165,0,4,169
15,36,15087,4401,3,172,121,33,2,0,328,0,10,338
15,36,15087,4402,3,168,61,9,0,2,240,2,0,242
15,36,15098,4601,3,264,352,474,33,11,1134,2,37,1173
15,36,15098,4602,3,114,271,218,12,8,623,1,17,641
15,36,15098,4603,3,134,366,164,6,4,674,1,26,701
15,36,15098,4604,3,153,380,321,30,13,897,2,33,932
15,36,15098,4605,3,60,195,191,9,6,461,1,13,475
15,36,15098,4606,3,106,141,157,13,5,422,2,20,444
15,36,15098,4607,3,48,172,285,8,6,519,1,11,531
15,36,15098,4608,3,100,236,120,7,11,474,0,21,495
15,36,15106,5137,3,80,335,422,15,3,855,1,38,894
15,36,15106,5138,3,65,235,375,2,2,679,0,37,716
15,36,15106,5139,3,38,157,302,1,1,499,0,18,517
15,36,15106,5140,3,14,122,145,2,2,285,0,16,301
15,36,15106,5141,3,13,138,203,0,0,354,0,21,375
15,36,15106,5142,3,37,114,154,0,2,307,0,21,328
15,36,15106,5143,3,90,195,386,3,1,675,2,40,717
15,36,15106,5144,3,9,79,90,0,0,178,0,3,181
15,36,15106,5145,3,16,215,233,5,1,470,0,11,481
15,36,15106,5146,3,44,115,186,1,1,347,0,14,361
15,36,15106,5147,3,52,131,308,0,1,492,0,7,499
15,36,15106,5148,3,146,294,435,38,7,920,4,24,948
15,36,15106,5149,3,2,21,43,1,0,67,0,1,68
15,36,15106,5150,3,39,65,109,3,1,217,1,13,231
15,36,15106,5151,3,40,64,179,1,1,285,0,22,307
15,36,15106,5152,3,30,99,173,6,0,308,0,8,316
15,36,15106,5153,3,19,261,333,16,7,636,2,27,665
15,36,15106,5154,3,13,102,121,0,2,238,0,7,245
15,36,15106,5155,3,2,147,106,0,0,255,0,4,259
15,36,15106,5156,3,13,103,151,2,1,270,0,5,275
15,36,15106,5157,3,20,211,246,0,3,480,2,11,493
15,36,15106,5158,3,32,79,228,14,1,354,0,12,366
15,36,15106,5159,3,30,109,149,17,3,308,0,17,325
15,36,15106,5160,3,8,89,110,2,4,213,0,7,220
15,36,15106,5161,3,42,147,289,25,0,503,0,19,522
15,36,15106,5162,3,5,48,97,0,0,150,0,14,164
15,36,15106,5163,3,33,182,327,27,0,569,0,30,599
15,36,15106,5164,3,29,115,171,2,0,317,0,5,322
15,36,15106,5165,3,13,123,163,0,0,299,0,1,300
15,36,15106,5166,3,13,38,109,2,1,163,0,5,168
15,36,15106,5167,3,18,35,112,0,0,165,0,6,171
15,36,15106,5168,3,15,87,109,0,2,213,0,6,219
15,36,15117,5805,3,495,439,217,14,4,1169,1,40,1210
15,36,15117,5806,3,161,92,45,1,1,300,0,17,317
15,36,15118,5807,3,160,174,151,12,11,508,1,7,516
15,36,15118,5808,3,237,261,252,15,17,782,0,19,801
15,36,15118,5809,3,84,178,210,1,3,476,2,14,492
15,36,15118,5810,3,100,131,154,5,2,392,1,12,405
15,36,15118,5811,3,51,76,70,6,2,205,1,11,217
15,36,15118,5812,3,40,144,67,1,1,253,0,5,258
15,36,15118,5813,3,20,97,28,1,2,148,0,4,152
15,36,15118,5814,3,23,49,40,0,0,112,0,3,115
15,36,15118,5815,3,15,59,25,0,0,99,0,4,103
15,36,15118,5816,3,69,208,99,2,9,387,1,18,406
15,36,15118,5817,3,124,80,67,4,3,278,1,7,286
15,36,15118,5818,3,31,210,146,1,2,390,0,16,406
15,36,15118,5819,3,44,126,40,2,3,215,2,13,230
15,36,15118,5820,3,47,88,69,3,1,208,0,8,216
15,36,15118,5821,3,6,43,38,0,0,87,0,3,90
15,36,15123,5929,3,54,123,58,2,1,238,0,19,257
15,36,15123,5930,3,3,14,22,0,0,39,0,2,41
15,36,15123,5931,3,6,12,12,0,0,30,0,4,34
15,37,15024,665,3,298,212,271,65,29,875,11,19,905
15,37,15024,666,3,330,274,224,87,31,946,3,24,973
15,37,15024,667,3,461,313,240,97,35,1146,11,20,1177
15,37,15024,668,3,454,344,311,108,63,1280,8,18,1306
15,37,15024,669,3,413,423,400,119,51,1406,5,48,1459
15,37,15024,670,3,539,366,539,126,67,1637,6,27,1670
15,37,15024,671,3,586,388,508,129,68,1679,14,28,1721
15,37,15024,672,3,585,396,523,154,69,1727,21,26,1774
15,37,15024,673,3,280,162,227,65,32,766,8,10,784
15,37,15024,674,3,279,176,236,78,24,793,1,15,809
15,37,15024,675,3,427,410,222,98,43,1200,4,27,1231
15,37,15024,676,3,278,174,232,56,24,764,2,11,777
15,37,15024,677,3,292,193,221,51,25,782,5,15,802
15,37,15024,678,3,282,260,166,102,35,845,9,12,866
15,37,15024,679,3,217,249,177,47,17,707,4,17,728
15,37,15024,680,3,307,310,310,101,32,1060,19,10,1089
15,37,15024,681,3,469,352,595,164,56,1636,14,24,1674
15,37,15024,682,3,207,162,238,47,20,674,0,6,680
15,37,15024,683,3,1356,777,1478,338,171,4120,6,53,4179
15,37,15024,684,3,535,353,535,152,79,1654,3,30,1687
15,37,15024,685,3,311,245,257,79,30,922,17,10,949
15,37,15024,686,3,77,85,75,26,7,270,1,4,275
15,37,15024,687,3,224,180,221,59,25,709,6,20,735
15,37,15024,688,3,209,169,192,49,23,642,2,13,657
15,37,15024,689,3,437,509,407,121,45,1519,15,19,1553
15,37,15024,690,3,437,319,406,96,52,1310,4,15,1329
15,37,15024,691,3,300,310,271,58,27,966,2,21,989
15,37,15045,2243,3,217,358,547,52,33,1207,13,14,1234
15,37,15045,2244,3,233,383,620,64,30,1330,8,36,1374
15,37,15045,2245,3,217,360,642,74,35,1328,11,20,1359
15,37,15045,2246,3,14,45,62,8,2,131,1,0,132
15,37,15125,2247,3,85,155,161,29,19,449,9,17,475
15,37,15125,2248,3,160,314,409,50,33,966,150,32,1148
15,37,15125,2249,3,171,390,532,42,40,1175,72,26,1273
15,37,15045,2250,3,328,177,496,110,66,1177,32,8,1217
15,37,15045,2251,3,150,96,286,48,27,607,19,24,650
15,37,15045,2252,3,132,106,222,40,25,525,23,16,564
15,37,15045,2253,3,110,78,186,47,27,448,11,14,473
15,37,15045,2254,3,192,120,245,44,25,626,23,20,669
15,37,15045,2255,3,120,105,276,54,26,581,15,13,609
15,37,15045,2256,3,189,146,266,66,24,691,20,7,718
15,37,15045,2257,3,138,114,291,61,27,631,26,10,667
15,37,15045,2258,3,95,78,151,32,8,364,8,7,379
15,37,15045,2259,3,114,94,155,52,22,437,11,4,452
15,37,15054,2448,3,231,191,317,61,17,817,9,17,843
15,37,15054,2449,3,258,103,281,47,21,710,6,7,723
15,37,15054,2450,3,316,744,513,69,23,1665,1,20,1686
15,37,15054,2451,3,161,600,489,50,12,1312,2,23,1337
15,37,15054,2452,3,186,397,563,71,24,1241,19,34,1294
15,37,15054,2453,3,420,302,692,113,52,1579,7,33,1619
15,37,15054,2454,3,474,275,581,89,36,1455,4,40,1499
15,37,15054,2455,3,333,213,455,72,19,1092,15,14,1121
15,37,15054,2456,3,244,237,537,66,21,1105,8,25,1138
15,37,15054,2457,3,220,203,550,73,20,1066,13,14,1093
15,37,15054,2458,3,263,238,413,49,15,978,8,22,1008
15,37,15054,2459,3,397,283,684,107,37,1508,25,25,1558
15,37,15054,2460,3,35,26,65,6,6,138,1,5,144
15,37,15054,2461,3,28,39,95,15,3,180,0,6,186
15,37,15054,2462,3,406,319,883,95,23,1726,37,33,1796
15,37,15054,2463,3,160,107,518,54,37,876,121,41,1038
15,37,15059,3036,3,358,395,513,90,55,1411,60,25,1496
15,37,15059,3037,3,354,284,343,69,30,1080,28,12,1120
15,37,15059,3038,3,173,156,237,76,25,667,76,15,758
15,37,15059,3039,3,114,91,168,25,15,413,45,17,475
15,37,15059,3040,3,320,287,380,63,35,1085,64,27,1176
15,37,15059,3041,3,101,118,173,33,8,433,21,12,466
15,37,15059,3042,3,127,89,248,45,13,522,56,36,614
15,37,15059,3043,3,111,65,160,37,9,382,51,19,452
15,37,15059,3044,3,45,43,102,12,9,211,27,11,249
15,37,15059,3045,3,149,249,442,66,22,928,122,63,1113
15,37,15110,5568,3,159,150,255,39,29,632,82,23,737
15,37,15110,5569,3,259,187,439,66,28,979,71,17,1067
15,37,15110,5570,3,108,188,260,54,21,631,29,20,680
15,37,15110,5571,3,88,146,200,44,17,495,71,11,577
15,37,15110,5572,3,276,336,501,101,71,1285,188,21,1494
15,37,15110,5573,3,246,176,309,84,37,852,88,15,955
15,37,15110,5574,3,133,144,215,42,26,560,38,3,601
15,37,15110,5575,3,199,240,389,75,45,948,92,35,1075
15,37,15110,5576,3,588,569,1205,215,101,2678,235,105,3018
15,37,15110,5577,3,301,243,404,67,38,1053,76,28,1157
15,37,15110,5578,3,292,189,364,70,37,952,117,18,1087
15,37,15110,5579,3,341,199,391,89,62,1082,146,31,1259
15,37,15110,5580,3,101,70,116,31,15,333,34,6,373
15,37,15110,5581,3,226,128,276,54,27,711,53,7,771
15,37,15110,5582,3,308,172,333,84,49,946,86,22,1054
15,37,15110,5583,3,280,232,481,91,52,1136,132,41,1309
15,37,15110,5584,3,203,103,353,58,31,748,60,15,823
15,37,15110,5585,3,74,73,184,35,26,392,34,8,434
15,37,15110,5586,3,123,68,153,37,19,400,47,9,456
15,37,15110,5587,3,175,170,293,50,37,725,153,26,904
15,37,15110,5588,3,399,366,771,163,69,1768,272,55,2095
15,37,15110,5589,3,178,148,326,80,41,773,96,21,890
15,37,15110,5590,3,456,475,862,212,87,2092,387,68,2547
15,37,15110,5591,3,109,91,233,55,22,510,86,13,609
15,37,15110,5592,3,142,108,216,45,36,547,46,7,600
15,37,15110,5593,3,145,99,254,52,27,577,76,19,672
15,37,15110,5594,3,136,124,235,68,30,593,131,12,736
15,37,15110,5595,3,540,303,831,175,94,1943,285,40,2268
15,37,15110,5596,3,81,116,238,50,16,501,50,17,568
15,37,15110,5597,3,356,240,602,106,63,1367,154,36,1557
15,37,15110,5598,3,492,419,963,195,77,2146,288,51,2485
15,37,15110,5599,3,529,307,761,185,94,1876,183,49,2108
15,37,15110,5600,3,286,304,639,109,50,1388,127,30,1545
15,37,15110,5601,3,132,159,310,65,35,701,94,23,818
15,37,15110,5602,3,115,131,310,63,31,650,87,27,764
15,37,15110,5603,3,119,76,205,23,22,445,50,15,510
15,37,15110,5604,3,136,127,282,74,34,653,97,31,781
15,37,15110,5605,3,243,192,273,79,30,817,76,22,915
15,37,15110,5606,3,132,136,286,77,23,654,60,20,734
15,37,15110,5607,3,207,200,357,78,43,885,144,23,1052
15,37,15110,5608,3,85,109,172,27,10,403,42,12,457
15,37,15110,5609,3,211,217,399,70,26,923,28,35,986
15,37,15110,5610,3,330,231,475,105,54,1195,56,48,1299
15,37,15110,5611,3,137,111,230,45,16,539,20,12,571
15,37,15110,5612,3,375,302,616,133,88,1514,148,45,1707
15,37,15110,5613,3,324,277,565,121,81,1368,129,36,1533
15,37,15110,5614,3,63,60,154,56,23,356,129,23,508
15,37,15110,5615,3,56,76,116,47,21,316,38,19,373
15,37,15110,5616,3,269,187,324,77,49,906,90,22,1018
15,37,15110,5617,3,229,189,292,73,55,838,152,13,1003
15,37,15110,5618,3,254,175,281,79,53,842,42,11,895
15,37,15110,5619,3,198,281,277,93,50,899,45,16,960
15,37,15110,5620,3,87,115,179,37,23,441,34,21,496
15,37,15110,5621,3,164,118,251,42,36,611,38,15,664
15,37,15110,5622,3,211,165,382,64,42,864,88,36,988
15,37,15110,5623,3,378,235,424,94,47,1178,132,21,1331
15,37,15110,5624,3,155,108,268,58,26,615,28,16,659
15,37,15110,5625,3,127,192,242,58,28,647,38,41,726
15,38,15032,1149,3,189,294,716,74,44,1317,5,38,1360
15,38,15032,1150,3,260,408,838,72,62,1640,29,35,1704
15,38,15032,1151,3,196,391,734,58,37,1416,7,31,1454
15,38,15032,1152,3,135,185,435,44,31,830,13,16,859
15,38,15032,1153,3,91,169,351,41,20,672,7,15,694
15,38,15032,1154,3,196,454,444,87,32,1213,10,5,1228
15,38,15032,1155,3,209,316,527,98,47,1197,2,46,1245
15,38,15032,1156,3,71,176,265,26,16,554,5,11,570
15,38,15032,1157,3,82,181,377,20,20,680,4,25,709
15,38,15032,1158,3,134,217,330,34,30,745,12,19,776
15,38,15032,1159,3,161,331,346,56,37,931,0,27,958
15,38,15032,1160,3,226,408,563,69,48,1314,3,28,1345
15,38,15032,1161,3,154,280,567,67,33,1101,14,21,1136
15,38,15032,1162,3,120,363,440,47,24,994,5,26,1025
15,38,15032,1163,3,182,422,674,64,34,1376,19,32,1427
15,38,15032,1164,3,274,644,828,87,55,1888,12,51,1951
15,38,15032,1165,3,144,276,409,61,47,937,8,9,954
15,38,15032,1166,3,146,289,488,61,46,1030,8,33,1071
15,38,15032,1167,3,120,219,447,58,33,877,11,22,910
15,38,15032,1171,3,161,365,429,53,33,1041,8,24,1073
15,38,15032,1172,3,230,369,601,61,38,1299,13,35,1347
15,38,15032,1179,3,138,226,407,40,37,848,6,23,877
15,38,15032,1180,3,164,316,495,61,31,1067,6,26,1099
15,38,15032,1181,3,153,216,395,52,24,840,1,14,855
15,38,15032,1182,3,151,272,384,61,22,890,8,18,916
15,38,15032,1183,3,133,226,483,43,37,922,16,23,961
15,38,15032,1184,3,143,233,423,41,36,876,5,13,894
15,38,15032,1201,3,121,270,388,33,24,836,4,22,862
15,38,15032,1202,3,147,255,421,52,30,905,12,24,941
15,38,15032,1203,3,123,189,351,36,26,725,5,20,750
15,38,15032,1221,3,114,173,355,34,30,706,2,15,723
15,38,15032,1271,3,105,207,455,44,27,838,20,19,877
15,38,15032,1272,3,88,225,322,37,12,684,4,19,707
15,38,15032,1273,3,116,271,365,34,20,806,4,21,831
15,38,15032,1274,3,168,369,550,72,37,1196,12,23,1231
15,38,15032,1275,3,307,1411,841,86,50,2695,19,92,2806
15,38,15032,1276,3,148,248,396,50,21,863,3,12,878
15,38,15100,4611,3,134,253,700,77,25,1189,2,13,1204
15,38,15100,4612,3,132,228,479,90,41,970,15,18,1003
15,38,15100,4613,3,237,204,493,64,38,1036,0,13,1049
15,38,15100,4614,3,237,211,300,47,29,824,3,15,842
15,38,15100,4615,3,102,215,418,44,38,817,5,27,849
15,38,15100,4616,3,93,222,553,63,39,970,7,19,996
15,38,15100,4617,3,155,300,685,70,42,1252,15,28,1295
15,38,15100,4618,3,392,427,729,108,61,1717,3,21,1741
15,38,15100,4619,3,188,233,297,54,31,803,0,15,818
15,38,15100,4620,3,260,272,432,53,38,1055,4,18,1077
15,38,15100,4621,3,138,324,420,44,30,956,1,41,998
15,38,15100,4622,3,193,223,281,35,27,759,0,13,772
15,38,15100,4623,3,204,245,473,66,35,1023,2,23,1048
15,38,15100,4624,3,133,175,378,40,33,759,2,10,771
15,38,15100,4625,3,313,346,457,74,64,1254,6,21,1281
15,38,15100,4626,3,252,250,314,51,40,907,2,29,938
15,38,15100,4627,3,268,285,472,64,51,1140,4,31,1175
15,38,15100,4628,3,165,314,703,90,25,1297,12,34,1343
15,38,15100,4629,3,145,310,581,57,29,1122,0,23,1145
15,38,15100,4630,3,237,272,536,80,38,1163,0,22,1185
15,38,15100,4631,3,274,308,395,56,48,1081,3,18,1102
15,38,15100,4632,3,205,264,374,64,31,938,7,25,970
15,38,15100,4633,3,177,199,359,46,27,808,1,14,823
15,38,15100,4634,3,183,210,380,46,19,838,2,17,857
15,38,15100,4635,3,280,372,710,101,48,1511,1,27,1539
15,38,15100,4636,3,277,403,732,75,39,1526,13,33,1572
15,38,15100,4637,3,198,300,471,69,29,1067,7,11,1085
15,38,15100,4638,3,160,194,204,41,21,620,0,11,631
15,38,15100,4639,3,115,135,162,41,13,466,0,7,473
15,38,15100,4640,3,142,430,709,58,21,1360,1,29,1390
15,38,15100,4641,3,105,131,202,32,9,479,1,7,487
15,38,15100,4642,3,0,0,0,0,0,0,0,0,0
15,38,15100,4643,3,187,239,519,87,35,1067,12,17,1096
15,38,15100,4644,3,116,216,480,50,25,887,5,4,896
15,38,15100,4645,3,107,186,382,48,20,743,3,21,767
15,38,15100,4646,3,196,247,514,85,45,1087,3,22,1112
15,38,15100,4647,3,117,124,343,52,38,674,0,10,684
15,38,15100,4648,3,213,171,606,69,33,1092,8,21,1121
15,38,15100,4649,3,379,885,1155,121,65,2605,9,57,2671
15,38,15100,4650,3,169,257,1004,61,56,1547,6,32,1585
15,38,15100,4651,3,146,233,954,60,42,1435,14,39,1488
15,38,15100,4652,3,225,360,694,100,40,1419,11,50,1480
15,38,15100,4653,3,222,364,671,74,50,1381,5,28,1414
15,38,15100,4654,3,261,401,629,85,39,1415,2,14,1431
15,38,15100,4655,3,277,517,591,66,50,1501,7,28,1536
15,38,15100,4656,3,142,156,298,32,16,644,10,15,669
15,38,15100,4657,3,80,165,270,26,14,555,3,16,574
15,38,15100,4658,3,183,336,476,63,35,1093,5,20,1118
15,38,15100,4659,3,156,300,442,53,25,976,5,40,1021
15,38,15100,4660,3,132,195,378,50,33,788,10,20,818
15,38,15100,4661,3,189,306,420,58,46,1019,7,21,1047
15,38,15100,4662,3,271,265,768,95,54,1453,10,31,1494
15,38,15100,4663,3,187,245,581,73,48,1134,7,27,1168
15,38,15100,4664,3,52,232,388,26,16,714,3,13,730
15,38,15100,4665,3,115,273,324,34,24,770,18,15,803
15,38,15100,4666,3,69,286,441,30,17,843,9,11,863
15,38,15100,4667,3,109,175,420,32,32,768,2,21,791
15,38,15100,4668,3,90,176,565,44,23,898,5,28,931
15,38,15100,4669,3,107,152,478,54,30,821,11,17,849
15,38,15100,4670,3,166,235,643,51,35,1130,3,17,1150
15,38,15100,4671,3,375,279,620,73,49,1396,2,22,1420
15,38,15100,4672,3,205,177,351,39,31,803,7,10,820
15,38,15100,4673,3,196,204,464,52,41,957,6,26,989
15,38,15100,4674,3,339,275,457,59,54,1184,7,34,1225
15,38,15100,4675,3,306,310,642,81,33,1372,1,37,1410
15,38,15100,4676,3,228,241,425,58,39,991,24,16,1031
15,38,15100,4677,3,215,713,697,56,48,1729,21,51,1801
15,38,15100,4678,3,71,186,137,19,8,421,3,27,451
15,38,15100,4679,3,331,542,731,69,56,1729,12,38,1779
15,38,15100,4680,3,260,181,403,57,35,936,5,10,951
15,38,15100,4681,3,193,299,440,51,25,1008,2,25,1035
15,38,15100,4682,3,89,198,264,21,16,588,6,24,618
15,38,15100,4683,3,120,136,187,46,22,511,3,11,525
15,38,15100,4684,3,671,727,1563,226,165,3352,11,55,3418
15,38,15100,4685,3,114,172,355,42,27,710,2,10,722
15,38,15100,4686,3,124,213,463,39,27,866,2,12,880
15,38,15100,4687,3,152,250,304,32,25,763,0,24,787
15,38,15100,4688,3,108,150,412,28,17,715,8,22,745
15,38,15100,4689,3,79,294,332,40,19,764,7,13,784
15,38,15100,4690,3,110,138,323,24,16,611,2,11,624
15,38,15032,5971,3,8,44,94,5,1,152,3,3,158
15,38,15032,5972,3,51,482,160,20,13,726,3,20,749
15,38,15032,5973,3,85,347,243,17,12,704,4,5,713
15,38,15032,5974,3,39,121,247,20,7,434,12,16,462
15,38,15032,5975,3,42,83,233,14,7,379,1,12,392
15,38,15032,5976,3,56,152,174,19,17,418,4,6,428
15,38,15032,5977,3,50,227,257,17,5,556,2,11,569
15,38,15032,5978,3,44,235,220,25,21,545,2,10,557
15,38,15032,5979,3,83,143,234,22,9,491,0,19,510
15,38,15032,5980,3,42,276,140,13,5,476,0,11,487
15,38,15032,5981,3,38,302,107,22,10,479,5,5,489
15,38,15032,5982,3,64,109,187,30,13,403,2,8,413
15,38,15032,5983,3,67,161,200,25,13,466,2,19,487
15,38,15032,5984,3,94,154,262,25,17,552,1,14,567
15,38,15032,5985,3,69,91,185,22,8,375,5,4,384
15,38,15032,5986,3,79,108,182,13,13,395,4,5,404
15,38,15032,5987,3,89,92,216,23,14,434,1,9,444
15,38,15032,5988,3,66,78,134,7,9,294,3,9,306
15,38,15032,5989,3,45,76,178,20,12,331,3,6,340
15,38,15032,5990,3,56,109,201,21,10,397,4,13,414
15,39,15030,1109,3,230,409,1011,132,57,1839,14,40,1893
15,39,15030,1110,3,133,305,600,83,32,1153,2,34,1189
15,39,15030,1111,3,108,286,505,118,44,1061,6,30,1097
15,39,15030,1112,3,1326,1541,4239,561,326,7993,32,142,8167
15,39,15030,1113,3,665,814,2393,242,185,4299,16,111,4426
15,39,15030,1114,3,122,291,694,107,32,1246,23,36,1305
15,39,15030,1115,3,75,188,467,54,29,813,9,26,848
15,39,15030,1116,3,144,409,543,100,46,1242,15,24,1281
15,39,15030,1117,3,120,148,449,66,29,812,2,19,833
15,39,15030,1118,3,137,261,495,73,32,998,2,27,1027
15,39,15030,1119,3,105,168,394,64,30,761,8,15,784
15,39,15030,1120,3,110,154,400,52,37,753,4,15,772
15,39,15030,1121,3,281,417,1439,131,120,2388,23,45,2456
15,39,15030,1122,3,140,259,609,57,48,1113,5,31,1149
15,39,15030,1123,3,129,194,550,52,45,970,8,38,1016
15,39,15030,1124,3,169,224,833,71,40,1337,19,26,1382
15,39,15030,1125,3,122,125,462,63,33,805,5,27,837
15,39,15030,1126,3,142,195,419,52,39,847,4,19,870
15,39,15030,1127,3,121,187,385,46,32,771,7,16,794
15,39,15030,1128,3,144,143,365,57,32,741,6,22,769
15,39,15030,1129,3,152,145,352,43,40,732,10,16,758
15,39,15030,1130,3,112,204,522,53,38,929,2,32,963
15,39,15030,1131,3,103,120,381,55,21,680,5,18,703
15,39,15030,1132,3,113,90,385,46,29,663,5,12,680
15,39,15030,1133,3,96,172,450,53,32,803,4,11,818
15,39,15030,1134,3,70,215,427,39,30,781,1,15,797
15,39,15030,1135,3,72,137,363,45,23,640,8,12,660
15,39,15030,1136,3,120,163,519,45,38,885,4,10,899
15,39,15030,1137,3,137,148,270,31,37,623,13,14,650
15,39,15030,1138,3,82,117,292,40,17,548,3,10,561
15,39,15030,1139,3,65,110,267,32,20,494,5,12,511
15,39,15030,1140,3,83,169,434,47,20,753,5,8,766
15,39,15071,3942,3,133,168,312,43,21,677,2,10,689
15,39,15071,3943,3,351,468,891,73,57,1840,10,32,1882
15,39,15071,3944,3,146,218,427,38,30,859,2,13,874
15,39,15071,3945,3,251,582,901,80,55,1869,15,40,1924
15,39,15071,3946,3,270,427,1029,80,70,1876,12,35,1923
15,39,15071,3947,3,150,528,836,41,42,1597,15,33,1645
15,39,15071,3948,3,107,661,562,42,29,1401,16,27,1444
15,39,15071,3949,3,175,811,1235,102,51,2374,13,45,2432
15,39,15071,3950,3,225,587,995,104,62,1973,6,42,2021
15,39,15071,3951,3,232,506,720,94,65,1617,7,25,1649
15,39,15071,3952,3,158,353,577,68,37,1193,10,33,1236
15,39,15071,3953,3,202,306,559,58,49,1174,7,15,1196
15,39,15071,3954,3,142,252,575,55,40,1064,9,26,1099
15,39,15071,3955,3,229,351,573,69,41,1263,3,12,1278
15,39,15071,3956,3,135,155,465,54,28,837,2,17,856
15,39,15071,3957,3,148,199,575,64,40,1026,5,28,1059
15,39,15071,3958,3,180,256,555,72,42,1105,6,18,1129
15,39,15071,3959,3,164,216,606,80,61,1127,9,19,1155
15,39,15071,3960,3,148,237,457,51,38,931,8,16,955
15,39,15071,3961,3,87,235,428,58,33,841,3,19,863
15,39,15071,3962,3,109,172,518,48,33,880,4,10,894
15,39,15071,3963,3,161,248,510,55,59,1033,10,21,1064
15,39,15071,3964,3,95,235,417,40,36,823,3,21,847
15,39,15071,3965,3,164,237,507,50,38,996,5,14,1015
15,39,15071,3966,3,124,193,472,44,31,864,5,22,891
15,39,15071,3967,3,486,524,1342,130,121,2603,11,23,2637
15,39,15071,3968,3,153,250,554,69,32,1058,7,14,1079
15,39,15071,3969,3,145,186,473,58,37,899,2,19,920
15,39,15071,3970,3,180,260,497,54,31,1022,1,18,1041
15,39,15071,3971,3,196,186,454,69,17,922,8,15,945
15,39,15071,3972,3,172,231,441,64,43,951,0,23,974
15,39,15071,3973,3,171,302,551,87,65,1176,11,17,1204
15,39,15071,3974,3,197,279,473,62,45,1056,4,24,1084
15,39,15071,3975,3,146,193,404,71,51,865,2,17,884
15,39,15071,3976,3,105,159,339,45,29,677,6,9,692
15,39,15071,3977,3,165,299,556,56,48,1124,19,33,1176
15,39,15071,3978,3,153,256,513,58,27,1007,8,7,1022
15,39,15071,3979,3,159,383,515,69,33,1159,5,13,1177
15,39,15071,3980,3,201,414,607,72,43,1337,8,30,1375
15,39,15071,3981,3,145,274,389,36,25,869,1,18,888
15,39,15071,3982,3,133,238,408,63,24,866,4,11,881
15,39,15071,3983,3,225,536,571,54,49,1435,10,22,1467
15,39,15071,3984,3,394,506,833,93,72,1898,11,34,1943
15,39,15071,3985,3,97,110,320,32,20,579,4,10,593
15,39,15071,3986,3,209,229,461,48,39,986,7,19,1012
15,39,15071,3987,3,190,295,490,45,43,1063,4,25,1092
15,39,15071,3988,3,334,315,489,51,41,1230,1,34,1265
15,39,15071,3989,3,173,207,343,29,33,785,4,16,805
15,39,15071,3990,3,153,139,496,44,37,869,2,17,888
15,39,15071,3991,3,178,240,305,19,20,762,5,7,774
15,39,15071,3992,3,168,191,333,36,20,748,4,19,771
15,39,15071,3993,3,145,306,349,30,23,853,3,20,876
15,39,15071,3994,3,251,345,433,54,40,1123,3,27,1153
15,39,15071,3995,3,135,238,347,33,24,777,0,5,782
15,39,15071,3996,3,138,171,256,22,19,606,1,5,612
15,39,15071,3997,3,196,296,338,24,20,874,3,7,884
15,39,15071,3998,3,162,227,460,48,50,947,8,11,966
15,39,15071,3999,3,83,195,292,22,23,615,2,9,626
15,39,15071,4000,3,140,284,481,41,41,987,4,22,1013
15,39,15071,4001,3,200,274,569,73,47,1163,4,24,1191
15,39,15071,4002,3,168,269,588,31,47,1103,1,38,1142
15,39,15071,4003,3,228,397,848,85,56,1614,6,34,1654
15,39,15071,4004,3,336,675,1113,109,81,2314,11,47,2372
15,39,15071,4005,3,207,408,676,48,59,1398,4,30,1432
15,39,15071,4006,3,99,319,319,24,14,775,0,15,790
15,39,15071,4007,3,89,250,444,47,30,860,5,21,886
15,39,15030,5938,3,23,92,136,4,1,256,6,7,269
15,39,15030,5939,3,36,138,319,10,12,515,4,28,547
15,39,15030,5940,3,21,64,201,4,12,302,1,6,309
15,39,15030,5941,3,46,252,218,20,18,554,5,18,577
15,39,15030,5942,3,47,105,220,17,17,406,4,17,427
15,39,15030,5943,3,52,185,226,26,18,507,9,17,533
15,39,15030,5944,3,48,120,326,18,18,530,2,9,541
15,39,15030,5945,3,50,137,339,23,33,582,3,11,596
15,39,15030,5946,3,38,174,242,29,14,497,2,14,513
15,39,15030,5947,3,96,43,177,31,22,369,2,2,373
15,39,15030,5948,3,78,66,205,25,15,389,1,5,395
15,39,15030,5949,3,36,103,303,19,14,475,5,7,487
15,39,15030,5950,3,47,225,142,21,20,455,10,16,481
15,39,15030,5951,3,90,84,270,37,26,507,2,8,517
15,39,15030,5952,3,95,56,251,28,18,448,0,3,451
15,39,15030,5953,3,93,79,200,17,19,408,0,2,410
15,40,15041,2164,3,238,559,122,20,15,954,0,20,974
15,40,15041,2165,3,111,227,31,6,7,382,3,6,391
15,40,15041,2166,3,164,472,102,26,9,773,0,15,788
15,40,15041,2167,3,172,455,103,16,14,760,4,16,780
15,40,15041,2168,3,105,402,59,8,3,577,0,13,590
15,40,15041,2169,3,180,395,75,12,8,670,0,16,686
15,40,15041,2170,3,230,552,177,24,17,1000,2,25,1027
15,40,15041,2171,3,33,75,30,6,3,147,0,6,153
15,40,15041,2172,3,254,603,133,25,18,1033,2,34,1069
15,40,15041,2173,3,83,160,33,16,3,295,0,11,306
15,40,15041,2174,3,288,251,112,19,11,681,2,33,716
15,40,15041,2175,3,49,170,12,5,1,237,0,10,247
15,40,15041,2176,3,131,299,57,4,9,500,1,21,522
15,40,15041,2177,3,27,92,4,2,0,125,0,4,129
15,40,15041,2178,3,101,325,58,18,7,509,2,0,511
15,40,15041,2179,3,137,269,70,16,4,496,3,14,513
15,40,15041,2180,3,78,154,67,2,2,303,1,7,311
15,40,15041,2181,3,46,245,36,3,5,335,3,5,343
15,40,15041,2182,3,51,171,64,16,2,304,2,5,311
15,40,15073,4018,3,408,379,332,85,39,1243,13,31,1287
15,40,15073,4019,3,298,310,191,44,20,863,14,24,901
15,40,15073,4020,3,304,287,268,78,24,961,7,22,990
15,40,15073,4021,3,244,282,143,43,14,726,4,19,749
15,40,15091,4471,3,380,300,339,103,43,1165,4,21,1190
15,40,15091,4472,3,364,379,283,86,38,1150,5,40,1195
15,40,15091,4473,3,333,389,291,88,22,1123,6,27,1156
15,40,15091,4474,3,319,366,349,77,36,1147,7,26,1180
15,40,15091,4475,3,308,321,244,67,28,968,0,28,996
15,40,15091,4476,3,170,219,139,47,20,595,0,25,620
15,40,15091,4477,3,262,219,197,29,20,727,0,32,759
15,40,15091,4478,3,226,226,249,51,20,772,4,24,800
15,40,15091,4479,3,208,222,173,42,24,669,1,18,688
15,40,15091,4480,3,35,58,23,7,6,129,0,7,136
15,40,15091,4481,3,411,133,213,54,15,826,5,10,841
15,40,15091,4482,3,406,268,238,54,30,996,15,17,1028
15,40,15091,4483,3,278,202,321,37,12,850,6,20,876
15,40,15091,4484,3,169,139,268,136,14,726,10,20,756
15,40,15091,4485,3,165,153,307,37,16,678,0,17,695
15,40,15091,4486,3,171,109,173,26,7,486,5,16,507
15,40,15091,4487,3,142,156,171,28,8,505,1,13,519
15,40,15091,4488,3,289,398,382,52,20,1141,2,47,1190
15,40,15091,4489,3,58,126,181,10,2,377,2,16,395
15,40,15091,4490,3,84,75,223,21,7,410,0,12,422
15,40,15091,4491,3,112,110,379,45,12,658,5,23,686
15,40,15091,4492,3,135,209,184,38,7,573,8,18,599
15,40,15091,4493,3,158,210,235,53,11,667,14,37,718
15,40,15091,4494,3,266,352,214,37,16,885,2,19,906
15,40,15091,4495,3,124,149,720,145,27,1165,3,41,1209
15,40,15091,4496,3,74,89,423,75,10,671,2,13,686
15,40,15091,4497,3,97,118,453,176,19,863,3,30,896
15,40,15108,5443,3,151,348,236,17,7,759,1,6,766
15,40,15108,5444,3,141,332,210,17,10,710,2,16,728
15,40,15108,5445,3,139,374,157,11,6,687,1,11,699
15,40,15108,5446,3,121,241,138,9,3,512,2,11,525
15,40,15108,5447,3,130,334,123,10,9,606,0,9,615
15,40,15108,5448,3,32,194,54,2,0,282,0,9,291
15,40,15108,5449,3,82,211,94,6,5,398,0,14,412
15,40,15108,5450,3,108,305,136,14,3,566,1,14,581
15,40,15108,5451,3,66,84,43,2,4,199,0,3,202
15,40,15114,5723,3,305,625,355,32,21,1338,9,19,1366
15,40,15114,5724,3,238,362,260,38,8,906,5,16,927
15,40,15114,5725,3,161,270,149,9,3,592,1,7,600
15,40,15114,5726,3,265,412,310,32,15,1034,10,26,1070
15,40,15114,5727,3,152,378,111,7,7,655,5,27,687
15,40,15114,5728,3,106,123,230,13,4,476,3,25,504
15,40,15114,5729,3,64,58,70,4,5,201,0,6,207
15,40,15114,5730,3,264,194,189,12,5,664,2,8,674
15,40,15114,5731,3,163,192,89,24,3,471,0,21,492
15,40,15114,5732,3,223,424,175,22,14,858,1,22,881
15,40,15114,5733,3,195,179,101,10,5,490,5,21,516
15,40,15114,5734,3,207,123,66,19,5,420,0,19,439
15,40,15114,5735,3,349,308,249,27,16,949,2,21,972
15,40,15114,5736,3,230,255,112,24,12,633,5,19,657
15,40,15114,5737,3,121,138,82,24,8,373,2,21,396
15,40,15114,5738,3,203,374,256,31,19,883,1,24,908
15,40,15114,5739,3,111,290,128,10,4,543,3,11,557
15,40,15114,5740,3,242,239,210,23,19,733,0,21,754
15,40,15114,5741,3,175,135,87,11,10,418,2,9,429
15,40,15114,5742,3,348,146,84,16,13,607,0,22,629
15,40,15114,5743,3,89,186,33,6,5,319,0,19,338
15,40,15114,5744,3,128,207,129,20,7,491,0,20,511
15,40,15114,5745,3,114,137,139,27,8,425,2,14,441
15,40,15114,5746,3,86,73,29,19,3,210,0,12,222
15,40,15114,5747,3,38,170,22,4,0,234,0,10,244
15,40,15119,5822,3,476,259,283,75,44,1137,0,23,1160
15,40,15119,5823,3,270,216,187,48,19,740,4,31,775
15,40,15119,5824,3,318,244,226,64,25,877,5,16,898
15,40,15119,5825,3,400,271,229,79,48,1027,0,25,1052
15,40,15119,5826,3,561,392,328,80,73,1434,9,31,1474
15,40,15119,5827,3,635,466,413,88,55,1657,7,31,1695
15,40,15119,5828,3,507,411,321,82,48,1369,8,34,1411
15,40,15119,5829,3,511,314,249,69,53,1196,1,31,1228
15,40,15119,5830,3,313,270,186,59,31,859,7,14,880
15,40,15119,5831,3,371,302,239,72,53,1037,12,21,1070
15,40,15119,5832,3,239,207,150,37,27,660,4,17,681
15,40,15119,5833,3,220,162,158,53,21,614,5,18,637
15,40,15119,5834,3,636,539,392,115,77,1759,4,53,1816
15,40,15119,5835,3,758,605,386,130,51,1930,19,43,1992
15,40,15119,5836,3,718,465,450,75,61,1769,12,45,1826
15,40,15119,5837,3,640,335,300,96,29,1400,2,31,1433
15,40,15119,5838,3,526,317,271,55,32,1201,10,20,1231
15,40,15119,5839,3,580,239,295,59,35,1208,5,16,1229
15,40,15119,5840,3,30,52,20,2,0,104,3,3,110
15,40,15119,5841,3,576,315,247,42,13,1193,12,51,1256
15,40,15119,5842,3,367,278,135,17,15,812,11,34,857
15,40,15119,5843,3,128,136,80,16,11,371,0,17,388
15,40,15119,5844,3,300,396,230,49,17,992,13,35,1040
15,40,15119,5845,3,492,211,235,52,22,1012,1,24,1037
15,40,15119,5846,3,398,235,151,38,22,844,2,15,861
15,40,15119,5847,3,769,373,338,99,33,1612,23,69,1704
15,40,15119,5848,3,533,249,313,42,38,1175,9,36,1220
15,40,15119,5849,3,929,417,515,108,43,2012,24,76,2112
15,40,15119,5850,3,153,177,71,17,3,421,7,12,440
15,40,15119,5851,3,582,341,223,48,21,1215,11,40,1266
15,40,15119,5852,3,87,57,35,8,2,189,2,8,199
15,40,15119,5853,3,467,501,304,50,19,1341,11,81,1433
15,40,15119,5854,3,538,356,310,35,17,1256,20,41,1317
15,40,15119,5855,3,635,336,221,61,31,1284,19,28,1331
15,40,15119,5856,3,594,250,165,56,24,1089,14,29,1132
15,40,15119,5857,3,623,346,254,76,37,1336,10,19,1365
15,40,15119,5858,3,501,273,170,55,31,1030,9,28,1067
15,40,15119,5859,3,549,295,219,57,36,1156,8,24,1188
15,40,15119,5860,3,701,388,316,80,49,1534,6,34,1574
15,40,15119,5861,3,400,401,167,41,20,1029,17,28,1074
15,40,15119,5862,3,487,286,143,94,31,1041,15,32,1088
15,40,15119,5863,3,173,237,131,25,17,583,5,19,607
15,40,15119,5864,3,347,137,79,24,14,601,8,18,627
15,40,15119,5865,3,112,50,49,7,4,222,3,6,231
15,40,15119,5866,3,56,108,22,10,2,198,2,4,204
15,40,15119,5867,3,104,56,42,10,2,214,2,9,225
15,40,15119,5868,3,74,94,21,5,2,196,7,5,208
15,40,15120,5869,3,332,335,190,20,3,880,1,24,905
15,40,15120,5870,3,138,231,163,11,4,547,2,20,569
15,40,15120,5871,3,114,118,103,7,1,343,1,16,360
15,40,15120,5872,3,191,266,153,13,4,627,0,24,651
15,40,15120,5873,3,202,180,110,11,7,510,1,8,519
15,40,15120,5874,3,91,105,44,5,1,246,0,13,259
15,40,15120,5875,3,85,87,21,2,1,196,0,11,207
15,40,15120,5876,3,34,76,3,0,0,113,3,2,118
15,40,15120,5877,3,96,162,176,13,2,449,4,28,481
15,40,15120,5878,3,80,106,136,8,2,332,0,9,341
15,40,15120,5879,3,55,78,47,7,0,187,0,11,198
16,1,16009,149,3,221,90,204,16,13,544,0,25,569
16,1,16009,150,3,196,69,110,16,8,399,0,15,414
16,1,16009,151,3,379,179,244,28,21,851,4,27,882
16,1,16009,152,3,187,60,107,16,13,383,4,12,399
16,1,16009,153,3,231,129,156,17,16,549,3,12,564
16,1,16009,154,3,380,152,284,30,24,870,8,29,907
16,1,16009,155,3,330,127,270,33,27,787,2,31,820
16,1,16009,156,3,251,193,244,45,20,753,4,35,792
16,1,16009,157,3,100,115,190,3,2,410,2,5,417
16,1,16009,158,3,105,177,125,9,3,419,5,28,452
16,1,16009,159,3,228,360,141,9,8,746,1,26,773
16,1,16009,160,3,145,440,77,3,5,670,4,26,700
16,1,16009,161,3,155,158,286,16,10,625,3,29,657
16,1,16009,162,3,31,31,54,2,5,123,0,6,129
16,1,16009,163,3,242,49,144,4,2,441,0,22,463
16,1,16009,164,3,72,68,70,9,3,222,1,8,231
16,1,16009,165,3,52,105,167,4,0,328,3,11,342
16,1,16009,166,3,103,117,257,5,7,489,4,20,513
16,1,16009,167,3,22,65,63,1,2,153,2,4,159
16,1,16009,168,3,23,82,105,4,0,214,0,5,219
16,1,16009,169,3,66,55,45,3,1,170,0,4,174
16,1,16010,170,3,156,255,415,11,8,845,2,27,874
16,1,16010,171,3,120,304,344,13,9,790,0,12,802
16,1,16010,172,3,100,326,433,8,4,871,0,15,886
16,1,16010,173,3,127,249,411,10,15,812,1,25,838
16,1,16010,174,3,105,183,191,3,3,485,0,10,495
16,1,16010,175,3,0,99,196,0,0,295,0,0,295
16,1,16010,176,3,72,254,454,2,1,783,0,16,799
16,1,16010,177,3,32,113,181,5,3,334,2,4,340
16,1,16010,178,3,20,168,194,0,0,382,1,5,388
16,1,16010,179,3,3,30,88,0,2,123,0,0,123
16,1,16010,180,3,33,256,98,0,0,387,0,7,394
16,1,16010,181,3,80,146,399,9,6,640,5,21,666
16,1,16010,182,3,21,43,56,1,0,121,1,1,123
16,1,16010,183,3,14,12,40,1,0,67,0,2,69
16,1,16029,420,3,26,141,215,1,1,384,0,8,392
16,1,16029,421,3,16,247,217,1,1,482,0,8,490
16,1,16029,422,3,29,164,447,4,0,644,1,5,650
16,1,16029,423,3,13,133,197,1,1,345,0,6,351
16,1,16029,424,3,12,95,184,0,0,291,0,1,292
16,1,16029,425,3,24,42,80,1,1,148,0,5,153
16,1,16029,426,3,20,107,300,4,3,434,0,14,448
16,1,16029,427,3,11,44,163,0,0,218,0,0,218
16,1,16029,428,3,7,30,216,0,0,253,1,9,263
16,1,16029,429,3,1,48,199,1,0,249,0,6,255
16,1,16029,430,3,2,37,165,1,0,205,0,1,206
16,1,16029,431,3,4,31,93,0,0,128,0,2,130
16,1,16029,432,3,19,114,216,1,0,350,0,4,354
16,1,16035,557,3,158,240,182,29,5,614,0,12,626
16,1,16035,558,3,140,252,222,23,2,639,3,23,665
16,1,16035,559,3,165,251,196,17,11,640,3,26,669
16,1,16035,560,3,136,173,159,13,4,485,0,15,500
16,1,16035,561,3,95,191,144,7,7,444,0,16,460
16,1,16035,562,3,69,117,187,7,3,383,0,18,401
16,1,16035,563,3,16,41,46,0,1,104,0,7,111
16,1,16035,564,3,73,158,196,5,1,433,0,13,446
16,1,16035,565,3,25,52,149,5,0,231,0,11,242
16,1,16035,566,3,65,179,118,9,1,372,0,4,376
16,1,16035,567,3,28,38,93,1,2,162,1,0,163
16,1,16035,568,3,30,70,276,0,0,376,0,12,388
16,1,16035,569,3,45,87,157,0,2,291,1,3,295
16,1,16035,570,3,42,150,155,1,1,349,4,12,365
16,1,16035,571,3,54,97,202,10,6,369,0,6,375
16,1,16035,572,3,38,239,657,4,2,940,0,11,951
16,1,16035,573,3,32,287,329,3,1,652,0,6,658
16,1,16035,574,3,22,219,258,0,0,499,0,11,510
16,1,16035,575,3,20,86,159,0,1,266,0,0,266
16,1,16035,576,3,18,14,159,2,2,195,0,6,201
16,1,16035,577,3,40,149,330,10,3,532,2,15,549
16,1,16035,578,3,13,127,210,1,1,352,0,9,361
16,1,16035,579,3,18,176,158,0,0,352,0,7,359
16,1,16050,806,3,545,379,1524,168,74,2690,5,46,2741
16,1,16050,807,3,287,281,970,158,46,1742,2,11,1755
16,1,16050,808,3,159,131,588,68,30,976,5,9,990
16,1,16050,809,3,109,116,315,30,12,582,2,10,594
16,1,16050,810,3,138,97,323,43,21,622,2,7,631
16,1,16050,811,3,247,186,396,62,42,933,1,8,942
16,1,16050,812,3,230,194,533,69,27,1053,3,9,1065
16,1,16050,813,3,434,343,914,102,64,1857,1,15,1873
16,1,16050,814,3,164,167,555,62,32,980,0,14,994
16,1,16050,815,3,184,174,532,86,13,989,0,12,1001
16,1,16050,816,3,95,75,314,20,19,523,1,11,535
16,1,16050,817,3,128,131,397,27,10,693,1,28,722
16,1,16050,818,3,93,142,359,24,23,641,1,7,649
16,1,16050,819,3,135,111,288,31,21,586,1,10,597
16,1,16050,820,3,228,157,438,71,20,914,3,15,932
16,1,16050,821,3,183,141,641,70,25,1060,5,19,1084
16,1,16050,822,3,137,165,542,61,32,937,4,10,951
16,1,16050,823,3,278,221,572,73,46,1190,2,16,1208
16,1,16050,824,3,124,114,309,29,10,586,1,12,599
16,1,16050,825,3,150,266,559,40,21,1036,1,21,1058
16,1,16050,826,3,154,242,387,34,12,829,0,8,837
16,1,16050,827,3,127,141,335,28,13,644,2,15,661
16,1,16050,828,3,248,299,755,67,23,1392,0,15,1407
16,1,16050,829,3,96,253,275,29,11,664,0,18,682
16,1,16050,830,3,29,29,98,1,1,158,0,7,165
16,1,16050,831,3,27,160,164,1,1,353,0,4,357
16,1,16050,832,3,311,212,338,12,7,880,0,27,907
16,1,16050,833,3,61,51,84,4,5,205,3,10,218
16,1,16050,834,3,75,131,505,16,4,731,0,11,742
16,1,16050,835,3,119,100,536,14,16,785,2,20,807
16,1,16050,836,3,86,103,554,27,12,782,0,23,805
16,1,16050,837,3,151,112,537,15,30,845,5,19,869
16,1,16050,838,3,81,93,317,18,23,532,1,9,542
16,1,16050,839,3,115,121,526,35,20,817,1,14,832
16,1,16050,840,3,132,103,459,42,24,760,0,8,768
16,1,16050,841,3,120,207,830,42,54,1253,4,32,1289
16,1,16050,842,3,98,160,499,26,50,833,4,22,859
16,1,16050,843,3,41,117,235,14,16,423,0,12,435
16,1,16050,844,3,68,137,634,18,8,865,5,16,886
16,1,16050,845,3,61,116,569,37,9,792,2,19,813
16,1,16050,846,3,64,131,569,33,23,820,0,11,831
16,1,16050,847,3,92,128,560,32,15,827,2,13,842
16,1,16050,848,3,91,117,508,43,23,782,3,20,805
16,1,16050,849,3,111,183,873,41,19,1227,4,23,1254
16,1,16050,850,3,116,148,599,52,14,929,2,4,935
16,1,16050,851,3,128,208,700,55,27,1118,0,22,1140
16,1,16050,852,3,112,175,568,59,27,941,5,11,957
16,1,16050,853,3,55,157,527,30,14,783,1,12,796
16,1,16050,854,3,63,118,572,48,18,819,2,13,834
16,1,16050,855,3,78,117,435,27,22,679,1,22,702
16,1,16050,856,3,92,125,571,33,26,847,4,14,865
16,1,16050,857,3,191,156,265,25,15,652,0,11,663
16,1,16050,858,3,144,182,780,49,34,1189,3,31,1223
16,1,16050,859,3,99,192,727,40,26,1084,0,16,1100
16,1,16050,860,3,207,246,1188,77,56,1774,7,51,1832
16,1,16050,861,3,26,67,169,4,5,271,0,5,276
16,1,16050,862,3,59,70,443,8,11,591,1,1,593
16,1,16050,863,3,118,153,715,24,14,1024,0,23,1047
16,1,16050,864,3,18,52,160,13,3,246,0,4,250
16,1,16050,865,3,69,194,583,49,22,917,1,20,938
16,1,16050,866,3,126,84,162,34,17,423,0,3,426
16,1,16050,867,3,145,81,162,22,21,431,0,4,435
16,1,16050,868,3,458,422,1739,126,76,2821,17,55,2893
16,1,16050,869,3,70,107,270,14,13,474,0,7,481
16,1,16050,870,3,37,108,293,11,21,470,5,7,482
16,1,16056,1297,3,51,121,156,9,3,340,0,8,348
16,1,16056,1298,3,96,274,383,22,11,786,1,21,808
16,1,16056,1299,3,84,231,248,20,6,589,0,10,599
16,1,16056,1300,3,69,224,292,21,5,611,3,12,626
16,1,16056,1301,3,86,168,226,25,8,513,0,9,522
16,1,16056,1302,3,77,125,391,32,13,638,2,14,654
16,1,16056,1303,3,80,121,404,36,5,646,4,20,670
16,1,16056,1304,3,60,107,359,23,3,552,0,16,568
16,1,16056,1305,3,117,220,341,22,6,706,0,23,729
16,1,16056,1306,3,50,130,287,22,2,491,1,11,503
16,1,16056,1307,3,77,190,336,14,12,629,0,18,647
16,1,16056,1308,3,130,271,446,28,18,893,2,22,917
16,1,16056,1309,3,52,160,227,17,8,464,1,12,477
16,1,16056,1310,3,57,202,275,36,7,577,3,15,595
16,1,16056,1311,3,42,148,212,8,5,415,0,15,430
16,1,16056,1312,3,28,168,250,15,4,465,2,3,470
16,1,16056,1313,3,52,172,357,31,6,618,0,10,628
16,1,16056,1314,3,14,50,188,3,3,258,0,0,258
16,1,16056,1315,3,78,186,483,15,4,766,1,11,778
16,1,16056,1316,3,49,97,303,10,4,463,0,27,490
16,1,16056,1317,3,61,67,289,5,1,423,0,16,439
16,1,16056,1318,3,35,206,403,8,5,657,2,12,671
16,1,16056,1319,3,9,103,265,11,3,391,1,2,394
16,1,16056,1320,3,19,44,154,3,3,223,0,19,242
16,1,16060,1360,3,76,186,513,9,4,788,1,16,805
16,1,16060,1361,3,51,127,146,8,1,333,0,3,336
16,1,16060,1362,3,33,71,147,2,0,253,0,1,254
16,1,16060,1363,3,41,64,173,3,1,282,0,2,284
16,1,16060,1364,3,21,42,321,9,8,401,1,15,417
16,1,16060,1365,3,21,9,130,1,0,161,0,1,162
16,1,16060,1366,3,37,24,208,2,5,276,0,7,283
16,1,16060,1367,3,13,35,103,4,2,157,0,3,160
16,1,16060,1368,3,12,9,67,0,0,88,0,4,92
16,1,16097,2065,3,34,182,411,2,0,629,0,4,633
16,1,16097,2066,3,25,127,297,6,4,459,0,5,464
16,1,16097,2067,3,3,46,307,0,0,356,0,4,360
16,1,16097,2068,3,24,390,364,1,2,781,0,12,793
16,1,16097,2069,3,4,35,44,0,1,84,0,1,85
16,1,16097,2070,3,2,4,46,0,0,52,0,1,53
16,1,16097,2071,3,21,112,196,1,1,331,0,11,342
16,1,16097,2072,3,6,22,54,1,1,84,0,1,85
16,1,16097,2073,3,0,1,40,0,0,41,0,3,44
16,1,16097,2074,3,3,18,135,0,0,156,0,0,156
16,1,16035,2666,3,17,8,108,0,0,133,0,0,133
16,1,16035,2667,3,46,45,26,0,0,117,0,9,126
16,1,16035,2668,3,5,74,174,1,0,254,0,4,258
16,1,16035,2669,3,26,84,240,2,2,354,0,7,361
16,1,16035,2670,3,14,99,193,1,2,309,0,6,315
16,2,16003,26,3,448,216,259,42,22,987,15,28,1030
16,2,16003,27,3,220,171,199,15,6,611,5,20,636
16,2,16003,28,3,277,162,287,25,13,764,5,43,812
16,2,16003,29,3,143,56,132,5,6,342,2,11,355
16,2,16003,30,3,95,141,175,4,7,422,0,6,428
16,2,16003,31,3,153,245,234,4,5,641,0,18,659
16,2,16003,32,3,138,187,262,8,9,604,8,25,637
16,2,16003,33,3,108,145,174,9,4,440,9,6,455
16,2,16003,34,3,174,113,235,10,3,535,1,12,548
16,2,16003,35,3,80,145,278,8,2,513,4,10,527
16,2,16003,36,3,227,55,156,11,4,453,1,14,468
16,2,16003,37,3,42,123,112,2,2,281,1,4,286
16,2,16004,38,3,76,155,176,12,7,426,1,6,433
16,2,16004,39,3,118,185,179,11,5,498,0,10,508
16,2,16004,40,3,109,143,167,6,4,429,4,6,439
16,2,16004,41,3,116,169,300,6,10,601,0,5,606
16,2,16004,42,3,34,95,155,0,2,286,1,3,290
16,2,16004,43,3,86,140,192,5,6,429,0,5,434
16,2,16004,44,3,26,70,97,2,0,195,4,7,206
16,2,16004,45,3,54,251,451,4,1,761,3,10,774
16,2,16004,46,3,20,192,131,0,0,343,1,4,348
16,2,16004,47,3,2,18,22,0,0,42,0,0,42
16,2,16004,48,3,7,95,96,0,0,198,1,7,206
16,2,16004,49,3,17,24,156,1,2,200,0,9,209
16,2,16004,50,3,13,164,131,3,1,312,0,6,318
16,2,16004,51,3,41,193,200,4,3,441,2,13,456
16,2,16018,299,3,47,124,94,3,4,272,2,14,288
16,2,16018,300,3,74,149,120,3,7,353,1,20,374
16,2,16018,301,3,116,180,192,9,4,501,0,23,524
16,2,16018,302,3,81,172,192,4,8,457,3,9,469
16,2,16018,303,3,88,98,275,5,10,476,6,11,493
16,2,16018,304,3,65,197,155,14,2,433,1,11,445
16,2,16020,324,3,342,174,398,29,22,965,11,22,998
16,2,16020,325,3,133,71,145,16,14,379,2,11,392
16,2,16020,326,3,202,94,139,17,16,468,1,24,493
16,2,16020,327,3,165,89,178,14,13,459,3,14,476
16,2,16020,328,3,133,72,278,8,11,502,5,14,521
16,2,16020,329,3,211,84,145,17,13,470,4,19,493
16,2,16020,330,3,77,50,121,5,6,259,2,13,274
16,2,16020,331,3,203,67,129,6,14,419,3,12,434
16,2,16020,332,3,93,107,89,6,5,300,2,18,320
16,2,16020,333,3,112,136,230,8,10,496,2,17,515
16,2,16020,334,3,38,26,15,2,0,81,0,1,82
16,2,16020,335,3,105,35,169,15,15,339,5,14,358
16,2,16020,336,3,107,51,128,12,5,303,2,12,317
16,2,16020,337,3,324,155,229,82,14,804,4,46,854
16,2,16020,338,3,218,106,181,113,13,631,11,29,671
16,2,16020,339,3,279,118,198,17,6,618,3,19,640
16,2,16027,405,3,101,89,139,11,2,342,5,16,363
16,2,16027,406,3,67,94,110,18,7,296,3,14,313
16,2,16027,407,3,74,97,200,10,4,385,1,11,397
16,2,16027,408,3,40,140,121,2,1,304,3,13,320
16,2,16027,409,3,87,97,184,7,3,378,3,20,401
16,2,16027,410,3,22,17,180,0,1,220,1,7,228
16,2,16028,411,3,127,132,146,10,13,428,4,6,438
16,2,16028,412,3,112,75,255,8,7,457,1,7,465
16,2,16028,413,3,113,91,169,8,10,391,2,5,398
16,2,16028,414,3,69,28,371,8,7,483,0,14,497
16,2,16028,415,3,10,4,26,0,0,40,0,0,40
16,2,16028,416,3,36,79,98,7,2,222,1,7,230
16,2,16028,417,3,23,7,244,0,2,276,0,5,281
16,2,16028,418,3,11,29,173,1,0,214,0,1,215
16,2,16028,419,3,22,45,45,0,0,112,0,1,113
16,2,16036,580,3,123,85,121,12,6,347,1,16,364
16,2,16036,581,3,146,166,149,8,7,476,0,12,488
16,2,16036,582,3,109,79,102,7,4,301,1,15,317
16,2,16036,583,3,151,81,127,11,7,377,1,6,384
16,2,16036,584,3,192,126,234,14,7,573,3,15,591
16,2,16036,585,3,129,65,101,6,7,308,2,4,314
16,2,16036,586,3,151,182,176,6,8,523,2,15,540
16,2,16036,587,3,108,67,106,6,3,290,1,12,303
16,2,16036,588,3,222,126,167,11,2,528,1,24,553
16,2,16036,589,3,202,168,231,22,15,638,3,23,664
16,2,16037,590,3,54,50,124,12,2,242,0,7,249
16,2,16037,591,3,44,51,79,9,4,187,5,0,192
16,2,16037,592,3,71,108,289,16,3,487,3,16,506
16,2,16037,593,3,49,90,173,3,9,324,2,6,332
16,2,16037,594,3,19,9,209,2,1,240,1,7,248
16,2,16037,595,3,12,9,154,3,1,179,0,6,185
16,2,16037,596,3,13,11,183,1,0,208,2,4,214
16,2,16037,597,3,17,15,147,1,2,182,0,6,188
16,2,16037,598,3,54,42,246,4,5,351,2,11,364
16,2,16037,599,3,21,7,250,1,0,279,0,15,294
16,2,16037,600,3,28,27,209,1,1,266,1,5,272
16,2,16044,712,3,185,149,218,15,13,580,2,22,604
16,2,16044,713,3,116,99,147,11,12,385,1,12,398
16,2,16044,714,3,192,149,211,18,12,582,3,16,601
16,2,16044,715,3,92,89,224,5,7,417,5,17,439
16,2,16044,716,3,102,88,261,6,5,462,2,12,476
16,2,16044,717,3,84,58,258,2,3,405,3,13,421
16,2,16044,718,3,47,102,74,1,1,225,1,11,237
16,2,16044,719,3,60,111,83,1,3,258,5,11,274
16,2,16044,720,3,30,115,18,1,1,165,0,10,175
16,2,16044,721,3,11,14,178,1,3,207,2,5,214
16,2,16044,722,3,118,120,245,15,5,503,4,15,522
16,2,16044,723,3,56,126,159,3,6,350,1,5,356
16,2,16044,724,3,38,24,71,6,1,140,0,2,142
16,2,16044,725,3,25,26,63,1,0,115,3,2,120
16,2,16046,756,3,348,63,195,11,4,621,0,13,634
16,2,16046,757,3,182,49,121,2,4,358,0,14,372
16,2,16046,758,3,362,163,437,8,4,974,1,19,994
16,2,16046,759,3,275,127,194,7,3,606,0,11,617
16,2,16046,760,3,367,235,301,12,7,922,1,15,938
16,2,16046,761,3,121,159,529,14,3,826,0,7,833
16,2,16046,762,3,117,199,312,8,4,640,0,9,649
16,2,16046,763,3,90,85,226,9,1,411,1,7,419
16,2,16046,764,3,148,153,375,2,2,680,0,4,684
16,2,16046,765,3,98,154,339,12,3,606,1,3,610
16,2,16046,766,3,128,151,316,10,3,608,0,7,615
16,2,16046,767,3,12,21,71,2,1,107,0,1,108
16,2,16046,768,3,84,48,102,1,3,238,0,0,238
16,2,16046,769,3,77,264,175,14,8,538,1,14,553
16,2,16046,770,3,121,279,395,4,3,802,1,8,811
16,2,16046,771,3,57,265,162,1,0,485,0,6,491
16,2,16046,772,3,65,171,293,5,6,540,0,10,550
16,2,16046,773,3,73,20,215,3,1,312,2,10,324
16,2,16055,1288,3,204,50,137,5,4,400,1,9,410
16,2,16055,1289,3,231,127,178,6,8,550,1,20,571
16,2,16055,1290,3,170,59,69,2,0,300,3,17,320
16,2,16055,1291,3,69,36,46,2,1,154,1,7,162
16,2,16055,1292,3,154,117,74,8,7,360,5,16,381
16,2,16055,1293,3,149,95,120,10,2,376,0,13,389
16,2,16055,1294,3,40,113,139,5,1,298,0,15,313
16,2,16055,1295,3,56,81,130,1,4,272,0,9,281
16,2,16055,1296,3,61,62,69,1,3,196,2,4,202
16,2,16061,1369,3,208,194,339,12,4,757,0,4,761
16,2,16061,1370,3,277,266,425,24,6,998,0,19,1017
16,2,16061,1371,3,13,12,40,1,0,66,0,2,68
16,2,16061,1372,3,11,37,37,0,0,85,0,1,86
16,2,16061,1373,3,157,149,278,4,3,591,0,15,606
16,2,16061,1374,3,77,78,67,3,0,225,1,1,227
16,2,16061,1375,3,55,86,95,4,6,246,1,5,252
16,2,16061,1376,3,63,98,141,3,1,306,0,2,308
16,2,16061,1377,3,24,154,110,8,3,299,1,12,312
16,2,16064,1407,3,13,26,34,0,0,73,0,0,73
16,2,16064,1408,3,23,43,29,1,1,97,0,8,105
16,2,16064,1409,3,69,190,135,7,4,405,2,8,415
16,2,16064,1410,3,39,166,53,2,3,263,5,10,278
16,2,16064,1411,3,118,160,90,13,13,394,0,8,402
16,2,16064,1412,3,90,136,160,5,4,395,4,3,402
16,2,16064,1413,3,133,166,157,8,6,470,6,17,493
16,2,16064,1414,3,92,152,80,8,4,336,0,10,346
16,2,16064,1415,3,61,59,60,0,0,180,6,11,197
16,2,16064,1416,3,4,25,29,0,0,58,0,3,61
16,2,16064,1417,3,44,73,186,1,8,312,2,16,330
16,2,16064,1418,3,28,45,102,3,3,181,0,2,183
16,2,16064,1419,3,21,59,126,0,0,206,4,3,213
16,2,16064,1420,3,48,31,80,0,0,159,0,2,161
16,2,16064,1421,3,43,86,360,1,2,492,2,17,511
16,2,16064,1422,3,12,44,121,2,0,179,0,0,179
16,2,16064,1423,3,46,103,126,2,4,281,0,2,283
16,2,16064,1424,3,13,44,214,0,4,275,6,0,281
16,2,16064,1425,3,57,42,175,3,1,278,2,1,281
16,2,16068,1498,3,146,102,125,15,9,397,0,12,409
16,2,16068,1499,3,101,101,76,4,3,285,0,5,290
16,2,16068,1500,3,138,115,116,5,7,381,0,10,391
16,2,16068,1501,3,93,96,148,2,4,343,2,7,352
16,2,16068,1502,3,11,151,55,0,1,218,0,10,228
16,2,16068,1503,3,21,267,107,1,0,396,5,10,411
16,2,16068,1504,3,92,256,134,3,3,488,0,16,504
16,2,16068,1505,3,32,96,131,2,2,263,1,2,266
16,2,16068,1506,3,9,199,199,1,2,410,1,7,418
16,2,16068,1507,3,195,104,210,7,4,520,0,11,531
16,2,16068,1508,3,122,107,121,3,4,357,1,6,364
16,2,16068,1509,3,28,137,70,7,7,249,12,12,273
16,2,16068,1510,3,39,76,35,1,0,151,1,6,158
16,2,16068,1511,3,69,80,140,1,0,290,1,8,299
16,2,16068,1512,3,34,247,106,1,2,390,4,11,405
16,2,16068,1513,3,14,51,157,1,0,223,0,7,230
16,2,16068,1514,3,35,94,97,1,3,230,0,0,230
16,2,16068,1515,3,15,35,123,0,2,175,0,2,177
16,2,16068,1516,3,26,73,126,3,2,230,7,8,245
16,2,16072,1601,3,184,93,223,14,6,520,0,6,526
16,2,16072,1602,3,499,162,400,36,22,1119,0,15,1134
16,2,16072,1603,3,437,128,392,33,22,1012,0,15,1027
16,2,16072,1604,3,270,59,287,19,17,652,3,19,674
16,2,16072,1605,3,206,89,188,20,13,516,0,11,527
16,2,16072,1606,3,352,99,190,32,12,685,0,13,698
16,2,16072,1607,3,391,152,426,34,7,1010,1,21,1032
16,2,16072,1608,3,225,107,351,25,11,719,2,14,735
16,2,16072,1609,3,374,136,469,23,14,1016,3,35,1054
16,2,16072,1610,3,188,87,171,23,10,479,3,7,489
16,2,16072,1611,3,385,161,349,20,11,926,4,20,950
16,2,16072,1612,3,202,55,238,15,10,520,0,11,531
16,2,16072,1613,3,329,111,534,48,19,1041,3,28,1072
16,2,16072,1614,3,194,70,219,7,6,496,0,8,504
16,2,16072,1615,3,159,95,406,3,10,673,1,15,689
16,2,16072,1616,3,82,46,206,7,1,342,1,18,361
16,2,16072,1617,3,54,66,256,4,1,381,1,8,390
16,2,16072,1618,3,109,87,270,3,2,471,1,10,482
16,2,16072,1619,3,34,14,381,7,9,445,0,12,457
16,2,16072,1620,3,61,69,247,3,11,391,0,9,400
16,2,16072,1621,3,134,29,88,2,6,259,0,7,266
16,2,16072,1622,3,105,9,70,2,4,190,0,7,197
16,2,16072,1623,3,82,30,379,4,2,497,3,8,508
16,2,16072,1624,3,118,67,515,9,10,719,5,18,742
16,2,16072,1625,3,212,191,469,13,7,892,0,35,927
16,2,16072,1626,3,30,12,439,3,1,485,1,3,489
16,2,16072,1627,3,7,19,179,1,1,207,0,2,209
16,2,16072,1628,3,26,72,229,0,1,328,3,3,334
16,2,16072,1629,3,110,105,191,5,0,411,7,11,429
16,2,16072,1630,3,18,4,195,2,2,221,1,8,230
16,2,16072,1631,3,35,28,219,9,2,293,0,8,301
16,2,16072,1632,3,82,59,312,3,11,467,0,14,481
16,2,16072,1633,3,65,89,85,1,1,241,0,14,255
16,2,16072,1634,3,65,107,115,3,0,290,1,8,299
16,2,16072,1635,3,163,164,273,5,3,608,4,20,632
16,2,16072,1636,3,55,190,107,3,3,358,0,11,369
16,2,16072,1637,3,109,86,398,6,6,605,1,11,617
16,2,16072,1638,3,400,77,209,15,13,714,4,15,733
16,2,16072,1639,3,58,13,82,5,1,159,2,5,166
16,2,16072,1640,3,176,41,88,9,3,317,2,12,331
16,2,16072,1641,3,70,186,187,6,7,456,2,9,467
16,2,16072,1642,3,32,76,92,1,2,203,2,5,210
16,2,16072,1643,3,20,8,182,2,5,217,0,1,218
16,2,16072,1644,3,38,45,163,7,2,255,2,9,266
16,2,16072,1645,3,84,57,106,4,2,253,0,17,270
16,2,16072,1646,3,233,167,119,7,6,532,11,36,579
16,2,16079,1788,3,105,46,118,9,4,282,2,6,290
16,2,16079,1789,3,190,162,187,17,11,567,0,10,577
16,2,16079,1790,3,220,302,215,36,6,779,2,26,807
16,2,16079,1791,3,338,240,195,40,14,827,2,26,855
16,2,16079,1792,3,206,117,152,9,6,490,3,13,506
16,2,16079,1793,3,177,33,77,9,3,299,0,11,310
16,2,16079,1794,3,9,14,19,1,0,43,0,4,47
16,2,16079,1795,3,144,63,107,12,3,329,0,17,346
16,2,16079,1796,3,47,51,139,2,3,242,0,4,246
16,2,16079,1797,3,154,41,52,1,9,257,0,10,267
16,2,16079,1798,3,47,29,145,1,3,225,1,14,240
16,2,16089,1959,3,236,170,135,12,2,555,0,24,579
16,2,16089,1960,3,309,175,141,13,8,646,2,17,665
16,2,16089,1961,3,228,156,162,14,3,563,2,20,585
16,2,16089,1962,3,36,254,290,4,3,587,6,10,603
16,2,16089,1963,3,65,83,425,19,6,598,1,19,618
16,2,16089,1964,3,88,64,120,16,0,288,3,9,300
16,2,16089,1965,3,194,161,234,17,10,616,5,19,640
16,2,16089,1966,3,143,278,299,21,15,756,4,32,792
16,2,16089,1967,3,283,224,579,29,15,1130,2,38,1170
16,2,16089,1968,3,32,39,220,2,0,293,1,7,301
16,2,16089,1969,3,38,67,233,37,4,379,1,20,400
16,2,16089,1970,3,17,240,104,0,1,362,1,13,376
16,2,16089,1971,3,278,287,255,27,19,866,11,34,911
16,2,16089,1972,3,143,209,140,20,5,517,4,5,526
16,2,16089,1973,3,98,115,69,3,2,287,3,8,298
16,2,16089,1974,3,205,193,196,23,6,623,9,25,657
16,2,16089,1975,3,102,177,336,6,7,628,0,17,645
16,2,16089,1976,3,1432,469,753,181,85,2920,5,44,2969
16,2,16089,1977,3,603,291,572,44,28,1538,7,31,1576
16,2,16089,1978,3,156,23,200,6,1,386,5,9,400
16,2,16095,2040,3,71,77,197,6,6,357,2,7,366
16,2,16095,2041,3,49,63,130,2,1,245,0,4,249
16,2,16095,2042,3,35,133,106,4,5,283,0,4,287
16,2,16095,2043,3,72,93,164,1,5,335,2,6,343
16,2,16095,2044,3,51,167,263,8,5,494,1,7,502
16,2,16095,2045,3,54,74,47,1,2,178,0,4,182
16,2,16095,2046,3,69,64,38,6,1,178,0,4,182
16,2,16095,2047,3,14,21,60,1,1,97,0,1,98
16,2,16095,2048,3,19,38,208,2,0,267,1,7,275
16,2,16095,2049,3,31,45,151,1,1,229,0,0,229
16,2,16095,2050,3,21,42,174,1,7,245,0,6,251
16,2,16095,2051,3,13,58,212,0,0,283,0,0,283
16,2,16110,2531,3,92,113,70,3,8,286,2,8,296
16,2,16110,2532,3,109,123,106,4,2,344,1,7,352
16,2,16110,2533,3,29,71,75,2,2,179,0,5,184
16,2,16110,2534,3,7,23,85,0,1,116,0,2,118
16,2,16110,2535,3,47,46,32,0,0,125,0,3,128
16,2,16110,2536,3,35,86,103,1,2,227,2,0,229
16,2,16110,2537,3,18,109,125,1,0,253,0,8,261
16,3,16005,52,3,151,220,124,22,3,520,1,14,535
16,3,16005,53,3,76,220,121,11,10,438,0,14,452
16,3,16005,54,3,82,254,86,14,13,449,0,19,468
16,3,16005,55,3,268,398,342,29,9,1046,3,33,1082
16,3,16005,56,3,63,129,311,5,2,510,0,17,527
16,3,16005,57,3,171,344,366,24,12,917,4,44,965
16,3,16007,132,3,96,220,190,10,5,521,0,14,535
16,3,16007,133,3,110,169,161,4,4,448,0,18,466
16,3,16007,134,3,12,45,62,0,0,119,0,4,123
16,3,16007,135,3,29,70,97,1,1,198,0,5,203
16,3,16022,346,3,516,237,311,27,35,1126,4,10,1140
16,3,16022,347,3,541,253,328,24,20,1166,5,41,1212
16,3,16022,348,3,218,118,208,21,3,568,13,12,593
16,3,16022,349,3,360,112,154,9,11,646,4,19,669
16,3,16022,350,3,163,57,86,3,2,311,0,8,319
16,3,16022,351,3,341,97,178,12,4,632,6,8,646
16,3,16022,352,3,197,64,99,1,9,370,0,14,384
16,3,16022,353,3,158,40,135,6,5,344,6,9,359
16,3,16022,354,3,108,36,18,3,2,167,2,4,173
16,3,16022,355,3,53,34,43,2,1,133,5,3,141
16,3,16022,356,3,102,37,57,4,4,204,0,8,212
16,3,16022,357,3,59,26,42,4,3,134,8,4,146
16,3,16022,358,3,72,47,62,2,2,185,4,1,190
16,3,16022,359,3,122,73,151,3,3,352,1,10,363
16,3,16022,360,3,61,53,56,4,3,177,2,10,189
16,3,16040,651,3,362,221,377,20,22,1002,2,26,1030
16,3,16040,652,3,191,171,237,15,16,630,3,27,660
16,3,16040,653,3,173,205,167,9,6,560,8,22,590
16,3,16040,654,3,206,112,211,19,10,558,9,25,592
16,3,16040,655,3,106,159,109,13,7,394,5,17,416
16,3,16040,656,3,67,24,168,4,3,266,0,5,271
16,3,16040,657,3,52,26,124,0,3,205,1,8,214
16,3,16040,658,3,44,49,64,2,1,160,5,4,169
16,3,16040,659,3,98,220,406,12,6,742,6,20,768
16,3,16040,660,3,44,101,97,4,2,248,5,17,270
16,3,16040,661,3,8,55,27,0,0,90,1,2,93
16,3,16040,662,3,55,67,25,1,1,149,0,3,152
16,3,16040,663,3,22,18,3,0,0,43,0,0,43
16,3,16040,664,3,18,22,29,1,1,71,5,1,77
16,3,16047,774,3,97,253,328,6,9,693,3,23,719
16,3,16047,775,3,75,318,263,22,5,683,2,10,695
16,3,16047,776,3,45,64,106,6,3,224,1,5,230
16,3,16047,777,3,69,93,225,0,3,390,3,2,395
16,3,16047,778,3,50,110,62,5,1,228,1,7,236
16,3,16047,779,3,29,74,122,1,4,230,2,9,241
16,3,16047,780,3,17,61,129,5,4,216,3,5,224
16,3,16047,781,3,10,86,19,0,0,115,2,2,119
16,3,16047,782,3,23,108,48,1,2,182,0,8,190
16,3,16047,783,3,49,134,222,3,2,410,2,7,419
16,3,16047,784,3,82,315,565,6,5,973,0,24,997
16,3,16047,785,3,43,73,128,0,1,245,1,11,257
16,3,16048,786,3,86,221,198,14,9,528,0,13,541
16,3,16048,787,3,112,277,388,14,5,796,1,18,815
16,3,16048,788,3,134,348,355,4,5,846,3,21,870
16,3,16048,789,3,7,66,179,1,4,257,0,0,257
16,3,16048,790,3,65,206,402,18,4,695,4,26,725
16,3,16048,791,3,38,151,273,5,3,470,4,5,479
16,3,16048,792,3,55,192,190,5,3,445,1,25,471
16,3,16048,793,3,49,133,256,1,1,440,0,7,447
16,3,16048,794,3,10,60,72,0,0,142,1,2,145
16,3,16048,795,3,7,75,131,2,0,215,0,1,216
16,3,16048,796,3,19,170,172,2,5,368,2,8,378
16,3,16048,797,3,15,65,216,0,1,297,1,4,302
16,3,16048,798,3,6,110,143,1,0,260,0,2,262
16,3,16048,799,3,11,120,193,0,3,327,1,8,336
16,3,16048,800,3,8,50,283,0,0,341,0,7,348
16,3,16048,801,3,6,21,25,0,0,52,0,1,53
16,3,16062,1378,3,137,195,247,35,8,622,0,24,646
16,3,16062,1379,3,188,235,246,52,10,731,2,16,749
16,3,16062,1380,3,14,92,192,4,4,306,1,13,320
16,3,16062,1381,3,84,153,389,38,3,667,0,20,687
16,3,16062,1382,3,24,57,97,0,4,182,0,4,186
16,3,16062,1383,3,80,192,340,23,7,642,1,22,665
16,3,16062,1384,3,116,147,473,5,2,743,4,25,772
16,3,16062,1385,3,99,109,511,10,2,731,2,49,782
16,3,16062,1386,3,102,203,337,14,3,659,2,36,697
16,3,16062,1387,3,40,120,167,8,6,341,3,23,367
16,3,16062,1388,3,98,253,262,19,3,635,2,32,669
16,3,16082,1832,3,49,226,161,3,3,442,0,13,455
16,3,16082,1833,3,19,231,179,1,0,430,0,20,450
16,3,16082,1834,3,18,147,309,1,0,475,0,13,488
16,3,16082,1835,3,19,87,84,0,1,191,0,2,193
16,3,16082,1836,3,37,292,363,1,2,695,1,8,704
16,3,16082,1837,3,14,39,52,0,0,105,0,4,109
16,3,16082,1838,3,0,34,3,0,0,37,0,0,37
16,3,16082,1839,3,11,82,228,1,1,323,1,10,334
16,3,16082,1840,3,6,64,46,0,0,116,0,3,119
16,3,16082,1841,3,4,117,60,0,0,181,0,5,186
16,3,16082,1842,3,6,11,9,0,0,26,0,1,27
16,3,16082,1843,3,8,20,90,3,2,123,0,5,128
16,3,16093,2013,3,28,254,234,5,4,525,0,4,529
16,3,16093,2014,3,73,358,305,10,5,751,0,7,758
16,3,16093,2015,3,15,71,145,0,2,233,0,4,237
16,3,16093,2016,3,1,13,44,0,0,58,0,1,59
16,3,16093,2017,3,23,217,214,1,0,455,0,2,457
16,3,16093,2018,3,21,155,250,1,3,430,2,3,435
16,3,16093,2019,3,67,270,101,4,1,443,1,20,464
16,3,16093,2020,3,20,104,187,0,1,312,0,6,318
16,3,16093,2021,3,13,133,65,1,2,214,0,0,214
16,3,16093,2022,3,41,158,207,1,0,407,0,14,421
16,3,16093,2023,3,6,50,254,0,0,310,0,2,312
16,3,16093,2024,3,28,78,105,0,2,213,0,10,223
16,3,16099,2113,3,168,205,175,7,10,565,4,26,595
16,3,16099,2114,3,179,207,236,21,15,658,1,16,675
16,3,16099,2115,3,205,263,183,20,14,685,3,21,709
16,3,16099,2116,3,293,281,382,41,12,1009,6,25,1040
16,3,16099,2117,3,170,247,198,20,10,645,1,13,659
16,3,16099,2118,3,260,376,369,21,18,1044,1,34,1079
16,3,16099,2119,3,128,115,336,14,8,601,9,14,624
16,3,16099,2120,3,36,24,203,6,1,270,5,10,285
16,3,16099,2121,3,159,65,123,12,8,367,0,11,378
16,3,16099,2122,3,82,183,97,4,8,374,0,17,391
16,3,16099,2123,3,206,189,225,12,10,642,5,22,669
16,3,16099,2124,3,36,48,45,2,1,132,1,6,139
16,3,16099,2125,3,69,121,85,1,6,282,0,12,294
16,3,16099,2126,3,83,84,70,1,2,240,0,13,253
16,3,16099,2127,3,63,177,146,4,6,396,0,6,402
16,3,16099,2128,3,11,51,49,0,0,111,0,3,114
16,3,16099,2129,3,20,49,25,0,0,94,0,4,98
16,3,16100,2130,3,74,207,169,6,2,458,0,5,463
16,3,16100,2131,3,108,258,352,8,3,729,4,18,751
16,3,16100,2132,3,13,38,217,0,0,268,0,2,270
16,3,16100,2133,3,34,161,308,8,1,512,0,7,519
16,3,16100,2134,3,13,85,202,1,4,305,1,8,314
16,3,16100,2135,3,11,122,168,12,1,314,0,8,322
16,3,16100,2136,3,23,113,177,0,1,314,0,1,315
16,3,16100,2137,3,9,71,65,1,0,146,0,3,149
16,3,16100,2138,3,38,71,154,1,1,265,1,5,271
16,3,16100,2139,3,30,112,251,3,0,396,1,5,402
16,3,16100,2140,3,11,61,227,0,0,299,0,5,304
16,3,16100,2141,3,39,90,238,3,0,370,0,4,374
16,3,16100,2142,3,13,125,71,1,0,210,0,1,211
16,3,16100,2143,3,4,3,25,0,0,32,0,2,34
16,3,16100,2144,3,25,43,78,3,0,149,0,4,153
16,3,16100,2145,3,4,42,61,0,0,107,1,0,108
16,3,16100,2146,3,73,205,331,3,2,614,1,4,619
16,3,16100,2147,3,8,13,202,0,0,223,0,2,225
16,3,16100,2148,3,9,28,26,0,2,65,0,1,66
16,3,16100,2149,3,20,82,16,2,1,121,0,1,122
16,3,16100,2150,3,33,11,35,1,0,80,0,0,80
16,3,16102,2160,3,46,83,87,4,0,220,2,9,231
16,3,16102,2161,3,109,107,86,2,1,305,0,8,313
16,3,16102,2162,3,8,57,20,0,0,85,0,6,91
16,3,16102,2163,3,11,51,31,1,0,94,0,1,95
16,3,16102,2164,3,28,44,27,0,0,99,0,7,106
16,3,16102,2165,3,25,21,18,0,0,64,0,0,64
16,3,16102,2166,3,94,131,124,1,1,351,0,10,361
16,3,16102,2167,3,13,26,38,0,1,78,0,4,82
16,3,16102,2168,3,57,154,118,2,3,334,3,15,352
16,3,16102,2169,3,133,212,164,9,3,521,5,27,553
16,3,16102,2170,3,112,124,121,2,1,360,0,5,365
16,3,16102,2171,3,34,74,79,3,3,193,0,7,200
16,3,16102,2172,3,30,45,48,0,1,124,1,13,138
16,3,16102,2173,3,23,95,39,0,0,157,0,3,160
16,3,16102,2174,3,18,9,37,1,0,65,0,0,65
16,3,16113,2578,3,147,181,154,23,15,520,2,25,547
16,3,16113,2579,3,260,412,128,34,9,843,3,33,879
16,3,16113,2580,3,176,243,98,31,3,551,3,29,583
16,3,16113,2581,3,157,248,112,31,8,556,3,8,567
16,3,16113,2582,3,213,235,99,32,3,582,3,15,600
16,3,16113,2583,3,285,363,172,69,18,907,1,27,935
16,3,16113,2584,3,242,362,213,29,17,863,12,24,899
16,3,16113,2585,3,475,346,406,47,23,1297,5,60,1362
16,3,16113,2586,3,150,252,115,44,10,571,0,22,593
16,3,16113,2587,3,248,253,150,52,12,715,5,15,735
16,3,16113,2588,3,249,404,128,45,14,840,0,39,879
16,3,16113,2589,3,191,307,119,41,12,670,6,20,696
16,3,16113,2590,3,147,204,83,40,10,484,0,12,496
16,3,16113,2591,3,160,404,107,22,10,703,0,18,721
16,3,16113,2592,3,190,343,235,34,15,817,1,27,845
16,3,16113,2593,3,148,239,153,37,11,588,2,29,619
16,3,16113,2594,3,229,213,265,20,14,741,3,22,766
16,3,16113,2595,3,146,142,159,35,5,487,5,26,518
16,3,16113,2596,3,107,209,111,17,6,450,2,9,461
16,3,16113,2597,3,110,177,143,33,11,474,0,29,503
16,3,16113,2598,3,127,261,157,27,10,582,2,18,602
16,3,16113,2599,3,188,337,165,34,13,737,0,27,764
16,3,16113,2600,3,176,254,110,38,11,589,1,18,608
16,3,16113,2601,3,113,186,93,46,6,444,6,13,463
16,3,16113,2602,3,202,183,177,52,17,631,0,24,655
16,3,16113,2603,3,209,270,189,36,15,719,3,26,748
16,3,16113,2604,3,155,196,120,42,10,523,1,23,547
16,3,16113,2605,3,211,235,172,46,16,680,2,21,703
16,3,16113,2606,3,127,194,128,22,6,477,0,24,501
16,3,16113,2607,3,184,248,209,28,16,685,3,27,715
16,3,16113,2608,3,127,181,151,16,8,483,4,9,496
16,3,16113,2609,3,142,378,190,72,13,795,1,16,812
16,3,16113,2610,3,287,417,248,54,21,1027,0,15,1042
16,3,16113,2611,3,106,138,131,37,6,418,2,24,444
16,3,16113,2612,3,93,179,112,35,10,429,5,8,442
16,3,16113,2613,3,218,241,200,45,15,719,4,28,751
16,3,16113,2614,3,160,163,143,16,6,488,2,21,511
16,3,16113,2615,3,139,232,124,50,16,561,0,17,578
16,3,16113,2616,3,151,207,128,14,12,512,1,36,549
16,3,16113,2617,3,89,142,123,24,5,383,0,13,396
16,3,16113,2618,3,115,117,176,27,9,444,1,6,451
16,3,16113,2619,3,125,155,181,57,8,526,4,10,540
16,3,16113,2620,3,163,237,299,35,15,749,4,29,782
16,3,16113,2621,3,26,128,49,1,2,206,4,4,214
16,3,16113,2622,3,176,394,275,10,8,863,17,43,923
16,3,16113,2623,3,127,212,172,12,8,531,5,23,559
16,3,16113,2624,3,8,32,0,0,0,40,0,3,43
16,3,16113,2625,3,30,181,261,7,0,479,0,38,517
16,3,16113,2626,3,73,217,243,3,5,541,5,46,592
16,3,16113,2627,3,50,90,37,0,0,177,2,23,202
16,3,16113,2628,3,99,163,349,10,8,629,4,36,669
16,3,16113,2629,3,217,343,424,27,6,1017,9,38,1064
16,3,16113,2630,3,86,176,203,11,6,482,5,8,495
16,3,16113,2631,3,92,129,191,6,1,419,5,15,439
16,3,16113,2632,3,111,194,156,6,7,474,10,19,503
16,3,16113,2633,3,43,98,106,4,2,253,2,15,270
16,3,16113,2634,3,35,168,225,4,4,436,0,4,440
16,3,16113,2635,3,68,169,156,1,2,396,1,38,435
16,3,16113,2636,3,133,177,217,6,7,540,2,33,575
16,3,16113,2637,3,125,273,162,20,6,586,10,11,607
16,3,16113,2638,3,225,421,335,32,10,1023,12,63,1098
16,3,16113,2639,3,134,252,200,19,8,613,2,23,638
16,3,16113,2640,3,177,468,398,18,15,1076,6,48,1130
16,3,16113,2641,3,156,216,355,9,8,744,2,25,771
16,3,16113,2642,3,146,198,334,11,6,695,5,57,757
16,3,16113,2643,3,220,305,397,21,34,977,4,35,1016
16,3,16113,2644,3,247,265,314,25,17,868,10,24,902
16,3,16113,2645,3,262,248,187,29,10,736,4,26,766
16,3,16113,2646,3,138,248,213,22,10,631,4,22,657
16,3,16113,2647,3,21,146,133,3,0,303,1,0,304
16,3,16113,2648,3,30,126,80,2,2,240,0,5,245
16,3,16113,2649,3,103,193,192,20,7,515,0,13,528
16,3,16113,2650,3,136,375,299,19,6,835,2,41,878
16,3,16113,2651,3,156,291,140,12,7,606,9,38,653
16,3,16113,2652,3,74,332,398,28,7,839,6,26,871
16,3,16113,2653,3,57,88,200,5,2,352,2,20,374
16,3,16113,2654,3,174,171,184,15,9,553,9,43,605
16,3,16113,2655,3,95,152,251,7,6,511,2,27,540
16,3,16113,2656,3,28,110,56,0,6,200,1,5,206
16,3,16113,2657,3,21,43,147,4,2,217,2,0,219
16,3,16113,2658,3,241,185,339,19,7,791,10,32,833
16,3,16113,2659,3,31,54,117,2,1,205,0,6,211
16,4,16011,184,3,148,182,203,16,6,555,1,15,571
16,4,16011,185,3,223,264,325,20,14,846,1,21,868
16,4,16011,186,3,97,86,139,5,4,331,2,7,340
16,4,16011,187,3,123,31,166,1,3,324,0,0,324
16,4,16011,188,3,154,180,338,26,5,703,10,17,730
16,4,16011,189,3,144,169,187,10,7,517,2,7,526
16,4,16019,305,3,162,27,112,2,2,305,1,9,315
16,4,16019,306,3,244,74,88,3,0,409,0,9,418
16,4,16019,307,3,334,117,265,11,5,732,1,12,745
16,4,16019,308,3,192,70,177,9,3,451,0,3,454
16,4,16019,309,3,236,108,87,4,5,440,0,5,445
16,4,16019,310,3,260,157,125,14,9,565,0,9,574
16,4,16019,311,3,368,77,129,9,6,589,0,7,596
16,4,16019,312,3,358,87,243,20,4,712,0,12,724
16,4,16019,313,3,524,67,123,16,8,738,0,13,751
16,4,16019,314,3,351,56,123,2,0,532,0,11,543
16,4,16019,315,3,173,19,92,2,2,288,1,0,289
16,4,16019,316,3,48,48,42,1,0,139,0,7,146
16,4,16019,317,3,21,88,34,0,0,143,0,2,145
16,4,16019,318,3,111,226,221,3,7,568,1,13,582
16,4,16019,319,3,105,69,60,5,0,239,3,7,249
16,4,16019,320,3,55,53,31,3,1,143,0,4,147
16,4,16019,321,3,136,103,152,4,1,396,0,13,409
16,4,16019,322,3,127,43,78,2,2,252,0,9,261
16,4,16019,323,3,52,18,3,0,1,74,0,3,77
16,4,16023,361,3,133,129,78,6,3,349,0,10,359
16,4,16023,362,3,185,136,47,3,1,372,0,6,378
16,4,16023,363,3,117,113,45,7,7,289,0,5,294
16,4,16023,364,3,75,113,181,10,10,389,0,11,400
16,4,16023,365,3,82,80,145,8,4,319,0,12,331
16,4,16023,366,3,140,63,87,12,0,302,0,6,308
16,4,16023,367,3,130,92,61,6,5,294,1,10,305
16,4,16023,368,3,81,67,103,5,2,258,0,10,268
16,4,16023,369,3,135,218,214,3,2,572,0,20,592
16,4,16023,370,3,24,113,81,4,3,225,0,5,230
16,4,16023,371,3,69,202,107,3,3,384,1,6,391
16,4,16043,685,3,235,171,113,16,7,542,3,8,553
16,4,16043,686,3,223,132,124,10,11,500,2,8,510
16,4,16043,687,3,350,144,198,21,13,726,1,13,740
16,4,16043,688,3,376,280,286,23,13,978,3,28,1009
16,4,16043,689,3,299,293,159,10,10,771,3,10,784
16,4,16043,690,3,296,277,151,17,10,751,0,13,764
16,4,16043,691,3,191,121,122,14,7,455,0,14,469
16,4,16043,692,3,196,172,217,15,14,614,2,12,628
16,4,16043,693,3,298,222,132,6,6,664,0,17,681
16,4,16043,694,3,190,128,91,2,3,414,0,5,419
16,4,16043,695,3,258,145,212,14,9,638,8,14,660
16,4,16043,696,3,172,150,167,10,17,516,0,31,547
16,4,16043,697,3,296,184,179,11,4,674,4,13,691
16,4,16043,698,3,360,216,216,10,8,810,3,22,835
16,4,16043,699,3,173,78,74,12,2,339,0,12,351
16,4,16043,700,3,152,103,110,5,5,375,4,13,392
16,4,16043,701,3,304,145,216,9,9,683,13,32,728
16,4,16043,702,3,223,151,129,8,4,515,3,12,530
16,4,16043,703,3,591,404,603,25,36,1659,26,34,1719
16,4,16043,704,3,193,106,152,11,4,466,3,0,469
16,4,16043,705,3,193,105,170,9,1,478,4,13,495
16,4,16043,706,3,165,61,172,5,5,408,1,14,423
16,4,16043,707,3,421,176,265,15,14,891,6,25,922
16,4,16043,708,3,478,226,392,21,15,1132,10,37,1179
16,4,16043,709,3,248,151,227,11,7,644,3,30,677
16,4,16043,710,3,148,156,248,7,8,567,6,7,580
16,4,16043,711,3,117,161,188,7,2,475,0,19,494
16,4,16045,726,3,89,49,161,9,3,311,0,0,311
16,4,16045,727,3,180,142,453,16,11,802,2,14,818
16,4,16045,728,3,214,115,298,10,11,648,0,9,657
16,4,16045,729,3,199,154,331,11,10,705,0,8,713
16,4,16045,730,3,145,126,257,12,6,546,2,12,560
16,4,16045,731,3,137,86,219,13,4,459,0,13,472
16,4,16045,732,3,78,54,135,5,4,276,2,8,286
16,4,16045,733,3,165,143,378,17,7,710,3,13,726
16,4,16045,734,3,228,173,346,14,9,770,0,2,772
16,4,16045,735,3,132,128,251,12,7,530,0,9,539
16,4,16045,736,3,166,97,253,14,9,539,0,11,550
16,4,16045,737,3,176,129,265,13,4,587,0,17,604
16,4,16045,738,3,202,206,362,15,18,803,2,23,828
16,4,16045,739,3,94,75,203,7,6,385,1,10,396
16,4,16045,740,3,68,83,201,9,5,366,0,6,372
16,4,16045,741,3,78,82,213,9,5,387,2,14,403
16,4,16045,742,3,204,117,352,12,9,694,0,24,718
16,4,16045,743,3,119,100,242,21,8,490,0,13,503
16,4,16045,744,3,362,193,395,30,11,991,0,12,1003
16,4,16045,745,3,45,63,207,1,3,319,0,9,328
16,4,16045,746,3,56,55,193,5,3,312,0,22,334
16,4,16045,747,3,217,69,198,13,8,505,1,6,512
16,4,16045,748,3,53,72,48,7,1,181,0,8,189
16,4,16045,749,3,31,24,47,1,1,104,0,10,114
16,4,16045,750,3,61,41,56,0,5,163,11,0,174
16,4,16045,751,3,65,68,297,10,2,442,0,9,451
16,4,16045,752,3,109,37,241,13,2,402,0,6,408
16,4,16045,753,3,28,19,19,0,0,66,1,5,72
16,4,16045,754,3,83,35,119,1,2,240,1,4,245
16,4,16045,755,3,24,21,6,1,1,53,0,4,57
16,4,16053,929,3,213,157,188,13,11,582,0,17,599
16,4,16053,930,3,361,182,271,25,19,858,1,19,878
16,4,16053,931,3,294,105,126,5,9,539,0,7,546
16,4,16053,932,3,284,109,154,12,7,566,1,6,573
16,4,16053,933,3,256,93,142,15,11,517,1,6,524
16,4,16053,934,3,203,71,146,16,4,440,0,5,445
16,4,16053,935,3,25,5,11,0,0,41,0,0,41
16,4,16053,936,3,98,65,44,3,4,214,0,2,216
16,4,16053,937,3,134,81,280,3,2,500,1,17,518
16,4,16053,938,3,73,22,54,3,1,153,0,3,156
16,4,16053,939,3,65,37,165,4,2,273,2,1,276
16,4,16053,940,3,34,22,28,3,0,87,1,1,89
16,4,16063,1389,3,140,36,117,7,3,303,0,11,314
16,4,16063,1390,3,206,84,173,5,6,474,1,11,486
16,4,16063,1391,3,285,120,149,7,5,566,2,5,573
16,4,16063,1392,3,189,101,173,6,4,473,0,1,474
16,4,16063,1393,3,140,63,144,13,2,362,2,4,368
16,4,16063,1394,3,202,152,187,4,2,547,1,13,561
16,4,16063,1395,3,219,140,158,8,6,531,1,14,546
16,4,16063,1396,3,246,140,143,6,1,536,2,9,547
16,4,16063,1397,3,83,37,114,1,0,235,1,0,236
16,4,16063,1398,3,85,37,93,6,1,222,0,10,232
16,4,16063,1399,3,96,12,82,0,0,190,0,7,197
16,4,16063,1400,3,136,17,63,5,4,225,1,3,229
16,4,16063,1401,3,115,60,176,8,3,362,3,5,370
16,4,16063,1402,3,111,38,160,8,0,317,0,7,324
16,4,16063,1403,3,98,33,117,0,3,251,0,6,257
16,4,16063,1404,3,202,36,90,6,0,334,0,0,334
16,4,16063,1405,3,212,44,58,2,4,320,0,14,334
16,4,16063,1406,3,136,53,45,1,0,235,1,7,243
16,4,16075,1675,3,117,116,127,14,5,379,0,5,384
16,4,16075,1676,3,91,137,119,25,6,378,1,6,385
16,4,16075,1677,3,111,63,112,117,3,406,0,2,408
16,4,16075,1678,3,102,65,217,19,2,405,1,9,415
16,4,16075,1679,3,112,85,355,21,3,576,2,15,593
16,4,16075,1680,3,158,75,329,27,1,590,9,11,610
16,4,16075,1681,3,35,53,219,7,2,316,3,13,332
16,4,16075,1682,3,61,66,199,20,3,349,0,1,350
16,4,16075,1683,3,49,48,251,9,0,357,1,12,370
16,4,16077,1719,3,200,44,95,6,3,348,0,9,357
16,4,16077,1720,3,276,105,179,16,6,582,3,14,599
16,4,16077,1721,3,260,119,205,27,4,615,1,26,642
16,4,16077,1722,3,137,92,98,7,2,336,0,0,336
16,4,16077,1723,3,194,127,106,11,0,438,0,15,453
16,4,16077,1724,3,264,121,97,7,2,491,0,32,523
16,4,16077,1725,3,343,86,108,12,6,555,0,11,566
16,4,16077,1726,3,393,154,179,10,4,740,0,16,756
16,4,16077,1727,3,288,61,82,14,8,453,1,15,469
16,4,16077,1728,3,394,74,70,4,5,547,0,5,552
16,4,16077,1729,3,267,87,119,5,5,483,0,5,488
16,4,16077,1730,3,281,86,83,7,3,460,0,4,464
16,4,16077,1731,3,358,127,153,11,5,654,0,25,679
16,4,16077,1732,3,374,145,154,12,1,686,0,4,690
16,4,16077,1733,3,376,137,134,8,4,659,0,11,670
16,4,16077,1734,3,437,123,118,11,2,691,0,3,694
16,4,16077,1735,3,309,75,67,8,5,464,0,8,472
16,4,16077,1736,3,286,75,67,5,3,436,0,2,438
16,4,16077,1737,3,317,86,107,12,7,529,0,12,541
16,4,16077,1738,3,475,113,169,14,10,781,0,23,804
16,4,16077,1739,3,144,59,40,11,4,258,4,2,264
16,4,16077,1740,3,230,65,107,4,5,411,1,10,422
16,4,16077,1741,3,106,62,80,5,2,255,0,4,259
16,4,16077,1742,3,259,80,119,7,6,471,0,12,483
16,4,16077,1743,3,217,65,96,3,0,381,1,5,387
16,4,16077,1744,3,262,79,107,7,2,457,0,13,470
16,4,16077,1745,3,317,95,98,10,3,523,0,7,530
16,4,16077,1746,3,357,109,103,8,3,580,0,12,592
16,4,16077,1747,3,326,109,106,8,3,552,1,8,561
16,4,16077,1748,3,348,139,159,8,5,659,1,11,671
16,4,16077,1749,3,289,104,210,15,3,621,0,8,629
16,4,16077,1750,3,324,106,191,15,8,644,1,7,652
16,4,16077,1751,3,226,90,224,16,5,561,1,18,580
16,4,16077,1752,3,263,102,124,8,10,507,1,7,515
16,4,16077,1753,3,225,70,225,12,2,534,0,14,548
16,4,16077,1754,3,298,94,165,12,3,572,1,11,584
16,4,16077,1755,3,306,151,77,7,3,544,0,8,552
16,4,16077,1756,3,303,130,128,9,6,576,0,6,582
16,4,16077,1757,3,228,63,117,18,3,429,0,17,446
16,4,16077,1758,3,259,55,107,8,4,433,0,15,448
16,4,16077,1759,3,269,73,124,10,4,480,1,7,488
16,4,16077,1760,3,255,129,90,9,4,487,6,7,500
16,4,16077,1761,3,523,153,269,14,6,965,20,36,1021
16,4,16077,1762,3,493,202,262,26,14,997,1,16,1014
16,4,16077,1763,3,355,129,223,21,8,736,1,16,753
16,4,16077,1764,3,147,53,41,4,4,249,0,4,253
16,4,16077,1765,3,86,33,53,1,3,176,0,1,177
16,4,16077,1766,3,50,26,27,1,0,104,1,3,108
16,4,16077,1767,3,476,229,306,18,16,1045,3,20,1068
16,4,16085,1898,3,169,101,149,6,11,436,3,8,447
16,4,16085,1899,3,276,228,259,14,8,785,1,11,797
16,4,16085,1900,3,262,353,313,19,8,955,6,22,983
16,4,16085,1901,3,185,218,233,15,10,661,0,21,682
16,4,16085,1902,3,163,160,160,12,6,501,0,33,534
16,4,16085,1903,3,281,175,179,5,11,651,6,15,672
16,4,16085,1904,3,69,122,276,4,3,474,4,16,494
16,4,16085,1905,3,68,101,507,7,4,687,4,24,715
16,4,16085,1906,3,109,103,150,7,3,372,1,11,384
16,4,16085,1907,3,80,164,173,3,5,425,2,12,439
16,4,16085,1908,3,83,136,300,4,1,524,0,11,535
16,4,16085,1909,3,137,180,299,4,10,630,10,2,642
16,4,16085,1910,3,133,218,202,4,5,562,2,7,571
16,4,16085,1911,3,60,169,208,2,1,440,0,19,459
16,4,16092,2002,3,401,109,94,20,8,632,1,12,645
16,4,16092,2003,3,248,129,74,8,8,467,1,8,476
16,4,16092,2004,3,276,144,130,7,3,560,3,12,575
16,4,16092,2005,3,411,200,133,11,18,773,1,19,793
16,4,16092,2006,3,303,156,108,14,6,587,5,17,609
16,4,16092,2007,3,148,140,127,4,3,422,0,12,434
16,4,16092,2008,3,166,122,196,4,2,490,0,14,504
16,4,16092,2009,3,116,207,250,9,7,589,1,26,616
16,4,16092,2010,3,134,91,185,7,10,427,0,12,439
16,4,16092,2011,3,211,62,60,4,8,345,1,5,351
16,4,16092,2012,3,97,115,29,0,0,241,1,1,243
16,4,16096,2052,3,197,108,127,10,8,450,1,6,457
16,4,16096,2053,3,149,56,134,6,5,350,0,12,362
16,4,16096,2054,3,140,58,106,4,3,311,0,14,325
16,4,16096,2055,3,150,170,191,8,6,525,1,16,542
16,4,16096,2056,3,177,172,317,15,13,694,2,11,707
16,4,16096,2057,3,151,123,162,19,5,460,1,6,467
16,4,16096,2058,3,157,73,141,13,8,392,2,8,402
16,4,16096,2059,3,145,182,241,13,4,585,1,23,609
16,4,16096,2060,3,28,71,83,0,0,182,0,5,187
16,4,16096,2061,3,45,68,127,4,0,244,0,11,255
16,4,16096,2062,3,170,87,49,6,7,319,0,4,323
16,4,16096,2063,3,94,17,31,2,1,145,0,4,149
16,4,16096,2064,3,21,11,12,0,1,45,0,0,45
16,4,16104,2317,3,49,27,60,1,1,138,0,6,144
16,4,16104,2318,3,216,91,125,3,2,437,0,16,453
16,4,16104,2319,3,135,93,210,2,3,443,0,24,467
16,4,16104,2320,3,182,113,136,7,0,438,2,10,450
16,4,16104,2321,3,44,25,125,1,1,196,0,0,196
16,4,16104,2322,3,101,56,169,4,0,330,0,5,335
16,4,16104,2323,3,169,64,276,3,1,513,3,10,526
16,4,16104,2324,3,197,135,357,4,3,696,0,5,701
16,4,16104,2325,3,150,49,233,5,1,438,0,14,452
16,4,16104,2326,3,150,111,132,3,4,400,0,18,418
16,4,16104,2327,3,116,55,170,1,1,343,0,8,351
16,4,16104,2328,3,112,89,292,5,6,504,0,13,517
16,4,16104,2329,3,92,111,279,6,1,489,0,16,505
16,4,16104,2330,3,50,66,86,117,2,321,1,22,344
16,4,16104,2331,3,60,61,106,85,7,319,0,19,338
16,4,16104,2332,3,78,75,175,101,1,430,0,25,455
16,4,16104,2333,3,47,35,127,101,3,313,0,24,337
16,4,16104,2334,3,83,81,94,4,3,265,2,0,267
16,4,16104,2335,3,100,90,306,19,1,516,1,10,527
16,4,16104,2336,3,22,85,77,5,0,189,0,7,196
16,4,16104,2337,3,77,89,48,6,0,220,2,6,228
16,4,16104,2338,3,85,83,190,3,7,368,3,14,385
16,4,16105,2339,3,171,111,216,11,8,517,3,12,532
16,4,16105,2340,3,141,135,323,12,4,615,3,17,635
16,4,16105,2341,3,234,144,356,12,5,751,0,10,761
16,4,16105,2342,3,173,119,113,11,4,420,0,9,429
16,4,16105,2343,3,186,127,240,13,7,573,3,14,590
16,4,16105,2344,3,118,46,40,4,0,208,0,8,216
16,4,16105,2345,3,48,80,45,2,1,176,0,7,183
16,4,16105,2346,3,65,18,53,0,4,140,3,7,150
16,4,16105,2347,3,114,41,56,9,2,222,0,12,234
16,4,16105,2348,3,156,60,181,5,4,406,0,1,407
16,4,16105,2349,3,76,92,64,6,2,240,1,3,244
16,4,16105,2350,3,228,187,123,5,3,546,0,14,560
16,4,16105,2351,3,57,39,57,2,2,157,1,17,175
16,4,16105,2352,3,51,107,109,2,4,273,0,7,280
16,4,16105,2353,3,83,91,177,2,1,354,0,4,358
16,4,16105,2354,3,108,126,110,2,1,347,0,16,363
16,4,16105,2355,3,88,77,25,3,0,193,0,10,203
16,4,16105,2356,3,48,40,61,2,4,155,0,3,158
16,5,16030,433,3,95,253,146,5,5,504,0,5,509
16,5,16030,434,3,42,173,142,3,0,360,0,13,373
16,5,16030,435,3,50,191,102,11,0,354,0,16,370
16,5,16030,436,3,60,313,269,3,2,647,0,20,667
16,5,16030,437,3,12,274,76,0,0,362,0,11,373
16,5,16030,438,3,52,234,137,2,1,426,0,11,437
16,5,16030,439,3,40,751,105,1,2,899,2,39,940
16,5,16030,440,3,104,203,118,5,5,435,3,13,451
16,5,16030,441,3,38,126,100,4,2,270,0,22,292
16,5,16030,442,3,26,129,125,2,1,283,0,17,300
16,5,16030,443,3,26,112,26,0,1,165,5,1,171
16,5,16030,444,3,77,120,94,0,1,292,0,10,302
16,5,16030,445,3,22,114,57,1,3,197,0,22,219
16,5,16042,673,3,129,227,252,13,4,625,0,7,632
16,5,16042,674,3,103,125,252,3,5,488,0,10,498
16,5,16042,675,3,91,145,159,3,3,401,5,4,410
16,5,16042,676,3,56,105,97,4,1,263,0,5,268
16,5,16042,677,3,41,33,252,6,4,336,2,9,347
16,5,16042,678,3,117,60,416,10,7,610,0,5,615
16,5,16042,679,3,92,98,122,4,5,321,0,3,324
16,5,16042,680,3,34,101,97,1,2,235,0,6,241
16,5,16042,681,3,209,68,89,7,3,376,1,15,392
16,5,16042,682,3,97,191,243,5,3,539,2,9,550
16,5,16042,683,3,102,169,322,6,4,603,0,13,616
16,5,16042,684,3,28,98,123,2,8,259,0,11,270
16,5,16070,1529,3,479,198,122,46,9,854,0,17,871
16,5,16070,1530,3,754,337,302,41,31,1465,7,22,1494
16,5,16070,1531,3,750,275,212,54,11,1302,8,21,1331
16,5,16070,1532,3,418,107,119,17,4,665,9,18,692
16,5,16070,1533,3,451,158,132,24,15,780,0,19,799
16,5,16070,1534,3,330,137,113,31,10,621,3,17,641
16,5,16070,1535,3,444,140,123,35,14,756,3,23,782
16,5,16070,1536,3,297,112,80,16,4,509,3,15,527
16,5,16070,1537,3,437,154,174,19,7,791,2,15,808
16,5,16070,1538,3,302,113,91,16,4,526,1,10,537
16,5,16070,1539,3,261,85,87,24,11,468,5,10,483
16,5,16070,1540,3,311,121,96,16,5,549,0,7,556
16,5,16070,1541,3,451,363,182,68,17,1081,0,21,1102
16,5,16070,1542,3,248,100,125,24,9,506,3,8,517
16,5,16070,1543,3,779,528,197,45,18,1567,2,10,1579
16,5,16070,1544,3,399,150,105,21,12,687,0,9,696
16,5,16070,1545,3,515,181,145,17,6,864,3,6,873
16,5,16070,1546,3,342,149,96,14,6,607,3,10,620
16,5,16070,1547,3,339,95,62,14,10,520,3,6,529
16,5,16070,1548,3,314,79,60,11,9,473,0,10,483
16,5,16070,1549,3,214,101,67,9,8,399,1,3,403
16,5,16070,1550,3,232,88,49,5,2,376,0,5,381
16,5,16070,1551,3,195,89,51,13,6,354,1,6,361
16,5,16070,1552,3,343,118,122,20,7,610,2,11,623
16,5,16070,1553,3,267,68,95,18,11,459,1,2,462
16,5,16070,1554,3,196,61,96,22,3,378,2,6,386
16,5,16070,1555,3,344,99,96,14,8,561,0,16,577
16,5,16070,1556,3,243,84,106,18,3,454,0,8,462
16,5,16070,1557,3,164,44,120,9,5,342,1,11,354
16,5,16070,1558,3,136,66,82,3,14,301,2,4,307
16,5,16070,1559,3,206,58,87,17,5,373,2,8,383
16,5,16070,1560,3,280,86,94,19,5,484,1,8,493
16,5,16070,1561,3,263,85,86,18,3,455,0,8,463
16,5,16070,1562,3,350,105,64,18,4,541,0,8,549
16,5,16070,1563,3,398,147,78,15,6,644,0,9,653
16,5,16070,1564,3,232,133,62,7,8,442,1,6,449
16,5,16070,1565,3,227,176,79,19,2,503,1,16,520
16,5,16070,1566,3,388,155,118,11,5,677,1,16,694
16,5,16070,1567,3,430,173,204,30,10,847,1,17,865
16,5,16070,1568,3,575,190,169,23,11,968,2,18,988
16,5,16070,1569,3,207,97,77,2,7,390,0,0,390
16,5,16070,1570,3,207,104,114,5,1,431,7,4,442
16,5,16070,1571,3,570,234,352,43,21,1220,1,21,1242
16,5,16070,1572,3,583,314,232,29,6,1164,2,16,1182
16,5,16070,1573,3,489,136,176,11,4,816,0,18,834
16,5,16070,1574,3,38,64,41,2,1,146,0,11,157
16,5,16070,1575,3,36,41,70,4,0,151,4,4,159
16,5,16070,1576,3,194,65,90,2,5,356,0,11,367
16,5,16070,1577,3,308,80,92,10,3,493,2,13,508
16,5,16070,1578,3,63,77,100,1,2,243,2,6,251
16,5,16070,1579,3,159,61,50,3,2,275,1,12,288
16,5,16070,1580,3,167,68,82,4,2,323,0,7,330
16,5,16070,1581,3,39,62,25,3,2,131,0,4,135
16,5,16070,1582,3,14,102,6,3,0,125,0,3,128
16,5,16070,1583,3,324,142,48,27,11,552,0,21,573
16,5,16070,1584,3,150,72,130,3,0,355,1,9,365
16,5,16070,1585,3,18,92,72,1,0,183,0,5,188
16,5,16070,1586,3,53,33,153,4,4,247,0,7,254
16,5,16070,1587,3,98,180,192,4,4,478,0,34,512
16,5,16070,1588,3,37,65,25,3,1,131,0,0,131
16,5,16070,1589,3,70,204,278,4,3,559,0,11,570
16,5,16087,1939,3,224,144,425,15,3,811,2,18,831
16,5,16087,1940,3,96,46,136,2,2,282,1,2,285
16,5,16087,1941,3,158,74,229,6,5,472,0,6,478
16,5,16087,1942,3,233,91,267,11,10,612,1,11,624
16,5,16087,1943,3,181,76,229,6,6,498,0,6,504
16,5,16087,1944,3,175,44,379,3,2,603,0,8,611
16,5,16087,1945,3,45,81,448,5,6,585,1,10,596
16,5,16087,1946,3,78,28,280,3,2,391,0,13,404
16,5,16087,1947,3,19,34,493,2,3,551,1,3,555
16,5,16087,1948,3,22,32,261,0,2,317,2,16,335
16,5,16087,1949,3,48,71,193,0,6,318,0,18,336
16,5,16106,2357,3,144,146,378,9,3,680,1,6,687
16,5,16106,2358,3,89,141,197,4,4,435,0,6,441
16,5,16106,2359,3,91,124,155,5,1,376,0,9,385
16,5,16106,2360,3,158,247,288,13,9,715,1,10,726
16,5,16106,2361,3,208,271,389,9,2,879,1,14,894
16,5,16106,2362,3,205,206,271,12,4,698,1,6,705
16,5,16106,2363,3,65,84,218,1,0,368,0,6,374
16,5,16106,2364,3,47,65,134,2,1,249,0,0,249
16,5,16106,2365,3,118,127,185,10,10,450,0,5,455
16,5,16106,2366,3,55,90,188,4,5,342,2,12,356
16,5,16106,2367,3,41,69,242,1,1,354,12,3,369
16,5,16106,2368,3,61,124,218,5,4,412,1,12,425
16,5,16106,2369,3,133,141,369,10,1,654,0,10,664
16,5,16107,2370,3,254,148,116,7,2,527,1,0,528
16,5,16107,2371,3,234,144,105,10,4,497,2,4,503
16,5,16107,2372,3,183,143,87,7,2,422,1,5,428
16,5,16107,2373,3,273,159,227,16,10,685,1,6,692
16,5,16107,2374,3,146,94,190,14,5,449,0,19,468
16,5,16107,2375,3,202,154,243,7,6,612,0,22,634
16,5,16107,2376,3,171,115,143,1,1,431,2,5,438
16,5,16107,2377,3,295,145,163,15,8,626,0,8,634
16,5,16107,2378,3,202,142,216,11,7,578,0,13,591
16,5,16107,2379,3,259,148,344,24,9,784,0,13,797
16,5,16107,2380,3,232,227,747,17,7,1230,5,32,1267
16,5,16107,2381,3,82,71,228,1,5,387,0,9,396
16,5,16107,2382,3,15,34,41,1,0,91,0,0,91
16,5,16107,2383,3,8,54,308,0,1,371,2,5,378
16,5,16107,2384,3,20,44,395,0,0,459,2,3,464
16,5,16107,2385,3,46,74,229,5,8,362,0,0,362
16,5,16107,2386,3,44,154,157,1,3,359,3,9,371
16,5,16107,2387,3,9,19,102,2,0,132,1,5,138
16,5,16107,2388,3,8,33,240,2,0,283,0,5,288
16,5,16109,2436,3,356,104,218,35,11,724,0,21,745
16,5,16109,2437,3,444,87,132,29,9,701,2,10,713
16,5,16109,2438,3,589,174,309,35,21,1128,11,20,1159
16,5,16109,2439,3,282,95,175,22,17,591,0,8,599
16,5,16109,2440,3,418,134,156,21,19,748,2,4,754
16,5,16109,2441,3,412,192,394,35,25,1058,5,26,1089
16,5,16109,2442,3,194,130,244,16,10,594,11,31,636
16,5,16109,2443,3,239,122,187,17,13,578,4,19,601
16,5,16109,2444,3,182,145,118,14,7,466,3,6,475
16,5,16109,2445,3,628,162,338,43,24,1195,6,3,1204
16,5,16109,2446,3,350,99,127,25,14,615,0,10,625
16,5,16109,2447,3,653,189,367,66,32,1307,5,21,1333
16,5,16109,2448,3,294,296,252,31,15,888,5,21,914
16,5,16109,2449,3,284,250,187,33,18,772,2,21,795
16,5,16109,2450,3,299,103,226,32,25,685,8,16,709
16,5,16109,2451,3,668,241,395,42,25,1371,3,17,1391
16,5,16109,2452,3,417,136,147,20,13,733,3,8,744
16,5,16109,2453,3,401,123,223,27,23,797,2,7,806
16,5,16109,2454,3,377,179,244,26,15,841,4,26,871
16,5,16109,2455,3,225,63,99,15,4,406,2,7,415
16,5,16109,2456,3,291,114,124,17,12,558,3,14,575
16,5,16109,2457,3,335,122,152,25,11,645,0,9,654
16,5,16109,2458,3,383,112,141,14,25,675,3,12,690
16,5,16109,2459,3,456,133,199,30,19,837,1,21,859
16,5,16109,2460,3,468,109,237,20,11,845,0,14,859
16,5,16109,2461,3,263,75,89,9,7,443,0,6,449
16,5,16109,2462,3,705,297,641,51,39,1733,8,38,1779
16,5,16109,2463,3,314,141,198,26,11,690,2,10,702
16,5,16109,2464,3,284,70,119,9,10,492,0,10,502
16,5,16109,2465,3,218,48,118,8,10,402,0,9,411
16,5,16109,2466,3,330,83,119,19,18,569,4,15,588
16,5,16109,2467,3,224,100,143,17,15,499,4,6,509
16,5,16109,2468,3,225,152,161,20,17,575,2,18,595
16,5,16109,2469,3,200,108,228,29,12,577,4,11,592
16,5,16109,2470,3,342,196,245,32,18,833,1,25,859
16,5,16109,2471,3,497,112,198,18,16,841,0,13,854
16,5,16109,2472,3,482,194,211,33,23,943,2,18,963
16,5,16109,2473,3,183,64,127,6,5,385,0,11,396
16,5,16109,2474,3,346,55,103,12,8,524,0,6,530
16,5,16109,2475,3,217,84,111,12,9,433,0,12,445
16,5,16109,2476,3,764,293,469,56,30,1612,9,33,1654
16,5,16109,2477,3,70,114,130,11,2,327,2,10,339
16,5,16109,2478,3,280,145,252,35,16,728,4,13,745
16,5,16109,2479,3,142,62,74,9,4,291,2,7,300
16,5,16109,2480,3,285,98,153,19,8,563,0,1,564
16,5,16109,2481,3,352,127,195,17,18,709,0,7,716
16,5,16109,2482,3,228,76,116,9,6,435,0,3,438
16,5,16109,2483,3,115,67,59,10,10,261,1,3,265
16,5,16109,2484,3,140,85,83,6,5,319,0,5,324
16,5,16109,2485,3,323,111,139,8,8,589,1,8,598
16,5,16109,2486,3,271,100,165,16,12,564,0,13,577
16,5,16109,2487,3,370,127,215,28,18,758,1,18,777
16,5,16109,2488,3,264,103,192,26,12,597,0,6,603
16,5,16109,2489,3,430,181,286,22,25,944,3,35,982
16,5,16109,2490,3,290,109,251,15,15,680,1,13,694
16,5,16109,2491,3,429,107,183,20,16,755,5,11,771
16,5,16109,2492,3,333,98,142,18,16,607,0,12,619
16,5,16109,2493,3,429,118,183,26,19,775,0,13,788
16,5,16109,2494,3,191,69,68,21,11,360,0,12,372
16,5,16109,2495,3,662,216,285,28,23,1214,1,17,1232
16,5,16109,2496,3,420,116,144,25,10,715,0,7,722
16,5,16109,2497,3,529,182,326,42,27,1106,1,18,1125
16,5,16109,2498,3,471,93,289,23,13,889,3,9,901
16,5,16109,2499,3,475,139,212,22,19,867,0,14,881
16,5,16109,2500,3,468,117,213,23,16,837,5,10,852
16,5,16109,2501,3,175,104,239,19,7,544,4,13,561
16,5,16109,2502,3,379,91,152,30,24,676,4,5,685
16,5,16109,2503,3,440,129,179,30,19,797,9,13,819
16,5,16109,2504,3,341,78,117,18,12,566,0,7,573
16,5,16109,2505,3,253,106,130,16,12,517,2,14,533
16,5,16109,2506,3,345,118,283,25,22,793,1,7,801
16,5,16109,2507,3,134,73,127,7,4,345,2,8,355
16,5,16109,2508,3,158,138,213,6,2,517,2,12,531
16,5,16109,2509,3,118,147,182,7,3,457,3,12,472
16,5,16109,2510,3,357,245,279,17,16,914,7,15,936
16,5,16109,2511,3,123,63,78,7,7,278,0,16,294
16,5,16109,2512,3,105,47,51,2,3,208,1,7,216
16,5,16109,2513,3,60,102,182,3,2,349,2,17,368
16,5,16109,2514,3,161,147,227,3,1,539,4,17,560
16,5,16109,2515,3,73,132,178,1,1,385,2,15,402
16,5,16109,2516,3,50,65,159,1,4,279,0,13,292
16,5,16109,2517,3,74,32,39,2,0,147,1,5,153
16,5,16109,2518,3,128,34,57,3,1,223,0,2,225
16,5,16109,2519,3,259,146,216,16,2,639,1,13,653
16,5,16109,2520,3,324,160,178,15,12,689,0,12,701
16,5,16109,2521,3,133,61,506,6,7,713,1,10,724
16,5,16109,2522,3,206,138,317,6,9,676,2,11,689
16,5,16109,2523,3,41,119,266,7,4,437,2,8,447
16,5,16109,2524,3,181,35,121,3,5,345,1,6,352
16,5,16109,2525,3,102,182,244,7,3,538,0,15,553
16,5,16109,2526,3,54,77,135,3,4,273,0,2,275
16,5,16109,2527,3,12,227,79,0,0,318,0,3,321
16,5,16109,2528,3,513,224,285,42,21,1085,0,25,1110
16,5,16109,2529,3,673,300,389,34,47,1443,9,17,1469
16,5,16109,2530,3,66,28,216,3,2,315,0,11,326
16,5,16109,2676,3,76,56,36,1,3,172,6,7,185
16,6,16017,286,3,275,255,301,27,9,867,7,31,905
16,6,16017,287,3,55,78,176,6,5,320,1,16,337
16,6,16017,288,3,504,351,488,54,12,1409,0,61,1470
16,6,16017,289,3,8,43,247,2,2,302,0,6,308
16,6,16017,290,3,33,80,284,8,0,405,1,14,420
16,6,16017,291,3,42,103,210,8,1,364,3,19,386
16,6,16017,292,3,63,78,695,18,5,859,0,20,879
16,6,16017,293,3,120,120,810,19,6,1075,2,31,1108
16,6,16017,294,3,199,172,602,20,12,1005,1,51,1057
16,6,16017,295,3,107,147,373,9,3,639,8,22,669
16,6,16017,296,3,42,100,570,5,2,719,5,16,740
16,6,16017,297,3,147,297,552,16,4,1016,7,61,1084
16,6,16017,298,3,153,76,281,12,10,532,4,21,557
16,6,16031,446,3,176,246,190,19,13,644,3,17,664
16,6,16031,447,3,185,209,77,19,5,495,2,25,522
16,6,16031,448,3,125,211,144,7,4,491,1,17,509
16,6,16031,449,3,144,165,174,13,7,503,1,29,533
16,6,16031,450,3,135,190,174,6,7,512,2,20,534
16,6,16031,451,3,116,114,174,3,7,414,7,17,438
16,6,16031,452,3,40,77,252,1,2,372,0,10,382
16,6,16031,453,3,58,96,150,5,5,314,3,11,328
16,6,16031,454,3,94,158,333,9,8,602,3,20,625
16,6,16031,455,3,116,211,490,11,10,838,0,17,855
16,6,16031,456,3,66,158,336,4,5,569,3,22,594
16,6,16034,480,3,629,110,184,15,9,947,2,26,975
16,6,16034,481,3,477,188,302,18,20,1005,2,40,1047
16,6,16034,482,3,685,330,332,28,17,1392,16,27,1435
16,6,16034,483,3,753,135,198,23,28,1137,11,37,1185
16,6,16034,484,3,527,171,207,31,13,949,8,22,979
16,6,16034,485,3,408,164,191,24,13,800,3,21,824
16,6,16034,486,3,694,168,200,27,12,1101,4,24,1129
16,6,16034,487,3,447,138,213,34,20,852,3,16,871
16,6,16034,488,3,436,152,235,23,14,860,1,11,872
16,6,16034,489,3,344,167,205,27,9,752,10,36,798
16,6,16034,490,3,389,141,265,25,7,827,3,21,851
16,6,16034,491,3,535,146,288,30,21,1020,4,26,1050
16,6,16034,492,3,373,116,176,24,18,707,1,17,725
16,6,16034,493,3,483,135,187,27,13,845,0,19,864
16,6,16034,494,3,618,230,344,56,25,1273,6,37,1316
16,6,16034,495,3,657,428,518,42,34,1679,8,53,1740
16,6,16034,496,3,482,178,267,38,26,991,2,17,1010
16,6,16034,497,3,352,164,177,26,14,733,4,18,755
16,6,16034,498,3,545,202,221,31,21,1020,3,21,1044
16,6,16034,499,3,465,162,241,30,14,912,1,33,946
16,6,16034,500,3,380,115,209,43,6,753,6,0,759
16,6,16034,501,3,289,123,176,18,11,617,6,12,635
16,6,16034,502,3,470,145,267,31,19,932,0,18,950
16,6,16034,503,3,494,156,280,51,28,1009,1,42,1052
16,6,16034,504,3,68,9,35,0,0,112,0,2,114
16,6,16034,505,3,47,16,13,0,0,76,0,0,76
16,6,16034,506,3,68,17,19,1,0,105,3,5,113
16,6,16034,507,3,13,4,25,3,2,47,1,0,48
16,6,16034,508,3,181,179,187,10,4,561,2,31,594
16,6,16034,509,3,39,25,82,6,2,154,0,1,155
16,6,16034,510,3,177,180,169,10,7,543,2,23,568
16,6,16034,511,3,216,261,141,15,4,637,1,24,662
16,6,16034,512,3,189,44,28,0,1,262,1,9,272
16,6,16034,513,3,429,133,91,17,6,676,5,24,705
16,6,16034,514,3,121,83,61,0,0,265,3,0,268
16,6,16034,515,3,129,49,51,5,2,236,5,2,243
16,6,16034,516,3,147,63,68,5,5,288,2,10,300
16,6,16034,517,3,268,307,239,16,16,846,8,26,880
16,6,16034,518,3,41,43,50,2,0,136,1,10,147
16,6,16034,519,3,8,32,10,1,0,51,1,2,54
16,6,16034,520,3,43,47,58,2,3,153,3,7,163
16,6,16034,521,3,245,155,228,11,7,646,6,34,686
16,6,16034,522,3,98,44,50,1,4,197,0,7,204
16,6,16034,523,3,97,41,86,6,1,231,0,11,242
16,6,16034,524,3,56,20,111,1,1,189,6,6,201
16,6,16034,525,3,32,55,129,3,5,224,3,7,234
16,6,16034,526,3,151,213,198,9,5,576,11,50,637
16,6,16034,527,3,228,168,173,6,1,576,15,42,633
16,6,16034,528,3,29,37,188,2,0,256,2,5,263
16,6,16034,529,3,19,34,170,1,3,227,0,6,233
16,6,16034,530,3,12,16,128,0,2,158,3,4,165
16,6,16034,531,3,36,131,67,9,0,243,4,8,255
16,6,16034,532,3,134,104,120,8,2,368,2,7,377
16,6,16034,533,3,27,28,19,1,0,75,2,4,81
16,6,16034,534,3,33,80,112,6,6,237,4,3,244
16,6,16034,535,3,12,13,25,0,1,51,0,1,52
16,6,16034,536,3,19,43,11,1,0,74,0,5,79
16,6,16034,537,3,70,21,53,4,1,149,0,6,155
16,6,16034,538,3,109,14,13,3,0,139,1,0,140
16,6,16034,539,3,123,26,29,2,1,181,0,9,190
16,6,16034,540,3,11,24,48,1,0,84,2,0,86
16,6,16034,541,3,15,10,78,0,1,104,2,4,110
16,6,16034,542,3,49,35,226,1,3,314,1,9,324
16,6,16034,543,3,32,11,15,1,0,59,0,2,61
16,6,16034,544,3,51,49,192,4,0,296,0,18,314
16,6,16034,545,3,213,86,205,1,5,510,1,8,519
16,6,16034,546,3,489,248,330,10,6,1083,1,23,1107
16,6,16034,547,3,36,44,27,1,0,108,0,0,108
16,6,16034,548,3,72,33,117,4,4,230,0,5,235
16,6,16034,549,3,179,44,235,6,3,467,1,14,482
16,6,16034,550,3,13,27,220,3,2,265,1,10,276
16,6,16034,551,3,44,68,23,0,0,135,0,3,138
16,6,16034,552,3,13,30,43,3,0,89,0,2,91
16,6,16034,553,3,3,8,22,0,2,35,0,1,36
16,6,16034,554,3,24,3,2,0,0,29,0,1,30
16,6,16034,555,3,29,5,19,0,0,53,0,0,53
16,6,16034,556,3,4,3,27,0,0,34,0,11,45
16,6,16041,665,3,277,240,367,19,17,920,10,20,950
16,6,16041,666,3,278,237,265,19,15,814,4,22,840
16,6,16041,667,3,54,24,33,6,0,117,0,7,124
16,6,16041,668,3,163,66,246,11,5,491,2,19,512
16,6,16041,669,3,233,119,309,22,7,690,5,27,722
16,6,16041,670,3,128,116,123,12,5,384,16,23,423
16,6,16041,671,3,79,83,62,4,2,230,2,9,241
16,6,16041,672,3,148,205,396,17,19,785,3,8,796
16,6,16052,885,3,274,152,251,35,8,720,11,18,749
16,6,16052,886,3,251,176,269,62,19,777,7,17,801
16,6,16052,887,3,218,150,221,45,21,655,1,32,688
16,6,16052,888,3,150,150,220,23,10,553,2,27,582
16,6,16052,889,3,205,155,250,28,12,650,3,32,685
16,6,16052,890,3,319,204,190,45,19,777,2,22,801
16,6,16052,891,3,217,126,232,29,8,612,3,29,644
16,6,16052,892,3,159,130,207,55,8,559,1,30,590
16,6,16052,893,3,183,157,165,37,12,554,3,17,574
16,6,16052,894,3,122,99,190,28,13,452,9,16,477
16,6,16052,895,3,179,166,320,32,11,708,4,23,735
16,6,16052,896,3,254,150,211,85,21,721,1,29,751
16,6,16052,897,3,181,99,266,41,8,595,3,29,627
16,6,16052,898,3,242,161,347,34,10,794,3,52,849
16,6,16052,899,3,167,82,231,25,6,511,0,21,532
16,6,16052,900,3,180,140,230,37,7,594,0,31,625
16,6,16052,901,3,119,107,257,13,5,501,3,9,513
16,6,16052,902,3,69,35,200,3,2,309,3,15,327
16,6,16052,903,3,279,116,494,23,12,924,5,45,974
16,6,16052,904,3,214,51,213,10,5,493,1,15,509
16,6,16052,905,3,103,96,224,7,3,433,7,3,443
16,6,16052,906,3,119,52,173,2,8,354,3,22,379
16,6,16052,907,3,27,47,144,4,0,222,1,10,233
16,6,16052,908,3,89,151,421,17,6,684,3,18,705
16,6,16052,909,3,132,74,293,35,7,541,3,10,554
16,6,16052,910,3,88,77,288,7,8,468,2,3,473
16,6,16052,911,3,111,90,233,12,12,458,9,25,492
16,6,16052,912,3,273,96,587,15,9,980,11,39,1030
16,6,16052,913,3,17,9,97,3,0,126,2,7,135
16,6,16052,914,3,91,95,591,23,10,810,9,29,848
16,6,16052,915,3,62,47,242,8,3,362,0,27,389
16,6,16052,916,3,72,156,364,15,8,615,0,30,645
16,6,16052,917,3,48,42,218,3,0,311,2,31,344
16,6,16052,918,3,26,12,180,6,1,225,0,7,232
16,6,16052,919,3,91,67,347,11,4,520,3,17,540
16,6,16052,920,3,74,48,205,35,1,363,3,34,400
16,6,16052,921,3,68,65,86,4,1,224,0,7,231
16,6,16052,922,3,94,117,416,23,8,658,1,69,728
16,6,16052,923,3,57,45,367,9,4,482,0,21,503
16,6,16052,924,3,179,82,347,7,6,621,3,22,646
16,6,16052,925,3,19,36,212,5,0,272,3,16,291
16,6,16052,926,3,46,83,153,3,2,287,2,16,305
16,6,16052,927,3,7,27,55,1,3,93,0,4,97
16,6,16052,928,3,121,137,420,44,4,726,0,41,767
16,6,16073,1647,3,169,140,235,21,12,577,7,21,605
16,6,16073,1648,3,142,102,158,20,10,432,5,20,457
16,6,16073,1649,3,186,58,149,13,9,415,1,10,426
16,6,16073,1650,3,125,110,213,18,8,474,20,14,508
16,6,16073,1651,3,202,158,294,28,11,693,2,27,722
16,6,16073,1652,3,140,80,199,26,14,459,8,20,487
16,6,16073,1653,3,18,68,28,1,1,116,4,6,126
16,6,16073,1654,3,35,31,84,2,2,154,5,9,168
16,6,16073,1655,3,61,34,104,2,0,201,5,6,212
16,6,16073,1656,3,104,105,190,2,1,402,7,21,430
16,6,16073,1657,3,54,35,20,1,1,111,2,6,119
16,6,16073,1658,3,47,45,60,2,2,156,1,5,162
16,6,16073,1659,3,23,11,98,1,6,139,0,2,141
16,6,16073,1660,3,7,7,73,0,0,87,0,4,91
16,6,16081,1821,3,184,190,127,10,6,517,0,20,537
16,6,16081,1822,3,222,200,199,13,7,641,1,39,681
16,6,16081,1823,3,51,39,250,5,3,348,2,19,369
16,6,16081,1824,3,69,55,433,10,10,577,1,31,609
16,6,16081,1825,3,158,176,427,21,12,794,5,52,851
16,6,16081,1826,3,67,88,157,9,1,322,0,6,328
16,6,16081,1827,3,143,67,223,18,10,461,9,28,498
16,6,16081,1828,3,138,344,274,14,22,792,6,59,857
16,6,16081,1829,3,94,57,186,3,3,343,0,16,359
16,6,16081,1830,3,94,105,95,5,3,302,6,12,320
16,6,16081,1831,3,64,48,194,5,3,314,0,18,332
16,6,16094,2025,3,273,179,353,54,15,874,6,26,906
16,6,16094,2026,3,276,164,241,40,18,739,8,17,764
16,6,16094,2027,3,146,39,101,26,4,316,5,16,337
16,6,16094,2028,3,188,58,165,16,7,434,4,11,449
16,6,16094,2029,3,181,87,211,104,15,598,21,42,661
16,6,16094,2030,3,187,95,343,36,7,668,0,22,690
16,6,16094,2031,3,248,139,253,41,18,699,11,23,733
16,6,16094,2032,3,166,60,244,26,7,503,9,38,550
16,6,16094,2033,3,421,166,469,91,31,1178,22,54,1254
16,6,16094,2034,3,306,148,267,60,11,792,14,38,844
16,6,16094,2035,3,74,56,165,30,5,330,1,15,346
16,6,16094,2036,3,31,11,109,19,6,176,1,7,184
16,6,16094,2037,3,143,54,275,63,10,545,9,35,589
16,6,16094,2038,3,121,77,353,27,5,583,10,28,621
16,6,16094,2039,3,72,26,73,15,2,188,1,8,197
16,6,16111,2538,3,123,148,176,22,7,476,3,12,491
16,6,16111,2539,3,66,72,114,6,4,262,0,16,278
16,6,16111,2540,3,164,157,235,26,17,599,3,28,630
16,6,16111,2541,3,202,97,204,15,10,528,0,16,544
16,6,16111,2542,3,234,136,259,19,13,661,4,21,686
16,6,16111,2543,3,217,145,171,26,7,566,2,18,586
16,6,16111,2544,3,438,242,286,35,22,1023,3,18,1044
16,6,16111,2545,3,240,176,247,26,14,703,5,14,722
16,6,16111,2546,3,201,177,282,34,17,711,4,19,734
16,6,16111,2547,3,108,91,169,2,6,376,4,16,396
16,6,16111,2548,3,131,92,97,11,4,335,4,19,358
16,6,16111,2549,3,112,185,315,15,6,633,6,20,659
16,6,16111,2550,3,215,200,407,24,9,855,9,36,900
16,6,16111,2551,3,45,68,109,3,1,226,2,11,239
16,6,16111,2552,3,259,114,128,11,6,518,6,22,546
16,6,16111,2553,3,163,134,127,13,4,441,3,9,453
16,6,16111,2554,3,56,52,44,3,2,157,7,4,168
16,6,16111,2555,3,139,104,254,12,8,517,4,21,542
16,6,16111,2556,3,157,26,266,7,6,462,1,10,473
16,6,16111,2557,3,295,46,398,18,18,775,0,9,784
16,6,16111,2558,3,84,62,233,3,4,386,2,7,395
16,6,16111,2559,3,197,67,385,13,15,677,4,18,699
16,6,16111,2560,3,190,79,400,8,13,690,3,24,717
16,6,16111,2561,3,68,74,292,4,7,445,4,19,468
16,6,16111,2562,3,28,17,138,4,3,190,1,6,197
16,6,16111,2563,3,127,58,205,6,3,399,3,17,419
16,6,16111,2564,3,242,137,148,8,9,544,11,27,582
16,6,16111,2565,3,200,245,186,11,7,649,6,21,676
16,6,16111,2566,3,92,136,125,4,2,359,10,19,388
16,6,16111,2567,3,83,63,136,2,1,285,5,6,296
16,6,16111,2568,3,110,285,164,18,5,582,10,21,613
16,6,16111,2569,3,46,53,142,2,1,244,3,10,257
16,7,16016,257,3,100,50,155,5,2,312,1,5,318
16,7,16016,258,3,87,70,189,13,4,363,0,5,368
16,7,16016,259,3,140,142,197,15,7,501,2,15,518
16,7,16016,260,3,107,87,165,14,5,378,1,18,397
16,7,16016,261,3,15,73,85,0,0,173,1,5,179
16,7,16016,262,3,31,148,190,8,3,380,0,16,396
16,7,16016,263,3,34,99,219,4,5,361,1,10,372
16,7,16016,264,3,30,98,161,13,7,309,0,11,320
16,7,16016,265,3,49,409,111,1,11,581,1,7,589
16,7,16016,266,3,6,10,55,0,2,73,0,4,77
16,7,16016,267,3,72,101,201,4,3,381,1,9,391
16,7,16016,268,3,37,24,123,5,6,195,0,7,202
16,7,16016,269,3,48,77,49,0,2,176,1,0,177
16,7,16016,270,3,14,44,234,3,2,297,0,3,300
16,7,16016,271,3,55,142,31,2,0,230,2,7,239
16,7,16016,272,3,47,110,23,0,0,180,2,2,184
16,7,16016,273,3,31,24,111,2,1,169,0,13,182
16,7,16016,274,3,61,26,98,7,6,198,0,0,198
16,7,16016,275,3,66,59,88,0,1,214,0,8,222
16,7,16016,276,3,7,9,74,0,0,90,0,6,96
16,7,16016,277,3,50,108,170,8,2,338,0,4,342
16,7,16016,278,3,53,132,210,0,6,401,0,16,417
16,7,16016,279,3,48,73,127,1,2,251,1,6,258
16,7,16016,280,3,45,87,312,5,6,455,6,6,467
16,7,16016,281,3,14,14,156,0,1,185,0,7,192
16,7,16016,282,3,7,22,300,3,1,333,0,9,342
16,7,16016,283,3,28,42,52,3,0,125,0,3,128
16,7,16016,284,3,33,50,215,4,1,303,0,10,313
16,7,16016,285,3,22,43,151,1,2,219,0,10,229
16,7,16021,340,3,182,182,209,3,3,579,5,18,602
16,7,16021,341,3,256,170,555,7,1,989,5,19,1013
16,7,16021,342,3,76,217,162,2,2,459,4,29,492
16,7,16021,343,3,42,183,126,4,1,356,2,16,374
16,7,16021,344,3,100,230,377,5,10,722,4,10,736
16,7,16021,345,3,106,519,127,6,2,760,3,22,785
16,7,16024,372,3,62,236,422,9,10,739,3,6,748
16,7,16024,373,3,73,181,514,8,10,786,2,11,799
16,7,16024,374,3,85,163,414,19,4,685,3,11,699
16,7,16024,375,3,67,138,264,10,6,485,0,18,503
16,7,16024,376,3,81,202,396,10,14,703,1,6,710
16,7,16024,377,3,101,149,346,18,7,621,1,12,634
16,7,16024,378,3,79,162,299,6,4,550,4,4,558
16,7,16024,379,3,40,119,208,4,0,371,4,5,380
16,7,16025,380,3,189,186,188,41,13,617,0,19,636
16,7,16025,381,3,212,232,316,36,11,807,1,14,822
16,7,16025,382,3,205,239,280,21,7,752,2,11,765
16,7,16025,383,3,48,209,211,3,2,473,2,8,483
16,7,16025,384,3,115,273,340,13,11,752,2,20,774
16,7,16025,385,3,127,134,144,6,2,413,0,8,421
16,7,16025,386,3,150,212,269,34,12,677,0,14,691
16,7,16025,387,3,95,239,386,12,5,737,2,22,761
16,7,16025,388,3,109,240,305,16,7,677,3,28,708
16,7,16025,389,3,73,266,575,11,7,932,9,15,956
16,7,16025,390,3,82,100,287,5,18,492,3,12,507
16,7,16025,391,3,111,122,208,6,7,454,0,16,470
16,7,16025,392,3,39,131,201,3,19,393,0,18,411
16,7,16025,393,3,237,211,299,5,4,756,0,22,778
16,7,16025,394,3,82,339,227,4,5,657,0,14,671
16,7,16025,395,3,46,226,179,3,4,458,0,5,463
16,7,16025,396,3,12,158,34,4,1,209,1,2,212
16,7,16032,457,3,246,277,246,50,19,838,14,25,877
16,7,16032,458,3,172,140,120,25,17,474,3,7,484
16,7,16032,459,3,10,21,183,3,2,219,0,10,229
16,7,16032,460,3,30,55,138,9,9,241,2,3,246
16,7,16032,461,3,169,315,685,23,13,1205,32,5,1242
16,7,16032,462,3,41,82,99,5,4,231,3,10,244
16,7,16032,463,3,165,100,255,18,16,554,8,11,573
16,7,16032,464,3,45,61,295,12,7,420,1,13,434
16,7,16032,465,3,85,74,241,16,12,428,4,8,440
16,7,16032,466,3,35,122,216,13,3,389,0,11,400
16,7,16057,1321,3,149,482,280,22,7,940,2,11,953
16,7,16057,1322,3,119,332,199,16,6,672,5,19,696
16,7,16057,1323,3,195,329,405,22,13,964,3,17,984
16,7,16057,1324,3,181,300,445,17,18,961,1,20,982
16,7,16057,1325,3,30,61,276,1,1,369,1,11,381
16,7,16057,1326,3,43,177,448,5,0,673,0,18,691
16,7,16057,1327,3,97,297,298,2,2,696,2,11,709
16,7,16057,1328,3,61,381,381,2,2,827,2,31,860
16,7,16057,1329,3,7,117,167,1,7,299,0,9,308
16,7,16057,1330,3,17,84,149,0,1,251,0,3,254
16,7,16057,1331,3,41,199,299,0,2,541,0,11,552
16,7,16057,1332,3,35,210,253,1,2,501,4,4,509
16,7,16057,1333,3,73,192,145,5,6,421,5,8,434
16,7,16057,1334,3,40,199,330,7,3,579,2,12,593
16,7,16057,1335,3,18,78,209,0,0,305,1,6,312
16,7,16066,1440,3,163,295,330,58,27,873,2,16,891
16,7,16066,1441,3,113,160,221,38,15,547,1,42,590
16,7,16066,1442,3,135,201,194,31,7,568,5,16,589
16,7,16066,1443,3,151,329,307,31,21,839,2,12,853
16,7,16066,1444,3,166,278,235,34,14,727,1,10,738
16,7,16066,1445,3,259,269,393,26,23,970,0,17,987
16,7,16066,1446,3,172,267,494,65,21,1019,3,29,1051
16,7,16066,1447,3,94,120,292,34,16,556,3,11,570
16,7,16066,1448,3,126,143,394,90,11,764,1,30,795
16,7,16066,1449,3,19,25,689,3,0,736,0,5,741
16,7,16066,1450,3,34,222,417,12,8,693,4,10,707
16,7,16066,1451,3,124,195,487,34,25,865,1,17,883
16,7,16066,1452,3,41,64,212,5,4,326,2,7,335
16,7,16066,1453,3,17,92,236,3,3,351,3,10,364
16,7,16066,1454,3,36,111,296,7,3,453,4,9,466
16,7,16066,1455,3,16,88,545,3,0,652,0,12,664
16,7,16071,1590,3,245,154,158,16,6,579,1,10,590
16,7,16071,1591,3,185,92,76,15,2,370,0,3,373
16,7,16071,1592,3,418,154,245,28,18,863,3,21,887
16,7,16071,1593,3,329,143,249,26,13,760,3,12,775
16,7,16071,1594,3,215,135,234,24,5,613,2,14,629
16,7,16071,1595,3,251,129,165,8,9,562,0,7,569
16,7,16071,1596,3,174,100,216,5,6,501,0,11,512
16,7,16071,1597,3,273,190,197,17,14,691,5,13,709
16,7,16071,1598,3,286,200,182,13,12,693,1,19,713
16,7,16071,1599,3,49,26,90,3,3,171,0,9,180
16,7,16071,1600,3,46,35,132,5,3,221,12,4,237
16,7,16074,1661,3,385,217,129,17,15,763,0,19,782
16,7,16074,1662,3,722,335,168,30,24,1279,10,49,1338
16,7,16074,1663,3,478,200,100,38,10,826,2,29,857
16,7,16074,1664,3,563,165,129,32,18,907,3,32,942
16,7,16074,1665,3,578,150,156,12,13,909,0,23,932
16,7,16074,1666,3,479,114,140,19,11,763,1,23,787
16,7,16074,1667,3,76,87,125,2,3,293,5,12,310
16,7,16074,1668,3,50,38,193,5,2,288,3,10,301
16,7,16074,1669,3,172,94,288,15,8,577,5,37,619
16,7,16074,1670,3,167,101,289,14,8,579,0,22,601
16,7,16074,1671,3,42,51,355,12,2,462,2,8,472
16,7,16074,1672,3,40,48,254,10,1,353,0,7,360
16,7,16074,1673,3,41,46,38,0,0,125,0,11,136
16,7,16074,1674,3,81,15,8,2,1,107,1,9,117
16,7,16076,1684,3,399,248,203,39,15,904,0,18,922
16,7,16076,1685,3,189,224,202,13,3,631,1,24,656
16,7,16076,1686,3,163,128,245,25,16,577,4,19,600
16,7,16076,1687,3,209,145,238,24,13,629,3,15,647
16,7,16076,1688,3,241,139,228,17,7,632,0,10,642
16,7,16076,1689,3,215,108,167,14,12,516,0,16,532
16,7,16076,1690,3,167,118,170,13,14,482,2,11,495
16,7,16076,1691,3,308,115,245,24,19,711,1,17,729
16,7,16076,1692,3,220,130,218,23,17,608,0,17,625
16,7,16076,1693,3,235,136,161,18,15,565,1,7,573
16,7,16076,1694,3,203,147,159,9,12,530,0,13,543
16,7,16076,1695,3,231,172,125,22,11,561,0,12,573
16,7,16076,1696,3,281,129,130,26,10,576,0,8,584
16,7,16076,1697,3,309,173,122,23,19,646,0,19,665
16,7,16076,1698,3,388,164,201,29,15,797,0,13,810
16,7,16076,1699,3,183,133,179,18,8,521,4,14,539
16,7,16076,1700,3,260,114,174,37,14,599,0,15,614
16,7,16076,1701,3,291,195,218,27,18,749,3,15,767
16,7,16076,1702,3,305,124,151,10,9,599,0,10,609
16,7,16076,1703,3,224,149,206,25,15,619,3,11,633
16,7,16076,1704,3,220,179,192,23,15,629,2,18,649
16,7,16076,1705,3,381,392,285,56,31,1145,2,12,1159
16,7,16076,1706,3,162,99,196,28,8,493,5,11,509
16,7,16076,1707,3,25,180,218,2,2,427,2,14,443
16,7,16076,1708,3,41,373,184,7,8,613,0,15,628
16,7,16076,1709,3,136,126,305,5,2,574,2,10,586
16,7,16076,1710,3,62,308,517,3,3,893,0,36,929
16,7,16076,1711,3,55,205,385,5,0,650,0,36,686
16,7,16076,1712,3,308,190,441,23,12,974,0,15,989
16,7,16076,1713,3,56,108,410,4,6,584,4,6,594
16,7,16076,1714,3,203,153,229,5,2,592,1,14,607
16,7,16076,1715,3,82,76,135,4,3,300,0,8,308
16,7,16076,1716,3,88,252,84,12,8,444,1,19,464
16,7,16076,1717,3,220,391,259,25,16,911,0,14,925
16,7,16076,1718,3,73,100,172,3,1,349,1,6,356
16,7,16086,1912,3,183,100,131,4,28,446,3,12,461
16,7,16086,1913,3,250,83,97,14,10,454,0,6,460
16,7,16086,1914,3,260,140,110,18,9,537,1,3,541
16,7,16086,1915,3,271,81,137,13,18,520,5,11,536
16,7,16086,1916,3,232,99,134,15,7,487,2,7,496
16,7,16086,1917,3,153,70,71,12,3,309,0,3,312
16,7,16086,1918,3,152,78,64,6,8,308,0,4,312
16,7,16086,1919,3,252,103,113,20,11,499,0,5,504
16,7,16086,1920,3,377,264,189,13,23,866,0,16,882
16,7,16086,1921,3,162,103,119,8,4,396,0,17,413
16,7,16086,1922,3,210,84,113,18,8,433,0,1,434
16,7,16086,1923,3,194,83,128,7,7,419,2,17,438
16,7,16086,1924,3,84,23,24,0,5,136,0,9,145
16,7,16086,1925,3,118,34,14,6,1,173,0,0,173
16,7,16086,1926,3,29,10,26,2,1,68,0,0,68
16,7,16086,1927,3,48,17,50,1,0,116,0,8,124
16,7,16086,1928,3,39,25,30,2,1,97,1,5,103
16,7,16086,1929,3,183,81,249,6,5,524,4,31,559
16,7,16086,1930,3,150,135,134,8,0,427,1,19,447
16,7,16086,1931,3,118,74,50,1,0,243,0,0,243
16,7,16086,1932,3,138,25,96,5,5,269,0,4,273
16,7,16086,1933,3,40,11,14,3,0,68,0,3,71
16,7,16086,1934,3,163,140,89,8,2,402,0,4,406
16,7,16086,1935,3,93,238,77,6,8,422,0,1,423
16,7,16086,1936,3,139,52,168,5,2,366,0,18,384
16,7,16086,1937,3,18,104,61,2,0,185,0,0,185
16,7,16086,1938,3,110,124,133,3,7,377,2,7,386
16,7,16108,2389,3,265,209,233,21,13,741,0,24,765
16,7,16108,2390,3,172,237,271,24,12,716,5,24,745
16,7,16108,2391,3,198,309,428,40,31,1006,11,27,1044
16,7,16108,2392,3,191,229,301,21,7,749,0,33,782
16,7,16108,2393,3,178,135,251,20,12,596,1,21,618
16,7,16108,2394,3,218,210,269,23,9,729,4,10,743
16,7,16108,2395,3,163,158,112,11,9,453,0,12,465
16,7,16108,2396,3,150,149,228,25,5,557,4,13,574
16,7,16108,2397,3,166,129,220,26,8,549,5,15,569
16,7,16108,2398,3,187,189,157,21,14,568,0,5,573
16,7,16108,2399,3,369,297,256,39,20,981,1,18,1000
16,7,16108,2400,3,141,141,115,15,10,422,0,13,435
16,7,16108,2401,3,148,145,129,23,4,449,1,12,462
16,7,16108,2402,3,114,155,143,16,12,440,0,11,451
16,7,16108,2403,3,243,261,223,26,10,763,0,10,773
16,7,16108,2404,3,376,305,245,39,26,991,2,16,1009
16,7,16108,2405,3,137,206,176,28,6,553,2,11,566
16,7,16108,2406,3,243,295,293,33,25,889,3,16,908
16,7,16108,2407,3,162,177,235,19,10,603,5,19,627
16,7,16108,2408,3,217,224,231,43,12,727,1,16,744
16,7,16108,2409,3,340,227,132,16,9,724,0,9,733
16,7,16108,2410,3,179,185,224,24,7,619,0,14,633
16,7,16108,2411,3,286,364,339,45,33,1067,0,33,1100
16,7,16108,2412,3,202,199,356,39,14,810,3,14,827
16,7,16108,2413,3,82,144,197,8,6,437,1,18,456
16,7,16108,2414,3,81,132,152,22,3,390,7,21,418
16,7,16108,2415,3,140,141,202,16,9,508,3,14,525
16,7,16108,2416,3,338,459,471,42,26,1336,12,39,1387
16,7,16108,2417,3,55,43,200,3,2,303,0,6,309
16,7,16108,2418,3,79,89,293,12,6,479,0,16,495
16,7,16108,2419,3,88,242,243,15,11,599,5,15,619
16,7,16108,2420,3,97,217,307,34,8,663,3,18,684
16,7,16108,2421,3,74,113,317,6,5,515,1,16,532
16,7,16108,2422,3,66,237,519,21,10,853,0,29,882
16,7,16108,2423,3,59,226,481,22,9,797,3,22,822
16,7,16108,2424,3,39,123,82,5,1,250,1,13,264
16,7,16108,2425,3,49,143,131,5,5,333,2,9,344
16,7,16108,2426,3,24,160,125,11,6,326,2,10,338
16,7,16108,2427,3,33,150,151,12,4,350,1,16,367
16,7,16108,2428,3,17,221,149,12,2,401,2,10,413
16,7,16108,2429,3,28,29,97,0,1,155,0,4,159
16,7,16108,2430,3,34,147,118,1,0,300,2,11,313
16,7,16108,2431,3,23,85,130,4,2,244,8,10,262
16,7,16108,2432,3,42,83,104,6,2,237,4,8,249
16,7,16108,2433,3,119,40,153,4,3,319,1,1,321
16,7,16108,2434,3,89,140,101,9,8,347,0,12,359
16,7,16108,2435,3,32,86,23,1,0,142,0,10,152
16,8,16054,941,3,268,127,227,32,23,677,1,15,693
16,8,16054,942,3,254,123,329,49,30,785,6,19,810
16,8,16054,943,3,218,75,201,17,19,530,1,17,548
16,8,16054,944,3,246,105,272,29,20,672,5,17,694
16,8,16054,945,3,263,131,373,30,33,830,3,21,854
16,8,16054,946,3,208,63,230,21,11,533,3,16,552
16,8,16054,947,3,233,96,189,35,22,575,2,21,598
16,8,16054,948,3,240,104,214,32,27,617,3,16,636
16,8,16054,949,3,347,217,622,70,47,1303,9,37,1349
16,8,16054,950,3,199,98,274,47,17,635,3,28,666
16,8,16054,951,3,232,133,250,27,16,658,0,25,683
16,8,16054,952,3,217,190,283,25,22,737,3,27,767
16,8,16054,953,3,826,254,616,90,77,1863,2,30,1895
16,8,16054,954,3,326,130,244,51,30,781,4,9,794
16,8,16054,955,3,379,152,325,55,44,955,1,18,974
16,8,16054,956,3,364,148,299,43,37,891,3,14,908
16,8,16054,957,3,213,122,141,15,13,504,0,3,507
16,8,16054,958,3,509,269,469,72,45,1364,7,23,1394
16,8,16054,959,3,258,126,264,47,34,729,3,20,752
16,8,16054,960,3,347,152,329,52,46,926,5,15,946
16,8,16054,961,3,165,80,165,33,16,459,0,17,476
16,8,16054,962,3,251,100,213,36,32,632,1,23,656
16,8,16054,963,3,309,136,307,46,19,817,0,25,842
16,8,16054,964,3,324,116,248,39,29,756,4,12,772
16,8,16054,965,3,334,146,235,41,18,774,1,16,791
16,8,16054,966,3,297,146,218,43,23,727,5,34,766
16,8,16054,967,3,265,114,202,35,35,651,2,3,656
16,8,16054,996,3,222,75,186,18,10,511,2,9,522
16,8,16054,997,3,333,147,248,47,16,791,4,15,810
16,8,16054,998,3,344,160,302,43,30,879,6,8,893
16,8,16054,999,3,320,131,246,49,24,770,1,19,790
16,8,16054,1000,3,248,121,186,24,21,600,3,6,609
16,8,16054,1001,3,278,113,253,43,14,701,3,23,727
16,8,16054,1002,3,232,108,216,36,19,611,0,13,624
16,8,16054,1003,3,231,99,204,27,23,584,1,21,606
16,8,16054,1004,3,331,136,285,45,24,821,5,24,850
16,8,16054,1005,3,332,155,360,36,36,919,0,28,947
16,8,16054,1006,3,333,180,215,43,19,790,5,8,803
16,8,16054,1007,3,393,166,258,46,25,888,0,21,909
16,8,16054,1008,3,405,146,230,54,21,856,1,26,883
16,8,16054,1009,3,305,120,243,51,34,753,3,11,767
16,8,16054,1010,3,305,145,233,55,26,764,6,12,782
16,8,16054,1011,3,307,145,285,30,37,804,1,18,823
16,8,16054,1012,3,343,103,300,28,26,800,1,31,832
16,8,16054,1013,3,321,111,272,29,23,756,2,16,774
16,8,16054,1014,3,246,152,263,40,26,727,4,8,739
16,8,16054,1015,3,244,150,345,33,34,806,0,30,836
16,8,16054,1016,3,285,123,195,41,19,663,0,23,686
16,8,16054,1017,3,155,95,193,23,20,486,0,11,497
16,8,16054,1018,3,238,113,177,25,22,575,3,10,588
16,8,16054,1019,3,231,117,222,29,18,617,3,16,636
16,8,16054,1020,3,326,198,303,44,15,886,2,17,905
16,8,16054,1021,3,275,111,196,37,26,645,8,12,665
16,8,16054,1022,3,149,57,98,14,14,332,1,1,334
16,8,16054,1023,3,146,72,110,19,19,366,1,6,373
16,8,16054,1052,3,381,121,249,56,31,838,24,16,878
16,8,16054,1053,3,344,173,327,49,48,941,1,14,956
16,8,16054,1054,3,221,79,200,26,18,544,1,10,555
16,8,16054,1055,3,208,99,164,40,28,539,6,11,556
16,8,16054,1056,3,187,134,219,29,26,595,0,15,610
16,8,16054,1057,3,368,133,377,44,47,969,1,16,986
16,8,16054,1058,3,248,106,253,46,18,671,0,34,705
16,8,16054,1059,3,582,218,597,55,37,1489,9,33,1531
16,8,16054,1060,3,396,178,366,57,50,1047,8,24,1079
16,8,16054,1061,3,95,67,107,12,6,287,1,3,291
16,8,16054,1141,3,416,162,350,42,33,1003,3,17,1023
16,8,16054,1142,3,474,184,168,42,23,891,0,9,900
16,8,16054,1143,3,343,148,334,47,29,901,2,30,933
16,8,16054,1144,3,238,142,254,35,24,693,0,15,708
16,8,16054,1145,3,376,153,245,36,29,839,0,12,851
16,8,16054,1146,3,197,73,192,27,14,503,2,20,525
16,8,16054,1147,3,342,229,345,56,43,1015,4,25,1044
16,8,16054,1148,3,276,140,202,42,30,690,1,15,706
16,8,16054,1149,3,189,82,226,32,10,539,3,5,547
16,8,16054,1150,3,309,119,288,47,35,798,4,14,816
16,8,16054,1151,3,226,137,203,22,16,604,1,4,609
16,8,16054,1152,3,320,100,180,36,20,656,1,2,659
16,8,16054,1153,3,253,108,110,24,8,503,0,7,510
16,8,16054,1160,3,871,307,629,93,83,1983,1,26,2010
16,8,16054,1161,3,323,133,242,28,30,756,1,16,773
16,8,16054,1191,3,1086,619,845,179,114,2843,8,83,2934
16,8,16054,1192,3,1116,481,1140,161,100,2998,18,121,3137
16,8,16054,1193,3,624,363,767,93,88,1935,12,38,1985
16,8,16054,1197,3,359,111,458,58,43,1029,1,29,1059
16,8,16054,1198,3,566,273,491,81,50,1461,11,23,1495
16,8,16054,1199,3,410,249,420,69,55,1203,2,28,1233
16,8,16054,1200,3,385,141,376,30,28,960,3,42,1005
16,8,16054,1201,3,346,194,332,51,37,960,8,31,999
16,8,16054,1202,3,562,199,574,96,67,1498,4,22,1524
16,8,16054,1203,3,476,211,368,50,42,1147,0,27,1174
16,8,16054,1204,3,349,142,390,50,38,969,1,28,998
16,8,16054,1208,3,455,102,313,39,36,945,4,26,975
16,8,16054,1209,3,373,113,353,49,36,924,2,27,953
16,8,16054,1210,3,250,100,163,30,24,567,3,9,579
16,8,16054,1211,3,494,173,338,55,20,1080,1,22,1103
16,8,16054,1212,3,454,198,376,60,41,1129,2,28,1159
16,8,16054,1213,3,327,121,221,40,28,737,2,18,757
16,8,16054,1214,3,365,202,306,36,35,944,3,19,966
16,8,16054,1215,3,715,231,661,74,61,1742,8,53,1803
16,8,16054,1216,3,936,480,984,143,80,2623,21,62,2706
16,8,16054,1217,3,394,220,347,56,38,1055,1,19,1075
16,8,16054,1218,3,390,104,306,48,26,874,4,32,910
16,8,16054,1219,3,432,156,347,63,41,1039,2,25,1066
16,8,16054,1220,3,521,178,375,68,47,1189,12,20,1221
16,8,16054,1221,3,1461,508,1117,166,131,3383,14,68,3465
16,8,16054,1222,3,560,213,563,77,60,1473,9,28,1510
16,8,16054,1239,3,370,288,226,20,19,923,4,36,963
16,8,16054,1240,3,282,217,208,30,18,755,6,35,796
16,8,16054,1241,3,276,160,326,33,19,814,7,23,844
16,8,16054,1242,3,257,165,390,45,34,891,3,28,922
16,8,16054,1243,3,104,30,104,11,3,252,0,11,263
16,8,16054,1244,3,148,96,153,12,9,418,1,9,428
16,8,16054,1245,3,194,125,213,23,15,570,7,22,599
16,8,16054,1246,3,72,35,52,6,4,169,1,10,180
16,8,16054,1247,3,98,336,208,16,7,665,4,25,694
16,8,16054,1248,3,151,72,91,12,7,333,4,25,362
16,8,16054,1249,3,148,93,94,16,10,361,5,16,382
16,8,16054,1250,3,281,188,428,36,15,948,6,25,979
16,8,16054,1251,3,176,95,340,14,7,632,3,25,660
16,8,16054,1252,3,98,156,432,9,7,702,0,32,734
16,8,16054,1253,3,58,147,124,4,1,334,4,7,345
16,8,16054,1254,3,113,64,58,9,1,245,1,6,252
16,8,16054,1255,3,97,227,72,6,4,406,0,9,415
16,8,16054,1256,3,180,172,72,24,7,455,3,31,489
16,8,16054,1257,3,102,122,31,9,3,267,1,19,287
16,8,16054,1258,3,23,31,61,6,1,122,1,6,129
16,8,16054,1259,3,24,69,57,3,0,153,2,12,167
16,8,16054,1260,3,219,109,89,8,8,433,0,18,451
16,8,16054,1261,3,181,174,82,22,5,464,0,20,484
16,8,16054,1263,3,1023,490,846,141,81,2581,13,66,2660
16,8,16054,1264,3,397,229,321,55,36,1038,10,25,1073
16,8,16054,1265,3,254,108,88,8,7,465,2,14,481
16,8,16054,1266,3,259,136,97,21,11,524,5,34,563
16,8,16054,1267,3,436,219,274,40,34,1003,11,36,1050
16,8,16054,1268,3,1263,458,810,201,88,2820,7,57,2884
16,8,16054,1271,3,465,246,426,58,30,1225,15,59,1299
16,8,16054,1272,3,68,57,121,1,1,248,0,14,262
16,8,16054,1277,3,224,169,235,29,17,674,4,35,713
16,8,16054,1278,3,81,79,131,4,3,298,0,9,307
16,8,16054,1281,3,12,10,80,2,1,105,0,5,110
16,8,16054,1282,3,55,27,274,4,5,365,3,14,382
16,8,16054,1283,3,860,460,929,144,86,2479,14,49,2542
16,8,16054,1286,3,414,255,468,44,34,1215,5,46,1266
16,8,16054,1287,3,98,30,115,16,14,273,6,7,286
16,8,16054,2677,3,94,95,78,13,5,285,1,10,296
16,9,16033,467,3,79,221,368,11,4,683,1,19,703
16,9,16033,468,3,34,58,192,3,2,289,2,20,311
16,9,16033,469,3,70,139,426,17,7,659,3,15,677
16,9,16033,470,3,44,129,351,9,4,537,0,21,558
16,9,16033,471,3,93,125,504,21,6,749,0,21,770
16,9,16033,472,3,86,174,266,11,3,540,0,15,555
16,9,16033,473,3,86,195,389,13,6,689,3,2,694
16,9,16033,474,3,44,170,437,5,1,657,1,12,670
16,9,16033,475,3,52,136,311,9,7,515,2,4,521
16,9,16033,476,3,60,46,347,8,5,466,0,8,474
16,9,16033,477,3,31,150,346,4,5,536,0,7,543
16,9,16033,478,3,25,139,280,6,5,455,4,6,465
16,9,16033,479,3,6,60,50,1,1,118,0,5,123
16,9,16059,1349,3,77,274,153,2,5,511,1,21,533
16,9,16059,1350,3,79,381,244,17,4,725,1,2,728
16,9,16059,1351,3,121,479,228,11,6,845,0,16,861
16,9,16059,1352,3,86,627,174,15,6,908,4,14,926
16,9,16059,1353,3,165,427,392,13,10,1007,4,19,1030
16,9,16059,1354,3,163,462,420,37,9,1091,0,19,1110
16,9,16059,1355,3,33,90,148,6,3,280,1,7,288
16,9,16059,1356,3,56,123,223,6,4,412,1,4,417
16,9,16059,1357,3,65,66,138,9,2,280,0,10,290
16,9,16059,1358,3,7,35,18,0,1,61,0,0,61
16,9,16059,1359,3,38,33,31,2,1,105,0,3,108
16,9,16088,1950,3,165,209,202,18,1,595,1,20,616
16,9,16088,1951,3,196,249,292,39,13,789,1,4,794
16,9,16088,1952,3,214,309,268,50,8,849,1,13,863
16,9,16088,1953,3,152,340,188,33,8,721,2,13,736
16,9,16088,1954,3,80,84,267,12,6,449,7,7,463
16,9,16088,1955,3,93,166,469,13,10,751,3,21,775
16,9,16088,1956,3,33,232,155,9,3,432,0,6,438
16,9,16088,1957,3,89,70,250,6,2,417,6,11,434
16,9,16088,1958,3,24,35,95,2,1,157,2,8,167
16,9,16091,1995,3,109,182,292,30,1,614,1,7,622
16,9,16091,1996,3,197,232,472,45,11,957,7,3,967
16,9,16091,1997,3,117,175,476,29,15,812,1,11,824
16,9,16091,1998,3,162,178,274,30,15,659,1,3,663
16,9,16091,1999,3,96,139,249,28,4,516,7,33,556
16,9,16091,2000,3,138,145,366,32,17,698,6,28,732
16,9,16091,2001,3,56,67,210,7,6,346,0,4,350
16,9,16103,2175,3,219,101,401,29,16,766,5,15,786
16,9,16103,2176,3,427,98,161,24,22,732,0,12,744
16,9,16103,2177,3,210,139,333,33,24,739,4,24,767
16,9,16103,2178,3,101,66,199,19,9,394,1,12,407
16,9,16103,2179,3,255,142,411,36,26,870,8,16,894
16,9,16103,2180,3,164,122,282,21,16,605,1,8,614
16,9,16103,2181,3,179,173,311,26,23,712,16,18,746
16,9,16103,2182,3,425,156,250,29,13,873,3,12,888
16,9,16103,2183,3,181,87,181,23,14,486,0,5,491
16,9,16103,2184,3,234,149,291,49,28,751,4,20,775
16,9,16103,2185,3,428,173,367,65,48,1081,4,33,1118
16,9,16103,2186,3,263,132,251,41,25,712,3,18,733
16,9,16103,2187,3,286,137,298,43,16,780,7,20,807
16,9,16103,2188,3,237,115,260,47,20,679,0,23,702
16,9,16103,2189,3,267,135,350,39,20,811,1,17,829
16,9,16103,2190,3,189,88,169,25,22,493,2,9,504
16,9,16103,2191,3,216,94,228,25,19,582,2,19,603
16,9,16103,2192,3,223,94,226,27,13,583,2,8,593
16,9,16103,2193,3,188,104,252,38,17,599,0,5,604
16,9,16103,2194,3,197,131,248,57,24,657,6,3,666
16,9,16103,2195,3,212,142,488,36,24,902,8,21,931
16,9,16103,2196,3,137,92,264,52,21,566,4,9,579
16,9,16103,2197,3,136,84,342,41,22,625,6,26,657
16,9,16103,2198,3,143,165,449,38,16,811,3,25,839
16,9,16103,2199,3,281,118,200,31,17,647,2,11,660
16,9,16103,2200,3,200,106,293,31,20,650,0,17,667
16,9,16103,2201,3,326,128,239,51,44,788,4,11,803
16,9,16103,2202,3,188,100,227,38,9,562,5,10,577
16,9,16103,2203,3,234,141,231,27,26,659,4,25,688
16,9,16103,2204,3,223,86,179,27,20,535,0,15,550
16,9,16103,2205,3,168,87,126,15,8,404,0,10,414
16,9,16103,2206,3,264,187,299,37,18,805,3,17,825
16,9,16103,2207,3,332,185,364,46,26,953,9,20,982
16,9,16103,2208,3,217,93,225,36,22,593,1,21,615
16,9,16103,2209,3,136,106,230,31,17,520,3,12,535
16,9,16103,2210,3,171,133,256,37,24,621,4,22,647
16,9,16103,2211,3,239,163,253,52,15,722,2,12,736
16,9,16103,2212,3,226,213,194,19,22,674,1,7,682
16,9,16103,2213,3,279,200,243,28,23,773,1,10,784
16,9,16103,2214,3,251,105,214,42,22,634,2,10,646
16,9,16103,2215,3,334,91,177,35,19,656,0,13,669
16,9,16103,2216,3,292,48,117,24,23,504,0,7,511
16,9,16103,2217,3,243,77,148,30,13,511,2,11,524
16,9,16103,2218,3,137,118,278,28,12,573,4,6,583
16,9,16103,2219,3,321,215,529,102,38,1205,16,28,1249
16,9,16103,2220,3,354,105,198,34,20,711,0,13,724
16,9,16103,2221,3,267,77,145,22,11,522,1,4,527
16,9,16103,2222,3,236,111,163,19,18,547,1,6,554
16,9,16103,2223,3,208,100,142,32,16,498,1,6,505
16,9,16103,2224,3,245,100,180,24,13,562,0,11,573
16,9,16103,2225,3,245,154,322,52,29,802,1,17,820
16,9,16103,2226,3,317,185,293,52,23,870,3,10,883
16,9,16103,2227,3,245,131,270,34,22,702,0,13,715
16,9,16103,2228,3,235,108,246,43,20,652,6,9,667
16,9,16103,2229,3,534,191,496,76,48,1345,7,15,1367
16,9,16103,2230,3,207,116,312,36,27,698,1,26,725
16,9,16103,2231,3,236,107,311,40,20,714,5,13,732
16,9,16103,2232,3,197,87,249,57,16,606,3,16,625
16,9,16103,2233,3,167,57,164,20,10,418,3,17,438
16,9,16103,2234,3,250,101,244,48,23,666,4,13,683
16,9,16103,2235,3,141,96,341,36,20,634,1,5,640
16,9,16103,2236,3,317,67,143,11,10,548,0,4,552
16,9,16103,2237,3,178,62,70,16,6,332,2,5,339
16,9,16103,2238,3,280,95,237,60,26,698,9,15,722
16,9,16103,2239,3,423,140,226,48,25,862,0,20,882
16,9,16103,2240,3,314,63,155,25,14,571,2,3,576
16,9,16103,2241,3,317,105,163,25,17,627,4,9,640
16,9,16103,2242,3,280,79,113,20,14,506,0,13,519
16,9,16103,2243,3,199,130,371,21,22,743,0,31,774
16,9,16103,2244,3,200,140,265,55,21,681,2,17,700
16,9,16103,2245,3,140,83,221,27,14,485,0,17,502
16,9,16103,2246,3,116,79,118,53,11,377,8,9,394
16,9,16103,2247,3,216,97,225,30,16,584,0,11,595
16,9,16103,2248,3,286,172,414,48,35,955,6,20,981
16,9,16103,2249,3,192,152,366,70,33,813,3,24,840
16,9,16103,2250,3,249,139,425,52,17,882,3,27,912
16,9,16103,2251,3,315,173,388,61,28,965,6,22,993
16,9,16103,2252,3,271,125,258,64,21,739,2,12,753
16,9,16103,2253,3,425,141,280,79,38,963,1,16,980
16,9,16103,2254,3,327,195,355,60,21,958,0,31,989
16,9,16103,2255,3,404,144,205,22,23,798,1,11,810
16,9,16103,2256,3,437,183,332,58,41,1051,0,14,1065
16,9,16103,2257,3,255,90,131,32,12,520,1,10,531
16,9,16103,2258,3,232,99,125,29,13,498,4,6,508
16,9,16103,2259,3,391,129,283,47,25,875,8,10,893
16,9,16103,2260,3,236,126,410,51,21,844,3,13,860
16,9,16103,2261,3,350,184,484,47,34,1099,8,34,1141
16,9,16103,2262,3,263,150,325,42,29,809,6,14,829
16,9,16103,2263,3,465,192,329,54,44,1084,5,8,1097
16,9,16103,2264,3,326,135,278,34,19,792,12,8,812
16,9,16103,2265,3,330,91,191,30,12,654,4,15,673
16,9,16103,2266,3,244,148,261,42,17,712,3,12,727
16,9,16103,2267,3,402,143,361,47,35,988,3,25,1016
16,9,16103,2268,3,255,243,312,49,16,875,4,23,902
16,9,16103,2269,3,336,259,535,71,28,1229,6,41,1276
16,9,16103,2270,3,186,60,198,19,16,479,6,12,497
16,9,16103,2271,3,470,127,289,28,26,940,2,7,949
16,9,16103,2272,3,442,94,195,24,13,768,3,13,784
16,9,16103,2273,3,529,196,258,40,33,1056,1,19,1076
16,9,16103,2274,3,305,96,269,34,10,714,1,16,731
16,9,16103,2275,3,250,102,295,40,30,717,2,17,736
16,9,16103,2276,3,230,94,280,31,30,665,5,11,681
16,9,16103,2277,3,237,116,250,26,17,646,0,17,663
16,9,16103,2278,3,159,93,221,30,12,515,2,18,535
16,9,16103,2279,3,190,72,215,11,6,494,1,14,509
16,9,16103,2280,3,388,136,388,29,8,949,5,5,959
16,9,16103,2281,3,203,112,161,40,17,533,3,7,543
16,9,16103,2282,3,307,156,367,41,29,900,0,6,906
16,9,16103,2283,3,458,215,336,101,44,1154,0,21,1175
16,9,16103,2284,3,310,175,290,49,30,854,1,23,878
16,9,16103,2285,3,386,137,274,40,20,857,4,14,875
16,9,16103,2286,3,421,110,227,45,35,838,2,16,856
16,9,16103,2287,3,320,188,264,46,21,839,3,18,860
16,9,16103,2288,3,243,161,224,34,20,682,3,16,701
16,9,16103,2289,3,282,146,231,20,20,699,0,13,712
16,9,16103,2290,3,291,137,306,33,21,788,1,14,803
16,9,16103,2291,3,392,108,223,42,30,795,2,21,818
16,9,16103,2292,3,346,143,273,26,21,809,5,14,828
16,9,16103,2293,3,1103,568,1313,188,91,3263,11,49,3323
16,9,16103,2294,3,128,64,145,16,1,354,3,11,368
16,9,16103,2295,3,256,106,294,11,7,674,3,23,700
16,9,16103,2296,3,269,74,274,10,6,633,4,24,661
16,9,16103,2297,3,120,88,484,38,17,747,1,16,764
16,9,16103,2298,3,128,111,316,30,8,593,0,18,611
16,9,16103,2299,3,104,54,324,12,4,498,4,34,536
16,9,16103,2300,3,120,46,312,10,2,490,0,32,522
16,9,16103,2301,3,73,60,167,5,3,308,3,13,324
16,9,16103,2302,3,53,69,167,4,1,294,2,5,301
16,9,16103,2303,3,54,72,251,7,1,385,0,8,393
16,9,16103,2304,3,49,66,267,7,7,396,1,6,403
16,9,16103,2305,3,251,141,207,14,7,620,4,28,652
16,9,16103,2306,3,143,91,104,10,3,351,1,11,363
16,9,16103,2307,3,41,29,70,4,1,145,1,4,150
16,9,16103,2308,3,125,115,83,11,10,344,1,6,351
16,9,16103,2309,3,189,110,372,41,19,731,9,29,769
16,9,16103,2310,3,150,109,167,18,5,449,3,14,466
16,9,16103,2311,3,231,85,244,22,16,598,10,18,626
16,9,16103,2312,3,147,144,154,20,9,474,6,6,486
16,9,16103,2313,3,102,41,86,8,3,240,1,8,249
16,9,16103,2314,3,118,45,132,7,5,307,2,8,317
16,9,16103,2315,3,52,23,18,3,4,100,2,7,109
16,9,16103,2316,3,59,122,194,13,4,392,6,15,413
16,9,16112,2570,3,208,365,196,45,22,836,5,14,855
16,9,16112,2571,3,145,187,181,19,17,549,3,30,582
16,9,16112,2572,3,109,364,706,85,11,1275,0,27,1302
16,9,16112,2573,3,301,89,459,30,6,885,11,12,908
16,9,16112,2574,3,130,162,235,9,5,541,1,8,550
16,9,16112,2575,3,38,102,243,11,3,397,0,11,408
16,9,16112,2576,3,43,46,340,6,5,440,0,10,450
16,9,16112,2577,3,32,55,36,1,1,125,1,7,133
16,10,16054,968,3,270,126,220,25,16,657,3,27,687
16,10,16054,969,3,294,166,284,29,14,787,6,38,831
16,10,16054,970,3,295,142,249,56,24,766,0,33,799
16,10,16054,971,3,148,37,170,3,4,362,6,8,376
16,10,16054,972,3,262,97,254,37,21,671,1,10,682
16,10,16054,973,3,177,78,192,18,13,478,5,14,497
16,10,16054,974,3,138,36,99,19,7,299,1,5,305
16,10,16054,975,3,59,48,85,21,8,221,0,9,230
16,10,16054,976,3,157,68,97,24,13,359,1,5,365
16,10,16054,977,3,135,90,115,35,16,391,0,5,396
16,10,16054,978,3,596,197,367,64,31,1255,0,35,1290
16,10,16054,979,3,211,62,188,26,14,501,3,15,519
16,10,16054,980,3,274,104,219,33,27,657,0,27,684
16,10,16054,981,3,160,81,167,22,10,440,4,15,459
16,10,16054,982,3,208,70,167,23,14,482,5,7,494
16,10,16054,983,3,319,112,234,43,22,730,5,16,751
16,10,16054,984,3,283,103,197,36,20,639,2,28,669
16,10,16054,985,3,315,97,235,18,15,680,4,22,706
16,10,16054,986,3,132,42,146,17,5,342,0,11,353
16,10,16054,987,3,146,59,117,13,12,347,0,10,357
16,10,16054,988,3,231,78,219,28,11,567,5,24,596
16,10,16054,989,3,266,93,295,37,19,710,0,26,736
16,10,16054,990,3,168,48,103,18,7,344,0,6,350
16,10,16054,991,3,205,80,151,36,19,491,2,17,510
16,10,16054,992,3,262,99,217,31,15,624,3,21,648
16,10,16054,993,3,117,68,119,17,11,332,2,8,342
16,10,16054,994,3,288,115,218,28,33,682,0,19,701
16,10,16054,995,3,328,126,212,21,21,708,1,13,722
16,10,16054,1024,3,171,68,72,19,15,345,0,7,352
16,10,16054,1025,3,199,62,103,17,12,393,3,10,406
16,10,16054,1026,3,242,87,114,16,18,477,0,10,487
16,10,16054,1027,3,172,45,55,7,8,287,2,8,297
16,10,16054,1028,3,218,40,62,5,9,334,3,9,346
16,10,16054,1029,3,274,91,118,17,14,514,4,13,531
16,10,16054,1030,3,286,125,165,20,24,620,3,10,633
16,10,16054,1031,3,286,98,214,38,24,660,0,24,684
16,10,16054,1032,3,291,109,266,34,19,719,1,19,739
16,10,16054,1033,3,372,150,347,42,19,930,8,20,958
16,10,16054,1034,3,328,143,232,35,17,755,1,22,778
16,10,16054,1035,3,746,247,584,93,49,1719,13,50,1782
16,10,16054,1036,3,480,158,349,49,34,1070,3,34,1107
16,10,16054,1037,3,509,161,325,39,28,1062,5,14,1081
16,10,16054,1038,3,388,121,308,57,27,901,2,18,921
16,10,16054,1039,3,404,138,237,44,32,855,3,20,878
16,10,16054,1040,3,378,120,259,43,24,824,0,8,832
16,10,16054,1041,3,268,83,180,35,17,583,1,15,599
16,10,16054,1042,3,232,64,127,13,12,448,0,5,453
16,10,16054,1043,3,230,65,68,16,8,387,0,10,397
16,10,16054,1044,3,312,90,169,31,14,616,2,7,625
16,10,16054,1045,3,395,133,199,29,21,777,0,11,788
16,10,16054,1046,3,262,91,192,18,12,575,0,15,590
16,10,16054,1047,3,314,100,206,32,22,674,1,20,695
16,10,16054,1048,3,234,115,128,32,10,519,0,5,524
16,10,16054,1049,3,249,110,107,25,22,513,1,7,521
16,10,16054,1050,3,267,100,226,29,17,639,0,9,648
16,10,16054,1051,3,311,99,245,42,23,720,8,10,738
16,10,16054,1062,3,268,148,168,35,22,641,4,14,659
16,10,16054,1063,3,264,104,251,24,26,669,2,17,688
16,10,16054,1064,3,316,127,175,28,29,675,1,19,695
16,10,16054,1065,3,172,51,101,11,11,346,0,10,356
16,10,16054,1066,3,277,161,191,21,23,673,2,26,701
16,10,16054,1067,3,268,96,116,18,27,525,1,11,537
16,10,16054,1068,3,205,101,65,10,15,396,2,6,404
16,10,16054,1069,3,186,71,129,15,4,405,3,10,418
16,10,16054,1070,3,377,114,141,22,18,672,0,4,676
16,10,16054,1071,3,247,109,152,19,17,544,2,13,559
16,10,16054,1072,3,402,87,86,11,16,602,0,10,612
16,10,16054,1073,3,289,130,78,8,8,513,0,13,526
16,10,16054,1074,3,487,116,86,24,17,730,2,13,745
16,10,16054,1075,3,276,103,55,18,13,465,0,11,476
16,10,16054,1076,3,498,166,226,54,25,969,2,15,986
16,10,16054,1077,3,667,145,250,76,23,1161,3,20,1184
16,10,16054,1078,3,508,154,176,62,25,925,2,24,951
16,10,16054,1079,3,294,136,75,10,12,527,0,11,538
16,10,16054,1080,3,323,92,75,14,9,513,1,7,521
16,10,16054,1081,3,379,143,187,28,23,760,3,10,773
16,10,16054,1082,3,345,93,205,46,24,713,1,17,731
16,10,16054,1083,3,194,130,126,25,11,486,1,9,496
16,10,16054,1084,3,331,111,225,59,21,747,0,38,785
16,10,16054,1085,3,473,135,224,43,26,901,1,23,925
16,10,16054,1086,3,460,134,209,73,21,897,1,16,914
16,10,16054,1087,3,415,171,209,54,32,881,0,19,900
16,10,16054,1088,3,303,97,127,27,14,568,2,14,584
16,10,16054,1089,3,344,165,231,44,26,810,0,10,820
16,10,16054,1090,3,179,142,136,39,18,514,0,14,528
16,10,16054,1091,3,203,99,121,29,16,468,0,8,476
16,10,16054,1092,3,435,162,156,44,33,830,2,23,855
16,10,16054,1093,3,465,141,241,47,28,922,2,12,936
16,10,16054,1094,3,316,100,204,35,19,674,2,23,699
16,10,16054,1095,3,222,71,162,21,14,490,1,8,499
16,10,16054,1096,3,352,121,216,49,21,759,0,3,762
16,10,16054,1097,3,538,138,293,42,34,1045,2,26,1073
16,10,16054,1098,3,312,85,207,21,14,639,1,24,664
16,10,16054,1099,3,356,133,256,23,21,789,0,28,817
16,10,16054,1100,3,319,130,238,33,26,746,2,24,772
16,10,16054,1101,3,513,197,355,44,27,1136,2,25,1163
16,10,16054,1102,3,408,141,274,47,16,886,0,21,907
16,10,16054,1103,3,370,180,277,52,23,902,4,28,934
16,10,16054,1104,3,207,157,253,46,27,690,5,22,717
16,10,16054,1105,3,270,112,176,31,17,606,5,8,619
16,10,16054,1106,3,315,187,308,36,23,869,4,33,906
16,10,16054,1107,3,1353,583,523,94,73,2626,17,27,2670
16,10,16054,1108,3,403,148,268,41,31,891,7,23,921
16,10,16054,1109,3,266,108,214,25,16,629,3,21,653
16,10,16054,1110,3,499,178,164,15,21,877,0,7,884
16,10,16054,1111,3,625,188,96,13,15,937,1,9,947
16,10,16054,1112,3,409,135,151,23,12,730,2,10,742
16,10,16054,1113,3,342,143,118,26,16,645,0,11,656
16,10,16054,1114,3,456,176,96,21,10,759,1,13,773
16,10,16054,1115,3,479,167,125,37,20,828,1,20,849
16,10,16054,1116,3,425,161,127,28,18,759,1,11,771
16,10,16054,1117,3,430,130,96,26,11,693,0,13,706
16,10,16054,1118,3,437,139,93,24,12,705,4,3,712
16,10,16054,1119,3,368,147,105,31,10,661,2,10,673
16,10,16054,1120,3,414,146,148,31,23,762,0,19,781
16,10,16054,1121,3,460,155,204,41,22,882,1,23,906
16,10,16054,1122,3,331,140,215,42,14,742,1,22,765
16,10,16054,1123,3,217,118,203,35,17,590,0,12,602
16,10,16054,1124,3,261,122,121,25,23,552,0,10,562
16,10,16054,1125,3,462,156,298,48,40,1004,0,26,1030
16,10,16054,1126,3,383,168,246,56,38,891,0,27,918
16,10,16054,1127,3,283,119,170,30,24,626,2,23,651
16,10,16054,1128,3,353,154,284,41,26,858,3,29,890
16,10,16054,1129,3,260,136,329,41,40,806,0,24,830
16,10,16054,1130,3,221,117,153,20,13,524,2,13,539
16,10,16054,1131,3,334,110,300,37,30,811,3,27,841
16,10,16054,1132,3,237,99,157,28,20,541,1,15,557
16,10,16054,1133,3,265,160,211,30,17,683,0,19,702
16,10,16054,1134,3,273,94,176,25,20,588,0,15,603
16,10,16054,1135,3,361,127,227,35,33,783,1,19,803
16,10,16054,1136,3,306,134,277,30,30,777,0,25,802
16,10,16054,1137,3,322,105,273,35,29,764,4,20,788
16,10,16054,1138,3,293,104,266,24,27,714,3,14,731
16,10,16054,1139,3,227,104,233,21,33,618,8,22,648
16,10,16054,1140,3,193,86,147,27,11,464,2,9,475
16,10,16054,1154,3,155,71,111,24,6,367,0,12,379
16,10,16054,1155,3,313,169,295,40,31,848,14,9,871
16,10,16054,1156,3,97,81,129,12,8,327,0,6,333
16,10,16054,1157,3,144,90,170,28,17,449,0,9,458
16,10,16054,1158,3,553,200,372,59,49,1233,1,37,1271
16,10,16054,1159,3,807,279,537,81,62,1766,2,25,1793
16,10,16054,1162,3,289,99,189,33,21,631,3,13,647
16,10,16054,1163,3,238,70,126,20,8,462,1,9,472
16,10,16054,1164,3,376,127,200,45,24,772,2,11,785
16,10,16054,1165,3,429,164,344,55,31,1023,7,16,1046
16,10,16054,1166,3,563,189,327,42,50,1171,1,16,1188
16,10,16054,1167,3,270,124,215,27,20,656,0,17,673
16,10,16054,1168,3,346,160,213,30,23,772,1,15,788
16,10,16054,1169,3,383,147,296,42,30,898,0,24,922
16,10,16054,1170,3,312,157,275,32,25,801,5,18,824
16,10,16054,1171,3,300,123,133,29,20,605,0,12,617
16,10,16054,1172,3,353,168,220,37,28,806,2,9,817
16,10,16054,1173,3,314,105,98,12,17,546,0,12,558
16,10,16054,1174,3,368,109,155,29,18,679,0,12,691
16,10,16054,1175,3,414,137,196,28,22,797,0,5,802
16,10,16054,1176,3,261,87,102,19,9,478,2,12,492
16,10,16054,1177,3,325,152,187,33,22,719,6,12,737
16,10,16054,1178,3,356,122,194,43,24,739,0,17,756
16,10,16054,1179,3,911,300,282,51,33,1577,2,27,1606
16,10,16054,1180,3,172,60,61,14,6,313,0,7,320
16,10,16054,1181,3,398,162,148,41,28,777,3,20,800
16,10,16054,1182,3,500,195,159,24,21,899,3,11,913
16,10,16054,1183,3,386,123,97,15,14,635,1,9,645
16,10,16054,1184,3,603,218,237,66,27,1151,2,25,1178
16,10,16054,1185,3,522,168,189,44,22,945,7,15,967
16,10,16054,1186,3,576,218,147,23,16,980,0,16,996
16,10,16054,1187,3,476,149,147,22,22,816,1,20,837
16,10,16054,1188,3,623,218,125,13,19,998,3,12,1013
16,10,16054,1189,3,331,111,235,33,27,737,3,14,754
16,10,16054,1190,3,309,96,245,22,28,700,3,8,711
16,10,16054,1194,3,580,260,652,87,50,1629,5,63,1697
16,10,16054,1195,3,446,185,389,73,34,1127,1,33,1161
16,10,16054,1196,3,520,306,534,103,32,1495,10,47,1552
16,10,16054,1205,3,396,189,287,71,18,961,4,22,987
16,10,16054,1206,3,719,239,484,92,44,1578,1,35,1614
16,10,16054,1207,3,407,141,293,46,30,917,1,11,929
16,10,16054,1223,3,454,151,118,20,19,762,1,8,771
16,10,16054,1224,3,754,214,408,49,53,1478,15,48,1541
16,10,16054,1225,3,820,298,340,49,66,1573,5,37,1615
16,10,16054,1226,3,639,233,333,47,40,1292,1,33,1326
16,10,16054,1227,3,141,64,108,9,12,334,0,2,336
16,10,16054,1228,3,662,225,330,73,55,1345,0,31,1376
16,10,16054,1229,3,319,191,231,41,31,813,6,27,846
16,10,16054,1230,3,242,148,220,34,25,669,3,24,696
16,10,16054,1231,3,180,82,170,24,17,473,1,17,491
16,10,16054,1232,3,357,145,707,35,29,1273,11,55,1339
16,10,16054,1233,3,749,269,695,82,53,1848,18,25,1891
16,10,16054,1234,3,238,92,302,29,21,682,2,21,705
16,10,16054,1235,3,256,155,229,22,15,677,9,27,713
16,10,16054,1236,3,347,101,327,28,25,828,7,45,880
16,10,16054,1237,3,161,164,89,11,7,432,2,32,466
16,10,16054,1238,3,153,144,92,13,4,406,2,20,428
16,10,16054,1262,3,256,237,482,40,15,1030,4,35,1069
16,10,16054,1269,3,85,55,103,4,4,251,9,19,279
16,10,16054,1270,3,281,211,477,23,25,1017,6,33,1056
16,10,16054,1273,3,116,96,107,0,5,324,3,19,346
16,10,16054,1274,3,35,7,48,0,2,92,0,1,93
16,10,16054,1275,3,48,26,39,1,0,114,0,7,121
16,10,16054,1276,3,259,168,207,22,14,670,7,29,706
16,10,16054,1279,3,115,51,123,8,6,303,7,33,343
16,10,16054,1280,3,222,77,229,10,12,550,2,24,576
16,10,16054,1284,3,374,369,343,60,38,1184,13,24,1221
16,10,16054,1285,3,347,165,411,63,24,1010,1,23,1034
16,10,16054,2675,3,252,68,170,19,19,528,2,15,545
16,11,16001,1,3,193,148,153,6,9,509,7,18,534
16,11,16001,2,3,164,131,180,15,8,498,10,20,528
16,11,16001,3,3,180,110,132,4,10,436,4,11,451
16,11,16001,4,3,169,145,139,9,7,469,8,18,495
16,11,16001,5,3,132,110,149,1,5,397,3,16,416
16,11,16001,6,3,34,10,141,2,1,188,0,7,195
16,11,16001,7,3,61,47,133,5,4,250,3,8,261
16,11,16001,8,3,53,36,33,2,3,127,3,5,135
16,11,16001,9,3,15,36,67,2,0,120,0,9,129
16,11,16001,10,3,66,63,167,2,4,302,4,14,320
16,11,16013,213,3,93,544,401,9,4,1051,1,37,1089
16,11,16013,214,3,14,149,76,0,0,239,0,9,248
16,11,16013,215,3,5,49,26,0,0,80,0,3,83
16,11,16013,216,3,15,33,32,0,0,80,0,3,83
16,11,16013,217,3,41,152,118,0,0,311,0,0,311
16,11,16013,218,3,10,52,19,0,0,81,0,8,89
16,11,16013,219,3,30,323,275,3,1,632,5,28,665
16,11,16013,220,3,13,84,35,0,0,132,0,21,153
16,11,16013,221,3,10,86,62,0,1,159,0,9,168
16,11,16013,222,3,9,36,21,0,0,66,0,0,66
16,11,16013,223,3,5,62,46,0,0,113,0,7,120
16,11,16013,224,3,14,109,52,0,1,176,0,9,185
16,11,16038,601,3,16,68,122,11,1,218,0,12,230
16,11,16038,602,3,22,103,104,1,0,230,0,5,235
16,11,16038,603,3,39,146,207,4,5,401,2,10,413
16,11,16038,604,3,29,168,220,10,2,429,2,11,442
16,11,16038,605,3,28,211,305,7,5,556,0,25,581
16,11,16038,606,3,26,151,269,6,2,454,0,12,466
16,11,16038,607,3,46,220,197,7,5,475,1,17,493
16,11,16038,608,3,46,269,192,20,5,532,2,11,545
16,11,16038,609,3,52,280,224,18,7,581,0,23,604
16,11,16038,610,3,21,199,176,11,0,407,1,7,415
16,11,16038,611,3,43,286,226,21,4,580,1,15,596
16,11,16038,612,3,24,172,188,8,1,393,0,8,401
16,11,16038,613,3,25,236,343,10,8,622,0,17,639
16,11,16038,614,3,24,141,199,5,3,372,0,17,389
16,11,16038,615,3,16,58,88,0,1,163,0,5,168
16,11,16038,616,3,8,69,158,3,1,239,0,13,252
16,11,16038,617,3,3,45,38,0,1,87,0,5,92
16,11,16038,618,3,7,24,111,0,1,143,0,1,144
16,11,16038,619,3,13,55,122,2,5,197,0,5,202
16,11,16038,620,3,1,12,20,0,1,34,0,1,35
16,11,16038,621,3,1,21,162,0,0,184,0,1,185
16,11,16038,622,3,14,98,176,1,1,290,1,12,303
16,11,16038,623,3,19,110,198,3,6,336,1,10,347
16,11,16038,624,3,17,40,75,2,1,135,1,7,143
16,11,16038,625,3,37,105,92,7,0,241,0,21,262
16,11,16038,626,3,1,43,31,0,0,75,0,0,75
16,11,16038,627,3,12,78,183,3,2,278,0,6,284
16,11,16038,628,3,23,212,188,3,1,427,0,9,436
16,11,16038,629,3,29,127,132,0,1,289,1,8,298
16,11,16038,630,3,9,98,118,0,1,226,0,7,233
16,11,16038,631,3,16,66,47,1,1,131,0,5,136
16,11,16038,632,3,30,74,268,0,1,373,0,10,383
16,11,16038,633,3,14,133,218,2,0,367,0,10,377
16,11,16038,634,3,33,183,117,2,1,336,0,14,350
16,11,16038,635,3,4,114,132,0,2,252,0,5,257
16,11,16038,636,3,2,33,20,1,1,57,0,2,59
16,11,16038,637,3,2,20,44,0,0,66,0,1,67
16,11,16038,638,3,4,39,57,0,2,102,0,5,107
16,11,16038,639,3,2,26,31,0,0,59,0,2,61
16,11,16038,640,3,29,72,69,1,1,172,1,7,180
16,11,16038,641,3,13,2,78,0,0,93,0,3,96
16,11,16038,642,3,7,61,68,1,1,138,0,8,146
16,11,16038,643,3,2,21,56,0,0,79,0,5,84
16,11,16038,644,3,14,40,79,1,1,135,0,5,140
16,11,16038,645,3,7,35,52,1,2,97,0,7,104
16,11,16038,646,3,9,28,55,0,0,92,0,5,97
16,11,16039,647,3,158,293,548,54,28,1081,9,39,1129
16,11,16039,648,3,61,97,167,10,5,340,4,11,355
16,11,16039,649,3,34,84,118,4,0,240,4,0,244
16,11,16039,650,3,44,159,465,5,4,677,1,10,688
16,11,16049,802,3,186,235,176,27,10,634,3,18,655
16,11,16049,803,3,63,107,395,6,2,573,8,23,604
16,11,16049,804,3,52,93,232,8,1,386,4,20,410
16,11,16049,805,3,138,152,102,10,14,416,0,14,430
16,11,16051,871,3,322,334,406,19,21,1102,12,52,1166
16,11,16051,872,3,109,132,237,5,2,485,9,13,507
16,11,16051,873,3,176,321,341,17,11,866,2,9,877
16,11,16051,874,3,59,55,134,7,1,256,0,10,266
16,11,16051,875,3,89,98,340,4,3,534,1,27,562
16,11,16051,876,3,18,19,78,0,1,116,0,5,121
16,11,16051,877,3,29,31,104,1,1,166,2,0,168
16,11,16051,878,3,37,68,111,1,2,219,0,16,235
16,11,16051,879,3,10,21,56,0,0,87,0,3,90
16,11,16051,880,3,30,77,131,1,1,240,0,5,245
16,11,16051,881,3,66,104,311,3,4,488,0,19,507
16,11,16051,882,3,29,23,121,0,0,173,0,5,178
16,11,16051,883,3,8,16,66,0,0,90,0,8,98
16,11,16051,884,3,9,8,21,0,0,38,0,2,40
16,11,16058,1336,3,6,94,72,5,0,177,0,8,185
16,11,16058,1337,3,21,262,156,4,3,446,0,16,462
16,11,16058,1338,3,58,354,211,2,0,625,3,16,644
16,11,16058,1339,3,2,90,90,0,2,184,0,4,188
16,11,16058,1340,3,4,22,42,0,1,69,0,1,70
16,11,16058,1341,3,11,36,83,0,0,130,0,1,131
16,11,16058,1342,3,8,195,176,0,2,381,2,3,386
16,11,16058,1343,3,7,63,105,2,0,177,0,6,183
16,11,16058,1344,3,11,38,201,0,0,250,0,7,257
16,11,16058,1345,3,0,26,30,0,0,56,0,2,58
16,11,16058,1346,3,1,91,36,0,2,130,0,3,133
16,11,16058,1347,3,4,29,43,0,1,77,0,3,80
16,11,16058,1348,3,3,95,118,0,0,216,0,6,222
16,11,16067,1456,3,249,232,457,53,31,1022,4,30,1056
16,11,16067,1457,3,182,148,320,28,30,708,5,22,735
16,11,16067,1458,3,276,225,511,59,27,1098,3,33,1134
16,11,16067,1459,3,283,323,505,53,35,1199,2,40,1241
16,11,16067,1460,3,322,210,473,33,33,1071,9,36,1116
16,11,16067,1461,3,144,120,154,22,14,454,0,8,462
16,11,16067,1462,3,169,165,397,45,18,794,4,37,835
16,11,16067,1463,3,87,72,136,22,8,325,0,15,340
16,11,16067,1464,3,217,117,181,12,12,539,1,20,560
16,11,16067,1465,3,188,164,261,21,18,652,0,16,668
16,11,16067,1466,3,181,169,165,25,17,557,1,20,578
16,11,16067,1467,3,213,175,290,51,29,758,5,34,797
16,11,16067,1468,3,177,153,91,18,4,443,1,16,460
16,11,16067,1469,3,320,127,160,26,20,653,8,18,679
16,11,16067,1470,3,482,337,513,53,39,1424,11,50,1485
16,11,16067,1471,3,329,206,302,46,29,912,3,23,938
16,11,16067,1472,3,225,169,300,33,28,755,3,9,767
16,11,16067,1473,3,282,228,397,40,23,970,5,36,1011
16,11,16067,1474,3,151,261,307,28,24,771,0,28,799
16,11,16067,1475,3,248,174,342,30,24,818,8,26,852
16,11,16067,1476,3,303,406,494,42,18,1263,19,48,1330
16,11,16067,1477,3,202,258,461,26,23,970,7,34,1011
16,11,16067,1478,3,109,265,216,19,12,621,4,20,645
16,11,16067,1479,3,181,223,221,26,9,660,11,35,706
16,11,16067,1480,3,162,125,266,30,17,600,6,35,641
16,11,16067,1481,3,121,83,225,8,10,447,0,21,468
16,11,16067,1482,3,92,75,210,13,9,399,1,18,418
16,11,16067,1483,3,60,70,601,26,7,764,11,13,788
16,11,16067,1484,3,39,42,251,2,4,338,0,20,358
16,11,16067,1485,3,161,76,200,15,15,467,2,22,491
16,11,16067,1486,3,104,60,242,19,13,438,8,20,466
16,11,16067,1487,3,105,89,203,11,10,418,4,22,444
16,11,16067,1488,3,56,63,121,9,5,254,3,10,267
16,11,16067,1489,3,87,98,87,7,10,289,4,21,314
16,11,16067,1490,3,83,95,196,11,9,394,3,16,413
16,11,16067,1491,3,136,98,146,9,5,394,4,13,411
16,11,16067,1492,3,142,71,156,14,17,400,2,9,411
16,11,16067,1493,3,96,232,139,11,4,482,15,38,535
16,11,16067,1494,3,30,53,56,3,4,146,0,6,152
16,11,16067,1495,3,83,47,36,0,0,166,0,3,169
16,11,16067,1496,3,40,227,143,2,3,415,12,43,470
16,11,16067,1497,3,180,134,311,18,13,656,2,16,674
16,11,16078,1768,3,44,177,168,3,2,394,0,10,404
16,11,16078,1769,3,55,116,148,1,0,320,0,1,321
16,11,16078,1770,3,38,183,144,3,0,368,0,13,381
16,11,16078,1771,3,32,113,67,4,2,218,0,8,226
16,11,16078,1772,3,8,93,121,0,0,222,0,8,230
16,11,16078,1773,3,33,68,143,1,3,248,0,15,263
16,11,16078,1774,3,25,126,100,0,1,252,0,11,263
16,11,16078,1775,3,34,88,115,0,0,237,0,12,249
16,11,16078,1776,3,3,81,98,1,0,183,0,6,189
16,11,16078,1777,3,4,29,45,0,0,78,0,1,79
16,11,16078,1778,3,31,50,171,0,1,253,0,4,257
16,11,16078,1779,3,32,67,249,3,1,352,0,3,355
16,11,16078,1780,3,0,23,78,0,0,101,0,2,103
16,11,16078,1781,3,45,75,262,4,2,388,0,10,398
16,11,16078,1782,3,26,114,305,4,0,449,0,13,462
16,11,16078,1783,3,53,82,194,2,1,332,1,5,338
16,11,16078,1784,3,103,75,332,9,3,522,3,9,534
16,11,16078,1785,3,56,71,272,12,6,417,0,8,425
16,11,16078,1786,3,40,110,279,0,2,431,0,8,439
16,11,16078,1787,3,9,120,103,0,0,232,0,6,238
16,11,16080,1799,3,207,210,261,26,11,715,2,19,736
16,11,16080,1800,3,278,283,468,20,32,1081,8,49,1138
16,11,16080,1801,3,317,301,351,20,28,1017,2,34,1053
16,11,16080,1802,3,353,304,444,43,17,1161,15,47,1223
16,11,16080,1803,3,128,180,669,18,6,1001,7,58,1066
16,11,16080,1804,3,70,90,520,25,5,710,9,26,745
16,11,16080,1805,3,76,63,387,13,2,541,12,25,578
16,11,16080,1806,3,231,226,437,48,17,959,7,56,1022
16,11,16080,1807,3,60,36,182,8,8,294,3,25,322
16,11,16080,1808,3,47,57,129,8,7,248,3,12,263
16,11,16080,1809,3,61,80,114,0,0,255,3,19,277
16,11,16080,1810,3,37,147,270,5,2,461,1,11,473
16,11,16080,1811,3,50,39,147,1,2,239,0,7,246
16,11,16080,1812,3,84,93,105,6,6,294,0,28,322
16,11,16080,1813,3,42,52,142,3,3,242,1,13,256
16,11,16080,1814,3,33,80,118,6,6,243,3,19,265
16,11,16080,1815,3,77,73,297,8,10,465,5,13,483
16,11,16080,1816,3,68,36,143,5,4,256,5,22,283
16,11,16080,1817,3,76,36,338,5,4,459,4,46,509
16,11,16080,1818,3,53,46,301,12,2,414,2,22,438
16,11,16080,1819,3,69,88,107,6,5,275,12,22,309
16,11,16080,1820,3,193,154,202,14,11,574,2,20,596
16,11,16083,1844,3,173,117,193,67,11,561,5,13,579
16,11,16083,1845,3,186,145,186,128,4,649,1,11,661
16,11,16083,1846,3,175,118,136,78,7,514,2,13,529
16,11,16083,1847,3,260,210,315,103,19,907,3,45,955
16,11,16083,1848,3,261,216,387,116,14,994,8,38,1040
16,11,16083,1849,3,194,147,226,117,8,692,0,22,714
16,11,16083,1850,3,94,42,57,48,3,244,0,6,250
16,11,16083,1851,3,259,141,303,145,26,874,3,22,899
16,11,16083,1852,3,137,87,172,58,14,468,7,16,491
16,11,16083,1853,3,278,305,501,149,26,1259,4,45,1308
16,11,16083,1854,3,161,183,294,99,15,752,5,14,771
16,11,16083,1855,3,124,181,278,55,16,654,8,26,688
16,11,16083,1856,3,361,231,193,34,19,838,11,30,879
16,11,16083,1857,3,88,44,25,18,1,176,4,8,188
16,11,16083,1858,3,36,36,24,1,0,97,0,2,99
16,11,16083,1859,3,309,134,87,20,10,560,10,15,585
16,11,16083,1860,3,176,212,44,1,2,435,1,18,454
16,11,16083,1861,3,268,66,37,8,6,385,7,9,401
16,11,16083,1862,3,275,136,50,10,11,482,11,17,510
16,11,16083,1863,3,328,120,69,16,8,541,8,21,570
16,11,16083,1864,3,252,165,185,29,11,642,16,33,691
16,11,16083,1865,3,141,46,58,5,7,257,3,7,267
16,11,16083,1866,3,155,70,148,44,9,426,1,22,449
16,11,16083,1867,3,397,172,277,51,22,919,8,35,962
16,11,16083,1868,3,395,162,133,25,15,730,4,35,769
16,11,16083,1869,3,50,239,112,13,3,417,3,19,439
16,11,16083,1870,3,94,238,193,16,5,546,4,25,575
16,11,16083,1871,3,22,16,2,1,1,42,0,3,45
16,11,16083,1872,3,92,97,70,3,3,265,0,25,290
16,11,16083,1873,3,116,214,240,28,9,607,2,28,637
16,11,16083,1874,3,52,163,143,4,3,365,1,17,383
16,11,16083,1875,3,52,258,143,48,7,508,1,16,525
16,11,16083,1876,3,75,362,372,54,7,870,1,30,901
16,11,16083,1877,3,46,188,177,37,5,453,3,21,477
16,11,16083,1878,3,85,136,121,4,3,349,7,12,368
16,11,16083,1879,3,77,221,238,48,3,587,10,21,618
16,11,16083,1880,3,230,116,127,19,8,500,13,18,531
16,11,16083,1881,3,11,20,15,0,0,46,0,3,49
16,11,16098,2075,3,30,48,174,7,6,265,3,12,280
16,11,16098,2076,3,38,66,283,16,4,407,1,16,424
16,11,16098,2077,3,49,96,135,2,3,285,0,10,295
16,11,16098,2078,3,38,43,71,3,1,156,4,4,164
16,11,16098,2079,3,43,177,230,14,6,470,4,12,486
16,11,16098,2080,3,32,135,174,13,5,359,7,12,378
16,11,16098,2081,3,39,189,203,14,13,458,1,13,472
16,11,16098,2082,3,44,96,162,10,4,316,0,9,325
16,11,16098,2083,3,78,168,233,12,8,499,3,9,511
16,11,16098,2084,3,45,122,113,5,2,287,0,7,294
16,11,16098,2085,3,17,56,80,7,4,164,0,8,172
16,11,16098,2086,3,105,247,363,16,10,741,3,42,786
16,11,16098,2087,3,8,219,97,0,2,326,0,10,336
16,11,16098,2088,3,17,379,217,1,0,614,0,39,653
16,11,16098,2089,3,5,172,86,0,0,263,0,13,276
16,11,16098,2090,3,18,57,70,8,4,157,0,7,164
16,11,16098,2091,3,31,138,68,3,5,245,1,7,253
16,11,16098,2092,3,13,117,117,4,4,255,2,16,273
16,11,16098,2093,3,25,71,163,2,2,263,0,10,273
16,11,16098,2094,3,22,56,54,1,0,133,0,35,168
16,11,16098,2095,3,27,21,11,1,8,68,0,0,68
16,11,16098,2096,3,25,66,278,0,3,372,0,10,382
16,11,16098,2097,3,19,99,339,1,3,461,0,20,481
16,11,16098,2098,3,28,8,116,2,1,155,0,3,158
16,11,16098,2099,3,2,17,224,1,1,245,0,6,251
16,11,16098,2100,3,6,9,31,0,0,46,0,1,47
16,11,16098,2101,3,3,7,76,0,1,87,0,3,90
16,11,16098,2102,3,34,198,121,0,3,356,1,14,371
16,11,16098,2103,3,4,26,11,2,0,43,0,1,44
16,11,16098,2104,3,7,77,98,4,1,187,2,0,189
16,11,16098,2105,3,8,10,44,1,0,63,0,1,64
16,11,16098,2107,3,12,38,70,0,0,120,0,2,122
16,11,16098,2108,3,4,13,42,0,1,60,0,3,63
16,11,16098,2109,3,20,27,99,0,1,147,1,2,150
16,11,16098,2110,3,24,14,185,0,1,224,2,3,229
16,11,16098,2111,3,4,2,110,0,0,116,0,0,116
16,11,16098,2112,3,5,5,80,0,0,90,0,1,91
16,11,16101,2151,3,178,133,291,13,14,629,7,15,651
16,11,16101,2152,3,223,116,327,14,13,693,5,12,710
16,11,16101,2153,3,164,91,208,9,12,484,1,21,506
16,11,16101,2154,3,93,44,88,4,5,234,0,13,247
16,11,16101,2155,3,149,97,159,6,6,417,0,20,437
16,11,16101,2156,3,8,17,105,4,3,137,1,3,141
16,11,16101,2157,3,85,77,161,6,6,335,3,8,346
16,11,16101,2158,3,118,183,342,12,3,658,4,15,677
16,11,16101,2159,3,127,123,282,19,12,563,1,13,577
16,11,16080,2673,3,27,44,204,7,3,285,5,18,308
16,11,16080,2674,3,36,45,183,13,0,277,5,15,297
16,12,16002,11,3,156,215,446,6,8,831,1,38,870
16,12,16002,12,3,40,66,289,1,2,398,2,4,404
16,12,16002,13,3,115,176,490,4,7,792,0,27,819
16,12,16002,14,3,107,136,424,5,5,677,0,26,703
16,12,16002,15,3,34,58,133,4,0,229,0,8,237
16,12,16002,16,3,47,92,762,5,4,910,1,29,940
16,12,16002,17,3,4,24,275,1,0,304,0,7,311
16,12,16002,18,3,23,30,331,0,0,384,0,14,398
16,12,16002,19,3,177,93,73,4,0,347,0,11,358
16,12,16002,20,3,7,14,64,0,0,85,0,4,89
16,12,16002,21,3,1,7,11,0,0,19,0,0,19
16,12,16002,22,3,7,26,100,0,0,133,0,0,133
16,12,16002,23,3,5,7,71,0,1,84,0,4,88
16,12,16002,25,3,7,22,31,0,0,60,0,3,63
16,12,16006,58,3,72,103,211,13,5,404,0,11,415
16,12,16006,59,3,89,130,219,11,5,454,2,12,468
16,12,16006,60,3,76,119,286,13,12,506,1,10,517
16,12,16006,61,3,94,57,196,15,5,367,2,16,385
16,12,16006,62,3,118,113,287,12,13,543,1,16,560
16,12,16006,63,3,109,102,240,22,9,482,0,24,506
16,12,16006,64,3,99,133,215,15,21,483,1,31,515
16,12,16006,65,3,100,135,242,17,5,499,4,16,519
16,12,16006,66,3,111,170,286,15,17,599,3,23,625
16,12,16006,67,3,71,109,186,15,13,394,0,7,401
16,12,16006,68,3,139,116,303,27,18,603,0,11,614
16,12,16006,69,3,132,128,333,38,18,649,0,7,656
16,12,16006,70,3,108,120,176,15,8,427,4,17,448
16,12,16006,71,3,102,139,248,10,12,511,0,16,527
16,12,16006,72,3,67,65,153,9,90,384,2,13,399
16,12,16006,73,3,71,203,207,12,8,501,2,9,512
16,12,16006,74,3,110,172,309,22,10,623,2,3,628
16,12,16006,75,3,127,128,240,20,7,522,0,15,537
16,12,16006,76,3,131,119,250,9,9,518,0,10,528
16,12,16006,77,3,243,240,360,30,24,897,2,23,922
16,12,16006,78,3,134,135,317,14,11,611,1,15,627
16,12,16006,79,3,83,130,229,16,5,463,1,9,473
16,12,16006,80,3,158,144,267,7,12,588,4,6,598
16,12,16006,81,3,126,104,238,24,5,497,0,13,510
16,12,16006,82,3,163,162,233,19,10,587,2,15,604
16,12,16006,83,3,98,80,192,12,8,390,1,12,403
16,12,16006,84,3,82,145,185,9,9,430,2,4,436
16,12,16006,85,3,141,128,226,10,10,515,1,11,527
16,12,16006,86,3,97,129,185,18,11,440,1,6,447
16,12,16006,87,3,135,156,176,19,7,493,2,4,499
16,12,16006,88,3,168,138,257,18,9,590,2,12,604
16,12,16006,89,3,100,96,221,26,13,456,0,15,471
16,12,16006,90,3,138,104,187,21,8,458,0,4,462
16,12,16006,91,3,68,80,109,4,7,268,0,11,279
16,12,16006,92,3,116,153,228,9,12,518,0,15,533
16,12,16006,93,3,49,107,117,5,7,285,0,7,292
16,12,16006,94,3,107,98,213,8,10,436,3,12,451
16,12,16006,95,3,145,114,161,14,1,435,0,7,442
16,12,16006,96,3,91,121,233,16,11,472,0,17,489
16,12,16006,97,3,121,126,178,11,6,442,0,5,447
16,12,16006,98,3,151,177,247,17,9,601,1,10,612
16,12,16006,99,3,82,111,254,12,6,465,3,17,485
16,12,16006,100,3,73,90,175,7,14,359,0,10,369
16,12,16006,101,3,173,193,279,20,21,686,3,16,705
16,12,16006,102,3,116,103,122,11,2,354,1,12,367
16,12,16006,103,3,60,71,143,19,3,296,0,19,315
16,12,16006,104,3,61,123,241,18,7,450,1,18,469
16,12,16006,105,3,125,172,429,14,7,747,0,33,780
16,12,16006,106,3,69,88,226,12,7,402,4,12,418
16,12,16006,107,3,105,90,167,17,9,388,1,8,397
16,12,16006,108,3,130,124,332,8,17,611,1,12,624
16,12,16006,109,3,144,168,391,12,22,737,1,22,760
16,12,16006,110,3,88,107,327,19,10,551,2,8,561
16,12,16006,111,3,185,181,302,22,12,702,1,4,707
16,12,16006,112,3,161,155,440,10,15,781,0,23,804
16,12,16006,113,3,291,382,638,48,22,1381,1,44,1426
16,12,16006,114,3,80,46,235,7,6,374,3,11,388
16,12,16006,115,3,189,131,161,7,7,495,15,19,529
16,12,16006,116,3,25,68,148,10,5,256,0,6,262
16,12,16006,117,3,37,89,254,7,3,390,2,5,397
16,12,16006,118,3,34,104,115,8,2,263,2,8,273
16,12,16006,119,3,85,163,206,8,8,470,6,16,492
16,12,16006,120,3,56,148,263,7,9,483,0,14,497
16,12,16006,121,3,39,63,242,1,5,350,0,9,359
16,12,16006,122,3,26,28,297,2,2,355,0,3,358
16,12,16006,123,3,6,47,29,0,0,82,0,4,86
16,12,16006,124,3,27,38,156,3,2,226,0,4,230
16,12,16006,125,3,79,91,205,4,4,383,2,12,397
16,12,16006,126,3,10,17,180,0,2,209,0,0,209
16,12,16006,127,3,19,57,214,0,0,290,0,7,297
16,12,16006,128,3,7,30,167,1,3,208,0,8,216
16,12,16006,129,3,16,63,186,0,5,270,2,2,274
16,12,16006,130,3,1,6,83,1,0,91,1,1,93
16,12,16006,131,3,2,14,42,0,0,58,0,1,59
16,12,16008,136,3,90,153,80,3,5,331,0,0,331
16,12,16008,137,3,147,289,221,4,9,670,0,46,716
16,12,16008,138,3,92,178,149,0,1,420,0,2,422
16,12,16008,139,3,148,237,372,12,8,777,1,10,788
16,12,16008,140,3,145,331,348,2,4,830,0,15,845
16,12,16008,141,3,14,129,137,0,0,280,0,6,286
16,12,16008,142,3,83,350,215,10,4,662,0,17,679
16,12,16008,143,3,24,173,237,0,3,437,1,8,446
16,12,16008,144,3,28,104,48,0,0,180,0,6,186
16,12,16008,145,3,69,123,385,3,2,582,0,15,597
16,12,16008,146,3,84,53,26,4,0,167,0,8,175
16,12,16008,147,3,250,280,300,9,3,842,0,12,854
16,12,16008,148,3,48,178,116,1,2,345,0,10,355
16,12,16012,190,3,156,271,589,28,13,1057,5,24,1086
16,12,16012,191,3,134,286,673,19,9,1121,3,31,1155
16,12,16012,192,3,106,218,215,14,11,564,0,9,573
16,12,16012,193,3,28,69,155,11,3,266,2,7,275
16,12,16012,194,3,42,49,138,2,4,235,0,2,237
16,12,16012,195,3,64,61,189,2,3,319,0,7,326
16,12,16012,196,3,4,5,61,0,1,71,0,0,71
16,12,16012,197,3,10,86,73,2,3,174,0,5,179
16,12,16012,198,3,82,121,308,8,9,528,0,12,540
16,12,16012,199,3,84,69,330,20,8,511,0,18,529
16,12,16012,200,3,132,101,463,15,8,719,0,18,737
16,12,16012,201,3,149,278,242,9,9,687,1,17,705
16,12,16012,202,3,141,232,268,8,8,657,3,19,679
16,12,16012,203,3,180,179,264,16,7,646,0,13,659
16,12,16012,204,3,194,197,369,9,7,776,1,16,793
16,12,16012,205,3,113,207,242,11,4,577,0,10,587
16,12,16012,206,3,35,79,180,4,1,299,0,9,308
16,12,16012,207,3,37,66,179,5,2,289,0,4,293
16,12,16012,208,3,76,64,386,4,4,534,0,10,544
16,12,16012,209,3,133,167,412,12,11,735,1,6,742
16,12,16012,210,3,40,61,168,3,4,276,0,3,279
16,12,16012,211,3,42,91,205,6,2,346,0,14,360
16,12,16012,212,3,15,85,103,0,1,204,0,5,209
16,12,16014,225,3,84,114,244,20,6,468,1,7,476
16,12,16014,226,3,133,173,324,26,7,663,5,16,684
16,12,16014,227,3,42,38,84,0,0,164,0,6,170
16,12,16014,228,3,150,86,44,11,2,293,2,8,303
16,12,16014,229,3,133,143,206,11,9,502,1,14,517
16,12,16014,230,3,19,12,53,1,0,85,0,0,85
16,12,16014,231,3,45,91,176,3,6,321,3,9,333
16,12,16014,232,3,111,149,284,13,12,569,0,14,583
16,12,16014,233,3,88,111,167,8,4,378,4,7,389
16,12,16014,234,3,67,119,121,6,7,320,5,5,330
16,12,16014,235,3,54,72,103,0,1,230,0,6,236
16,12,16014,236,3,13,39,25,0,1,78,0,1,79
16,12,16015,237,3,323,333,307,12,8,983,1,30,1014
16,12,16015,238,3,228,199,190,1,6,624,0,29,653
16,12,16015,239,3,267,148,186,5,3,609,1,13,623
16,12,16015,240,3,250,180,204,7,2,643,0,12,655
16,12,16015,241,3,157,115,151,5,5,433,0,16,449
16,12,16015,242,3,408,380,280,18,10,1096,1,26,1123
16,12,16015,243,3,18,19,26,1,0,64,0,0,64
16,12,16015,244,3,8,43,16,1,0,68,0,0,68
16,12,16015,245,3,62,68,244,0,1,375,0,15,390
16,12,16015,246,3,69,77,106,0,2,254,4,8,266
16,12,16015,247,3,14,8,32,0,0,54,0,3,57
16,12,16015,248,3,23,16,21,1,0,61,0,0,61
16,12,16015,249,3,26,34,160,1,1,222,0,5,227
16,12,16015,250,3,27,29,61,0,0,117,0,6,123
16,12,16015,251,3,37,18,56,2,0,113,1,2,116
16,12,16015,252,3,52,23,39,1,3,118,0,5,123
16,12,16015,253,3,32,8,25,0,0,65,0,1,66
16,12,16015,254,3,30,16,53,0,0,99,0,2,101
16,12,16015,255,3,29,36,13,0,1,79,0,2,81
16,12,16015,256,3,26,73,144,0,1,244,0,3,247
16,12,16026,397,3,78,292,160,3,1,534,2,14,550
16,12,16026,398,3,25,70,112,0,0,207,0,3,210
16,12,16026,399,3,12,16,106,0,0,134,0,0,134
16,12,16026,400,3,7,59,35,0,0,101,0,1,102
16,12,16026,401,3,4,33,21,0,0,58,0,2,60
16,12,16026,402,3,31,140,86,2,0,259,0,0,259
16,12,16026,403,3,29,114,168,0,0,311,0,10,321
16,12,16026,404,3,13,42,163,0,2,220,1,3,224
16,12,16065,1426,3,82,123,225,12,6,448,1,13,462
16,12,16065,1427,3,146,205,538,27,10,926,0,25,951
16,12,16065,1428,3,34,88,451,9,4,586,0,13,599
16,12,16065,1429,3,4,19,229,4,2,258,1,9,268
16,12,16065,1430,3,45,36,239,2,2,324,2,3,329
16,12,16065,1431,3,25,20,405,3,2,455,1,17,473
16,12,16065,1432,3,54,99,262,1,1,417,2,9,428
16,12,16065,1433,3,85,107,338,1,1,532,2,5,539
16,12,16065,1434,3,89,121,522,6,9,747,2,28,777
16,12,16065,1435,3,77,103,380,1,9,570,0,8,578
16,12,16065,1436,3,73,113,348,10,3,547,1,15,563
16,12,16065,1437,3,28,72,188,2,2,292,2,5,299
16,12,16065,1438,3,18,80,132,0,0,230,1,13,244
16,12,16065,1439,3,24,65,176,0,0,265,0,2,267
16,12,16069,1517,3,612,233,244,36,23,1148,2,29,1179
16,12,16069,1518,3,359,121,149,15,16,660,1,16,677
16,12,16069,1519,3,406,189,108,23,14,740,0,27,767
16,12,16069,1520,3,470,206,110,21,13,820,1,16,837
16,12,16069,1521,3,461,193,99,36,18,807,2,4,813
16,12,16069,1522,3,318,200,158,20,8,704,5,9,718
16,12,16069,1523,3,278,108,133,15,9,543,1,25,569
16,12,16069,1524,3,184,202,228,22,7,643,1,16,660
16,12,16069,1525,3,312,226,516,32,20,1106,5,27,1138
16,12,16069,1526,3,433,49,76,11,6,575,3,6,584
16,12,16069,1527,3,113,71,109,4,1,298,0,1,299
16,12,16069,1528,3,109,35,389,4,0,537,0,5,542
16,12,16084,1882,3,172,337,286,11,7,813,1,21,835
16,12,16084,1883,3,109,178,239,2,5,533,0,7,540
16,12,16084,1884,3,287,380,326,12,13,1018,0,33,1051
16,12,16084,1885,3,139,129,217,3,7,495,9,10,514
16,12,16084,1886,3,84,121,193,5,3,406,6,12,424
16,12,16084,1887,3,116,42,778,5,11,952,2,18,972
16,12,16084,1888,3,134,124,344,4,18,624,3,14,641
16,12,16084,1889,3,92,47,182,5,2,328,4,12,344
16,12,16084,1890,3,313,70,348,11,13,755,0,30,785
16,12,16084,1891,3,106,34,374,4,2,520,0,6,526
16,12,16084,1892,3,77,40,211,3,3,334,3,7,344
16,12,16084,1893,3,104,58,352,2,5,521,1,5,527
16,12,16084,1894,3,82,108,50,2,2,244,0,22,266
16,12,16084,1895,3,64,75,42,4,3,188,0,1,189
16,12,16084,1896,3,254,115,59,5,4,437,2,8,447
16,12,16084,1897,3,7,10,14,0,0,31,0,0,31
16,12,16090,1979,3,288,259,202,9,12,770,2,29,801
16,12,16090,1980,3,71,112,97,4,3,287,0,10,297
16,12,16090,1981,3,221,244,266,17,15,763,6,18,787
16,12,16090,1982,3,243,261,274,11,13,802,0,19,821
16,12,16090,1983,3,96,130,148,8,5,387,5,15,407
16,12,16090,1984,3,74,93,173,15,4,359,3,13,375
16,12,16090,1985,3,168,205,241,19,11,644,0,23,667
16,12,16090,1986,3,163,190,269,18,6,646,1,21,668
16,12,16090,1987,3,52,67,90,6,1,216,0,2,218
16,12,16090,1988,3,93,81,106,6,0,286,0,19,305
16,12,16090,1989,3,56,164,421,7,2,650,1,20,671
16,12,16090,1990,3,43,116,105,4,5,273,1,5,279
16,12,16090,1991,3,52,110,406,5,3,576,0,16,592
16,12,16090,1992,3,33,28,141,3,7,212,0,4,216
16,12,16090,1993,3,15,16,209,0,1,241,0,2,243
16,12,16090,1994,3,11,17,149,0,2,179,0,7,186
16,12,16006,2660,3,23,45,825,4,1,898,1,14,913
16,12,16006,2661,3,22,80,110,3,2,217,4,2,223
16,12,16006,2662,3,12,60,175,1,1,249,5,5,259
16,12,16006,2663,3,6,12,53,0,1,72,0,3,75
16,12,16006,2664,3,10,91,29,1,1,132,0,2,134
16,12,16006,2665,3,8,33,78,2,3,124,0,2,126
16,12,16065,2671,3,13,10,145,2,0,170,0,9,179
16,12,16065,2672,3,4,10,96,0,0,110,0,5,115
17,1,17007,188,3,616,264,415,85,42,1422,2,23,1447
17,1,17007,190,3,696,216,480,75,49,1516,7,14,1537
17,1,17007,191,3,402,148,282,71,45,948,5,15,968
17,1,17007,194,3,626,293,559,106,74,1658,1,53,1712
17,1,17007,195,3,529,146,322,52,41,1090,4,29,1123
17,1,17007,198,3,349,151,307,53,31,891,4,25,920
17,1,17007,199,3,575,185,427,69,47,1303,2,31,1336
17,1,17007,202,3,523,214,419,75,46,1277,3,30,1310
17,1,17007,203,3,301,94,319,48,36,798,0,15,813
17,1,17007,206,3,438,195,310,39,35,1017,5,20,1042
17,1,17007,207,3,561,270,248,50,56,1185,6,25,1216
17,1,17007,210,3,355,92,191,44,44,726,2,7,735
17,1,17007,211,3,345,111,192,29,28,705,2,18,725
17,1,17007,214,3,448,227,337,72,75,1159,6,17,1182
17,1,17007,215,3,271,195,250,52,20,788,2,18,808
17,1,17007,218,3,281,93,177,38,23,612,0,8,620
17,1,17007,219,3,465,137,325,59,37,1023,4,22,1049
17,1,17007,222,3,609,214,656,72,56,1607,12,30,1649
17,1,17007,223,3,268,121,244,27,19,679,1,17,697
17,1,17007,226,3,279,109,259,39,23,709,2,9,720
17,1,17007,227,3,467,161,345,40,39,1052,0,23,1075
17,1,17007,230,3,598,177,322,59,48,1204,2,15,1221
17,1,17007,231,3,299,107,155,62,35,658,2,9,669
17,1,17007,234,3,332,90,173,45,35,675,1,9,685
17,1,17007,235,3,101,219,120,13,15,468,0,5,473
17,1,17007,238,3,275,89,142,18,45,569,0,13,582
17,1,17007,239,3,1611,514,922,221,195,3463,11,36,3510
17,1,17007,242,3,342,135,212,42,31,762,0,21,783
17,1,17007,243,3,171,90,104,29,19,413,2,8,423
17,1,17007,246,3,296,188,266,43,35,828,0,13,841
17,1,17007,247,3,354,127,239,55,28,803,0,18,821
17,1,17007,250,3,490,118,166,23,33,830,1,9,840
17,1,17007,251,3,339,77,81,21,29,547,0,4,551
17,1,17007,254,3,287,124,322,36,34,803,1,24,828
17,1,17007,255,3,552,190,375,57,26,1200,6,19,1225
17,1,17007,258,3,142,99,133,24,9,407,1,9,417
17,1,17007,259,3,144,69,121,25,11,370,0,3,373
17,1,17007,262,3,305,76,111,31,33,556,0,5,561
17,1,17007,263,3,399,101,116,30,24,670,1,9,680
17,1,17007,266,3,318,116,155,27,25,641,0,4,645
17,1,17007,267,3,528,172,355,76,45,1176,0,13,1189
17,1,17007,270,3,222,90,119,36,29,496,0,8,504
17,1,17007,271,3,317,112,195,34,29,687,0,15,702
17,1,17007,274,3,360,214,305,68,38,985,1,13,999
17,1,17007,275,3,348,119,208,45,33,753,2,17,772
17,1,17007,278,3,266,152,164,33,22,637,0,12,649
17,1,17007,279,3,437,133,254,50,43,917,0,13,930
17,1,17007,282,3,318,163,356,67,49,953,1,27,981
17,1,17007,283,3,361,149,332,46,38,926,3,16,945
17,1,17007,286,3,303,155,284,48,37,827,1,19,847
17,1,17007,287,3,318,117,252,59,37,783,2,10,795
17,1,17007,290,3,591,158,460,53,38,1300,0,20,1320
17,1,17007,291,3,253,75,133,33,22,516,5,4,525
17,1,17007,294,3,264,124,202,43,33,666,4,9,679
17,1,17007,295,3,246,110,119,37,12,524,3,11,538
17,1,17007,298,3,198,116,207,42,30,593,4,12,609
17,1,17007,299,3,124,66,97,19,11,317,1,7,325
17,1,17007,302,3,166,355,324,46,16,907,6,49,962
17,1,17007,303,3,697,226,447,94,61,1525,2,15,1542
17,1,17007,306,3,335,138,285,41,29,828,4,24,856
17,1,17007,307,3,262,134,278,52,31,757,3,8,768
17,1,17007,310,3,280,124,155,36,27,622,3,15,640
17,1,17007,311,3,337,153,282,51,31,854,1,16,871
17,1,17007,314,3,219,163,183,64,16,645,3,17,665
17,1,17007,315,3,252,149,202,54,19,676,2,15,693
17,1,17007,318,3,269,193,220,209,20,911,2,28,941
17,1,17007,319,3,115,47,114,40,9,325,0,10,335
17,1,17007,322,3,311,135,263,91,41,841,6,13,860
17,1,17007,323,3,117,59,119,20,8,323,1,1,325
17,1,17007,326,3,82,41,53,11,8,195,1,6,202
17,1,17007,327,3,325,129,218,35,32,739,3,10,752
17,1,17007,330,3,359,92,160,42,30,683,2,12,697
17,1,17007,331,3,261,110,200,37,14,622,1,7,630
17,1,17007,334,3,388,164,424,80,30,1086,5,14,1105
17,1,17007,335,3,395,154,404,67,34,1054,3,13,1070
17,1,17007,338,3,379,208,225,45,23,880,5,12,897
17,1,17007,339,3,256,103,259,40,28,686,0,10,696
17,1,17007,342,3,342,97,163,27,26,655,4,7,666
17,1,17007,343,3,307,105,191,51,19,673,0,11,684
17,1,17007,346,3,163,88,142,40,21,454,3,5,462
17,1,17007,347,3,139,58,95,22,15,329,0,2,331
17,1,17007,350,3,363,210,280,106,33,992,2,23,1017
17,1,17007,351,3,153,62,173,19,16,423,1,11,435
17,1,17007,354,3,416,115,177,45,45,798,1,6,805
17,1,17007,355,3,486,185,342,128,41,1182,4,28,1214
17,1,17007,358,3,138,69,114,20,17,358,0,5,363
17,1,17007,359,3,296,120,220,30,42,708,2,10,720
17,1,17007,362,3,167,58,120,20,20,385,0,5,390
17,1,17007,363,3,186,70,132,51,22,461,0,4,465
17,1,17007,366,3,288,167,308,35,20,818,4,16,838
17,1,17007,367,3,276,160,329,56,34,855,10,9,874
17,1,17007,370,3,490,181,335,77,30,1113,10,18,1141
17,1,17007,371,3,333,92,214,35,38,712,3,9,724
17,1,17007,374,3,176,108,291,33,13,621,4,11,636
17,1,17007,375,3,583,327,455,100,57,1522,9,41,1572
17,1,17007,378,3,321,114,237,43,33,748,4,12,764
17,1,17007,379,3,318,144,213,34,39,748,4,15,767
17,1,17007,382,3,582,255,433,85,33,1388,4,31,1423
17,1,17007,383,3,426,177,354,70,41,1068,1,17,1086
17,1,17007,386,3,508,219,299,76,58,1160,4,11,1175
17,1,17007,389,3,254,44,57,30,7,392,4,3,399
17,1,17007,390,3,120,127,145,19,15,426,0,6,432
17,1,17007,612,3,257,191,216,54,19,737,0,37,774
17,1,17007,907,3,103,46,78,16,6,249,0,6,255
17,2,17007,387,3,448,205,360,49,17,1079,5,39,1123
17,2,17008,391,3,312,352,420,43,14,1141,5,50,1196
17,2,17008,394,3,236,319,247,38,7,847,0,37,884
17,2,17008,395,3,197,186,204,12,4,603,2,29,634
17,2,17008,398,3,307,275,257,47,14,900,1,25,926
17,2,17008,399,3,335,338,309,21,6,1009,1,37,1047
17,2,17008,402,3,431,477,366,53,13,1340,2,52,1394
17,2,17008,403,3,392,247,244,46,16,945,3,24,972
17,2,17008,406,3,765,576,701,96,30,2168,4,60,2232
17,2,17008,407,3,349,243,449,49,14,1104,1,24,1129
17,2,17008,410,3,389,315,310,119,16,1149,0,42,1191
17,2,17008,411,3,667,445,400,121,31,1664,3,33,1700
17,2,17011,431,3,247,129,277,34,5,692,1,16,709
17,2,17011,434,3,485,224,455,42,22,1228,5,20,1253
17,2,17011,435,3,451,162,389,75,22,1099,4,18,1121
17,2,17011,438,3,508,209,455,52,23,1247,1,29,1277
17,2,17011,439,3,390,147,375,62,23,997,0,26,1023
17,2,17011,442,3,271,80,194,36,9,590,0,9,599
17,2,17011,443,3,394,106,210,43,18,771,0,12,783
17,2,17011,446,3,250,75,207,30,15,577,0,4,581
17,2,17011,447,3,268,84,212,56,18,638,1,4,643
17,2,17011,450,3,550,153,517,53,37,1310,3,19,1332
17,2,17011,451,3,407,92,249,39,14,801,0,9,810
17,2,17011,454,3,536,244,552,50,30,1412,0,37,1449
17,2,17011,455,3,588,520,786,70,29,1993,7,45,2045
17,2,17011,458,3,230,185,392,28,14,849,0,26,875
17,2,17011,459,3,213,214,315,31,11,784,0,20,804
17,2,17011,462,3,310,75,232,25,15,657,1,10,668
17,2,17011,463,3,258,143,323,18,24,766,0,13,779
17,2,17011,466,3,220,65,198,30,18,531,0,8,539
17,2,17011,467,3,244,66,299,37,14,660,0,19,679
17,2,17011,470,3,361,177,462,36,21,1057,4,8,1069
17,2,17011,471,3,379,251,479,76,30,1215,1,26,1242
17,2,17011,474,3,349,119,353,44,16,881,0,19,900
17,2,17011,475,3,271,75,170,36,8,560,0,10,570
17,2,17011,478,3,308,86,199,21,8,622,0,5,627
17,2,17011,479,3,281,86,256,40,8,671,2,4,677
17,2,17011,482,3,368,98,554,48,23,1091,2,10,1103
17,2,17011,483,3,540,142,692,65,30,1469,7,18,1494
17,2,17011,486,3,933,308,1168,125,63,2597,7,51,2655
17,2,17011,487,3,500,346,759,74,15,1694,14,48,1756
17,2,17011,490,3,181,87,185,20,7,480,6,15,501
17,2,17011,491,3,182,108,182,21,7,500,6,11,517
17,2,17011,494,3,239,88,172,11,5,515,2,8,525
17,2,17011,495,3,320,131,315,23,5,794,8,28,830
17,2,17011,498,3,302,130,323,34,17,806,1,13,820
17,2,17011,499,3,233,148,324,33,13,751,0,26,777
17,2,17018,611,3,225,227,331,44,15,842,1,19,862
17,2,17018,614,3,330,72,156,38,26,622,3,6,631
17,2,17018,615,3,311,229,245,67,14,866,7,23,896
17,2,17018,618,3,527,396,566,80,20,1589,14,49,1652
17,2,17018,619,3,253,159,222,43,15,692,0,31,723
17,2,17018,622,3,288,253,297,52,15,905,12,20,937
17,2,17018,623,3,275,305,528,39,17,1164,4,32,1200
17,2,17018,626,3,305,148,285,50,19,807,0,18,825
17,2,17018,627,3,196,145,173,49,15,578,15,15,608
17,2,17018,630,3,425,352,403,117,50,1347,8,39,1394
17,2,17018,631,3,267,195,249,31,15,757,0,23,780
17,2,17018,634,3,324,243,322,77,22,988,2,23,1013
17,2,17018,635,3,229,184,313,43,22,791,2,30,823
17,2,17018,638,3,303,130,325,38,19,815,2,16,833
17,2,17018,639,3,278,234,292,59,20,883,4,10,897
17,2,17018,642,3,267,166,273,22,12,740,4,7,751
17,2,17018,643,3,129,98,140,20,8,395,4,22,421
17,2,17018,646,3,234,126,251,26,11,648,3,17,668
17,2,17018,647,3,408,243,407,62,32,1152,3,22,1177
17,2,17018,650,3,93,51,68,7,3,222,1,2,225
17,2,17018,651,3,446,328,353,53,18,1198,5,30,1233
17,3,17002,12,3,313,183,342,124,108,1070,1,44,1115
17,3,17002,14,3,255,158,230,90,67,800,4,29,833
17,3,17002,15,3,260,107,204,43,58,672,5,30,707
17,3,17002,18,3,205,73,92,32,66,468,1,21,490
17,3,17002,19,3,296,230,299,62,57,944,8,55,1007
17,3,17002,22,3,155,34,50,4,8,251,0,2,253
17,3,17002,23,3,111,14,40,11,9,185,1,8,194
17,3,17006,97,3,479,383,524,165,33,1584,3,53,1640
17,3,17006,98,3,159,105,198,40,19,521,2,17,540
17,3,17006,99,3,285,153,320,58,15,831,2,33,866
17,3,17006,102,3,327,206,334,108,31,1006,2,36,1044
17,3,17006,103,3,222,136,259,49,18,684,0,14,698
17,3,17006,106,3,153,127,155,43,26,504,2,11,517
17,3,17006,107,3,181,132,193,43,13,562,2,14,578
17,3,17006,110,3,266,218,303,79,32,898,1,20,919
17,3,17006,111,3,244,202,325,153,34,958,3,34,995
17,3,17006,114,3,289,303,417,82,35,1126,9,40,1175
17,3,17006,115,3,164,168,163,59,12,566,0,9,575
17,3,17006,118,3,169,183,245,101,33,731,1,22,754
17,3,17006,119,3,173,206,229,82,15,705,0,21,726
17,3,17006,122,3,140,122,173,40,12,487,0,13,500
17,3,17006,123,3,241,306,331,89,24,991,5,16,1012
17,3,17006,126,3,246,232,333,90,39,940,0,22,962
17,3,17006,127,3,216,202,232,68,22,740,0,20,760
17,3,17006,130,3,368,252,383,126,40,1169,9,18,1196
17,3,17006,131,3,250,240,282,92,29,893,2,21,916
17,3,17006,134,3,196,190,228,117,76,807,0,24,831
17,3,17006,135,3,357,386,504,154,34,1435,4,64,1503
17,3,17006,138,3,196,206,224,88,19,733,3,12,748
17,3,17006,139,3,139,170,160,87,18,574,7,13,594
17,3,17006,142,3,215,240,226,81,24,786,6,17,809
17,3,17006,143,3,235,311,259,81,33,919,0,23,942
17,3,17006,146,3,188,219,204,76,19,706,2,11,719
17,3,17006,147,3,182,168,234,103,30,717,2,11,730
17,3,17006,150,3,300,195,419,74,23,1011,1,28,1040
17,3,17006,151,3,378,329,510,130,43,1390,16,30,1436
17,3,17006,154,3,169,201,183,55,18,626,1,11,638
17,3,17006,155,3,199,171,204,119,24,717,1,22,740
17,3,17006,158,3,80,112,73,29,18,312,1,9,322
17,3,17006,159,3,235,284,314,96,25,954,4,24,982
17,3,17006,162,3,214,140,196,87,22,659,1,20,680
17,3,17006,163,3,62,77,64,30,7,240,0,14,254
17,3,17006,166,3,141,310,186,92,10,739,3,25,767
17,3,17006,167,3,101,179,137,59,12,488,0,12,500
17,3,17006,170,3,98,169,173,96,16,552,1,9,562
17,3,17006,171,3,59,87,98,39,3,286,0,10,296
17,3,17006,174,3,195,121,198,58,21,593,1,13,607
17,3,17006,175,3,185,148,232,49,20,634,1,21,656
17,3,17006,178,3,394,357,501,112,57,1421,4,48,1473
17,3,17006,179,3,167,175,265,81,21,709,0,19,728
17,3,17006,182,3,205,167,266,65,13,716,3,26,745
17,3,17006,183,3,187,177,237,48,8,657,2,31,690
17,3,17006,186,3,98,285,165,75,12,635,4,32,671
17,3,17006,187,3,84,33,35,9,2,163,0,7,170
17,3,17009,412,3,249,130,497,18,14,908,2,24,934
17,3,17009,414,3,176,101,377,10,7,671,3,9,683
17,3,17009,415,3,6,15,63,4,0,88,1,1,90
17,3,17009,418,3,200,180,289,14,14,697,0,24,721
17,3,17009,419,3,204,223,302,44,25,798,4,60,862
17,3,17009,422,3,157,61,118,13,20,369,1,3,373
17,3,17016,569,3,504,218,231,101,33,1087,1,23,1111
17,3,17016,570,3,203,116,108,58,13,498,0,27,525
17,3,17016,571,3,352,87,78,11,14,542,2,8,552
17,3,17016,574,3,175,69,127,39,37,447,0,22,469
17,3,17016,575,3,202,93,272,25,217,809,5,54,868
17,3,17016,578,3,245,87,398,37,34,801,13,22,836
17,3,17020,670,3,194,111,422,39,17,783,6,20,809
17,3,17020,671,3,220,136,355,36,32,779,6,24,809
17,3,17020,674,3,200,121,364,46,16,747,1,25,773
17,3,17020,675,3,289,169,434,56,38,986,9,39,1034
17,3,17020,678,3,172,79,259,75,26,611,1,16,628
17,3,17020,679,3,232,136,349,37,30,784,9,26,819
17,3,17020,682,3,241,173,298,31,8,751,2,40,793
17,3,17020,683,3,151,168,342,14,14,689,8,36,733
17,3,17020,686,3,689,260,559,102,48,1658,6,42,1706
17,3,17020,687,3,112,162,193,51,10,528,3,9,540
17,3,17022,695,3,405,265,275,124,17,1086,2,38,1126
17,3,17022,698,3,123,143,123,114,48,551,1,36,588
17,3,17022,699,3,135,49,133,290,10,617,0,31,648
17,3,17022,702,3,95,44,110,259,22,530,1,15,546
17,3,17023,703,3,92,298,664,18,7,1079,1,34,1114
17,3,17023,706,3,49,1,179,12,3,244,1,15,260
17,3,17026,760,3,142,197,422,143,18,922,0,18,940
17,3,17026,762,3,162,170,430,173,37,972,3,38,1013
17,3,17026,763,3,104,156,262,117,30,669,0,19,688
17,3,17026,766,3,179,294,111,118,11,713,4,25,742
17,3,17026,767,3,146,100,261,114,23,644,3,23,670
17,3,17027,770,3,403,177,153,48,8,789,0,26,815
17,3,17027,771,3,400,261,184,37,13,895,3,24,922
17,3,17027,774,3,63,57,59,15,4,198,1,4,203
17,3,17027,775,3,56,31,51,18,1,157,0,3,160
17,3,17030,850,3,322,403,263,66,29,1083,4,44,1131
17,3,17030,851,3,351,337,258,105,43,1094,4,26,1124
17,3,17030,854,3,204,248,118,48,34,652,6,14,672
17,3,17030,855,3,291,380,249,90,22,1032,2,31,1065
17,3,17030,858,3,255,228,284,51,20,838,13,33,884
17,3,17030,859,3,175,135,313,59,83,765,8,24,797
17,3,17030,862,3,203,221,276,73,21,794,0,23,817
17,3,17030,863,3,211,248,348,78,20,905,2,46,953
17,3,17030,866,3,96,144,105,28,2,375,0,9,384
17,3,17030,867,3,147,197,105,31,21,501,8,20,529
17,4,17001,1,3,161,186,293,51,9,700,0,31,731
17,4,17001,2,3,66,129,186,28,9,418,3,20,441
17,4,17001,3,3,148,282,242,60,14,746,3,29,778
17,4,17001,6,3,175,341,266,80,14,876,7,32,915
17,4,17001,7,3,95,185,155,74,19,528,2,20,550
17,4,17001,10,3,88,80,293,85,6,552,1,30,583
17,4,17001,11,3,53,82,126,3,3,267,0,0,267
17,4,17005,86,3,122,228,133,31,8,522,3,47,572
17,4,17005,87,3,191,297,264,35,4,791,3,45,839
17,4,17005,90,3,53,89,74,17,4,237,0,12,249
17,4,17005,91,3,35,46,32,9,0,122,0,8,130
17,4,17005,94,3,132,152,79,36,4,403,2,20,425
17,4,17005,95,3,55,117,21,19,2,214,0,8,222
17,4,17012,501,3,189,305,372,72,17,955,3,30,988
17,4,17012,502,3,124,180,243,47,19,613,3,12,628
17,4,17012,503,3,75,88,96,27,10,296,3,3,302
17,4,17012,506,3,126,97,142,52,10,427,2,14,443
17,4,17012,507,3,154,106,295,58,13,626,2,6,634
17,4,17012,510,3,137,117,222,45,17,538,1,11,550
17,4,17012,511,3,209,227,279,78,16,809,0,18,827
17,4,17012,514,3,97,144,217,55,9,522,1,14,537
17,4,17012,515,3,102,119,193,51,14,479,1,12,492
17,4,17012,518,3,188,208,160,41,11,608,0,0,608
17,4,17012,519,3,232,185,197,62,6,682,0,19,701
17,4,17012,522,3,135,114,216,47,5,517,2,11,530
17,4,17012,523,3,180,106,183,34,18,521,0,9,530
17,4,17012,526,3,213,326,254,51,6,850,1,35,886
17,4,17012,527,3,90,135,146,23,11,405,2,13,420
17,4,17012,530,3,221,313,371,56,16,977,1,27,1005
17,4,17012,531,3,115,283,262,61,7,728,3,31,762
17,4,17012,534,3,407,230,191,41,8,877,4,13,894
17,4,17012,535,3,380,206,226,34,11,857,4,26,887
17,4,17014,548,3,157,417,166,33,3,776,2,21,799
17,4,17014,550,3,108,250,134,24,2,518,0,25,543
17,4,17014,551,3,84,306,138,35,5,568,0,16,584
17,4,17014,554,3,118,149,189,30,6,492,2,7,501
17,4,17015,555,3,141,421,255,20,7,844,2,30,876
17,4,17015,558,3,101,443,267,18,4,833,3,24,860
17,4,17015,559,3,71,192,108,2,3,376,0,14,390
17,4,17015,562,3,129,303,179,14,6,631,1,26,658
17,4,17015,563,3,89,194,194,2,3,482,0,18,500
17,4,17015,566,3,33,169,33,4,1,240,0,14,254
17,4,17015,567,3,138,232,184,8,3,565,0,28,593
17,4,17017,579,3,123,159,246,41,3,572,0,27,599
17,4,17017,582,3,126,266,193,26,15,626,3,6,635
17,4,17017,583,3,249,200,223,44,9,725,5,19,749
17,4,17017,586,3,191,313,213,46,16,779,1,37,817
17,4,17017,587,3,203,220,195,48,14,680,3,22,705
17,4,17017,590,3,116,241,260,46,12,675,0,13,688
17,4,17017,591,3,169,208,258,65,13,713,0,8,721
17,4,17017,594,3,232,147,215,63,15,672,1,26,699
17,4,17017,595,3,237,338,317,72,13,977,0,38,1015
17,4,17017,598,3,282,406,442,84,33,1247,8,23,1278
17,4,17017,599,3,267,311,343,75,11,1007,3,36,1046
17,4,17017,602,3,230,362,202,74,17,885,2,28,915
17,4,17017,603,3,42,56,43,12,4,157,0,3,160
17,4,17017,606,3,162,160,80,108,5,515,2,24,541
17,4,17017,607,3,206,163,113,83,8,573,2,29,604
17,4,17017,610,3,59,60,21,24,0,164,0,8,172
17,4,17021,689,3,224,406,196,81,5,912,3,19,934
17,4,17021,690,3,225,409,178,71,12,895,4,32,931
17,4,17021,691,3,176,248,164,63,11,662,3,34,699
17,4,17021,694,3,61,35,45,7,3,151,0,3,154
17,4,17025,734,3,192,361,228,22,23,826,3,11,840
17,4,17025,735,3,106,228,205,29,17,585,2,34,621
17,4,17025,738,3,212,320,323,52,41,948,3,36,987
17,4,17025,739,3,135,299,217,32,26,709,2,33,744
17,4,17025,742,3,144,355,195,32,23,749,1,33,783
17,4,17025,743,3,118,267,220,28,14,647,1,23,671
17,4,17025,746,3,37,159,68,3,14,281,3,15,299
17,4,17025,747,3,54,68,27,2,2,153,0,8,161
17,4,17025,750,3,70,78,40,2,14,204,1,14,219
17,4,17025,751,3,23,69,85,1,0,178,1,8,187
17,4,17025,754,3,35,58,19,0,1,113,4,4,121
17,4,17025,755,3,77,60,19,4,0,160,0,5,165
17,4,17025,758,3,23,33,8,1,3,68,0,2,70
17,4,17025,759,3,49,32,11,1,7,100,0,1,101
17,4,17028,776,3,276,141,296,28,24,765,4,25,794
17,4,17028,778,3,259,176,350,31,11,827,5,30,862
17,4,17028,779,3,192,302,167,33,10,704,0,30,734
17,4,17028,782,3,296,283,152,24,10,765,2,21,788
17,4,17028,783,3,560,471,342,52,37,1462,2,32,1496
17,4,17028,786,3,152,97,187,26,17,479,1,11,491
17,4,17028,787,3,353,244,328,50,20,995,8,31,1034
17,4,17028,790,3,278,153,257,24,13,725,9,9,743
17,4,17028,791,3,341,173,214,20,7,755,4,4,763
17,4,17028,794,3,457,222,454,35,15,1183,10,17,1210
17,4,17028,795,3,270,260,382,29,26,967,1,24,992
17,4,17028,798,3,336,181,285,21,21,844,3,21,868
17,4,17031,869,3,163,210,296,28,28,725,2,36,763
17,4,17031,870,3,204,242,324,23,42,835,3,36,874
17,4,17031,871,3,186,277,295,44,25,827,0,21,848
17,4,17031,874,3,158,302,370,55,44,929,2,25,956
17,4,17031,875,3,150,166,243,41,17,617,0,24,641
17,4,17031,878,3,60,88,100,13,10,271,1,6,278
17,4,17031,879,3,118,194,274,29,19,634,2,22,658
17,4,17031,882,3,165,279,307,52,36,839,9,20,868
17,4,17031,883,3,157,186,289,36,22,690,3,24,717
17,4,17031,886,3,18,71,64,5,3,161,0,3,164
17,4,17031,887,3,89,200,126,16,15,446,5,17,468
17,4,17031,890,3,143,250,190,54,17,654,4,12,670
17,4,17031,891,3,114,184,173,17,8,496,1,13,510
17,4,17031,894,3,146,174,233,37,17,607,9,26,642
17,5,17003,24,3,120,324,125,18,34,621,2,30,653
17,5,17003,26,3,245,496,192,42,52,1027,4,40,1071
17,5,17003,27,3,191,278,126,39,29,663,0,36,699
17,5,17003,30,3,221,353,143,24,24,765,3,38,806
17,5,17003,31,3,226,416,178,31,71,922,5,54,981
17,5,17003,34,3,72,17,23,1,3,116,0,6,122
17,5,17003,35,3,100,124,240,24,54,542,5,45,592
17,5,17003,38,3,201,201,166,21,72,661,0,30,691
17,5,17003,39,3,133,148,100,7,24,412,3,13,428
17,5,17003,42,3,42,113,6,7,3,171,1,0,172
17,5,17003,43,3,82,119,78,10,10,299,0,19,318
17,5,17004,46,3,225,130,153,67,13,588,4,22,614
17,5,17004,47,3,280,96,202,69,9,656,5,0,661
17,5,17004,50,3,222,192,105,57,13,589,4,23,616
17,5,17004,51,3,252,157,132,52,8,601,0,14,615
17,5,17004,54,3,269,96,266,44,19,694,1,19,714
17,5,17004,55,3,334,209,262,70,24,899,6,26,931
17,5,17004,58,3,221,193,130,98,12,654,0,23,677
17,5,17004,59,3,336,181,265,101,26,909,10,28,947
17,5,17004,62,3,375,213,250,91,19,948,7,29,984
17,5,17004,63,3,69,36,69,20,1,195,0,4,199
17,5,17004,66,3,210,196,166,108,18,698,4,27,729
17,5,17004,67,3,164,181,309,89,13,756,3,36,795
17,5,17004,70,3,210,148,232,91,11,692,1,24,717
17,5,17004,71,3,189,198,212,93,16,708,0,29,737
17,5,17004,74,3,363,216,293,116,17,1005,2,31,1038
17,5,17004,75,3,258,188,146,45,52,689,4,34,727
17,5,17004,78,3,54,36,19,7,1,117,1,6,124
17,5,17004,79,3,84,47,140,26,9,306,0,16,322
17,5,17004,82,3,27,58,20,33,0,138,2,3,143
17,5,17004,83,3,148,145,129,34,13,469,0,23,492
17,5,17010,423,3,169,343,98,43,18,671,2,23,696
17,5,17010,426,3,291,133,455,34,23,936,1,52,989
17,5,17010,427,3,212,114,351,32,14,723,1,32,756
17,5,17010,430,3,369,185,221,22,10,807,0,14,821
17,5,17013,537,3,153,167,90,34,16,460,1,6,467
17,5,17013,538,3,288,222,211,43,40,804,9,22,835
17,5,17013,539,3,278,181,78,34,17,588,2,21,611
17,5,17013,542,3,221,215,138,57,30,661,3,21,685
17,5,17013,543,3,177,28,36,5,7,253,0,13,266
17,5,17013,546,3,238,53,55,12,20,378,2,10,390
17,5,17013,547,3,308,65,66,20,37,496,2,36,534
17,5,17019,654,3,266,323,387,66,10,1052,3,20,1075
17,5,17019,655,3,213,245,238,72,5,773,1,26,800
17,5,17019,658,3,189,222,111,104,10,636,1,17,654
17,5,17019,659,3,91,60,32,14,5,202,0,4,206
17,5,17019,662,3,162,180,170,44,3,559,0,34,593
17,5,17019,663,3,368,190,199,52,10,819,1,39,859
17,5,17019,666,3,31,23,12,0,0,66,0,0,66
17,5,17019,667,3,178,318,143,35,5,679,2,16,697
17,5,17024,707,3,241,128,306,64,31,770,3,23,796
17,5,17024,710,3,388,204,401,137,20,1150,10,58,1218
17,5,17024,711,3,236,125,132,75,14,582,4,39,625
17,5,17024,714,3,262,327,203,68,32,892,4,24,920
17,5,17024,715,3,48,64,85,19,5,221,2,4,227
17,5,17024,718,3,96,93,157,29,21,396,1,15,412
17,5,17024,719,3,169,141,162,50,20,542,1,13,556
17,5,17024,722,3,87,196,124,14,27,448,0,22,470
17,5,17024,723,3,244,310,249,113,14,930,6,20,956
17,5,17024,726,3,113,162,305,67,28,675,3,15,693
17,5,17024,727,3,174,185,429,50,16,854,3,21,878
17,5,17024,730,3,220,201,253,28,10,712,0,29,741
17,5,17024,731,3,238,388,451,123,25,1225,11,42,1278
17,5,17029,799,3,257,224,366,58,19,924,6,39,969
17,5,17029,802,3,240,174,206,56,20,696,1,39,736
17,5,17029,803,3,271,157,216,63,17,724,5,13,742
17,5,17029,806,3,218,181,218,87,13,717,3,38,758
17,5,17029,807,3,186,84,128,65,16,479,3,12,494
17,5,17029,810,3,316,230,393,96,28,1063,6,32,1101
17,5,17029,811,3,445,283,329,75,30,1162,12,58,1232
17,5,17029,814,3,109,59,105,26,8,307,4,19,330
17,5,17029,815,3,172,162,191,56,16,597,0,19,616
17,5,17029,818,3,265,324,266,46,20,921,4,33,958
17,5,17029,819,3,176,118,187,28,12,521,0,20,541
17,5,17029,822,3,214,136,232,29,12,623,5,16,644
17,5,17029,823,3,198,90,178,18,9,493,2,9,504
17,5,17029,826,3,155,106,166,28,13,468,4,18,490
17,5,17029,827,3,120,100,160,40,8,428,0,18,446
17,5,17029,830,3,190,93,235,69,11,598,4,15,617
17,5,17029,831,3,233,110,214,46,14,617,8,34,659
17,5,17029,834,3,361,174,233,140,20,928,1,22,951
17,5,17029,835,3,170,42,93,45,8,358,3,5,366
17,5,17029,838,3,152,72,205,25,21,475,3,8,486
17,5,17029,839,3,321,198,291,72,19,901,3,28,932
17,5,17029,842,3,176,107,267,35,12,597,2,15,614
17,5,17029,843,3,329,148,317,74,18,886,2,43,931
17,5,17029,846,3,132,92,161,20,1,406,2,14,422
17,5,17029,847,3,218,84,195,59,9,565,0,23,588
17,5,17032,895,3,141,243,98,75,5,562,0,33,595
17,5,17032,898,3,313,105,134,70,4,626,0,7,633
17,5,17032,899,3,295,165,151,83,7,701,0,21,722
17,5,17033,902,3,490,278,447,122,31,1368,0,58,1426
17,5,17033,903,3,67,125,129,21,8,350,0,6,356
17,5,17033,906,3,156,501,462,76,14,1209,1,40,1250
18,1,18001,1,3,53,87,106,14,3,263,0,8,271
18,1,18001,2,3,79,116,128,11,4,338,1,19,358
18,1,18001,3,3,131,301,273,22,5,732,1,19,752
18,1,18001,6,3,62,111,125,14,1,313,1,8,322
18,1,18001,7,3,80,131,126,19,1,357,0,6,363
18,1,18001,10,3,96,187,188,44,5,520,0,11,531
18,1,18001,11,3,61,95,77,19,2,254,1,4,259
18,1,18001,14,3,46,80,51,11,1,189,0,4,193
18,1,18001,15,3,48,125,97,23,2,295,0,10,305
18,1,18001,18,3,80,131,141,31,3,386,0,8,394
18,1,18001,19,3,22,42,7,1,0,72,0,2,74
18,1,18001,22,3,12,41,25,1,0,79,0,1,80
18,1,18001,23,3,34,99,164,25,4,326,1,26,353
18,1,18001,26,3,18,42,31,2,1,94,0,1,95
18,1,18001,27,3,13,76,57,14,1,161,0,6,167
18,1,18001,30,3,29,56,18,2,1,106,0,2,108
18,1,18001,31,3,24,107,61,1,0,193,0,4,197
18,1,18001,34,3,47,45,43,1,0,136,0,4,140
18,1,18001,35,3,16,25,11,1,1,54,0,1,55
18,1,18001,38,3,174,136,162,15,14,501,0,5,506
18,1,18001,39,3,109,126,137,21,4,397,1,14,412
18,1,18001,42,3,1,15,35,0,2,53,0,3,56
18,1,18001,43,3,59,142,163,13,0,377,0,8,385
18,1,18001,46,3,159,155,116,8,1,439,0,6,445
18,1,18001,47,3,131,171,59,6,0,367,0,11,378
18,1,18006,196,3,44,269,253,3,0,569,1,8,578
18,1,18006,198,3,10,70,51,2,1,134,0,4,138
18,1,18006,199,3,2,71,30,1,1,105,0,1,106
18,1,18006,202,3,21,133,133,1,0,288,0,8,296
18,1,18006,203,3,10,121,120,1,2,254,0,7,261
18,1,18006,206,3,9,83,20,9,2,123,0,7,130
18,1,18006,207,3,1,85,71,2,0,159,0,4,163
18,1,18006,210,3,16,32,68,1,0,117,0,5,122
18,1,18006,211,3,4,37,48,13,1,103,0,2,105
18,1,18006,214,3,18,84,62,2,0,166,0,5,171
18,1,18009,257,3,35,91,90,1,2,219,0,15,234
18,1,18009,258,3,50,191,114,4,6,365,0,21,386
18,1,18009,259,3,110,442,132,7,9,700,1,73,774
18,1,18009,262,3,161,213,114,1,10,499,0,18,517
18,1,18009,263,3,1,18,47,0,1,67,0,0,67
18,1,18009,266,3,30,101,31,0,0,162,3,14,179
18,1,18009,267,3,146,295,207,1,7,656,0,46,702
18,1,18009,270,3,57,222,192,0,1,472,0,32,504
18,1,18009,271,3,23,148,84,1,1,257,0,13,270
18,1,18009,274,3,16,113,57,2,4,192,1,12,205
18,1,18009,275,3,5,72,111,0,1,189,0,10,199
18,1,18010,278,3,14,126,137,5,3,285,0,10,295
18,1,18010,279,3,14,47,56,14,0,131,0,3,134
18,1,18010,282,3,35,143,106,75,0,359,1,9,369
18,1,18010,283,3,46,83,106,8,2,245,2,13,260
18,1,18010,286,3,30,233,115,2,1,381,0,5,386
18,1,18010,287,3,16,110,136,5,2,269,0,2,271
18,1,18010,290,3,7,129,176,13,2,327,0,18,345
18,1,18010,291,3,28,259,153,8,1,449,3,23,475
18,1,18010,294,3,2,69,21,1,0,93,0,1,94
18,1,18010,295,3,30,159,173,6,6,374,0,12,386
18,1,18010,298,3,31,154,120,8,2,315,0,8,323
18,1,18010,299,3,33,128,118,4,2,285,0,6,291
18,1,18010,302,3,36,232,103,11,1,383,0,10,393
18,1,18010,303,3,19,120,94,2,0,235,0,3,238
18,1,18010,306,3,23,202,236,5,1,467,1,10,478
18,1,18010,307,3,28,116,147,1,1,293,0,0,293
18,1,18010,310,3,72,187,229,17,2,507,2,11,520
18,1,18010,311,3,59,287,323,22,5,696,0,16,712
18,1,18010,314,3,46,146,113,7,4,316,0,3,319
18,1,18010,315,3,64,111,148,6,3,332,1,6,339
18,1,18010,318,3,18,98,105,0,1,222,0,3,225
18,1,18010,319,3,4,67,40,0,2,113,0,0,113
18,1,18011,322,3,115,121,210,6,4,456,0,7,463
18,1,18011,323,3,119,135,209,6,3,472,0,15,487
18,1,18011,326,3,59,161,165,6,3,394,0,13,407
18,1,18011,327,3,91,106,127,9,1,334,1,0,335
18,1,18011,330,3,76,104,99,14,3,296,0,6,302
18,1,18011,331,3,76,112,130,5,3,326,0,9,335
18,1,18011,334,3,8,86,51,1,0,146,0,3,149
18,1,18011,335,3,4,27,51,2,0,84,0,4,88
18,1,18011,338,3,104,75,48,2,1,230,0,7,237
18,1,18011,339,3,29,47,26,0,1,103,0,5,108
18,1,18011,342,3,22,68,61,1,2,154,0,2,156
18,1,18011,343,3,26,172,176,11,1,386,0,0,386
18,1,18011,346,3,45,151,61,2,2,261,0,7,268
18,1,18015,435,3,15,179,129,4,6,333,0,17,350
18,1,18015,438,3,22,179,195,7,0,403,1,4,408
18,1,18015,439,3,14,114,132,5,1,266,0,2,268
18,1,18015,442,3,28,211,223,9,1,472,0,11,483
18,1,18015,443,3,12,207,172,2,3,396,0,4,400
18,1,18015,446,3,26,188,142,5,1,362,0,8,370
18,1,18015,447,3,22,209,293,15,3,542,1,7,550
18,1,18015,450,3,12,148,138,11,0,309,1,5,315
18,1,18015,451,3,32,218,281,8,5,544,0,12,556
18,1,18015,454,3,6,56,75,2,1,140,0,4,144
18,1,18015,455,3,11,126,162,1,1,301,0,4,305
18,1,18015,458,3,32,182,179,32,0,425,0,2,427
18,1,18015,459,3,46,280,233,15,3,577,0,18,595
18,1,18015,462,3,12,69,30,2,1,114,0,1,115
18,1,18015,463,3,49,302,102,11,3,467,0,6,473
18,1,18015,466,3,113,155,56,3,0,327,0,19,346
18,1,18015,467,3,30,93,21,5,0,149,0,9,158
18,1,18015,470,3,21,165,205,6,3,400,0,2,402
18,1,18015,471,3,14,99,119,1,1,234,0,3,237
18,1,18015,474,3,15,157,173,2,0,347,3,10,360
18,1,18015,475,3,31,76,105,1,0,213,1,5,219
18,1,18015,478,3,10,127,61,5,1,204,0,0,204
18,1,18015,479,3,2,37,16,1,0,56,0,0,56
18,1,18015,482,3,42,151,176,6,1,376,0,9,385
18,1,18015,483,3,37,212,229,10,0,488,2,12,502
18,1,18015,486,3,11,66,49,0,1,127,0,6,133
18,1,18015,487,3,30,206,217,3,1,457,1,7,465
18,1,18015,490,3,23,128,98,1,1,251,0,5,256
18,1,18015,491,3,6,96,144,1,1,248,0,6,254
18,1,18015,494,3,20,132,131,7,0,290,0,1,291
18,1,18015,495,3,15,138,130,5,3,291,0,9,300
18,1,18015,498,3,12,222,147,2,0,383,1,7,391
18,1,18015,499,3,3,110,21,0,0,134,0,1,135
18,1,18015,502,3,37,182,140,3,5,367,0,7,374
18,1,18015,503,3,31,164,201,7,5,408,2,20,430
18,1,18015,506,3,14,75,106,4,0,199,0,6,205
18,1,18015,507,3,13,145,139,6,1,304,0,9,313
18,1,18015,510,3,6,106,103,4,0,219,0,2,221
18,1,18015,511,3,42,206,194,6,2,450,3,4,457
18,1,18015,514,3,5,70,45,0,0,120,0,1,121
18,1,18015,515,3,23,94,136,3,4,260,0,22,282
18,1,18015,518,3,23,61,10,0,0,94,0,1,95
18,1,18015,519,3,14,101,62,4,2,183,0,3,186
18,1,18015,522,3,39,149,187,29,5,409,0,10,419
18,1,18015,523,3,35,211,182,23,7,458,1,14,473
18,1,18015,526,3,41,212,184,18,3,458,0,7,465
18,1,18015,527,3,17,168,146,3,0,334,0,9,343
18,1,18015,530,3,19,128,110,21,0,278,0,7,285
18,1,18015,531,3,30,175,236,9,3,453,2,17,472
18,1,18015,534,3,22,73,81,9,4,189,0,3,192
18,1,18015,535,3,23,84,117,6,3,233,0,4,237
18,1,18015,538,3,15,138,148,2,0,303,0,3,306
18,1,18015,539,3,27,114,156,6,0,303,0,11,314
18,1,18015,542,3,26,241,235,0,2,504,0,3,507
18,1,18015,543,3,52,263,278,10,1,604,0,19,623
18,1,18015,546,3,50,138,179,3,1,371,1,8,380
18,1,18016,547,3,54,50,100,8,1,213,0,6,219
18,1,18016,550,3,141,173,211,37,1,563,0,19,582
18,1,18016,551,3,91,105,176,10,4,386,0,13,399
18,1,18016,554,3,173,101,81,10,5,370,0,0,370
18,1,18016,555,3,101,107,77,6,0,291,0,5,296
18,1,18016,558,3,80,68,97,14,0,259,0,7,266
18,1,18016,559,3,81,65,89,7,3,245,0,6,251
18,1,18016,562,3,85,105,96,20,0,306,0,0,306
18,1,18016,563,3,105,72,140,8,1,326,0,4,330
18,1,18016,566,3,22,48,8,0,0,78,0,0,78
18,1,18016,567,3,17,266,120,2,1,406,0,4,410
18,1,18016,570,3,97,142,257,11,2,509,0,21,530
18,1,18016,571,3,152,113,117,5,6,393,0,25,418
18,1,18016,574,3,35,200,144,3,2,384,0,4,388
18,1,18016,575,3,33,187,247,3,0,470,0,14,484
18,1,18016,578,3,54,166,233,9,0,462,0,14,476
18,1,18016,579,3,72,60,166,13,25,336,0,15,351
18,1,18016,582,3,70,211,197,5,2,485,0,13,498
18,1,18016,583,3,116,128,220,4,1,469,0,5,474
18,1,18016,586,3,63,139,111,3,0,316,0,0,316
18,1,18016,587,3,51,106,183,12,0,352,1,15,368
18,1,18016,590,3,20,53,40,0,0,113,0,4,117
18,1,18016,591,3,63,129,199,5,1,397,0,37,434
18,1,18016,594,3,19,64,103,3,1,190,0,1,191
18,1,18016,595,3,19,80,59,6,2,166,0,3,169
18,1,18018,810,3,46,163,176,13,1,399,0,9,408
18,1,18018,811,3,31,119,147,9,3,309,1,7,317
18,1,18018,814,3,46,134,151,22,3,356,0,3,359
18,1,18018,815,3,59,123,153,12,3,350,0,9,359
18,1,18018,818,3,34,103,76,12,3,228,0,4,232
18,1,18018,819,3,35,137,115,10,1,298,0,3,301
18,1,18018,822,3,49,121,139,14,2,325,1,8,334
18,1,18018,823,3,78,105,206,17,2,408,0,7,415
18,1,18018,826,3,30,67,116,9,0,222,0,5,227
18,1,18018,827,3,65,148,207,31,4,455,0,13,468
18,1,18018,830,3,55,118,153,15,5,346,2,6,354
18,1,18018,831,3,52,115,126,11,2,306,0,0,306
18,1,18018,834,3,57,89,69,10,1,226,0,6,232
18,1,18018,835,3,48,109,186,19,4,366,1,9,376
18,1,18018,838,3,64,213,221,8,4,510,0,6,516
18,1,18018,839,3,54,179,128,6,0,367,0,9,376
18,1,18018,842,3,52,118,199,3,4,376,0,16,392
18,1,18018,843,3,42,136,159,4,5,346,0,10,356
18,2,18017,597,3,43,101,176,43,6,369,0,13,382
18,2,18017,598,3,158,461,674,102,41,1436,5,40,1481
18,2,18017,599,3,23,100,88,17,0,228,0,9,237
18,2,18017,602,3,115,248,340,75,29,807,2,17,826
18,2,18017,603,3,70,228,237,33,15,583,4,3,590
18,2,18017,606,3,84,212,216,55,17,584,4,23,611
18,2,18017,607,3,114,310,386,82,16,908,8,26,942
18,2,18017,610,3,207,346,488,87,37,1165,15,16,1196
18,2,18017,611,3,322,847,1002,181,58,2410,12,58,2480
18,2,18017,614,3,106,170,208,39,10,533,0,5,538
18,2,18017,615,3,85,190,227,46,17,565,4,10,579
18,2,18017,618,3,43,103,156,21,7,330,2,6,338
18,2,18017,619,3,60,107,116,22,6,311,0,9,320
18,2,18017,622,3,62,142,192,17,5,418,2,8,428
18,2,18017,623,3,73,218,261,39,10,601,0,12,613
18,2,18017,626,3,123,201,328,51,20,723,3,18,744
18,2,18017,627,3,99,197,279,45,19,639,1,19,659
18,2,18017,630,3,95,225,312,60,17,709,4,19,732
18,2,18017,631,3,142,286,384,80,16,908,1,17,926
18,2,18017,634,3,351,509,795,167,49,1871,2,19,1892
18,2,18017,635,3,171,296,404,68,26,965,3,21,989
18,2,18017,638,3,58,129,131,26,14,358,4,4,366
18,2,18017,639,3,80,184,232,37,15,548,1,14,563
18,2,18017,642,3,64,128,156,21,13,382,2,8,392
18,2,18017,643,3,113,214,252,37,19,635,0,19,654
18,2,18017,646,3,110,222,273,55,24,684,1,21,706
18,2,18017,647,3,48,94,171,38,8,359,3,3,365
18,2,18017,650,3,47,112,174,21,9,363,1,7,371
18,2,18017,651,3,133,194,332,34,15,708,1,18,727
18,2,18017,654,3,55,123,171,34,8,391,0,8,399
18,2,18017,655,3,70,137,195,37,10,449,0,9,458
18,2,18017,658,3,83,190,235,74,13,595,1,15,611
18,2,18017,659,3,63,98,180,19,8,368,1,7,376
18,2,18017,662,3,104,248,289,59,26,726,1,6,733
18,2,18017,663,3,224,269,514,68,29,1104,0,14,1118
18,2,18017,666,3,174,197,217,22,10,620,2,6,628
18,2,18017,667,3,85,140,240,33,16,514,0,13,527
18,2,18017,670,3,118,135,168,22,12,455,0,5,460
18,2,18017,671,3,78,54,105,5,10,252,4,1,257
18,2,18017,674,3,61,91,137,20,6,315,0,2,317
18,2,18017,675,3,62,48,89,10,15,224,1,6,231
18,2,18017,678,3,114,221,332,52,19,738,3,16,757
18,2,18017,679,3,92,230,315,63,22,722,6,32,760
18,2,18017,682,3,78,48,96,8,6,236,0,3,239
18,2,18017,683,3,45,49,75,6,0,175,0,2,177
18,2,18017,686,3,53,55,101,18,4,231,0,4,235
18,2,18017,687,3,93,157,230,35,5,520,0,9,529
18,2,18017,690,3,67,84,139,20,6,316,4,2,322
18,2,18017,691,3,96,134,168,23,7,428,1,9,438
18,2,18017,694,3,80,288,241,17,10,636,6,29,671
18,2,18017,695,3,156,477,505,62,30,1230,3,24,1257
18,2,18017,698,3,66,102,131,21,9,329,0,2,331
18,2,18017,699,3,46,81,113,22,4,266,0,7,273
18,2,18017,702,3,127,191,340,52,17,727,1,18,746
18,2,18017,703,3,97,123,222,29,12,483,0,5,488
18,2,18017,706,3,72,153,241,36,14,516,0,7,523
18,2,18017,707,3,70,128,145,29,6,378,3,10,391
18,2,18017,710,3,95,238,317,56,21,727,0,14,741
18,2,18017,711,3,269,660,904,145,55,2033,3,45,2081
18,2,18017,714,3,61,145,172,32,8,418,2,8,428
18,2,18017,715,3,166,263,313,40,22,804,5,4,813
18,2,18017,718,3,71,153,171,41,15,451,0,5,456
18,2,18017,719,3,168,242,346,70,35,861,1,16,878
18,2,18017,722,3,89,195,216,37,17,554,0,10,564
18,2,18017,723,3,165,332,399,87,33,1016,3,34,1053
18,2,18017,726,3,116,185,274,31,16,622,1,0,623
18,2,18017,727,3,90,116,225,26,13,470,1,7,478
18,2,18017,730,3,99,167,248,53,16,583,4,14,601
18,2,18017,731,3,75,133,181,34,16,439,2,6,447
18,2,18017,734,3,87,162,196,37,15,497,1,5,503
18,2,18017,735,3,58,128,186,27,9,408,0,16,424
18,2,18017,738,3,68,285,416,51,13,833,3,14,850
18,2,18017,739,3,129,318,403,50,19,919,2,24,945
18,2,18017,742,3,91,169,274,33,18,585,1,6,592
18,2,18017,743,3,63,122,184,26,14,409,2,10,421
18,2,18017,746,3,129,227,357,66,16,795,10,11,816
18,2,18017,747,3,66,176,277,26,17,562,0,14,576
18,2,18017,750,3,115,98,204,16,9,442,3,7,452
18,2,18017,751,3,88,161,170,50,13,482,0,2,484
18,2,18017,754,3,97,286,388,66,17,854,0,26,880
18,2,18017,755,3,89,175,208,39,15,526,1,9,536
18,2,18017,758,3,281,459,743,87,48,1618,8,47,1673
18,2,18017,759,3,93,221,296,32,11,653,5,14,672
18,2,18017,762,3,81,224,288,50,17,660,1,5,666
18,2,18017,763,3,77,215,365,38,15,710,2,6,718
18,2,18017,766,3,74,200,237,34,7,552,4,20,576
18,2,18017,767,3,71,114,176,26,7,394,1,7,402
18,2,18017,770,3,73,213,269,14,7,576,0,10,586
18,2,18017,771,3,16,89,69,1,1,176,2,5,183
18,2,18017,774,3,49,148,342,25,0,564,0,14,578
18,2,18017,775,3,7,45,59,5,1,117,1,1,119
18,2,18017,778,3,26,117,72,12,3,230,0,0,230
18,2,18017,779,3,60,141,166,24,5,396,0,12,408
18,2,18017,782,3,60,176,188,26,9,459,3,21,483
18,2,18017,783,3,46,147,292,24,7,516,3,4,523
18,2,18017,786,3,7,104,69,10,0,190,0,9,199
18,2,18017,787,3,15,112,43,2,1,173,0,0,173
18,2,18017,790,3,12,19,79,1,0,111,0,3,114
18,2,18017,791,3,3,37,27,2,0,69,0,2,71
18,2,18017,794,3,23,29,59,12,2,125,1,5,131
18,2,18017,795,3,29,150,76,14,7,276,6,0,282
18,2,18017,798,3,27,126,145,18,2,318,0,8,326
18,2,18017,799,3,35,150,136,15,8,344,1,10,355
18,2,18017,802,3,35,136,122,7,6,306,4,5,315
18,2,18017,803,3,36,158,151,20,5,370,1,18,389
18,2,18017,806,3,41,104,166,32,6,349,2,9,360
18,2,18017,807,3,44,309,390,77,11,831,2,33,866
18,3,18002,49,3,86,94,60,17,6,263,0,6,269
18,3,18002,50,3,158,99,89,17,6,369,1,6,376
18,3,18002,51,3,148,130,87,16,7,388,0,19,407
18,3,18002,54,3,217,200,196,27,3,643,0,7,650
18,3,18002,55,3,18,72,60,4,1,155,0,8,163
18,3,18002,58,3,47,95,148,3,2,295,0,8,303
18,3,18002,59,3,131,316,160,32,2,641,1,22,664
18,3,18002,62,3,41,47,30,5,2,125,0,4,129
18,3,18002,63,3,32,64,28,3,3,130,0,6,136
18,3,18003,66,3,98,78,19,5,1,201,0,1,202
18,3,18003,67,3,212,106,51,2,3,374,1,8,383
18,3,18003,70,3,43,62,12,2,1,120,0,3,123
18,3,18003,71,3,51,30,9,0,4,94,0,3,97
18,3,18003,74,3,74,83,84,4,5,250,0,10,260
18,3,18003,75,3,133,106,26,1,0,266,1,12,279
18,3,18003,78,3,113,112,88,2,2,317,2,9,328
18,3,18003,79,3,166,168,65,2,4,405,1,9,415
18,3,18003,82,3,111,50,59,5,3,228,0,2,230
18,3,18003,83,3,114,113,68,6,4,305,0,7,312
18,3,18003,86,3,28,103,15,0,3,149,0,7,156
18,3,18003,87,3,29,21,7,1,1,59,0,0,59
18,3,18004,90,3,550,405,653,79,40,1727,8,40,1775
18,3,18004,91,3,81,146,102,6,7,342,0,6,348
18,3,18004,94,3,35,119,77,2,1,234,0,7,241
18,3,18004,95,3,34,153,83,2,4,276,0,6,282
18,3,18004,98,3,229,465,187,20,6,907,0,18,925
18,3,18004,99,3,49,177,78,0,0,304,1,7,312
18,3,18004,102,3,144,183,227,17,8,579,0,10,589
18,3,18004,103,3,108,238,178,9,11,544,0,12,556
18,3,18004,106,3,115,272,93,34,13,527,0,18,545
18,3,18004,107,3,167,269,141,22,3,602,3,10,615
18,3,18004,110,3,76,177,135,100,8,496,1,17,514
18,3,18004,111,3,323,353,415,34,17,1142,2,26,1170
18,3,18004,114,3,236,269,211,43,12,771,0,14,785
18,3,18004,115,3,329,381,301,33,21,1065,0,12,1077
18,3,18004,118,3,390,480,262,38,18,1188,3,24,1215
18,3,18004,119,3,159,139,110,11,8,427,0,12,439
18,3,18004,122,3,207,139,82,14,11,453,0,8,461
18,3,18004,123,3,169,84,90,9,9,361,0,5,366
18,3,18005,126,3,123,145,129,15,6,418,2,17,437
18,3,18005,127,3,116,144,135,24,3,422,1,15,438
18,3,18005,130,3,112,147,84,17,5,365,0,7,372
18,3,18005,131,3,104,161,112,9,6,392,0,4,396
18,3,18005,134,3,113,227,148,28,6,522,3,16,541
18,3,18005,135,3,130,200,134,25,5,494,2,4,500
18,3,18005,138,3,85,119,140,24,3,371,0,11,382
18,3,18005,139,3,28,53,178,12,6,277,0,10,287
18,3,18005,142,3,15,27,17,5,0,64,0,1,65
18,3,18005,143,3,8,90,47,17,1,163,0,9,172
18,3,18005,146,3,16,39,30,1,0,86,0,1,87
18,3,18005,147,3,36,60,102,2,0,200,0,8,208
18,3,18005,150,3,34,73,130,4,1,242,5,5,252
18,3,18005,151,3,70,182,249,15,7,523,0,12,535
18,3,18005,154,3,28,49,90,5,2,174,0,2,176
18,3,18005,155,3,29,82,77,10,1,199,1,5,205
18,3,18005,158,3,76,99,144,12,2,333,1,4,338
18,3,18005,159,3,61,89,115,5,1,271,0,0,271
18,3,18005,162,3,42,89,103,2,1,237,0,5,242
18,3,18005,163,3,46,76,130,5,0,257,2,6,265
18,3,18005,166,3,78,81,136,6,1,302,0,10,312
18,3,18005,167,3,120,124,147,5,5,401,1,7,409
18,3,18005,170,3,15,71,33,6,0,125,0,6,131
18,3,18005,171,3,77,212,109,9,3,410,0,10,420
18,3,18005,174,3,5,25,28,1,1,60,0,1,61
18,3,18005,175,3,14,179,87,9,1,290,0,7,297
18,3,18005,178,3,22,92,112,2,2,230,0,0,230
18,3,18005,179,3,15,72,102,3,0,192,1,5,198
18,3,18005,182,3,16,56,12,7,3,94,0,6,100
18,3,18005,183,3,151,83,114,8,4,360,0,0,360
18,3,18005,186,3,102,108,99,16,4,329,0,6,335
18,3,18005,187,3,141,85,88,8,11,333,0,16,349
18,3,18005,190,3,339,355,490,42,16,1242,1,35,1278
18,3,18005,191,3,24,32,40,1,1,98,0,1,99
18,3,18005,194,3,51,56,25,15,0,147,0,2,149
18,3,18005,195,3,39,71,66,5,1,182,0,10,192
18,3,18007,215,3,233,240,302,38,7,820,1,21,842
18,3,18007,218,3,185,166,278,22,11,662,0,22,684
18,3,18007,219,3,94,105,120,10,2,331,1,13,345
18,3,18007,222,3,243,277,203,40,6,769,0,14,783
18,3,18007,223,3,136,258,188,50,9,641,0,11,652
18,3,18007,226,3,110,143,121,29,2,405,2,11,418
18,3,18007,227,3,115,87,102,15,2,321,1,11,333
18,3,18007,230,3,89,117,84,20,5,315,1,13,329
18,3,18007,231,3,116,118,171,19,7,431,3,7,441
18,3,18007,234,3,47,48,40,8,1,144,0,6,150
18,3,18007,235,3,58,58,28,1,1,146,0,5,151
18,3,18007,238,3,50,60,38,7,2,157,0,8,165
18,3,18008,239,3,120,121,30,2,2,275,0,6,281
18,3,18008,242,3,133,217,105,11,3,469,1,6,476
18,3,18008,243,3,130,120,97,13,2,362,0,6,368
18,3,18008,246,3,6,56,6,2,0,70,0,0,70
18,3,18008,247,3,61,63,40,3,6,173,0,1,174
18,3,18008,250,3,53,213,55,3,1,325,0,5,330
18,3,18008,251,3,57,117,33,0,0,207,0,30,237
18,3,18008,254,3,171,111,87,14,5,388,2,8,398
18,3,18008,255,3,52,136,81,11,0,280,1,0,281
18,3,18012,347,3,397,213,167,6,6,789,0,17,806
18,3,18012,350,3,365,169,185,9,8,736,0,13,749
18,3,18012,351,3,196,150,106,5,3,460,1,16,477
18,3,18012,354,3,17,61,75,3,1,157,0,6,163
18,3,18012,355,3,38,42,51,2,2,135,0,2,137
18,3,18012,358,3,43,63,76,2,1,185,0,10,195
18,3,18012,359,3,91,64,130,2,1,288,2,6,296
18,3,18012,362,3,65,50,24,0,2,141,0,2,143
18,3,18012,363,3,29,18,17,0,0,64,0,0,64
18,3,18012,366,3,45,90,101,3,4,243,0,7,250
18,3,18012,367,3,135,208,77,6,6,432,0,15,447
18,3,18012,370,3,98,61,22,1,2,184,0,3,187
18,3,18012,371,3,23,15,8,1,0,47,0,0,47
18,3,18012,374,3,18,31,16,3,1,69,0,11,80
18,3,18012,375,3,17,33,23,1,0,74,0,0,74
18,3,18012,378,3,18,26,60,2,1,107,0,2,109
18,3,18012,379,3,6,14,17,2,0,39,0,1,40
18,3,18012,382,3,96,192,148,10,2,448,0,11,459
18,3,18012,383,3,118,132,87,7,4,348,0,13,361
18,3,18012,386,3,129,163,227,13,12,544,1,11,556
18,3,18012,387,3,128,158,140,4,2,432,0,10,442
18,3,18012,390,3,116,122,95,7,12,352,2,15,369
18,3,18012,391,3,43,45,28,4,1,121,2,4,127
18,3,18012,394,3,2,45,57,7,1,112,0,7,119
18,3,18012,395,3,106,144,72,6,2,330,0,9,339
18,3,18013,398,3,146,185,62,14,5,412,0,12,424
18,3,18013,399,3,169,130,53,20,4,376,0,6,382
18,3,18013,402,3,3,103,5,2,1,114,0,0,114
18,3,18013,403,3,29,64,31,16,1,141,0,6,147
18,3,18013,406,3,66,83,39,6,4,198,0,9,207
18,3,18013,407,3,54,36,20,6,0,116,0,8,124
18,3,18013,410,3,81,173,43,4,1,302,0,8,310
18,3,18014,411,3,46,398,224,15,9,692,0,9,701
18,3,18014,414,3,26,203,75,8,2,314,0,1,315
18,3,18014,415,3,32,235,84,3,1,355,0,13,368
18,3,18014,418,3,6,82,83,2,0,173,0,6,179
18,3,18014,419,3,10,209,41,2,1,263,0,15,278
18,3,18014,422,3,23,237,77,7,1,345,2,11,358
18,3,18014,423,3,52,202,52,5,2,313,0,0,313
18,3,18014,426,3,2,88,12,2,0,104,1,2,107
18,3,18014,427,3,32,287,104,6,5,434,2,8,444
18,3,18014,430,3,49,133,70,5,1,258,0,15,273
18,3,18014,431,3,64,134,50,8,2,258,0,12,270
18,3,18014,434,3,2,71,7,6,3,89,0,4,93
18,3,18019,844,3,194,498,483,63,42,1280,6,30,1316
18,3,18019,846,3,72,368,324,55,18,837,2,18,857
18,3,18019,847,3,174,743,630,84,47,1678,14,29,1721
18,3,18019,850,3,114,297,245,38,13,707,1,8,716
18,3,18019,851,3,42,181,141,20,4,388,1,3,392
18,3,18019,854,3,56,271,269,30,8,634,1,8,643
18,3,18019,855,3,46,234,167,20,14,481,5,11,497
18,3,18019,858,3,63,188,203,71,5,530,0,14,544
18,3,18019,859,3,61,429,405,16,3,914,1,27,942
18,3,18019,862,3,41,256,109,7,5,418,0,10,428
18,3,18019,863,3,17,124,57,9,6,213,0,9,222
18,3,18020,866,3,61,103,24,1,0,189,0,2,191
18,3,18020,867,3,131,211,124,1,5,472,0,17,489
18,3,18020,870,3,164,144,26,4,3,341,0,4,345
18,3,18020,872,3,14,94,8,1,0,117,0,0,117
18,3,18020,874,3,28,77,11,2,1,119,0,4,123
18,3,18020,875,3,45,8,10,0,0,63,0,6,69
18,3,18020,878,3,40,228,8,0,2,278,1,8,287
19,1,19019,356,3,258,468,42,54,5,827,0,32,859
19,1,19019,358,3,247,391,32,61,7,738,0,23,761
19,1,19019,359,3,670,716,78,193,12,1669,3,34,1706
19,1,19019,362,3,510,316,63,83,10,982,0,16,998
19,1,19019,363,3,459,337,59,121,17,993,3,26,1022
19,1,19019,366,3,424,584,67,199,6,1280,1,54,1335
19,1,19019,367,3,368,483,46,79,2,978,1,23,1002
19,1,19019,370,3,269,297,64,41,5,676,0,20,696
19,1,19019,371,3,486,463,61,106,14,1130,0,24,1154
19,1,19019,374,3,395,651,71,85,6,1208,0,31,1239
19,1,19019,375,3,420,422,50,92,9,993,2,31,1026
19,1,19019,378,3,563,391,47,64,6,1071,0,13,1084
19,1,19019,379,3,293,295,21,53,4,666,0,9,675
19,1,19019,382,3,814,216,27,23,8,1088,1,8,1097
19,1,19019,383,3,609,142,21,26,8,806,0,3,809
19,1,19019,386,3,766,219,44,25,12,1066,0,8,1074
19,1,19019,387,3,872,202,22,30,17,1143,3,2,1148
19,1,19019,390,3,1669,446,45,57,26,2243,0,10,2253
19,1,19019,391,3,915,246,17,37,14,1229,4,6,1239
19,1,19019,394,3,631,152,19,25,8,835,0,4,839
19,1,19019,395,3,433,123,19,13,12,600,0,0,600
19,1,19019,398,3,735,194,15,33,9,986,1,6,993
19,1,19019,399,3,736,153,28,25,5,947,1,3,951
19,1,19019,402,3,1202,270,61,40,14,1587,0,7,1594
19,1,19019,403,3,835,288,28,35,8,1194,2,11,1207
19,1,19019,406,3,595,303,33,55,12,998,0,9,1007
19,1,19019,407,3,585,243,38,32,9,907,1,13,921
19,1,19019,410,3,1049,264,27,22,16,1378,0,6,1384
19,1,19019,411,3,1128,306,33,31,16,1514,1,7,1522
19,1,19019,414,3,512,245,26,25,48,856,1,8,865
19,1,19019,415,3,589,180,26,26,6,827,0,6,833
19,1,19048,1999,3,702,581,126,312,25,1746,8,39,1793
19,1,19048,2002,3,818,411,112,297,17,1655,0,19,1674
19,1,19048,2003,3,758,556,115,331,19,1779,7,33,1819
19,1,19048,2006,3,818,572,194,420,27,2031,4,42,2077
19,1,19048,2007,3,375,330,88,200,16,1009,2,65,1076
19,1,19048,2010,3,265,375,71,150,6,867,2,31,900
19,1,19048,2011,3,221,373,50,115,8,767,1,39,807
19,1,19048,2014,3,356,456,64,173,7,1056,0,45,1101
19,1,19048,2015,3,326,348,93,172,6,945,1,56,1002
19,1,19048,2018,3,405,321,95,194,12,1027,2,69,1098
19,1,19048,2019,3,930,425,144,281,36,1816,2,29,1847
19,1,19048,2022,3,406,196,44,129,10,785,0,15,800
19,1,19048,2023,3,387,156,51,126,6,726,0,7,733
19,1,19048,2026,3,372,135,39,118,6,670,0,14,684
19,1,19048,2027,3,750,265,61,193,10,1279,1,33,1313
19,1,19048,2030,3,744,242,74,159,13,1232,1,31,1264
19,1,19048,2031,3,636,268,91,152,11,1158,3,21,1182
19,1,19048,2034,3,229,291,54,127,12,713,0,6,719
19,1,19048,2035,3,174,273,36,145,5,633,2,33,668
19,1,19048,2038,3,296,326,70,161,2,855,0,40,895
19,1,19048,2039,3,719,451,95,323,44,1632,1,37,1670
19,1,19048,2042,3,593,239,88,54,19,993,1,11,1005
19,1,19048,2043,3,325,241,53,85,3,707,0,13,720
19,1,19048,2046,3,346,351,68,138,15,918,16,26,960
19,1,19048,2047,3,1920,1405,292,712,50,4379,11,69,4459
19,1,19048,2050,3,244,460,56,151,10,921,4,36,961
19,1,19048,2051,3,300,501,73,208,8,1090,1,38,1129
19,1,19048,2054,3,429,328,85,107,18,967,0,35,1002
19,1,19048,2055,3,404,246,70,79,11,810,1,21,832
19,1,19048,2058,3,486,421,129,167,18,1221,7,30,1258
19,1,19048,2059,3,264,214,161,93,6,738,0,41,779
19,1,19048,2062,3,123,102,52,117,8,402,1,11,414
19,1,19048,2063,3,527,256,79,181,18,1061,2,17,1080
19,1,19048,2066,3,512,236,103,173,10,1034,3,27,1064
19,1,19048,2067,3,605,260,68,141,11,1085,1,14,1100
19,1,19048,2070,3,312,350,96,136,12,906,0,15,921
19,1,19048,2071,3,550,366,75,195,14,1200,1,18,1219
19,1,19048,2074,3,511,269,70,117,10,977,2,16,995
19,1,19048,2075,3,608,340,94,133,14,1189,3,27,1219
19,1,19048,2078,3,550,211,74,154,10,999,0,26,1025
19,1,19048,2079,3,529,293,61,121,9,1013,2,34,1049
19,1,19048,2082,3,190,193,33,136,7,559,3,24,586
19,1,19048,2083,3,236,197,50,147,5,635,0,14,649
19,2,19006,63,3,422,806,251,81,32,1592,0,35,1627
19,2,19006,66,3,378,629,116,105,17,1245,2,38,1285
19,2,19006,67,3,2169,2111,565,696,71,5612,8,93,5713
19,2,19006,70,3,1155,852,256,221,28,2512,4,31,2547
19,2,19006,71,3,187,224,73,53,8,545,1,8,554
19,2,19006,74,3,126,296,39,35,5,501,4,12,517
19,2,19006,75,3,118,267,18,30,4,437,1,10,448
19,2,19006,78,3,231,404,64,66,11,776,5,22,803
19,2,19006,79,3,253,463,74,65,15,870,4,29,903
19,2,19006,82,3,228,187,63,62,8,548,1,8,557
19,2,19006,83,3,111,172,45,43,6,377,0,7,384
19,2,19006,86,3,339,547,107,166,12,1171,8,18,1197
19,2,19006,87,3,305,422,83,73,3,886,0,3,889
19,2,19006,90,3,353,375,68,108,13,917,0,19,936
19,2,19006,91,3,286,338,68,59,9,760,1,11,772
19,2,19006,94,3,285,527,86,87,7,992,1,35,1028
19,2,19006,95,3,765,447,128,155,24,1519,2,23,1544
19,2,19006,98,3,291,470,70,69,6,906,0,34,940
19,2,19006,99,3,384,309,53,107,10,863,2,23,888
19,2,19006,102,3,994,743,154,127,30,2048,1,49,2098
19,2,19006,103,3,447,446,85,64,17,1059,0,42,1101
19,2,19006,106,3,382,279,46,69,6,782,0,13,795
19,2,19006,107,3,300,534,52,47,8,941,0,18,959
19,2,19006,110,3,369,207,34,41,8,659,0,17,676
19,2,19006,111,3,250,340,45,58,6,699,0,16,715
19,2,19006,114,3,240,270,25,22,6,563,1,12,576
19,2,19006,115,3,418,443,81,61,17,1020,0,26,1046
19,2,19006,118,3,146,514,63,35,10,768,4,14,786
19,2,19006,119,3,144,442,48,26,7,667,2,28,697
19,2,19006,122,3,222,684,86,80,9,1081,1,41,1123
19,2,19006,123,3,230,591,66,77,7,971,1,37,1009
19,2,19006,126,3,78,321,30,21,2,452,8,16,476
19,2,19006,127,3,70,366,40,28,8,512,0,24,536
19,2,19006,130,3,845,1153,203,291,33,2525,8,51,2584
19,2,19006,131,3,1075,1007,184,188,30,2484,8,29,2521
19,2,19006,134,3,210,355,37,59,7,668,1,9,678
19,2,19006,135,3,376,474,67,70,11,998,3,12,1013
19,2,19006,138,3,237,470,49,34,7,797,0,30,827
19,2,19006,139,3,394,462,105,140,10,1111,0,20,1131
19,2,19006,142,3,795,1115,150,182,33,2275,9,46,2330
19,2,19006,143,3,202,494,59,50,17,822,0,32,854
19,2,19006,146,3,333,632,85,77,13,1140,4,28,1172
19,2,19006,147,3,233,376,71,52,9,741,1,27,769
19,2,19006,150,3,281,279,32,30,5,627,2,21,650
19,3,19021,430,3,170,574,91,38,6,879,3,33,915
19,3,19021,431,3,138,328,91,26,7,590,3,23,616
19,3,19021,434,3,198,517,93,61,9,878,2,22,902
19,3,19021,435,3,186,348,101,50,7,692,2,20,714
19,3,19021,438,3,183,472,81,30,6,772,0,13,785
19,3,19021,440,3,329,525,85,87,9,1035,7,27,1069
19,3,19021,442,3,20,78,15,3,2,118,0,3,121
19,3,19021,443,3,507,637,342,89,14,1589,13,34,1636
19,3,19021,446,3,236,284,42,50,3,615,3,14,632
19,3,19021,447,3,814,567,144,130,21,1676,1,20,1697
19,3,19021,450,3,488,369,83,112,25,1077,1,19,1097
19,3,19021,451,3,391,367,67,68,14,907,1,15,923
19,3,19021,454,3,168,416,37,46,9,676,2,22,700
19,3,19021,455,3,156,437,58,46,3,700,0,24,724
19,3,19021,458,3,433,627,127,60,11,1258,2,27,1287
19,3,19021,459,3,777,637,170,166,30,1780,0,33,1813
19,3,19021,462,3,703,607,133,128,19,1590,7,12,1609
19,3,19021,463,3,383,467,84,68,8,1010,0,29,1039
19,3,19021,466,3,459,486,80,108,14,1147,0,7,1154
19,3,19021,467,3,443,437,63,68,23,1034,4,17,1055
19,3,19021,470,3,549,624,158,111,25,1467,3,24,1494
19,3,19021,471,3,164,320,49,27,9,569,0,13,582
19,3,19021,474,3,528,716,148,132,27,1551,2,40,1593
19,3,19021,475,3,214,197,41,44,4,500,0,11,511
19,3,19021,478,3,219,202,26,32,4,483,0,8,491
19,3,19021,479,3,250,371,58,68,6,753,2,4,759
19,3,19021,482,3,327,575,117,88,11,1118,3,27,1148
19,3,19021,483,3,926,1318,264,200,42,2750,6,60,2816
19,3,19021,486,3,182,244,45,35,7,513,0,11,524
19,3,19021,487,3,305,344,60,45,11,765,0,16,781
19,3,19021,490,3,366,442,88,71,7,974,1,35,1010
19,3,19021,491,3,1678,1148,308,252,36,3422,1,36,3459
19,3,19047,1761,3,290,420,95,19,9,833,0,33,866
19,3,19047,1762,3,218,271,65,39,6,599,1,21,621
19,3,19047,1763,3,825,313,114,134,19,1405,1,8,1414
19,3,19047,1766,3,630,302,88,96,24,1140,0,13,1153
19,3,19047,1767,3,738,226,89,104,22,1179,0,11,1190
19,3,19047,1770,3,1243,380,148,140,23,1934,1,31,1966
19,3,19047,1771,3,384,191,59,48,8,690,0,11,701
19,3,19047,1776,3,899,264,108,117,22,1410,3,8,1421
19,3,19047,1778,3,685,218,67,68,13,1051,1,14,1066
19,3,19047,1779,3,622,203,81,80,18,1004,2,3,1009
19,3,19047,1782,3,674,180,109,92,12,1067,3,9,1079
19,3,19047,1783,3,770,276,93,112,14,1265,1,27,1293
19,3,19047,1786,3,812,202,133,107,17,1271,3,10,1284
19,3,19047,1787,3,869,262,129,68,28,1356,0,21,1377
19,3,19047,1790,3,265,376,83,33,2,759,2,18,779
19,3,19047,1791,3,956,258,98,83,14,1409,0,9,1418
19,3,19047,1794,3,942,278,114,101,35,1470,2,8,1480
19,3,19047,1795,3,216,138,31,23,1,409,0,5,414
19,3,19047,1798,3,121,64,24,8,2,219,1,3,223
19,3,19047,1799,3,134,104,17,19,2,276,0,4,280
19,3,19047,1802,3,243,138,45,21,2,449,0,8,457
19,3,19047,1803,3,450,198,68,46,6,768,0,12,780
19,3,19047,1806,3,500,184,69,53,11,817,2,16,835
19,3,19047,1807,3,606,209,72,69,9,965,0,11,976
19,3,19047,1817,3,309,116,32,30,6,493,0,13,506
19,3,19047,1820,3,570,248,89,51,11,969,0,26,995
19,3,19047,1822,3,275,108,40,30,5,458,1,6,465
19,3,19047,1823,3,262,111,39,40,6,458,0,15,473
19,3,19047,1826,3,524,207,36,70,10,847,3,20,870
19,3,19047,1827,3,798,232,118,182,25,1355,0,22,1377
19,3,19047,1830,3,496,156,67,57,5,781,0,10,791
19,3,19047,1831,3,629,153,80,50,13,925,0,8,933
19,3,19047,1834,3,477,128,63,53,6,727,0,11,738
19,3,19047,1835,3,414,109,40,35,1,599,0,5,604
19,3,19047,1838,3,314,84,52,52,5,507,1,7,515
19,3,19047,1839,3,331,124,40,57,8,560,0,9,569
19,3,19047,1842,3,751,200,57,94,14,1116,0,11,1127
19,3,19047,1843,3,310,90,39,44,11,494,0,8,502
19,3,19047,1868,3,596,135,59,59,9,858,0,12,870
19,3,19047,1870,3,772,113,42,29,4,960,1,22,983
19,3,19047,1871,3,723,106,33,36,12,910,0,9,919
19,3,19021,2136,3,6,88,8,3,0,105,0,0,105
19,3,19021,2138,3,39,105,15,8,1,168,0,8,176
19,3,19021,2139,3,80,173,37,16,4,310,1,9,320
19,3,19021,2142,3,10,51,10,1,0,72,0,3,75
19,3,19021,2143,3,86,207,48,20,2,363,1,15,379
19,3,19021,2146,3,84,246,41,14,2,387,1,6,394
19,3,19021,2147,3,104,293,52,19,7,475,0,15,490
19,3,19021,2150,3,118,157,30,20,3,328,0,15,343
19,3,19021,2151,3,78,190,38,18,5,329,3,9,341
19,3,19021,2154,3,74,192,31,21,0,318,0,2,320
19,3,19021,2155,3,70,271,62,21,5,429,2,14,445
19,3,19021,2158,3,84,235,43,20,3,385,1,11,397
19,3,19021,2159,3,74,293,41,24,2,434,0,14,448
19,3,19021,2162,3,94,170,25,18,4,311,2,6,319
19,3,19021,2163,3,61,108,29,20,1,219,0,3,222
19,4,19047,1773,3,397,229,87,62,5,780,0,26,806
19,4,19047,1774,3,496,209,66,53,9,833,0,20,853
19,4,19047,1775,3,539,225,51,82,13,910,0,6,916
19,4,19047,1808,3,549,232,95,125,8,1009,1,8,1018
19,4,19047,1810,3,331,396,77,56,12,872,3,29,904
19,4,19047,1811,3,326,420,58,55,7,866,2,20,888
19,4,19047,1814,3,508,250,54,72,17,901,0,8,909
19,4,19047,1815,3,558,383,91,68,18,1118,2,19,1139
19,4,19047,1818,3,472,105,61,39,6,683,0,11,694
19,4,19047,1819,3,654,253,73,76,10,1066,1,28,1095
19,4,19047,1845,3,733,284,94,126,13,1250,3,26,1279
19,4,19047,1846,3,321,176,56,30,4,587,3,20,610
19,4,19047,1847,3,742,219,90,79,16,1146,1,17,1164
19,4,19047,1850,3,583,230,91,126,25,1055,1,9,1065
19,4,19047,1851,3,529,166,78,108,9,890,0,12,902
19,4,19047,1854,3,327,440,50,58,42,917,0,27,944
19,4,19047,1855,3,571,308,122,52,12,1065,6,45,1116
19,4,19047,1858,3,368,314,110,70,6,868,2,19,889
19,4,19047,1859,3,440,341,96,74,15,966,5,26,997
19,4,19047,1862,3,976,195,65,102,16,1354,1,16,1371
19,4,19047,1863,3,767,179,80,73,11,1110,1,14,1125
19,4,19047,1866,3,415,139,46,71,7,678,1,6,685
19,4,19047,1867,3,579,122,34,36,11,782,1,7,790
19,4,19047,1872,3,439,76,48,21,5,589,0,11,600
19,4,19047,1874,3,704,168,56,82,14,1024,0,12,1036
19,4,19047,1875,3,1930,448,152,319,30,2879,1,17,2897
19,4,19047,1878,3,959,192,70,110,13,1344,3,16,1363
19,4,19047,1879,3,801,182,69,96,14,1162,2,16,1180
19,4,19047,1882,3,539,228,73,102,8,950,1,15,966
19,4,19047,1883,3,525,195,98,100,9,927,2,16,945
19,4,19047,1886,3,314,486,78,64,14,956,3,25,984
19,4,19047,1887,3,565,292,77,105,14,1053,5,19,1077
19,4,19047,1890,3,245,205,44,50,7,551,2,22,575
19,4,19047,1891,3,415,445,74,46,5,985,3,32,1020
19,4,19047,1894,3,334,145,53,51,13,596,0,12,608
19,4,19047,1895,3,406,218,77,63,12,776,2,14,792
19,4,19047,1898,3,706,225,103,121,18,1173,2,8,1183
19,4,19047,1899,3,827,203,69,124,18,1241,3,8,1252
19,4,19047,1902,3,502,439,148,80,16,1185,21,20,1226
19,4,19047,1903,3,376,379,79,59,21,914,0,16,930
19,4,19047,1906,3,254,155,32,62,8,511,0,8,519
19,4,19047,1907,3,395,348,67,34,12,856,2,25,883
19,4,19047,1910,3,378,362,61,48,7,856,5,36,897
19,4,19047,1911,3,757,290,92,109,19,1267,2,15,1284
19,4,19047,1914,3,488,140,89,43,9,769,3,7,779
19,4,19047,1915,3,458,141,41,55,10,705,0,5,710
19,4,19047,1918,3,472,296,110,79,12,969,3,11,983
19,4,19047,1919,3,379,453,65,40,8,945,4,31,980
19,4,19047,1922,3,377,144,73,61,7,662,3,16,681
19,4,19047,1923,3,419,130,60,33,6,648,0,14,662
19,4,19047,1926,3,574,295,70,32,11,982,0,18,1000
19,4,19047,1927,3,546,292,86,64,11,999,4,26,1029
19,4,19047,1930,3,266,176,71,47,2,562,2,7,571
19,4,19047,1931,3,412,203,63,57,5,740,1,25,766
19,4,19047,1934,3,236,124,41,13,7,421,1,22,444
19,4,19047,1935,3,632,208,89,55,9,993,0,28,1021
19,4,19047,1938,3,324,140,46,53,4,567,3,15,585
19,4,19047,1939,3,170,103,32,0,15,320,5,12,337
19,4,19047,1942,3,295,136,52,52,9,544,2,11,557
19,4,19047,1943,3,498,273,96,92,10,969,1,19,989
19,4,19047,1946,3,551,290,86,65,6,998,1,23,1022
19,4,19047,1947,3,459,156,66,49,16,746,1,18,765
19,4,19047,1950,3,254,114,32,20,8,428,1,11,440
19,4,19047,1951,3,330,75,28,36,5,474,0,11,485
19,4,19047,1954,3,894,311,106,68,10,1389,1,31,1421
19,4,19047,1955,3,674,289,92,89,20,1164,0,29,1193
19,4,19047,1958,3,796,346,122,83,13,1360,5,33,1398
19,4,19047,1959,3,723,213,97,93,19,1145,2,20,1167
19,4,19047,1962,3,961,371,100,125,18,1575,4,22,1601
19,4,19047,1963,3,1233,470,189,188,25,2105,1,21,2127
19,4,19047,1966,3,632,239,87,93,20,1071,5,8,1084
19,4,19047,1967,3,665,217,84,91,18,1075,9,13,1097
19,4,19047,1970,3,955,235,92,117,15,1414,1,28,1443
19,4,19047,1971,3,560,219,90,107,10,986,2,10,998
19,4,19047,1974,3,1070,325,118,156,25,1694,4,19,1717
19,4,19047,1975,3,651,206,68,85,10,1020,3,16,1039
19,4,19047,1978,3,1124,321,136,115,27,1723,0,19,1742
19,4,19047,1979,3,478,236,86,73,11,884,1,32,917
19,4,19047,1982,3,315,95,43,34,9,496,3,5,504
19,4,19047,1983,3,722,189,94,107,10,1122,2,3,1127
19,4,19047,1986,3,208,67,28,16,4,323,1,13,337
19,4,19047,1987,3,635,193,75,52,11,966,3,22,991
19,4,19047,1990,3,342,125,48,61,12,588,0,6,594
19,4,19047,1991,3,277,134,64,75,7,557,1,5,563
19,4,19047,1994,3,400,106,41,51,6,604,0,4,608
19,4,19047,1995,3,242,73,32,43,4,394,2,9,405
19,4,19047,1998,3,381,346,63,88,10,888,3,11,902
19,5,19040,975,3,237,215,62,56,4,574,2,13,589
19,5,19040,978,3,303,337,101,64,16,821,3,28,852
19,5,19040,979,3,384,423,146,75,9,1037,9,26,1072
19,5,19040,982,3,376,279,108,68,8,839,3,30,872
19,5,19040,983,3,261,405,81,27,36,810,2,22,834
19,5,19040,987,3,332,349,96,56,9,842,1,26,869
19,5,19040,1432,3,197,571,86,42,11,907,3,41,951
19,5,19040,1434,3,266,564,89,47,7,973,0,39,1012
19,5,19040,1435,3,253,759,138,80,4,1234,2,52,1288
19,5,19040,1438,3,312,519,112,70,8,1021,9,23,1053
19,5,19040,1439,3,234,405,124,32,5,800,0,37,837
19,5,19040,1442,3,359,605,139,95,13,1211,17,33,1261
19,5,19040,1443,3,195,481,108,56,11,851,2,31,884
19,5,19040,1446,3,304,659,103,67,15,1148,3,29,1180
19,5,19040,1447,3,181,505,94,68,5,853,0,38,891
19,5,19040,1450,3,184,455,135,57,8,839,4,26,869
19,5,19040,1451,3,183,398,124,56,9,770,2,18,790
19,5,19040,1454,3,208,549,126,60,8,951,0,38,989
19,5,19040,1455,3,208,588,131,54,9,990,2,25,1017
19,5,19040,1458,3,153,636,95,62,10,956,4,44,1004
19,5,19040,1459,3,188,480,63,59,10,800,0,28,828
19,5,19040,1462,3,164,580,77,66,9,896,1,39,936
19,5,19040,1467,3,257,462,98,76,6,899,0,25,924
19,5,19040,1470,3,293,492,82,117,7,991,3,12,1006
19,5,19040,1471,3,367,469,135,118,13,1102,1,26,1129
19,5,19040,1474,3,121,468,98,43,15,745,5,20,770
19,5,19040,1475,3,176,524,115,56,8,879,0,50,929
19,5,19040,1478,3,228,537,105,81,10,961,6,30,997
19,5,19040,1479,3,388,466,131,125,8,1118,1,25,1144
19,5,19040,1495,3,260,484,79,108,11,942,2,31,975
19,5,19040,1498,3,231,640,84,58,6,1019,6,33,1058
19,5,19040,1499,3,314,621,137,90,7,1169,3,62,1234
19,5,19040,1517,3,328,465,117,82,13,1005,3,38,1046
19,5,19040,1518,3,269,645,135,60,12,1121,5,49,1175
19,5,19040,1519,3,206,724,174,51,11,1166,8,56,1230
19,5,19040,1522,3,150,409,247,59,6,871,2,36,909
19,5,19040,1523,3,381,534,125,99,9,1148,1,43,1192
19,5,19040,1544,3,343,471,122,92,8,1036,4,31,1071
19,5,19040,1546,3,330,484,111,102,12,1039,9,18,1066
19,5,19040,1547,3,282,410,182,41,8,923,10,33,966
19,5,19040,1550,3,73,142,332,14,2,563,2,17,582
19,5,19040,1551,3,199,338,278,53,5,873,8,51,932
19,5,19040,1554,3,265,360,110,62,19,816,2,26,844
19,5,19040,1555,3,318,472,119,79,18,1006,3,31,1040
19,5,19040,1588,3,429,403,126,83,16,1057,3,42,1102
19,5,19040,1590,3,166,309,338,65,9,887,4,37,928
19,5,19040,1591,3,140,215,581,48,5,989,5,68,1062
19,5,19040,1612,3,199,463,65,53,6,786,2,39,827
19,5,19040,1614,3,152,184,62,31,7,436,1,14,451
19,5,19040,1615,3,210,382,240,45,5,882,9,33,924
19,5,19040,1618,3,173,486,357,51,3,1070,1,50,1121
19,5,19040,1619,3,210,369,285,55,5,924,1,38,963
19,5,19040,2124,3,248,540,129,70,8,995,6,50,1051
19,5,19040,2126,3,355,349,97,94,10,905,1,13,919
19,5,19040,2127,3,352,311,79,95,12,849,1,22,872
19,5,19040,2130,3,384,357,96,101,16,954,1,8,963
19,5,19040,2131,3,69,171,36,23,3,302,0,24,326
19,5,19040,2134,3,795,506,148,243,26,1718,0,24,1742
19,6,19040,1006,3,335,296,74,48,15,768,2,18,788
19,6,19040,1007,3,266,330,86,53,9,744,0,26,770
19,6,19040,1014,3,331,489,112,73,15,1020,2,22,1044
19,6,19040,1015,3,283,401,103,59,2,848,2,37,887
19,6,19040,1037,3,90,125,31,13,5,264,0,8,272
19,6,19040,1038,3,213,189,37,33,3,475,1,15,491
19,6,19040,1039,3,153,254,45,43,8,503,0,14,517
19,6,19040,1042,3,698,358,52,37,4,1149,0,6,1155
19,6,19040,1043,3,663,348,78,38,10,1137,2,9,1148
19,6,19040,1046,3,613,350,42,44,13,1062,2,3,1067
19,6,19040,1047,3,561,312,65,21,8,967,0,8,975
19,6,19040,1084,3,544,216,43,24,18,845,2,6,853
19,6,19040,1086,3,336,170,15,42,7,570,0,6,576
19,6,19040,1087,3,291,134,26,17,8,476,1,6,483
19,6,19040,1090,3,812,454,67,54,23,1410,0,10,1420
19,6,19040,1091,3,1309,689,66,81,31,2176,2,7,2185
19,6,19040,1094,3,813,362,32,43,10,1260,0,3,1263
19,6,19040,1095,3,691,267,36,37,11,1042,2,5,1049
19,6,19040,1098,3,925,466,62,57,23,1533,1,19,1553
19,6,19040,1463,3,164,672,74,47,7,964,0,24,988
19,6,19040,1466,3,208,445,48,52,9,762,1,24,787
19,6,19040,1481,3,399,503,92,62,12,1068,0,36,1104
19,6,19040,1482,3,333,506,96,60,18,1013,2,30,1045
19,6,19040,1483,3,216,797,73,68,5,1159,2,37,1198
19,6,19040,1486,3,280,586,72,55,10,1003,1,21,1025
19,6,19040,1487,3,237,617,76,56,11,997,3,21,1021
19,6,19040,1490,3,253,614,68,69,14,1018,4,41,1063
19,6,19040,1491,3,235,854,86,53,14,1242,2,34,1278
19,6,19040,1494,3,257,371,79,56,6,769,1,27,797
19,6,19040,1501,3,434,360,66,65,5,930,2,21,953
19,6,19040,1502,3,490,363,64,70,9,996,1,31,1028
19,6,19040,1503,3,406,328,80,69,14,897,0,17,914
19,6,19040,1506,3,1196,763,172,174,30,2335,2,16,2353
19,6,19040,1507,3,2080,1042,222,199,42,3585,2,20,3607
19,6,19040,1510,3,648,479,126,93,21,1367,0,28,1395
19,6,19040,1511,3,547,426,102,78,9,1162,2,12,1176
19,6,19040,1514,3,578,433,92,96,11,1210,1,23,1234
19,6,19040,1515,3,481,414,56,67,11,1029,0,14,1043
19,6,19040,1526,3,569,343,105,67,8,1092,2,33,1127
19,6,19040,1527,3,526,454,110,106,19,1215,3,23,1241
19,6,19040,1530,3,424,516,59,72,12,1083,1,35,1119
19,6,19040,1531,3,508,591,123,85,15,1322,3,35,1360
19,6,19040,1534,3,432,449,84,67,26,1058,1,18,1077
19,6,19040,1535,3,609,562,118,104,18,1411,5,33,1449
19,6,19040,1538,3,590,371,111,83,13,1168,0,28,1196
19,6,19040,1539,3,321,400,102,64,6,893,3,22,918
19,6,19040,1542,3,371,311,74,59,10,825,1,23,849
19,6,19040,1543,3,507,290,86,45,7,935,0,20,955
19,6,19040,1557,3,295,174,43,32,7,551,0,10,561
19,6,19040,1558,3,271,171,36,25,5,508,0,13,521
19,6,19040,1559,3,518,367,87,55,10,1037,0,27,1064
19,6,19040,1562,3,451,338,177,57,7,1030,3,27,1060
19,6,19040,1563,3,471,441,128,72,11,1123,1,35,1159
19,6,19040,1566,3,473,326,102,65,16,982,0,24,1006
19,6,19040,1567,3,517,345,176,54,12,1104,0,23,1127
19,6,19040,1570,3,301,366,69,42,4,782,0,14,796
19,6,19040,1571,3,545,548,70,80,4,1247,0,37,1284
19,6,19040,1574,3,1476,728,103,77,28,2412,6,12,2430
19,6,19040,1575,3,843,429,48,49,14,1383,1,5,1389
19,6,19040,1578,3,609,353,52,35,14,1063,0,11,1074
19,6,19040,1579,3,408,538,91,103,11,1151,0,10,1161
19,6,19040,1582,3,463,348,90,65,19,985,0,17,1002
19,6,19040,1583,3,625,348,103,85,8,1169,0,18,1187
19,6,19040,1586,3,411,431,117,85,38,1082,0,28,1110
19,6,19040,1587,3,391,535,111,77,18,1132,3,32,1167
19,6,19040,1596,3,472,437,91,70,14,1084,2,31,1117
19,6,19040,1598,3,606,457,104,95,16,1278,0,0,1278
19,6,19040,1599,3,619,569,93,73,13,1367,2,37,1406
19,6,19040,1602,3,984,472,72,53,20,1601,0,17,1618
19,6,19040,1603,3,343,662,91,58,8,1162,3,32,1197
19,6,19040,2135,3,1557,599,99,62,31,2348,0,7,2355
19,7,19040,985,3,339,330,89,84,5,847,1,12,860
19,7,19040,986,3,243,236,51,36,7,573,0,18,591
19,7,19040,988,3,547,337,107,99,6,1096,1,18,1115
19,7,19040,990,3,332,254,74,60,11,731,0,15,746
19,7,19040,991,3,395,242,64,75,7,783,1,18,802
19,7,19040,994,3,277,150,46,57,5,535,0,12,547
19,7,19040,995,3,481,301,72,94,12,960,0,25,985
19,7,19040,998,3,191,169,20,75,4,459,1,15,475
19,7,19040,999,3,139,170,33,55,4,401,0,15,416
19,7,19040,1002,3,649,247,75,109,12,1092,9,21,1122
19,7,19040,1003,3,562,233,68,64,15,942,2,7,951
19,7,19040,1009,3,566,281,82,104,16,1049,1,5,1055
19,7,19040,1010,3,432,172,64,67,13,748,0,13,761
19,7,19040,1011,3,296,104,29,47,5,481,0,5,486
19,7,19040,1017,3,574,229,48,66,18,935,0,7,942
19,7,19040,1018,3,605,205,52,61,10,933,2,19,954
19,7,19040,1019,3,284,126,41,26,3,480,4,10,494
19,7,19040,1022,3,68,44,14,17,1,144,0,10,154
19,7,19040,1023,3,261,181,46,66,13,567,0,16,583
19,7,19040,1026,3,64,153,22,9,0,248,0,15,263
19,7,19040,1027,3,50,145,14,18,2,229,0,7,236
19,7,19040,1030,3,206,109,28,32,6,381,0,10,391
19,7,19040,1031,3,261,117,62,44,8,492,1,8,501
19,7,19040,1034,3,421,192,45,55,2,715,2,6,723
19,7,19040,1035,3,408,129,37,49,7,630,0,4,634
19,7,19040,1050,3,425,142,43,34,4,648,0,9,657
19,7,19040,1051,3,152,62,23,22,4,263,2,5,270
19,7,19040,1054,3,220,241,53,75,8,597,0,13,610
19,7,19040,1055,3,138,116,26,36,6,322,0,5,327
19,7,19040,1058,3,92,424,42,49,8,615,0,26,641
19,7,19040,1059,3,139,311,94,60,4,608,0,24,632
19,7,19040,1062,3,67,82,16,30,1,196,0,7,203
19,7,19040,1063,3,172,178,31,61,11,453,13,16,482
19,7,19040,1066,3,288,280,60,79,11,718,0,18,736
19,7,19040,1067,3,203,147,48,47,13,458,2,6,466
19,7,19040,1070,3,264,70,40,20,6,400,0,6,406
19,7,19040,1071,3,229,88,23,22,6,368,2,0,370
19,7,19040,1074,3,206,159,32,42,6,445,1,6,452
19,7,19040,1075,3,153,117,25,48,4,347,2,5,354
19,7,19040,1078,3,187,72,56,47,4,366,0,8,374
19,7,19040,1079,3,102,80,24,19,6,231,0,1,232
19,7,19040,1082,3,248,90,33,21,2,394,0,5,399
19,7,19040,1083,3,348,99,37,25,9,518,2,2,522
19,7,19040,1099,3,320,80,22,17,3,442,1,5,448
19,7,19040,1102,3,174,125,29,44,7,379,0,6,385
19,7,19040,1103,3,203,176,36,42,5,462,0,15,477
19,7,19040,1106,3,163,84,36,25,6,314,0,7,321
19,7,19040,1107,3,120,87,38,22,3,270,0,6,276
19,7,19040,1110,3,203,62,29,57,14,365,0,3,368
19,7,19040,1111,3,137,54,21,36,3,251,0,5,256
19,7,19040,1114,3,141,72,24,20,6,263,0,5,268
19,7,19040,1115,3,253,66,20,14,3,356,0,10,366
19,7,19040,1118,3,232,68,21,26,9,356,0,2,358
19,7,19040,1119,3,54,24,14,8,4,104,0,1,105
19,7,19040,1122,3,215,114,45,20,4,398,0,10,408
19,7,19040,1123,3,170,255,28,39,20,512,0,9,521
19,7,19040,1126,3,402,186,67,60,30,745,2,12,759
19,7,19040,1127,3,273,370,60,79,9,791,0,37,828
19,7,19040,1130,3,433,123,34,34,4,628,4,5,637
19,7,19040,1131,3,41,38,19,5,2,105,0,1,106
19,7,19040,1134,3,332,274,79,80,6,771,0,7,778
19,7,19040,1135,3,107,117,32,31,2,289,0,5,294
19,7,19040,1138,3,159,60,9,7,1,236,0,2,238
19,7,19040,1139,3,96,58,17,11,0,182,0,4,186
19,7,19040,1142,3,47,24,6,9,0,86,0,2,88
19,7,19040,1143,3,85,50,14,13,3,165,1,6,172
19,7,19040,1146,3,135,94,16,24,2,271,0,8,279
19,7,19040,1147,3,120,118,29,27,5,299,0,13,312
19,7,19040,1150,3,153,171,41,32,7,404,0,16,420
19,7,19040,1151,3,110,55,20,17,1,203,0,0,203
19,7,19040,1154,3,166,264,24,37,4,495,0,11,506
19,7,19040,1155,3,62,114,14,16,0,206,0,9,215
19,7,19040,1158,3,98,98,23,24,6,249,0,10,259
19,7,19040,1159,3,85,69,16,24,3,197,0,8,205
19,7,19040,1162,3,79,61,24,21,3,188,0,5,193
19,7,19040,1163,3,63,78,20,16,1,178,0,0,178
19,7,19040,1166,3,111,111,26,41,3,292,0,15,307
19,7,19040,1167,3,96,109,7,26,2,240,0,6,246
19,7,19040,1171,3,36,48,18,6,1,109,1,1,111
19,7,19040,1174,3,58,53,28,12,2,153,0,4,157
19,7,19040,1175,3,140,74,28,27,4,273,0,4,277
19,7,19040,1178,3,96,26,13,19,7,161,2,1,164
19,7,19040,1180,3,75,54,17,12,2,160,0,1,161
19,7,19040,1182,3,65,45,27,17,3,157,0,4,161
19,7,19040,1183,3,104,65,30,13,5,217,0,5,222
19,7,19040,1186,3,111,42,21,20,0,194,0,2,196
19,7,19040,1187,3,95,31,22,17,3,168,0,2,170
19,7,19040,1190,3,35,22,6,5,1,69,0,2,71
19,7,19040,1191,3,60,53,30,17,3,163,0,2,165
19,7,19040,1194,3,71,18,13,10,1,113,0,3,116
19,7,19040,1195,3,106,51,24,19,6,206,0,4,210
19,7,19040,1198,3,40,17,9,7,2,75,0,1,76
19,7,19040,1199,3,43,19,17,11,1,91,0,2,93
19,7,19040,1202,3,46,28,30,6,2,112,0,0,112
19,7,19040,1203,3,47,20,7,10,0,84,0,2,86
19,7,19040,1206,3,129,142,15,21,8,315,0,7,322
19,7,19040,1207,3,128,129,48,4,13,322,5,12,339
19,7,19040,1210,3,96,139,24,33,2,294,0,4,298
19,7,19040,1211,3,147,147,42,50,6,392,0,8,400
19,7,19040,1214,3,81,63,33,34,2,213,0,2,215
19,7,19040,1215,3,106,95,16,32,5,254,0,7,261
19,7,19040,1218,3,114,218,19,50,2,403,1,16,420
19,7,19040,1219,3,222,136,39,57,2,456,2,17,475
19,7,19040,1222,3,161,195,53,60,5,474,1,19,494
19,7,19040,1223,3,204,181,37,41,11,474,0,9,483
19,7,19040,1226,3,120,103,20,26,11,280,0,10,290
19,7,19040,1227,3,200,222,28,42,11,503,0,0,503
19,7,19040,1230,3,118,412,41,76,10,657,0,30,687
19,7,19040,1231,3,143,256,38,89,6,532,0,24,556
19,7,19040,1234,3,100,190,24,51,4,369,3,13,385
19,7,19040,1235,3,125,397,68,123,2,715,2,43,760
19,7,19040,1238,3,103,389,11,114,3,620,0,52,672
19,7,19040,1239,3,102,176,49,33,7,367,2,24,393
19,7,19040,1242,3,170,119,20,17,0,326,0,11,337
19,7,19040,1243,3,238,190,50,42,5,525,0,10,535
19,7,19040,1246,3,207,154,38,43,5,447,0,18,465
19,7,19040,1253,3,229,143,62,36,4,474,3,13,490
19,7,19040,1254,3,107,99,31,25,3,265,0,8,273
19,7,19040,1255,3,163,139,35,34,1,372,0,12,384
19,7,19040,1262,3,78,56,15,9,2,160,0,5,165
19,7,19040,1263,3,103,95,35,23,5,261,0,4,265
19,7,19040,1269,3,120,66,23,22,3,234,0,4,238
19,7,19040,1270,3,124,59,36,17,8,244,0,8,252
19,7,19040,1271,3,97,61,19,12,2,191,0,4,195
19,7,19040,1276,3,100,56,31,23,4,214,0,11,225
19,7,19040,1278,3,108,75,25,33,10,251,0,5,256
19,7,19040,1279,3,116,87,36,28,4,271,0,3,274
19,7,19040,1282,3,152,75,43,25,10,305,0,0,305
19,7,19040,1283,3,73,28,18,10,2,131,2,6,139
19,7,19040,1286,3,277,159,69,47,13,565,5,17,587
19,7,19040,1287,3,115,53,20,15,8,211,0,4,215
19,7,19040,1594,3,330,473,122,72,8,1005,2,46,1053
19,7,19040,1595,3,656,550,154,106,15,1481,2,28,1511
19,7,19040,1606,3,99,127,29,32,3,290,1,18,309
19,7,19040,1607,3,340,313,78,75,3,809,0,27,836
19,7,19040,1610,3,284,315,71,92,8,770,4,23,797
19,7,19040,1611,3,222,233,66,46,5,572,2,25,599
19,7,19040,1622,3,458,433,122,71,8,1092,5,43,1140
19,7,19040,1623,3,474,499,99,90,10,1172,7,32,1211
19,7,19040,1626,3,269,319,251,59,9,907,1,54,962
19,7,19040,1627,3,259,435,90,95,9,888,0,22,910
19,7,19040,1630,3,228,325,80,50,2,685,2,17,704
19,7,19040,1631,3,87,89,18,28,2,224,0,9,233
19,7,19040,1634,3,67,73,18,22,3,183,1,7,191
19,7,19040,1635,3,146,240,94,52,4,536,0,23,559
19,7,19040,1638,3,187,200,56,49,3,495,0,13,508
19,7,19040,1639,3,38,49,15,8,0,110,1,3,114
19,7,19040,1642,3,667,285,78,103,12,1145,2,20,1167
19,7,19040,1643,3,178,159,32,29,6,404,2,4,410
19,7,19040,1646,3,100,75,22,6,0,203,0,4,207
19,7,19040,1647,3,61,110,27,19,1,218,2,7,227
19,7,19040,1650,3,93,46,11,16,4,170,3,2,175
19,7,19040,1651,3,280,173,40,56,5,554,0,17,571
19,7,19040,1654,3,216,154,52,28,4,454,0,7,461
19,7,19040,1655,3,238,203,39,33,2,515,0,12,527
19,7,19040,1658,3,297,302,60,42,7,708,0,22,730
19,7,19040,1659,3,378,355,77,70,8,888,2,29,919
19,7,19040,1662,3,222,192,36,37,10,497,0,15,512
19,7,19040,1663,3,196,166,50,38,3,453,0,10,463
19,7,19040,1666,3,100,111,33,17,3,264,0,15,279
19,7,19040,1667,3,215,176,43,30,4,468,0,9,477
19,7,19040,1670,3,208,168,38,37,12,463,1,8,472
19,7,19040,1671,3,184,215,32,19,4,454,0,12,466
19,7,19040,1674,3,208,320,67,41,5,641,2,20,663
19,7,19040,1675,3,227,308,69,44,10,658,1,22,681
19,7,19040,1678,3,154,147,22,17,6,346,0,12,358
19,7,19040,1686,3,772,271,88,108,14,1253,0,62,1315
19,8,19026,526,3,108,63,18,29,1,219,1,0,220
19,8,19026,527,3,164,166,52,32,6,420,0,14,434
19,8,19026,530,3,133,75,26,19,6,259,0,8,267
19,8,19026,531,3,122,131,45,32,1,331,0,10,341
19,8,19026,534,3,230,184,53,38,4,509,1,3,513
19,8,19026,535,3,424,252,83,77,14,850,0,11,861
19,8,19026,538,3,554,373,112,95,25,1159,1,31,1191
19,8,19026,539,3,446,378,101,87,6,1018,0,31,1049
19,8,19026,542,3,342,225,66,49,6,688,4,22,714
19,8,19026,543,3,235,255,74,38,6,608,1,27,636
19,8,19026,546,3,431,348,98,74,13,964,1,26,991
19,8,19026,547,3,217,164,51,48,4,484,0,8,492
19,8,19026,550,3,214,214,65,36,6,535,0,17,552
19,8,19026,551,3,239,275,73,43,11,641,0,11,652
19,8,19026,554,3,478,302,92,116,18,1006,1,9,1016
19,8,19026,555,3,391,346,92,63,7,899,1,39,939
19,8,19026,558,3,353,188,70,50,10,671,0,10,681
19,8,19026,559,3,268,157,43,40,3,511,0,8,519
19,8,19026,562,3,195,147,38,8,13,401,0,13,414
19,8,19026,563,3,238,182,57,28,7,512,0,19,531
19,8,19026,566,3,126,167,37,15,1,346,0,0,346
19,8,19026,567,3,193,135,46,25,3,402,0,8,410
19,8,19026,570,3,291,195,81,40,10,617,0,18,635
19,8,19026,571,3,306,322,107,43,7,785,0,13,798
19,8,19026,574,3,149,142,62,34,3,390,3,11,404
19,8,19026,575,3,179,146,38,22,6,391,0,0,391
19,8,19026,578,3,512,270,110,89,7,988,1,27,1016
19,8,19026,579,3,338,200,78,56,7,679,3,12,694
19,8,19026,582,3,556,368,135,86,23,1168,0,20,1188
19,8,19026,583,3,613,487,172,104,23,1399,2,15,1416
19,8,19026,586,3,369,377,138,68,15,967,1,28,996
19,8,19026,587,3,299,270,113,62,15,759,0,40,799
19,8,19026,590,3,505,238,78,74,8,903,1,14,918
19,8,19026,591,3,171,85,44,17,5,322,0,7,329
19,8,19026,604,3,857,534,144,133,17,1685,1,25,1711
19,8,19026,606,3,474,308,94,65,12,953,5,33,991
19,8,19026,607,3,1725,1227,364,234,57,3607,2,57,3666
19,8,19026,610,3,273,480,87,56,17,913,1,20,934
19,8,19026,611,3,245,513,99,52,10,919,0,30,949
19,8,19026,614,3,205,405,76,39,13,738,2,34,774
19,8,19026,615,3,241,516,83,40,16,896,1,38,935
19,8,19026,618,3,451,407,133,96,20,1107,1,18,1126
19,8,19026,619,3,865,602,159,123,26,1775,0,21,1796
19,8,19026,622,3,1082,620,205,226,36,2169,4,29,2202
19,8,19026,623,3,1251,708,242,248,40,2489,2,45,2536
19,8,19026,626,3,1079,427,155,124,20,1805,1,21,1827
19,8,19026,627,3,926,342,130,143,30,1571,3,13,1587
19,8,19026,630,3,529,316,107,63,20,1035,0,19,1054
19,8,19026,631,3,263,182,66,41,7,559,1,20,580
19,8,19026,634,3,376,284,71,54,11,796,4,21,821
19,8,19026,635,3,441,264,112,67,11,895,1,27,923
19,8,19026,638,3,413,230,93,55,11,802,0,17,819
19,8,19026,639,3,631,203,95,70,10,1009,0,6,1015
19,8,19026,642,3,537,328,99,95,12,1071,0,25,1096
19,8,19026,643,3,549,453,122,91,8,1223,2,18,1243
19,8,19026,646,3,201,582,82,47,9,921,2,27,950
19,8,19026,647,3,338,522,119,40,12,1031,1,29,1061
19,8,19026,650,3,373,433,124,74,11,1015,0,19,1034
19,8,19026,651,3,423,415,145,101,25,1109,2,33,1144
19,8,19026,654,3,499,302,87,77,17,982,1,20,1003
19,8,19026,655,3,624,245,69,88,18,1044,1,6,1051
19,8,19026,658,3,335,152,37,28,8,560,1,4,565
19,8,19026,659,3,357,160,45,29,10,601,0,5,606
19,8,19026,662,3,309,143,35,19,4,510,3,4,517
19,8,19026,663,3,598,246,116,63,17,1040,2,13,1055
19,8,19026,666,3,421,208,71,45,22,767,0,12,779
19,8,19026,667,3,639,406,109,98,16,1268,1,25,1294
19,8,19026,670,3,284,516,107,63,21,991,5,34,1030
19,8,19026,671,3,385,531,108,98,26,1148,5,30,1183
19,8,19026,674,3,296,529,86,68,11,990,4,39,1033
19,8,19026,675,3,353,389,123,85,12,962,2,25,989
19,8,19026,678,3,432,491,110,65,18,1116,4,38,1158
19,8,19026,679,3,255,571,134,52,54,1066,1,57,1124
19,8,19026,682,3,383,387,115,57,14,956,5,19,980
19,8,19026,683,3,420,382,122,59,15,998,2,32,1032
19,8,19026,686,3,598,282,116,107,14,1117,1,10,1128
19,8,19026,687,3,491,350,100,83,12,1036,2,14,1052
19,8,19026,690,3,594,386,102,86,6,1174,2,16,1192
19,8,19026,691,3,385,360,80,70,11,906,1,30,937
19,8,19026,694,3,396,494,118,78,17,1103,3,29,1135
19,9,19004,20,3,256,675,331,41,15,1318,3,52,1373
19,9,19004,22,3,228,377,111,42,4,762,0,28,790
19,9,19004,23,3,248,327,114,43,7,739,0,21,760
19,9,19004,26,3,302,363,65,50,11,791,0,21,812
19,9,19004,27,3,249,294,84,24,17,668,0,9,677
19,9,19004,30,3,237,397,128,28,11,801,0,37,838
19,9,19004,31,3,143,172,50,12,2,379,0,16,395
19,9,19004,34,3,92,170,90,23,7,382,0,19,401
19,9,19004,35,3,44,63,38,5,0,150,0,9,159
19,9,19004,38,3,80,143,45,19,3,290,1,9,300
19,9,19007,151,3,71,473,22,191,10,767,0,69,836
19,9,19007,154,3,6,144,1,24,1,176,0,32,208
19,9,19007,155,3,28,210,4,72,1,315,0,37,352
19,9,19007,158,3,51,299,22,94,4,470,0,40,510
19,9,19007,159,3,12,87,0,23,3,125,0,0,125
19,9,19007,162,3,17,336,34,95,2,484,0,60,544
19,9,19007,163,3,2,204,3,109,0,318,0,13,331
19,9,19007,166,3,28,179,11,70,0,288,0,47,335
19,9,19007,167,3,14,139,33,32,2,220,0,119,339
19,9,19013,237,3,105,169,68,12,0,354,0,8,362
19,9,19013,238,3,131,300,68,17,1,517,1,8,526
19,9,19013,239,3,112,260,47,11,2,432,0,9,441
19,9,19013,242,3,183,298,90,32,3,606,0,26,632
19,9,19013,243,3,156,235,129,19,1,540,0,19,559
19,9,19013,246,3,19,31,6,0,1,57,0,0,57
19,9,19013,247,3,20,43,19,1,0,83,0,3,86
19,9,19013,252,3,9,50,15,0,0,74,0,6,80
19,9,19013,256,3,209,129,118,9,4,469,0,12,481
19,9,19014,258,3,351,417,170,92,15,1045,0,54,1099
19,9,19014,259,3,216,244,96,86,20,662,1,33,696
19,9,19014,262,3,130,334,85,29,1,579,0,47,626
19,9,19014,263,3,99,211,72,43,2,427,0,51,478
19,9,19014,266,3,10,128,147,4,1,290,0,31,321
19,9,19014,267,3,9,66,96,2,0,173,0,20,193
19,9,19014,270,3,70,196,68,6,4,344,0,0,344
19,9,19014,271,3,44,321,260,14,5,644,0,60,704
19,9,19014,274,3,49,140,87,4,2,282,0,19,301
19,9,19014,275,3,30,269,98,19,3,419,0,36,455
19,9,19014,278,3,24,92,21,4,0,141,0,20,161
19,9,19014,279,3,24,146,81,8,4,263,0,34,297
19,9,19014,282,3,88,126,72,18,0,304,0,47,351
19,9,19014,283,3,67,162,90,9,5,333,0,17,350
19,9,19014,286,3,34,130,34,4,2,204,0,13,217
19,9,19014,287,3,26,146,30,6,0,208,1,30,239
19,9,19014,290,3,30,93,44,5,1,173,0,16,189
19,9,19014,291,3,62,167,71,6,0,306,0,42,348
19,9,19015,294,3,80,64,7,3,0,154,0,4,158
19,9,19015,295,3,355,354,28,9,0,746,1,16,763
19,9,19015,299,3,44,82,7,0,1,134,0,7,141
19,9,19015,303,3,195,77,12,5,1,290,0,6,296
19,9,19017,309,3,78,318,75,191,272,934,0,43,977
19,9,19017,310,3,104,247,53,192,164,760,0,37,797
19,9,19017,311,3,115,383,92,235,209,1034,1,54,1089
19,9,19017,314,3,5,41,5,2,60,113,0,9,122
19,9,19017,315,3,5,107,3,3,88,206,0,19,225
19,9,19017,318,3,45,165,73,4,98,385,0,19,404
19,9,19017,319,3,41,196,100,3,72,412,0,28,440
19,9,19017,322,3,121,274,76,16,99,586,1,46,633
19,9,19017,323,3,33,231,54,7,113,438,0,19,457
19,9,19017,326,3,69,398,30,84,150,731,0,77,808
19,9,19017,327,3,3,167,12,2,45,229,1,14,244
19,9,19017,330,3,12,71,12,2,25,122,0,7,129
19,9,19017,331,3,26,71,13,6,38,154,0,19,173
19,9,19017,334,3,70,147,13,0,140,370,0,58,428
19,9,19017,335,3,22,106,8,4,76,216,0,26,242
19,9,19017,338,3,7,49,13,10,37,116,0,11,127
19,9,19017,339,3,16,62,9,11,24,122,0,3,125
19,9,19017,342,3,64,296,21,22,166,569,0,115,684
19,9,19017,343,3,106,425,32,33,276,872,0,97,969
19,9,19020,418,3,157,209,41,101,2,510,0,25,535
19,9,19020,419,3,64,108,25,91,0,288,0,15,303
19,9,19020,422,3,158,334,46,103,2,643,0,12,655
19,9,19020,423,3,77,232,17,44,2,372,0,25,397
19,9,19020,426,3,33,25,9,8,0,75,0,7,82
19,9,19020,427,3,17,41,8,3,1,70,0,2,72
19,9,19022,494,3,393,380,12,28,7,820,0,24,844
19,9,19022,495,3,416,395,31,26,3,871,0,8,879
19,9,19022,498,3,66,16,2,0,0,84,0,2,86
19,9,19022,499,3,34,14,0,1,0,49,0,2,51
19,9,19022,502,3,236,150,22,2,1,411,0,10,421
19,9,19022,503,3,196,99,7,5,0,307,0,5,312
19,9,19022,506,3,155,72,14,11,0,252,0,9,261
19,9,19022,507,3,213,125,12,1,0,351,0,12,363
19,9,19022,510,3,17,25,2,1,0,45,0,3,48
19,9,19022,511,3,24,26,2,0,0,52,0,0,52
19,9,19022,514,3,132,100,15,3,0,250,0,9,259
19,9,19024,518,3,157,432,76,11,4,680,0,24,704
19,9,19024,519,3,193,595,103,29,0,920,0,36,956
19,9,19024,522,3,75,301,63,2,2,443,0,23,466
19,9,19030,822,3,285,212,21,32,4,554,0,14,568
19,9,19030,823,3,262,238,21,38,5,564,0,18,582
19,9,19030,826,3,385,288,23,5,0,701,0,25,726
19,9,19030,827,3,113,148,13,5,0,279,1,11,291
19,9,19030,830,3,43,34,1,2,0,80,0,1,81
19,9,19031,831,3,126,409,234,33,6,808,1,57,866
19,9,19031,834,3,48,211,61,2,2,324,1,24,349
19,9,19034,860,3,458,350,47,78,5,938,0,28,966
19,9,19034,862,3,450,237,29,72,5,793,0,29,822
19,9,19034,863,3,803,516,56,75,4,1454,1,54,1509
19,9,19034,866,3,738,600,68,253,10,1669,2,31,1702
19,9,19034,867,3,249,245,30,42,5,571,1,28,600
19,9,19034,870,3,172,124,14,14,0,324,0,13,337
19,9,19034,871,3,631,278,75,136,10,1130,2,28,1160
19,9,19034,874,3,215,115,34,29,5,398,0,11,409
19,9,19034,875,3,265,155,43,48,2,513,4,12,529
19,9,19034,878,3,191,122,31,36,2,382,0,13,395
19,9,19034,879,3,403,212,43,74,6,738,3,27,768
19,9,19034,882,3,671,374,24,82,6,1157,3,31,1191
19,9,19034,883,3,408,312,50,51,7,828,1,34,863
19,9,19034,886,3,638,430,73,114,8,1263,2,28,1293
19,9,19034,887,3,486,206,35,75,9,811,3,24,838
19,9,19034,890,3,59,48,4,0,0,111,0,0,111
19,9,19034,891,3,43,59,4,8,0,114,0,6,120
19,9,19034,894,3,53,57,0,1,0,111,0,4,115
19,9,19034,895,3,131,115,13,6,0,265,1,12,278
19,9,19034,898,3,211,252,37,13,3,516,0,38,554
19,9,19034,899,3,101,138,6,6,0,251,2,6,259
19,9,19034,902,3,315,317,17,30,6,685,2,28,715
19,9,19034,903,3,103,46,6,6,0,161,1,13,175
19,9,19034,906,3,62,130,11,6,0,209,1,21,231
19,9,19034,907,3,195,238,24,8,5,470,2,12,484
19,9,19037,913,3,69,284,13,19,1,386,0,31,417
19,9,19037,914,3,59,153,12,20,2,246,0,19,265
19,9,19037,915,3,41,266,19,3,3,332,1,35,368
19,9,19037,918,3,9,173,1,24,1,208,0,17,225
19,9,19037,919,3,60,310,15,14,2,401,1,24,426
19,9,19037,922,3,5,90,1,0,2,98,1,6,105
19,9,19037,923,3,2,41,1,1,0,45,0,0,45
19,9,19039,931,3,129,327,146,46,51,699,0,9,708
19,9,19039,934,3,306,249,105,83,51,794,0,28,822
19,9,19039,935,3,333,273,178,107,49,940,2,14,956
19,9,19039,938,3,355,269,129,37,80,870,1,30,901
19,9,19039,939,3,652,465,270,80,222,1689,3,65,1757
19,9,19039,942,3,275,240,112,29,58,714,0,30,744
19,9,19039,943,3,88,65,18,6,14,191,0,3,194
19,9,19039,946,3,271,309,108,57,53,798,0,14,812
19,9,19039,947,3,296,263,145,39,51,794,0,42,836
19,9,19039,950,3,256,208,128,30,77,699,2,25,726
19,9,19039,951,3,340,211,151,46,55,803,0,64,867
19,9,19039,954,3,201,116,22,9,18,366,16,0,382
19,9,19039,956,3,38,70,37,6,2,153,0,5,158
19,9,19039,958,3,237,97,34,8,15,391,1,13,405
19,9,19039,959,3,22,21,5,2,7,57,0,6,63
19,9,19039,962,3,89,86,32,2,8,217,3,11,231
19,9,19039,963,3,321,260,60,15,27,683,1,32,716
19,9,19039,966,3,79,31,27,7,3,147,0,3,150
19,9,19039,967,3,34,24,3,1,22,84,0,8,92
19,9,19039,970,3,45,32,26,1,1,105,0,7,112
19,9,19039,971,3,61,62,17,0,8,148,0,4,152
19,9,19039,974,3,18,19,2,2,3,44,0,0,44
19,9,19044,1724,3,115,380,67,14,14,590,0,26,616
19,9,19044,1726,3,22,123,21,0,0,166,0,7,173
19,9,19044,1727,3,32,97,5,0,2,136,0,3,139
19,9,19049,2086,3,702,376,70,77,15,1240,2,24,1266
19,9,19049,2087,3,533,272,73,66,16,960,0,24,984
19,9,19049,2090,3,251,213,54,49,5,572,0,15,587
19,9,19049,2091,3,381,405,72,83,9,950,0,26,976
19,9,19049,2094,3,219,442,58,47,6,772,0,34,806
19,9,19049,2095,3,402,585,100,81,13,1181,0,45,1226
19,9,19049,2098,3,518,364,101,89,9,1081,1,35,1117
19,9,19049,2099,3,521,275,73,65,6,940,1,21,962
19,9,19049,2102,3,138,131,27,14,4,314,0,8,322
19,9,19049,2103,3,265,298,45,23,4,635,0,12,647
19,9,19049,2106,3,69,53,17,2,0,141,0,6,147
19,9,19049,2107,3,25,21,3,1,0,50,0,1,51
19,9,19049,2110,3,113,75,11,9,3,211,0,7,218
19,10,19040,1247,3,345,266,71,55,12,749,1,17,767
19,10,19040,1250,3,206,135,52,37,4,434,2,9,445
19,10,19040,1251,3,127,133,44,23,3,330,1,8,339
19,10,19040,1257,3,171,110,42,23,7,353,0,14,367
19,10,19040,1258,3,218,141,70,37,12,478,0,11,489
19,10,19040,1259,3,123,85,31,23,9,271,0,34,305
19,10,19040,1264,3,161,121,33,27,6,348,1,10,359
19,10,19040,1266,3,102,85,45,24,5,261,1,6,268
19,10,19040,1267,3,204,142,45,35,8,434,2,6,442
19,10,19040,1274,3,228,138,70,27,12,475,0,9,484
19,10,19040,1275,3,225,101,65,35,11,437,2,7,446
19,10,19040,1288,3,136,168,35,34,8,381,3,15,399
19,10,19040,1290,3,107,129,46,18,6,306,0,12,318
19,10,19040,1291,3,209,165,49,40,7,470,0,15,485
19,10,19040,1294,3,298,150,77,65,10,600,0,6,606
19,10,19040,1295,3,182,83,54,37,7,363,0,4,367
19,10,19040,1298,3,186,69,53,24,8,340,0,2,342
19,10,19040,1299,3,492,228,125,68,12,925,0,12,937
19,10,19040,1302,3,133,133,38,27,4,335,0,13,348
19,10,19040,1303,3,100,74,30,15,2,221,0,6,227
19,10,19040,1306,3,216,102,34,43,3,398,1,16,415
19,10,19040,1307,3,722,284,158,95,14,1273,2,13,1288
19,10,19040,1310,3,611,294,137,72,16,1130,4,11,1145
19,10,19040,1311,3,440,184,88,82,17,811,1,21,833
19,10,19040,1314,3,449,246,116,93,16,920,0,25,945
19,10,19040,1315,3,709,220,136,99,15,1179,4,20,1203
19,10,19040,1318,3,534,191,110,62,18,915,0,16,931
19,10,19040,1319,3,203,159,67,44,7,480,1,15,496
19,10,19040,1322,3,105,91,28,13,0,237,0,5,242
19,10,19040,1323,3,94,70,33,15,6,218,0,0,218
19,10,19040,1326,3,792,262,155,81,23,1313,3,13,1329
19,10,19040,1327,3,271,123,49,34,9,486,2,7,495
19,10,19040,1330,3,637,220,109,60,16,1042,2,4,1048
19,10,19040,1331,3,845,283,108,93,16,1345,0,16,1361
19,10,19040,1334,3,933,283,86,48,16,1366,0,12,1378
19,10,19040,1335,3,635,178,88,84,25,1010,1,4,1015
19,10,19040,1338,3,658,197,72,50,18,995,1,8,1004
19,10,19040,1339,3,301,200,55,41,10,607,1,15,623
19,10,19040,1342,3,208,168,111,37,8,532,0,16,548
19,10,19040,1343,3,262,226,85,61,6,640,0,23,663
19,10,19040,1346,3,612,206,89,80,20,1007,0,7,1014
19,10,19040,1347,3,397,108,65,37,25,632,0,4,636
19,10,19040,1350,3,690,326,152,84,24,1276,3,7,1286
19,10,19040,1351,3,700,237,100,58,24,1119,1,14,1134
19,10,19040,1354,3,489,137,91,17,13,747,0,5,752
19,10,19040,1355,3,294,603,121,69,13,1100,6,46,1152
19,10,19040,1358,3,212,558,161,62,13,1006,0,37,1043
19,10,19040,1359,3,264,473,169,84,17,1007,0,32,1039
19,10,19040,1362,3,138,439,27,43,2,649,1,23,673
19,10,19040,1363,3,144,279,38,25,5,491,3,25,519
19,10,19040,1366,3,371,237,63,71,7,749,0,10,759
19,10,19040,1367,3,415,212,82,72,9,790,0,11,801
19,10,19040,1370,3,76,358,30,27,3,494,3,20,517
19,10,19040,1371,3,111,451,35,42,7,646,1,21,668
19,10,19040,1374,3,151,441,35,27,4,658,0,29,687
19,10,19040,1375,3,172,640,64,52,11,939,0,33,972
19,10,19040,1378,3,126,351,44,14,4,539,0,26,565
19,10,19040,1379,3,117,271,44,27,1,460,0,13,473
19,10,19040,1382,3,271,502,119,22,9,923,2,24,949
19,10,19040,1383,3,287,398,74,21,7,787,3,38,828
19,10,19040,1386,3,201,424,77,25,10,737,4,32,773
19,10,19040,1387,3,186,438,55,29,4,712,2,14,728
19,10,19040,1390,3,664,205,101,64,19,1053,1,9,1063
19,10,19040,1391,3,727,172,90,59,17,1065,1,8,1074
19,10,19040,1394,3,431,571,112,120,11,1245,0,39,1284
19,10,19040,1395,3,79,302,24,23,5,433,0,5,438
19,10,19040,1398,3,284,528,94,55,5,966,1,19,986
19,10,19040,1399,3,325,456,78,54,7,920,2,41,963
19,10,19040,1402,3,531,302,82,64,11,990,0,27,1017
19,10,19040,1403,3,198,258,38,35,13,542,0,10,552
19,10,19040,1406,3,272,271,72,43,4,662,1,23,686
19,10,19040,1407,3,351,205,79,51,11,697,0,10,707
19,10,19040,1410,3,1089,339,137,75,27,1667,0,14,1681
19,10,19040,1411,3,817,227,148,84,20,1296,0,9,1305
19,10,19040,1414,3,878,379,130,111,21,1519,0,8,1527
19,10,19040,1415,3,733,226,144,89,17,1209,0,4,1213
19,10,19040,1418,3,1053,299,190,93,32,1667,3,7,1677
19,10,19040,1419,3,535,174,106,40,8,863,0,9,872
19,10,19040,1422,3,868,368,92,48,18,1394,1,24,1419
19,10,19040,1423,3,242,446,65,17,4,774,1,25,800
19,10,19040,1426,3,100,320,35,24,3,482,0,23,505
19,10,19040,1427,3,102,352,55,20,6,535,2,7,544
19,10,19040,1430,3,39,43,6,7,1,96,0,0,96
19,10,19040,1431,3,220,205,44,21,4,494,1,8,503
19,10,19040,1679,3,250,226,83,41,10,610,1,9,620
19,10,19040,1682,3,413,271,116,45,18,863,0,17,880
19,10,19040,1683,3,105,91,24,14,6,240,1,12,253
19,10,19040,1687,3,511,205,78,67,10,871,2,2,875
19,10,19040,1690,3,232,195,76,37,8,548,1,11,560
19,10,19040,1691,3,295,293,89,41,14,732,0,9,741
19,10,19040,1694,3,184,196,49,22,5,456,0,15,471
19,10,19040,1695,3,171,131,38,23,5,368,2,7,377
19,10,19040,1698,3,194,104,58,26,8,390,0,6,396
19,10,19040,1699,3,64,36,18,18,2,138,1,4,143
19,11,19026,580,3,176,122,41,43,4,386,0,2,388
19,11,19026,594,3,1255,474,105,78,14,1926,1,11,1938
19,11,19026,595,3,684,416,73,62,20,1255,1,21,1277
19,11,19026,598,3,1203,331,100,60,24,1718,2,9,1729
19,11,19026,599,3,745,150,35,47,12,989,0,5,994
19,11,19026,602,3,1097,349,80,34,18,1578,0,9,1587
19,11,19026,603,3,1030,260,68,32,7,1397,0,13,1410
19,11,19026,695,3,522,365,130,90,24,1131,0,26,1157
19,11,19026,698,3,336,372,68,35,11,822,0,16,838
19,11,19026,699,3,690,749,191,137,30,1797,4,66,1867
19,11,19026,702,3,298,335,90,76,19,818,0,18,836
19,11,19026,703,3,966,1306,378,224,36,2910,10,53,2973
19,11,19026,706,3,448,645,180,97,23,1393,1,50,1444
19,11,19026,707,3,218,344,69,47,7,685,0,29,714
19,11,19026,710,3,243,188,55,62,17,565,2,6,573
19,11,19026,711,3,258,354,86,34,7,739,0,18,757
19,11,19026,714,3,376,403,211,58,12,1060,1,27,1088
19,11,19026,715,3,243,408,74,26,8,759,2,32,793
19,11,19026,718,3,426,371,85,56,18,956,0,19,975
19,11,19026,719,3,349,363,96,47,21,876,1,26,903
19,11,19026,722,3,479,464,102,83,15,1143,2,39,1184
19,11,19026,723,3,470,428,123,71,15,1107,0,50,1157
19,11,19026,726,3,354,467,93,92,8,1014,2,39,1055
19,11,19026,727,3,329,459,80,51,19,938,0,25,963
19,11,19026,730,3,400,425,99,79,28,1031,0,26,1057
19,11,19026,731,3,549,449,121,103,22,1244,1,25,1270
19,11,19026,734,3,361,602,107,79,11,1160,3,42,1205
19,11,19026,735,3,474,547,135,117,18,1291,1,29,1321
19,11,19026,738,3,325,349,107,60,14,855,1,16,872
19,11,19026,739,3,1618,1377,381,347,76,3799,0,34,3833
19,11,19026,742,3,627,1203,192,116,23,2161,1,34,2196
19,11,19026,743,3,280,556,115,100,20,1071,5,19,1095
19,11,19026,746,3,411,361,82,152,17,1023,0,13,1036
19,11,19026,747,3,295,400,71,88,10,864,1,18,883
19,11,19026,750,3,589,532,152,122,34,1429,0,26,1455
19,11,19026,751,3,532,539,88,104,18,1281,0,26,1307
19,11,19026,754,3,259,527,87,39,12,924,1,35,960
19,11,19026,755,3,370,785,116,84,19,1374,3,42,1419
19,11,19026,758,3,271,417,90,52,17,847,1,26,874
19,11,19026,759,3,849,767,187,241,47,2091,0,23,2114
19,11,19026,762,3,194,293,56,73,6,622,2,19,643
19,11,19026,763,3,678,496,115,139,25,1453,3,23,1479
19,11,19026,766,3,428,540,114,106,10,1198,0,18,1216
19,11,19026,767,3,324,731,86,95,10,1246,0,49,1295
19,11,19026,770,3,226,676,88,67,15,1072,3,44,1119
19,11,19026,771,3,289,580,106,78,12,1065,1,20,1086
19,11,19026,774,3,249,303,60,41,15,668,0,24,692
19,11,19026,775,3,355,362,106,52,18,893,1,20,914
19,11,19026,778,3,326,285,42,81,16,750,1,8,759
19,11,19026,779,3,351,473,94,84,7,1009,1,26,1036
19,11,19026,782,3,277,357,79,53,5,771,1,23,795
19,11,19026,783,3,241,658,94,73,7,1073,1,41,1115
19,11,19026,786,3,285,362,220,61,13,941,2,36,979
19,11,19026,787,3,491,475,104,103,30,1203,4,36,1243
19,11,19026,790,3,239,558,134,52,7,990,3,49,1042
19,11,19026,791,3,284,741,155,70,24,1274,1,51,1326
19,11,19026,794,3,949,858,243,252,33,2335,4,29,2368
19,11,19026,795,3,486,526,110,130,17,1269,3,27,1299
19,11,19026,798,3,331,269,71,56,8,735,0,13,748
19,11,19026,799,3,461,763,167,159,28,1578,2,32,1612
19,11,19026,802,3,386,347,62,78,15,888,5,14,907
19,11,19026,803,3,479,572,129,121,18,1319,1,40,1360
19,12,19001,1,3,164,250,13,30,5,462,0,7,469
19,12,19001,2,3,358,517,43,65,3,986,1,27,1014
19,12,19002,3,3,272,304,14,7,0,597,0,19,616
19,12,19002,6,3,187,238,10,4,0,439,0,3,442
19,12,19002,7,3,70,76,2,0,0,148,0,0,148
19,12,19002,10,3,87,113,6,1,2,209,0,1,210
19,12,19002,11,3,74,73,2,0,0,149,0,2,151
19,12,19003,14,3,25,11,0,0,0,36,0,3,39
19,12,19003,15,3,148,59,3,0,1,211,0,3,214
19,12,19003,18,3,32,13,0,0,0,45,0,5,50
19,12,19003,19,3,18,60,4,0,0,82,0,4,86
19,12,19005,39,3,264,308,50,16,2,640,0,26,666
19,12,19005,42,3,318,362,56,7,1,744,0,13,757
19,12,19005,43,3,234,313,47,14,5,613,0,11,624
19,12,19005,46,3,172,191,59,15,0,437,0,14,451
19,12,19005,47,3,186,220,29,4,1,440,0,8,448
19,12,19005,51,3,26,48,3,0,0,77,0,1,78
19,12,19005,54,3,16,25,3,1,0,45,0,1,46
19,12,19005,55,3,27,52,6,1,0,86,0,6,92
19,12,19005,58,3,16,14,3,3,1,37,0,1,38
19,12,19005,59,3,22,20,0,0,0,42,0,1,43
19,12,19005,62,3,15,38,5,2,0,60,0,6,66
19,12,19008,168,3,267,134,84,8,1,494,0,5,499
19,12,19008,170,3,257,145,47,16,2,467,0,9,476
19,12,19008,171,3,247,161,78,8,2,496,0,9,505
19,12,19009,174,3,479,658,230,101,15,1483,0,68,1551
19,12,19009,175,3,345,452,181,59,7,1044,0,40,1084
19,12,19009,178,3,253,300,103,52,8,716,1,31,748
19,12,19009,179,3,309,358,99,34,3,803,1,50,854
19,12,19009,182,3,401,418,140,63,9,1031,0,34,1065
19,12,19009,183,3,765,714,231,143,39,1892,0,46,1938
19,12,19009,186,3,342,326,86,52,14,820,0,18,838
19,12,19009,187,3,373,473,128,74,19,1067,1,32,1100
19,12,19009,190,3,373,490,231,140,42,1276,0,18,1294
19,12,19009,191,3,1006,1206,640,276,66,3194,8,29,3231
19,12,19009,194,3,206,198,56,18,2,480,0,24,504
19,12,19009,195,3,31,53,16,4,1,105,0,6,111
19,12,19009,198,3,110,112,40,9,3,274,0,17,291
19,12,19009,199,3,114,156,21,15,3,309,0,6,315
19,12,19009,202,3,52,89,16,4,1,162,0,12,174
19,12,19009,203,3,118,128,16,10,0,272,0,12,284
19,12,19009,206,3,59,133,4,11,0,207,0,8,215
19,12,19009,207,3,39,54,20,10,1,124,2,5,131
19,12,19009,210,3,112,286,57,16,2,473,1,22,496
19,12,19009,211,3,41,167,12,1,0,221,0,11,232
19,12,19009,214,3,99,72,47,14,5,237,1,0,238
19,12,19009,215,3,42,45,11,6,0,104,0,8,112
19,12,19010,218,3,234,467,42,180,3,926,0,35,961
19,12,19010,219,3,377,496,49,305,3,1230,0,27,1257
19,12,19011,222,3,249,349,21,16,2,637,0,20,657
19,12,19011,223,3,228,385,19,23,2,657,1,20,678
19,12,19011,226,3,226,364,7,20,2,619,1,24,644
19,12,19011,227,3,11,55,1,1,0,68,0,0,68
19,12,19011,230,3,23,37,1,1,0,62,0,1,63
19,12,19011,231,3,19,39,1,0,0,59,0,0,59
19,12,19012,234,3,228,240,116,21,3,608,0,15,623
19,12,19012,235,3,221,185,104,31,3,544,0,13,557
19,12,19016,305,3,197,157,96,45,2,497,1,11,509
19,12,19016,306,3,267,159,97,35,2,560,0,15,575
19,12,19016,307,3,123,97,53,39,2,314,0,8,322
19,12,19018,346,3,236,633,419,129,10,1427,3,43,1473
19,12,19018,347,3,1151,2085,1455,459,49,5199,4,138,5341
19,12,19018,350,3,445,433,476,161,11,1526,0,36,1562
19,12,19018,351,3,434,550,469,155,15,1623,0,34,1657
19,12,19018,354,3,9,50,93,25,1,178,0,12,190
19,12,19018,355,3,122,221,193,83,9,628,1,21,650
19,12,19023,515,3,68,35,5,0,0,108,0,1,109
19,12,19025,523,3,406,314,14,21,4,759,0,6,765
19,12,19027,805,3,121,161,7,6,1,296,1,4,301
19,12,19027,806,3,168,157,21,8,1,355,0,6,361
19,12,19027,807,3,171,233,20,28,0,452,0,9,461
19,12,19027,810,3,61,116,12,7,0,196,0,3,199
19,12,19028,811,3,95,252,69,35,2,453,0,12,465
19,12,19028,814,3,131,210,49,34,2,426,0,15,441
19,12,19028,815,3,151,292,90,62,3,598,0,7,605
19,12,19028,818,3,121,280,95,61,1,558,0,24,582
19,12,19028,819,3,213,446,81,53,5,798,2,30,830
19,12,19032,835,3,360,410,116,34,6,926,1,30,957
19,12,19032,838,3,446,461,126,97,10,1140,4,16,1160
19,12,19032,839,3,229,296,82,57,9,673,2,22,697
19,12,19032,842,3,297,489,86,40,8,920,1,32,953
19,12,19032,843,3,138,168,38,31,3,378,0,3,381
19,12,19032,846,3,295,328,135,38,16,812,5,8,825
19,12,19032,847,3,315,144,111,48,3,621,3,24,648
19,12,19032,850,3,2898,2961,970,554,93,7476,11,178,7665
19,12,19032,851,3,66,153,22,15,0,256,0,5,261
19,12,19033,854,3,155,166,49,115,6,491,1,27,519
19,12,19033,855,3,112,248,33,171,4,568,0,19,587
19,12,19033,858,3,19,51,8,21,0,99,0,6,105
19,12,19033,859,3,13,18,2,13,3,49,0,6,55
19,12,19035,908,3,205,228,61,27,2,523,10,15,548
19,12,19035,910,3,447,593,165,54,3,1262,1,10,1273
19,12,19036,911,3,134,221,10,124,1,490,0,13,503
19,12,19038,924,3,259,658,304,147,4,1372,1,45,1418
19,12,19038,927,3,24,79,54,2,0,159,0,8,167
19,12,19038,930,3,3,71,40,2,0,116,0,10,126
19,12,19041,1700,3,64,115,118,3,0,300,0,5,305
19,12,19041,1702,3,19,99,147,1,0,266,0,13,279
19,12,19042,1703,3,514,673,143,83,23,1436,2,40,1478
19,12,19042,1706,3,250,203,45,25,5,528,0,13,541
19,12,19042,1707,3,198,310,58,32,5,603,1,22,626
19,12,19042,1710,3,319,233,31,19,1,603,0,14,617
19,12,19042,1711,3,159,88,17,8,0,272,0,8,280
19,12,19043,1714,3,39,80,5,2,0,126,0,6,132
19,12,19043,1715,3,41,81,3,0,1,126,0,0,126
19,12,19043,1718,3,90,43,5,2,0,140,0,4,144
19,12,19043,1719,3,100,25,4,0,1,130,0,5,135
19,12,19043,1722,3,69,37,5,6,0,117,0,7,124
19,12,19043,1723,3,81,78,2,0,1,162,0,2,164
19,12,19045,1729,3,1207,501,266,49,8,2031,0,53,2084
19,12,19045,1730,3,436,359,180,64,7,1046,1,21,1068
19,12,19045,1731,3,290,209,127,27,3,656,1,14,671
19,12,19045,1734,3,297,184,101,20,5,607,1,12,620
19,12,19045,1735,3,261,121,89,11,4,486,0,8,494
19,12,19045,1738,3,850,508,263,63,5,1689,0,25,1714
19,12,19045,1739,3,673,363,263,52,7,1358,2,30,1390
19,12,19045,1742,3,251,170,141,25,9,596,0,13,609
19,12,19045,1743,3,414,201,146,29,2,792,3,23,818
19,12,19045,1746,3,291,134,103,20,5,553,0,12,565
19,12,19045,1749,3,185,78,55,3,2,323,0,10,333
19,12,19045,1750,3,27,8,9,1,0,45,0,0,45
19,12,19045,1751,3,64,67,17,0,0,148,0,4,152
19,12,19046,1754,3,214,561,50,159,6,990,0,66,1056
19,12,19046,1755,3,216,499,24,159,3,901,3,43,947
19,12,19046,1758,3,113,326,13,31,1,484,3,15,502
19,12,19046,1759,3,158,363,24,50,3,598,0,18,616
19,12,19050,2111,3,25,145,78,3,1,252,0,7,259
19,12,19050,2114,3,6,66,41,0,0,113,0,6,119
19,12,19050,2115,3,44,202,140,1,0,387,0,10,397
19,12,19051,2118,3,252,413,314,37,10,1026,0,45,1071
19,12,19051,2119,3,62,91,57,7,0,217,0,4,221
19,12,19051,2122,3,11,35,30,0,3,79,0,8,87
19,12,19051,2123,3,83,138,180,9,2,412,1,18,431
20,1,20002,2,3,82,177,234,7,6,506,0,17,523
20,1,20002,3,3,157,288,371,19,19,854,2,30,886
20,1,20002,6,3,148,211,614,25,13,1011,1,43,1055
20,1,20002,7,3,62,127,257,3,5,454,2,22,478
20,1,20002,10,3,223,328,159,15,22,747,0,23,770
20,1,20002,11,3,229,276,216,18,41,780,7,48,835
20,1,20002,14,3,155,158,90,7,5,415,3,15,433
20,1,20002,15,3,98,202,134,9,8,451,0,10,461
20,1,20002,18,3,21,62,168,2,3,256,1,9,266
20,1,20002,19,3,70,140,89,10,14,323,0,4,327
20,1,20002,22,3,53,76,159,2,1,291,0,13,304
20,1,20002,23,3,99,146,109,7,6,367,0,14,381
20,1,20002,26,3,128,194,125,10,8,465,1,15,481
20,1,20002,27,3,117,235,69,6,5,432,7,21,460
20,1,20002,30,3,76,108,172,2,1,359,2,16,377
20,1,20002,31,3,226,282,378,5,3,894,5,27,926
20,1,20002,34,3,160,224,291,14,5,694,1,8,703
20,1,20011,74,3,35,339,322,6,4,706,0,16,722
20,1,20011,75,3,45,381,426,6,3,861,2,32,895
20,1,20024,134,3,134,197,239,16,11,597,0,14,611
20,1,20024,135,3,267,232,506,36,22,1063,2,36,1101
20,1,20024,138,3,38,152,212,8,12,422,0,13,435
20,1,20024,139,3,170,283,219,17,12,701,3,24,728
20,1,20024,142,3,38,114,44,0,14,210,3,28,241
20,1,20024,143,3,140,243,277,27,13,700,0,17,717
20,1,20044,333,3,66,117,210,10,7,410,4,16,430
20,1,20044,334,3,73,105,186,9,6,379,6,10,395
20,1,20044,335,3,84,114,153,9,3,363,3,14,380
20,1,20044,338,3,100,138,332,16,7,593,1,28,622
20,1,20044,339,3,125,149,269,10,4,557,0,23,580
20,1,20044,342,3,117,150,224,15,9,515,2,14,531
20,1,20044,343,3,156,130,167,13,15,481,4,8,493
20,1,20044,346,3,57,78,106,68,4,313,3,10,326
20,1,20044,347,3,143,78,216,10,3,450,8,17,475
20,1,20044,350,3,65,161,125,5,9,365,2,14,381
20,1,20044,351,3,165,169,258,12,3,607,4,24,635
20,1,20044,354,3,150,153,220,13,8,544,4,20,568
20,1,20044,355,3,105,121,178,3,7,414,9,11,434
20,1,20044,358,3,36,55,127,1,2,221,2,16,239
20,1,20044,359,3,46,129,224,1,1,401,4,11,416
20,1,20044,362,3,45,194,243,4,3,489,3,14,506
20,1,20044,363,3,23,141,147,2,4,317,2,4,323
20,1,20164,943,3,308,294,493,22,15,1132,2,15,1149
20,1,20164,946,3,195,153,321,10,6,685,3,7,695
20,1,20164,947,3,336,209,241,10,5,801,8,5,814
20,1,20182,1010,3,506,340,536,41,54,1477,8,8,1493
20,1,20182,1011,3,173,126,243,12,8,562,4,7,573
20,1,20182,1014,3,188,210,273,18,13,702,2,13,717
20,1,20182,1015,3,232,227,317,21,13,810,6,12,828
20,1,20182,1018,3,407,261,527,22,22,1239,12,25,1276
20,1,20182,1019,3,287,218,380,27,19,931,8,28,967
20,1,20182,1022,3,301,367,464,21,21,1174,3,20,1197
20,1,20182,1023,3,219,261,328,27,15,850,8,22,880
20,1,20182,1026,3,149,152,134,17,7,459,3,11,473
20,1,20182,1027,3,159,166,158,12,5,500,0,11,511
20,1,20182,1030,3,254,214,217,16,17,718,1,10,729
20,1,20182,1031,3,269,245,280,14,14,822,2,14,838
20,1,20182,1034,3,432,307,610,29,22,1400,7,22,1429
20,1,20182,1035,3,333,222,365,23,15,958,1,13,972
20,1,20182,1038,3,267,266,400,24,12,969,9,12,990
20,1,20182,1039,3,283,253,373,20,12,941,6,12,959
20,1,20182,1042,3,936,695,1048,52,31,2762,17,72,2851
20,1,20182,1043,3,309,173,317,25,11,835,2,22,859
20,1,20182,1046,3,142,175,182,6,5,510,0,15,525
20,1,20182,1047,3,117,165,152,8,7,449,0,5,454
20,1,20182,1050,3,249,142,94,7,5,497,4,26,527
20,1,20182,1051,3,238,243,182,10,3,676,8,18,702
20,1,20182,1054,3,319,242,324,33,14,932,3,40,975
20,1,20182,1055,3,304,245,347,18,8,922,8,27,957
20,1,20182,1058,3,319,261,165,10,18,773,4,21,798
20,1,20182,1059,3,131,133,123,5,3,395,0,10,405
20,1,20182,1062,3,142,283,262,12,8,707,3,21,731
20,1,20182,1063,3,176,120,69,6,7,378,0,13,391
20,1,20182,1066,3,118,173,208,4,7,510,7,3,520
20,1,20182,1067,3,269,221,65,4,2,561,6,7,574
20,1,20182,1070,3,228,229,182,8,17,664,1,23,688
20,1,20182,1071,3,140,113,69,4,3,329,0,18,347
20,1,20182,1074,3,162,163,156,10,8,499,1,8,508
20,1,20182,1075,3,234,237,191,5,16,683,5,22,710
20,1,20182,1078,3,448,165,109,12,10,744,11,18,773
20,1,20182,1079,3,128,374,195,14,5,716,3,32,751
20,1,20182,1082,3,102,147,73,4,4,330,0,9,339
20,1,20182,1083,3,197,119,171,11,13,511,7,16,534
20,1,20276,1372,3,153,353,342,14,7,869,0,30,899
20,1,20276,1374,3,90,278,357,9,4,738,1,10,749
20,1,20276,1375,3,115,293,254,13,4,679,2,11,692
20,1,20276,1378,3,21,110,87,0,1,219,0,8,227
20,1,20276,1379,3,163,441,279,1,6,890,3,24,917
20,1,20276,1382,3,133,264,141,8,4,550,2,21,573
20,1,20276,1383,3,261,574,216,5,5,1061,0,25,1086
20,1,20276,1386,3,64,428,414,38,7,951,36,21,1008
20,1,20276,1387,3,114,268,124,1,2,509,0,23,532
20,1,20276,1390,3,193,304,79,3,3,582,3,13,598
20,1,20276,1391,3,35,453,202,3,9,702,0,6,708
20,1,20276,1394,3,37,217,147,1,1,403,0,8,411
20,1,20276,1395,3,110,310,285,19,2,726,1,30,757
20,1,20418,1860,3,287,313,514,14,8,1136,0,19,1155
20,1,20418,1862,3,143,224,308,4,6,685,12,20,717
20,1,20418,1863,3,26,49,87,1,0,163,0,7,170
20,1,20469,2025,3,277,292,180,5,5,759,1,29,789
20,1,20469,2026,3,75,105,246,3,10,439,3,25,467
20,1,20469,2027,3,104,42,59,1,1,207,0,8,215
20,1,20469,2030,3,160,115,239,1,1,516,0,31,547
20,1,20469,2031,3,50,246,309,2,4,611,0,22,633
20,2,20022,127,3,37,199,155,8,4,403,2,2,407
20,2,20022,130,3,17,111,114,2,3,247,0,30,277
20,2,20027,153,3,61,148,141,9,4,363,9,34,406
20,2,20027,154,3,16,20,35,1,1,73,0,4,77
20,2,20027,155,3,59,171,105,6,5,346,2,40,388
20,2,20029,176,3,72,88,185,2,2,349,1,41,391
20,2,20029,178,3,33,47,67,0,0,147,0,13,160
20,2,20029,179,3,22,116,84,1,0,223,2,46,271
20,2,20038,232,3,24,469,242,3,1,739,2,57,798
20,2,20038,234,3,4,232,165,0,3,404,0,24,428
20,2,20038,235,3,14,360,123,0,3,500,0,110,610
20,2,20039,238,3,101,267,348,12,10,738,0,27,765
20,2,20039,239,3,294,318,369,12,12,1005,4,35,1044
20,2,20039,242,3,25,130,51,0,1,207,1,14,222
20,2,20039,243,3,50,194,107,4,1,356,0,22,378
20,2,20039,246,3,188,253,109,0,3,553,0,22,575
20,2,20039,247,3,217,596,284,1,4,1102,3,57,1162
20,2,20039,250,3,160,492,262,5,1,920,1,31,952
20,2,20039,251,3,81,270,245,2,7,605,0,36,641
20,2,20039,254,3,34,153,138,0,1,326,0,11,337
20,2,20058,422,3,40,392,382,4,14,832,5,102,939
20,2,20058,423,3,13,139,146,2,3,303,0,39,342
20,2,20058,426,3,39,251,254,5,7,556,0,45,601
20,2,20058,427,3,5,120,67,0,3,195,0,17,212
20,2,20058,430,3,14,119,60,2,0,195,0,37,232
20,2,20058,431,3,19,126,102,0,4,251,1,33,285
20,2,20095,759,3,117,308,274,3,2,704,0,66,770
20,2,20106,788,3,49,256,259,11,3,578,0,5,583
20,2,20115,804,3,121,187,354,2,0,664,1,23,688
20,2,20115,806,3,89,151,109,0,2,351,0,25,376
20,2,20131,851,3,50,479,286,0,4,819,0,0,819
20,2,20131,854,3,185,357,743,5,9,1299,6,31,1336
20,2,20131,855,3,22,164,238,1,1,426,0,9,435
20,2,20131,858,3,55,541,583,2,1,1182,0,10,1192
20,2,20131,859,3,29,235,277,0,1,542,0,24,566
20,2,20133,866,3,231,571,394,1,1,1198,0,5,1203
20,2,20133,867,3,206,552,562,0,4,1324,1,9,1334
20,2,20133,870,3,120,90,54,1,0,265,1,3,269
20,2,20136,875,3,13,263,119,2,3,400,0,37,437
20,2,20139,882,3,60,62,275,5,3,405,0,36,441
20,2,20160,932,3,35,270,167,12,7,491,0,63,554
20,2,20167,952,3,35,530,584,6,8,1163,1,45,1209
20,2,20167,954,3,9,217,162,1,1,390,1,17,408
20,2,20170,962,3,92,385,558,3,7,1045,1,43,1089
20,2,20170,963,3,38,110,123,0,3,274,0,15,289
20,2,20170,966,3,32,166,305,1,2,506,0,31,537
20,2,20170,967,3,77,112,163,1,1,354,1,15,370
20,2,20170,970,3,49,232,353,1,1,636,0,22,658
20,2,20170,971,3,9,65,46,1,0,121,0,6,127
20,2,20170,974,3,7,78,196,1,1,283,0,22,305
20,2,20170,975,3,6,122,164,0,0,292,0,20,312
20,2,20173,981,3,142,185,224,7,9,567,4,23,594
20,2,20175,986,3,135,130,251,10,3,529,1,37,567
20,2,20175,987,3,127,197,305,10,7,646,2,34,682
20,2,20175,990,3,9,97,43,0,0,149,0,27,176
20,2,20175,991,3,6,47,56,0,0,109,0,2,111
20,2,20175,994,3,28,82,97,2,1,210,0,66,276
20,2,20175,995,3,18,168,108,2,5,301,2,11,314
20,2,20175,998,3,10,20,16,0,2,48,0,5,53
20,2,20181,1009,3,17,407,302,2,4,732,1,111,844
20,2,20183,1084,3,123,193,477,14,2,809,3,16,828
20,2,20183,1086,3,127,228,334,5,7,701,0,9,710
20,2,20183,1087,3,129,264,499,4,7,903,0,16,919
20,2,20183,1090,3,57,217,344,5,3,626,4,21,651
20,2,20183,1091,3,43,128,439,1,1,612,1,28,641
20,2,20183,1094,3,44,164,334,3,4,549,1,5,555
20,2,20183,1095,3,67,206,208,2,3,486,7,25,518
20,2,20183,1098,3,23,146,181,2,0,352,1,18,371
20,2,20187,1108,3,19,215,127,3,3,367,0,30,397
20,2,20189,1111,3,14,486,302,0,1,803,0,81,884
20,2,20193,1129,3,196,238,182,12,6,634,0,6,640
20,2,20193,1130,3,5,16,273,0,0,294,0,16,310
20,2,20220,1228,3,27,42,118,2,1,190,0,1,191
20,2,20220,1230,3,35,64,87,2,4,192,0,6,198
20,2,20220,1231,3,14,78,61,0,1,154,1,8,163
20,2,20228,1248,3,17,164,121,1,0,303,0,13,316
20,2,20232,1254,3,64,190,184,6,3,447,0,25,472
20,2,20232,1255,3,140,254,297,7,6,704,0,23,727
20,2,20232,1258,3,275,289,196,3,3,766,3,18,787
20,2,20232,1259,3,336,449,278,2,7,1072,1,26,1099
20,2,20232,1262,3,86,197,115,1,3,402,2,19,423
20,2,20232,1263,3,133,315,402,1,0,851,0,15,866
20,2,20234,1267,3,42,294,190,10,2,538,0,89,627
20,2,20234,1270,3,20,425,268,11,5,729,0,112,841
20,2,20244,1292,3,90,250,389,16,10,755,3,14,772
20,2,20255,1316,3,66,287,253,5,7,618,1,56,675
20,2,20275,1371,3,22,88,71,3,4,188,0,47,235
20,2,20307,1473,3,297,379,123,3,4,806,0,19,825
20,2,20307,1474,3,384,432,180,6,1,1003,0,18,1021
20,2,20307,1475,3,34,121,87,1,2,245,1,10,256
20,2,20307,1478,3,240,264,133,3,2,642,0,13,655
20,2,20307,1479,3,113,150,85,0,0,348,0,12,360
20,2,20309,1484,3,11,136,52,5,2,206,0,42,248
20,2,20311,1492,3,3,227,227,0,0,457,0,11,468
20,2,20320,1514,3,7,201,68,12,2,290,6,29,325
20,2,20324,1541,3,148,455,143,6,3,755,4,54,813
20,2,20324,1542,3,42,89,131,0,5,267,3,20,290
20,2,20324,1543,3,18,42,159,2,1,222,1,16,239
20,2,20328,1555,3,83,305,151,2,1,542,1,28,571
20,2,20354,1642,3,21,100,54,3,3,181,0,26,207
20,2,20355,1643,3,14,124,124,1,5,268,2,27,297
20,2,20375,1685,3,22,174,244,2,1,443,0,37,480
20,2,20399,1782,3,55,271,81,1,0,408,0,75,483
20,2,20399,1783,3,9,266,71,2,0,348,0,55,403
20,2,20404,1793,3,106,435,198,6,7,752,0,49,801
20,2,20404,1794,3,117,256,89,2,4,468,2,26,496
20,2,20404,1795,3,129,212,346,2,3,692,2,56,750
20,2,20404,1798,3,25,362,136,1,1,525,0,21,546
20,2,20404,1799,3,11,130,121,1,0,263,0,19,282
20,2,20404,1802,3,30,193,139,1,0,363,3,36,402
20,2,20404,1803,3,32,173,77,0,1,283,0,21,304
20,2,20404,1806,3,4,103,64,0,1,172,0,11,183
20,2,20404,1807,3,8,128,23,1,3,163,0,17,180
20,2,20417,1859,3,13,268,25,5,0,311,2,6,319
20,2,20426,1887,3,56,227,345,7,6,641,0,64,705
20,2,20432,1906,3,31,410,383,2,2,828,0,20,848
20,2,20435,1909,3,42,321,140,4,2,509,0,51,560
20,2,20435,1910,3,44,375,138,1,9,567,1,38,606
20,2,20437,1913,3,24,136,258,1,5,424,0,23,447
20,2,20439,1918,3,24,214,120,2,3,363,0,53,416
20,2,20491,2131,3,23,413,91,3,4,534,0,45,579
20,2,20531,2272,3,42,295,178,0,1,516,2,78,596
20,2,20545,2325,3,89,325,354,16,11,795,1,22,818
20,2,20545,2326,3,113,444,438,24,11,1030,3,32,1065
20,2,20545,2327,3,89,274,390,25,12,790,2,18,810
20,2,20545,2330,3,8,112,148,0,0,268,0,8,276
20,2,20558,2405,3,9,147,169,3,2,330,0,27,357
20,2,20558,2406,3,15,149,144,2,5,315,0,15,330
20,3,20005,42,3,212,187,36,3,3,441,0,9,450
20,3,20007,57,3,188,491,568,14,13,1274,6,40,1320
20,3,20007,58,3,155,472,467,16,20,1130,2,40,1172
20,3,20007,59,3,106,585,339,10,11,1051,1,44,1096
20,3,20007,62,3,15,71,194,3,3,286,0,10,296
20,3,20007,63,3,34,76,144,5,3,262,0,21,283
20,3,20021,125,3,35,37,59,1,1,133,0,7,140
20,3,20021,126,3,36,39,49,6,2,132,0,8,140
20,3,20025,144,3,13,129,77,4,3,226,0,12,238
20,3,20025,146,3,10,27,35,1,1,74,0,2,76
20,3,20033,192,3,160,172,511,36,24,903,2,19,924
20,3,20037,201,3,285,278,467,38,30,1098,0,12,1110
20,3,20037,202,3,378,230,370,23,25,1026,0,15,1041
20,3,20037,203,3,243,164,497,24,30,958,1,14,973
20,3,20037,206,3,392,211,409,35,28,1075,0,29,1104
20,3,20037,207,3,471,284,347,31,40,1173,3,16,1192
20,3,20037,210,3,272,163,224,18,28,705,3,10,718
20,3,20037,211,3,180,89,147,14,15,445,1,8,454
20,3,20037,214,3,316,213,289,14,16,848,0,25,873
20,3,20037,215,3,210,97,155,14,10,486,3,6,495
20,3,20037,218,3,414,370,438,34,23,1279,2,19,1300
20,3,20037,219,3,377,242,489,23,28,1159,0,19,1178
20,3,20037,222,3,212,193,112,9,2,528,0,2,530
20,3,20037,223,3,28,84,40,0,0,152,0,12,164
20,3,20037,226,3,103,115,57,3,5,283,2,5,290
20,3,20037,227,3,313,85,40,4,7,449,0,9,458
20,3,20037,230,3,74,44,17,2,2,139,0,1,140
20,3,20037,231,3,332,161,232,15,15,755,3,17,775
20,3,20045,365,3,179,131,291,22,11,634,1,15,650
20,3,20045,366,3,223,154,391,25,26,819,2,15,836
20,3,20045,367,3,50,58,148,11,3,270,0,2,272
20,3,20046,370,3,44,100,82,7,3,236,0,6,242
20,3,20046,371,3,77,124,105,3,4,313,4,7,324
20,3,20053,387,3,85,156,173,4,5,423,0,12,435
20,3,20063,459,3,82,233,518,22,16,871,1,11,883
20,3,20074,666,3,151,126,418,15,16,726,2,24,752
20,3,20074,667,3,90,128,253,11,7,489,1,15,505
20,3,20081,719,3,164,159,411,31,21,786,0,25,811
20,3,20086,741,3,27,257,189,8,4,485,0,10,495
20,3,20086,742,3,18,74,54,6,3,155,0,7,162
20,3,20086,743,3,11,3,39,0,0,53,0,0,53
20,3,20089,749,3,121,113,229,17,14,494,8,23,525
20,3,20090,750,3,17,106,104,2,2,231,0,13,244
20,3,20091,751,3,21,302,21,2,3,349,0,6,355
20,3,20093,756,3,55,98,115,2,10,280,1,6,287
20,3,20099,764,3,85,389,552,19,9,1054,1,10,1065
20,3,20103,776,3,37,58,61,0,3,159,0,5,164
20,3,20113,801,3,27,71,126,12,9,245,1,21,267
20,3,20113,802,3,26,14,36,12,0,88,0,0,88
20,3,20118,810,3,9,61,61,0,2,133,0,8,141
20,3,20126,837,3,24,37,67,3,2,133,2,6,141
20,3,20132,862,3,92,148,201,12,9,462,1,13,476
20,3,20132,863,3,75,136,128,14,10,363,1,14,378
20,3,20137,876,3,9,147,99,1,3,259,2,1,262
20,3,20141,891,3,24,80,101,1,2,208,1,3,212
20,3,20144,896,3,11,82,47,1,1,142,0,5,147
20,3,20147,900,3,88,409,404,34,21,956,4,10,970
20,3,20147,902,3,85,320,572,27,17,1021,2,12,1035
20,3,20147,903,3,150,375,631,34,26,1216,5,23,1244
20,3,20148,906,3,20,70,64,1,1,156,1,9,166
20,3,20157,924,3,50,116,43,2,0,211,1,3,215
20,3,20157,926,3,128,13,23,0,2,166,0,7,173
20,3,20158,927,3,34,139,54,5,1,233,0,10,243
20,3,20158,930,3,41,64,82,4,3,194,1,17,212
20,3,20163,941,3,19,92,141,5,0,257,0,11,268
20,3,20163,942,3,9,107,71,2,4,193,0,5,198
20,3,20171,978,3,16,58,148,5,2,229,0,7,236
20,3,20174,982,3,55,48,130,5,1,239,0,13,252
20,3,20174,983,3,37,56,100,3,0,196,0,6,202
20,3,20176,999,3,62,94,138,5,0,299,0,13,312
20,3,20177,1002,3,61,204,144,9,7,425,2,25,452
20,3,20179,1005,3,85,82,6,1,0,174,0,3,177
20,3,20179,1006,3,14,46,8,1,3,72,0,2,74
20,3,20194,1131,3,187,89,108,14,14,412,3,13,428
20,3,20196,1134,3,69,54,136,0,4,263,0,21,284
20,3,20196,1135,3,27,58,53,1,1,140,0,16,156
20,3,20215,1219,3,45,95,109,4,8,261,2,10,273
20,3,20217,1222,3,11,42,145,4,3,205,4,21,230
20,3,20217,1223,3,24,183,108,4,5,324,2,26,352
20,3,20221,1232,3,27,44,162,2,1,236,0,16,252
20,3,20224,1237,3,50,99,188,2,5,344,1,9,354
20,3,20227,1243,3,259,165,593,44,29,1090,5,14,1109
20,3,20227,1246,3,216,213,654,57,41,1181,7,20,1208
20,3,20227,1247,3,91,80,219,20,11,421,0,10,431
20,3,20239,1283,3,38,74,259,7,8,386,0,16,402
20,3,20248,1302,3,56,131,143,2,3,335,1,10,346
20,3,20253,1314,3,55,108,130,5,4,302,0,15,317
20,3,20254,1315,3,31,28,48,0,2,109,0,2,111
20,3,20257,1319,3,25,166,82,4,3,280,7,21,308
20,3,20260,1324,3,158,255,23,1,1,438,0,4,442
20,3,20260,1326,3,63,282,80,1,6,432,0,8,440
20,3,20260,1327,3,65,157,52,1,1,276,0,13,289
20,3,20260,1330,3,24,100,17,0,0,141,0,7,148
20,3,20260,1331,3,11,129,70,0,1,211,3,15,229
20,3,20262,1336,3,33,65,298,8,2,406,0,28,434
20,3,20269,1359,3,7,84,88,3,0,182,2,15,199
20,3,20273,1367,3,84,159,126,3,6,378,0,16,394
20,3,20279,1401,3,16,56,42,1,2,117,0,6,123
20,3,20281,1404,3,43,84,55,23,6,211,0,11,222
20,3,20281,1406,3,8,19,35,3,2,67,1,3,71
20,3,20285,1415,3,58,46,62,4,2,172,0,3,175
20,3,20291,1423,3,140,62,323,27,25,577,1,21,599
20,3,20292,1426,3,98,164,271,18,12,563,0,17,580
20,3,20292,1427,3,212,302,279,20,12,825,0,19,844
20,3,20292,1430,3,23,66,39,3,0,131,2,2,135
20,3,20302,1459,3,37,92,97,4,2,232,0,13,245
20,3,20308,1482,3,82,124,198,14,11,429,0,61,490
20,3,20308,1483,3,180,200,414,44,20,858,2,42,902
20,3,20315,1496,3,37,55,148,5,5,250,1,11,262
20,3,20319,1513,3,89,76,60,2,3,230,0,11,241
20,3,20327,1554,3,77,146,193,2,4,422,0,17,439
20,3,20329,1558,3,27,35,84,2,3,151,0,7,158
20,3,20329,1559,3,14,27,70,2,6,119,1,8,128
20,3,20334,1589,3,73,129,256,16,13,487,1,16,504
20,3,20334,1590,3,50,127,309,8,8,502,3,14,519
20,3,20334,1591,3,9,63,13,0,0,85,1,5,91
20,3,20335,1594,3,62,98,101,4,3,268,2,11,281
20,3,20335,1595,3,18,33,16,0,3,70,0,2,72
20,3,20335,1598,3,16,34,84,3,5,142,0,8,150
20,3,20335,1599,3,8,28,32,0,0,68,0,1,69
20,3,20338,1604,3,14,62,23,0,2,101,0,2,103
20,3,20352,1640,3,67,129,22,3,4,225,0,2,227
20,3,20371,1677,3,25,115,112,3,3,258,0,10,268
20,3,20374,1683,3,25,77,71,0,1,174,0,0,174
20,3,20384,1708,3,23,128,81,2,2,236,1,2,239
20,3,20391,1743,3,21,175,38,2,4,240,0,8,248
20,3,20396,1777,3,6,40,3,0,0,49,0,0,49
20,3,20398,1780,3,19,139,129,7,7,301,0,73,374
20,3,20400,1784,3,324,284,822,66,47,1543,2,30,1575
20,3,20400,1786,3,277,201,427,44,23,972,5,44,1021
20,3,20401,1787,3,26,145,173,7,2,353,0,8,361
20,3,20403,1790,3,76,42,134,7,4,263,0,12,275
20,3,20403,1791,3,86,121,134,13,11,365,1,22,388
20,3,20409,1828,3,16,97,59,5,0,177,0,9,186
20,3,20423,1878,3,5,8,99,1,0,113,0,4,117
20,3,20423,1879,3,18,38,88,21,1,166,0,10,176
20,3,20428,1898,3,42,287,97,0,0,426,2,33,461
20,3,20428,1899,3,29,340,29,1,2,401,0,39,440
20,3,20428,1902,3,17,209,154,1,3,384,0,23,407
20,3,20431,1905,3,8,76,36,0,0,120,0,4,124
20,3,20452,1960,3,20,62,136,0,4,222,0,22,244
20,3,20456,1971,3,292,253,62,1,2,610,0,7,617
20,3,20459,1978,3,46,187,285,24,15,557,2,8,567
20,3,20459,1979,3,52,185,188,10,8,443,0,11,454
20,3,20459,1982,3,17,93,34,3,2,149,0,10,159
20,3,20459,1983,3,31,45,70,3,1,150,0,5,155
20,3,20459,1986,3,25,62,106,2,1,196,2,2,200
20,3,20463,1995,3,175,431,323,11,13,953,0,15,968
20,3,20463,1998,3,16,212,38,1,1,268,0,5,273
20,3,20464,1999,3,17,94,86,1,2,200,2,2,204
20,3,20465,2002,3,32,24,43,1,4,104,0,4,108
20,3,20465,2003,3,8,8,51,0,4,71,0,3,74
20,3,20477,2070,3,18,64,55,0,0,137,0,1,138
20,3,20479,2072,3,25,181,81,3,0,290,2,8,300
20,3,20479,2074,3,48,67,88,1,0,204,0,19,223
20,3,20479,2075,3,20,55,65,2,0,142,0,5,147
20,3,20485,2112,3,110,331,452,20,24,937,6,27,970
20,3,20485,2114,3,104,343,211,14,3,675,0,18,693
20,3,20485,2115,3,80,39,128,8,9,264,4,4,272
20,3,20488,2125,3,46,126,110,6,5,293,2,10,305
20,3,20488,2126,3,82,110,168,7,5,372,1,15,388
20,3,20489,2127,3,3,87,10,0,0,100,0,1,101
20,3,20493,2135,3,37,75,162,4,6,284,3,25,312
20,3,20493,2138,3,25,84,113,0,1,223,3,21,247
20,3,20494,2139,3,35,73,111,6,1,226,1,8,235
20,3,20495,2142,3,62,94,167,3,5,331,1,43,375
20,3,20495,2143,3,55,70,104,6,10,245,3,28,276
20,3,20500,2156,3,43,28,281,6,11,369,0,16,385
20,3,20511,2186,3,6,206,29,1,0,242,0,7,249
20,3,20511,2187,3,20,181,40,0,2,243,1,8,252
20,3,20518,2234,3,5,66,10,2,1,84,0,1,85
20,3,20521,2244,3,17,88,33,1,2,141,0,11,152
20,3,20523,2246,3,88,143,269,9,9,518,6,24,548
20,3,20523,2247,3,20,26,30,3,1,80,0,4,84
20,3,20527,2261,3,77,165,220,10,12,484,2,13,499
20,3,20537,2301,3,92,273,368,19,16,768,2,7,777
20,3,20537,2302,3,76,134,200,15,4,429,0,3,432
20,3,20537,2303,3,86,186,430,21,12,735,0,16,751
20,3,20539,2306,3,119,228,323,15,19,704,4,21,729
20,3,20539,2307,3,81,89,232,9,12,423,0,9,432
20,3,20539,2310,3,4,15,53,0,1,73,1,3,77
20,3,20543,2321,3,40,163,105,3,4,315,0,7,322
20,3,20543,2322,3,59,139,167,4,3,372,0,12,384
20,3,20543,2323,3,26,87,98,1,4,216,0,5,221
20,3,20547,2335,3,37,49,282,4,12,384,2,26,412
20,3,20548,2338,3,8,33,51,1,1,94,0,3,97
20,3,20551,2362,3,41,32,121,6,3,203,0,3,206
20,3,20556,2393,3,15,31,62,1,4,113,0,2,115
20,3,20560,2408,3,160,190,354,39,15,758,5,14,777
20,3,20560,2410,3,175,354,478,33,37,1077,0,19,1096
20,3,20560,2411,3,219,173,483,43,17,935,3,6,944
20,3,20565,2422,3,61,255,49,1,1,367,0,32,399
20,3,20569,2435,3,42,327,77,7,2,455,0,31,486
20,3,20037,2451,3,117,83,10,0,1,211,0,5,216
20,4,20001,1,3,35,186,113,0,5,339,0,15,354
20,4,20004,39,3,22,111,164,2,5,304,2,11,317
20,4,20008,65,3,171,153,105,3,7,439,1,40,480
20,4,20008,66,3,168,113,65,5,2,353,2,13,368
20,4,20008,67,3,131,59,55,1,2,248,1,10,259
20,4,20034,193,3,18,52,148,1,4,223,0,6,229
20,4,20042,276,3,175,205,342,16,22,760,3,14,777
20,4,20042,278,3,52,137,219,6,0,414,0,25,439
20,4,20042,279,3,14,51,62,2,0,129,0,5,134
20,4,20042,282,3,117,133,92,5,7,354,0,17,371
20,4,20050,378,3,36,63,65,1,2,167,2,20,189
20,4,20050,379,3,48,66,78,3,2,197,1,17,215
20,4,20060,454,3,29,333,96,2,2,462,3,22,487
20,4,20060,455,3,10,122,46,1,0,179,0,8,187
20,4,20062,458,3,39,94,70,5,5,213,2,12,227
20,4,20065,469,3,107,130,96,3,3,339,4,10,353
20,4,20067,617,3,200,154,336,34,27,751,10,29,790
20,4,20067,618,3,193,140,318,25,24,700,4,29,733
20,4,20067,619,3,297,161,331,29,29,847,3,23,873
20,4,20067,622,3,250,151,480,28,31,940,4,29,973
20,4,20067,623,3,64,47,232,10,18,371,4,9,384
20,4,20067,626,3,64,30,30,1,8,133,0,6,139
20,4,20067,627,3,24,36,51,2,2,115,0,3,118
20,4,20067,630,3,52,231,55,1,6,345,2,7,354
20,4,20067,631,3,14,39,70,0,8,131,1,6,138
20,4,20075,668,3,97,96,156,17,8,374,2,18,394
20,4,20084,736,3,183,165,117,21,16,502,3,13,518
20,4,20088,747,3,131,126,270,30,35,592,6,11,609
20,4,20094,757,3,43,41,204,6,3,297,1,12,310
20,4,20094,758,3,43,44,79,1,2,169,0,18,187
20,4,20097,762,3,26,22,151,2,2,203,0,22,225
20,4,20100,766,3,83,180,241,11,11,526,0,14,540
20,4,20100,767,3,62,103,196,1,0,362,0,7,369
20,4,20109,792,3,111,289,208,3,2,613,4,41,658
20,4,20111,795,3,5,8,103,2,1,119,0,5,124
20,4,20117,809,3,95,244,67,3,5,414,0,43,457
20,4,20119,811,3,20,33,105,3,1,162,0,9,171
20,4,20125,836,3,115,120,207,6,11,459,3,44,506
20,4,20128,841,3,180,129,183,15,14,521,0,38,559
20,4,20128,842,3,218,154,319,9,4,704,0,54,758
20,4,20128,843,3,36,459,88,9,1,593,0,39,632
20,4,20129,846,3,143,146,136,8,9,442,7,17,466
20,4,20135,874,3,30,9,146,8,7,200,0,7,207
20,4,20142,893,3,142,168,246,20,24,600,6,15,621
20,4,20153,914,3,210,222,370,1,13,816,1,35,852
20,4,20153,915,3,33,68,98,2,3,204,1,22,227
20,4,20159,931,3,53,256,90,6,2,407,0,20,427
20,4,20161,934,3,85,152,306,14,10,567,0,20,587
20,4,20161,935,3,46,161,183,11,5,406,0,17,423
20,4,20172,979,3,31,94,138,3,4,270,0,22,292
20,4,20185,1106,3,17,71,63,2,3,156,0,9,165
20,4,20186,1107,3,147,188,295,22,13,665,0,19,684
20,4,20191,1117,3,60,218,110,0,0,388,0,30,418
20,4,20191,1118,3,34,213,37,1,0,285,0,5,290
20,4,20195,1133,3,155,179,105,7,7,453,8,32,493
20,4,20197,1136,3,9,78,138,1,2,228,1,7,236
20,4,20198,1138,3,75,106,113,5,7,306,0,9,315
20,4,20201,1164,3,54,76,100,3,1,234,0,43,277
20,4,20201,1166,3,18,29,53,1,4,105,0,14,119
20,4,20201,1167,3,118,97,130,10,6,361,5,54,420
20,4,20212,1213,3,8,22,241,2,3,276,2,28,306
20,4,20212,1214,3,37,76,42,0,3,158,0,28,186
20,4,20214,1217,3,74,82,278,8,6,448,10,42,500
20,4,20214,1218,3,21,16,104,3,2,146,1,11,158
20,4,20216,1220,3,25,71,201,3,2,302,0,19,321
20,4,20219,1226,3,140,159,51,4,5,359,8,21,388
20,4,20219,1227,3,107,148,72,7,0,334,3,42,379
20,4,20222,1234,3,41,98,168,1,2,310,4,24,338
20,4,20222,1235,3,8,30,50,1,0,89,0,10,99
20,4,20226,1241,3,98,231,144,7,12,492,2,80,574
20,4,20226,1242,3,55,60,27,3,3,148,2,11,161
20,4,20231,1253,3,112,112,41,2,1,268,0,19,287
20,4,20233,1266,3,83,186,28,4,5,306,1,17,324
20,4,20243,1291,3,165,239,181,11,16,612,3,16,631
20,4,20246,1296,3,23,94,90,2,1,210,0,15,225
20,4,20256,1318,3,18,115,196,4,5,338,0,29,367
20,4,20259,1322,3,76,438,87,4,5,610,2,6,618
20,4,20259,1323,3,11,12,158,0,2,183,0,8,191
20,4,20261,1333,3,18,56,36,4,5,119,0,8,127
20,4,20261,1335,3,27,114,58,5,6,210,1,11,222
20,4,20266,1352,3,9,45,42,2,0,98,0,3,101
20,4,20274,1368,3,23,196,157,5,3,384,0,46,430
20,4,20274,1370,3,18,60,134,5,1,218,1,9,228
20,4,20278,1398,3,44,73,148,2,3,270,4,6,280
20,4,20278,1399,3,50,56,184,3,0,293,4,19,316
20,4,20282,1407,3,46,210,224,4,4,488,5,58,551
20,4,20286,1416,3,33,92,58,2,0,185,0,7,192
20,4,20294,1437,3,48,102,249,9,6,414,2,21,437
20,4,20296,1440,3,154,142,315,16,22,649,2,12,663
20,4,20296,1442,3,234,201,201,20,22,678,1,31,710
20,4,20296,1443,3,155,164,251,14,16,600,0,12,612
20,4,20296,1446,3,31,79,146,3,1,260,0,9,269
20,4,20296,1447,3,132,160,33,2,4,331,0,19,350
20,4,20299,1452,3,57,66,98,3,5,229,0,12,241
20,4,20301,1458,3,275,47,217,10,10,559,0,12,571
20,4,20313,1494,3,134,151,162,13,12,472,2,33,507
20,4,20321,1515,3,53,249,81,4,7,394,0,9,403
20,4,20323,1535,3,30,305,100,1,1,437,1,24,462
20,4,20323,1538,3,83,119,236,24,6,468,0,34,502
20,4,20323,1539,3,97,115,328,12,5,557,0,33,590
20,4,20333,1585,3,62,119,147,4,8,340,8,46,394
20,4,20333,1586,3,48,225,195,4,8,480,1,41,522
20,4,20333,1587,3,69,134,65,0,1,269,0,11,280
20,4,20336,1601,3,8,94,126,1,1,230,1,14,245
20,4,20337,1602,3,120,100,308,20,13,561,5,57,623
20,4,20337,1603,3,16,12,26,1,2,57,0,4,61
20,4,20340,1606,3,174,186,182,10,12,564,0,17,581
20,4,20346,1626,3,109,295,205,9,8,626,6,38,670
20,4,20356,1644,3,69,84,96,8,6,263,0,3,266
20,4,20359,1649,3,30,91,170,5,10,306,0,52,358
20,4,20360,1650,3,118,279,230,14,10,651,3,34,688
20,4,20360,1651,3,81,196,188,14,11,490,2,38,530
20,4,20363,1654,3,83,134,166,6,7,396,0,14,410
20,4,20363,1655,3,49,85,99,4,3,240,0,4,244
20,4,20365,1665,3,24,53,38,3,4,122,0,6,128
20,4,20365,1666,3,48,117,141,6,9,321,0,20,341
20,4,20365,1667,3,34,60,95,7,5,201,2,1,204
20,4,20368,1673,3,72,107,97,10,3,289,0,13,302
20,4,20368,1674,3,91,73,111,7,1,283,2,21,306
20,4,20381,1703,3,75,172,259,12,11,529,1,9,539
20,4,20390,1742,3,28,93,61,5,1,188,0,28,216
20,4,20395,1776,3,119,457,146,16,9,747,5,50,802
20,4,20397,1778,3,30,104,221,3,6,364,0,41,405
20,4,20397,1779,3,32,80,216,2,1,331,17,17,365
20,4,20410,1829,3,217,194,360,31,42,844,0,18,862
20,4,20410,1830,3,114,177,254,34,30,609,6,15,630
20,4,20410,1831,3,173,166,383,42,32,796,0,7,803
20,4,20412,1838,3,31,105,93,5,11,245,0,7,252
20,4,20420,1873,3,50,27,106,5,5,193,1,9,203
20,4,20433,1907,3,42,73,132,0,2,249,0,22,271
20,4,20436,1911,3,59,135,126,8,8,336,10,32,378
20,4,20438,1914,3,58,26,216,22,13,335,2,28,365
20,4,20438,1915,3,130,137,320,28,28,643,8,41,692
20,4,20443,1933,3,31,44,95,2,1,173,0,8,181
20,4,20444,1934,3,24,69,84,18,1,196,0,13,209
20,4,20453,1962,3,109,77,49,5,4,244,0,22,266
20,4,20453,1963,3,172,102,130,16,14,434,5,27,466
20,4,20455,1969,3,38,137,120,1,3,299,2,25,326
20,4,20455,1970,3,27,18,76,1,2,124,3,11,138
20,4,20458,1976,3,55,121,225,3,4,408,0,3,411
20,4,20461,1991,3,84,105,218,6,9,422,0,28,450
20,4,20472,2056,3,22,51,170,0,5,248,3,14,265
20,4,20474,2060,3,19,58,61,1,1,140,0,15,155
20,4,20476,2065,3,125,121,122,11,5,384,1,21,406
20,4,20476,2066,3,105,98,80,7,4,294,0,25,319
20,4,20476,2067,3,129,152,73,8,4,366,0,13,379
20,4,20497,2148,3,67,126,127,2,3,325,2,14,341
20,4,20503,2167,3,39,87,120,2,1,249,2,24,275
20,4,20503,2170,3,81,71,123,3,2,280,0,42,322
20,4,20504,2171,3,35,40,121,3,4,203,1,8,212
20,4,20514,2199,3,18,117,23,0,1,159,0,0,159
20,4,20517,2231,3,79,231,141,7,7,465,6,32,503
20,4,20519,2235,3,141,85,174,13,13,426,0,24,450
20,4,20522,2245,3,22,144,97,1,4,268,0,18,286
20,4,20526,2258,3,65,51,87,4,7,214,0,6,220
20,4,20526,2259,3,52,56,67,11,4,190,1,5,196
20,4,20540,2311,3,61,35,343,14,17,470,2,9,481
20,4,20540,2314,3,52,126,119,8,4,309,5,30,344
20,4,20540,2315,3,17,21,83,2,5,128,3,6,137
20,4,20544,2324,3,98,199,162,7,8,474,3,9,486
20,4,20546,2331,3,210,63,307,19,25,624,1,11,636
20,4,20546,2334,3,73,55,161,11,2,302,1,10,313
20,4,20550,2352,3,180,252,519,38,23,1012,2,27,1041
20,4,20550,2354,3,206,254,326,45,27,858,5,29,892
20,4,20550,2355,3,193,174,415,28,24,834,1,26,861
20,4,20550,2358,3,128,197,336,18,28,707,3,22,732
20,4,20550,2359,3,35,91,110,2,7,245,0,7,252
20,4,20552,2363,3,147,107,249,17,22,542,4,12,558
20,4,20552,2366,3,195,113,220,22,24,574,1,10,585
20,4,20554,2386,3,119,106,83,3,5,316,2,21,339
20,4,20554,2387,3,140,106,87,6,5,344,0,12,356
20,4,20554,2390,3,16,16,60,0,1,93,0,6,99
20,4,20559,2407,3,103,102,293,9,11,518,0,11,529
20,4,20561,2412,3,116,118,162,16,7,419,0,22,441
20,4,20561,2414,3,91,193,47,1,3,335,0,16,351
20,4,20561,2415,3,118,173,77,5,4,377,0,12,389
20,4,20562,2418,3,25,144,126,4,0,299,0,20,319
20,5,20006,43,3,11,217,249,3,2,482,2,5,489
20,5,20006,46,3,12,197,378,7,5,599,0,10,609
20,5,20006,47,3,49,218,558,4,6,835,1,14,850
20,5,20006,50,3,43,274,142,2,0,461,3,21,485
20,5,20006,51,3,9,290,344,0,2,645,0,26,671
20,5,20006,54,3,66,198,258,5,2,529,0,21,550
20,5,20006,55,3,11,73,79,0,1,164,0,5,169
20,5,20009,68,3,4,172,160,0,1,337,0,3,340
20,5,20012,77,3,280,262,300,12,16,870,1,8,879
20,5,20012,78,3,212,225,181,6,0,624,2,1,627
20,5,20012,79,3,238,286,310,14,18,866,0,19,885
20,5,20012,82,3,138,188,191,7,2,526,3,25,554
20,5,20012,83,3,106,151,146,6,2,411,1,11,423
20,5,20012,86,3,33,292,329,6,4,664,4,17,685
20,5,20035,194,3,72,291,178,0,0,541,2,12,555
20,5,20035,195,3,42,322,228,3,2,597,0,12,609
20,5,20041,258,3,129,473,363,14,8,987,7,32,1026
20,5,20041,259,3,65,304,290,26,11,696,5,16,717
20,5,20041,262,3,127,252,300,8,2,689,2,15,706
20,5,20041,263,3,66,228,258,12,4,568,2,23,593
20,5,20041,266,3,51,196,162,7,10,426,2,6,434
20,5,20041,267,3,65,216,233,10,4,528,1,7,536
20,5,20041,270,3,88,292,401,16,12,809,4,16,829
20,5,20041,271,3,91,223,272,15,10,611,3,20,634
20,5,20041,274,3,107,266,412,9,11,805,7,35,847
20,5,20041,275,3,6,30,18,0,0,54,0,2,56
20,5,20051,380,3,14,200,355,17,3,589,2,23,614
20,5,20051,382,3,32,258,546,65,9,910,0,27,937
20,5,20051,383,3,8,7,59,1,0,75,1,2,78
20,5,20052,386,3,5,336,255,0,5,601,1,5,607
20,5,20076,669,3,219,478,675,18,9,1399,6,32,1437
20,5,20076,670,3,210,257,606,15,10,1098,4,18,1120
20,5,20076,671,3,132,174,373,8,10,697,2,10,709
20,5,20076,674,3,150,239,401,16,10,816,0,17,833
20,5,20076,675,3,163,191,402,5,12,773,3,9,785
20,5,20076,678,3,161,266,369,13,9,818,6,15,839
20,5,20076,679,3,152,406,692,9,9,1268,9,20,1297
20,5,20076,682,3,82,218,405,6,8,719,2,23,744
20,5,20076,683,3,98,234,456,15,6,809,5,22,836
20,5,20076,686,3,109,289,556,14,6,974,2,19,995
20,5,20076,687,3,96,216,507,17,11,847,7,25,879
20,5,20076,690,3,69,134,208,4,1,416,1,8,425
20,5,20076,691,3,119,178,373,13,10,693,0,19,712
20,5,20076,694,3,92,191,452,5,10,750,2,8,760
20,5,20076,695,3,82,194,344,7,6,633,0,13,646
20,5,20076,698,3,44,87,121,11,7,270,1,7,278
20,5,20076,699,3,79,199,378,12,7,675,0,14,689
20,5,20076,702,3,88,262,307,8,6,671,0,10,681
20,5,20076,703,3,120,318,427,15,11,891,4,13,908
20,5,20076,706,3,50,106,178,1,1,336,0,5,341
20,5,20076,707,3,52,246,135,7,2,442,1,9,452
20,5,20121,814,3,14,759,370,3,2,1148,2,18,1168
20,5,20121,815,3,22,852,523,2,4,1403,1,29,1433
20,5,20121,818,3,50,1007,561,4,3,1625,1,76,1702
20,5,20121,819,3,10,1093,425,12,0,1540,2,2,1544
20,5,20247,1297,3,62,423,309,7,9,810,5,57,872
20,5,20247,1298,3,51,361,210,6,10,638,1,38,677
20,5,20247,1299,3,40,463,157,7,3,670,5,43,718
20,5,20280,1402,3,34,215,52,1,1,303,0,10,313
20,5,20280,1403,3,2,35,1,0,0,38,0,1,39
20,5,20303,1461,3,16,384,836,6,4,1246,1,16,1263
20,5,20303,1462,3,13,449,406,9,3,880,0,20,900
20,5,20305,1465,3,35,223,240,2,3,503,1,23,527
20,5,20305,1466,3,35,256,226,1,2,520,1,20,541
20,5,20305,1467,3,19,60,25,0,0,104,0,2,106
20,5,20305,1470,3,29,525,451,6,3,1014,1,28,1043
20,5,20305,1471,3,35,354,302,1,4,696,0,24,720
20,5,20413,1839,3,50,455,214,4,0,723,0,39,762
20,5,20419,1866,3,28,344,454,11,1,838,4,5,847
20,5,20419,1867,3,23,269,444,14,0,750,1,7,758
20,5,20419,1870,3,42,408,413,26,3,892,1,13,906
20,5,20419,1871,3,15,172,96,14,1,298,0,0,298
20,5,20422,1875,3,3,270,277,3,2,555,0,12,567
20,5,20441,1928,3,15,220,194,6,5,440,3,15,458
20,5,20442,1930,3,39,379,277,1,1,697,0,0,697
20,5,20442,1931,3,23,248,326,0,2,599,0,1,600
20,5,20454,1965,3,10,212,281,2,1,506,1,10,517
20,5,20454,1966,3,12,205,279,3,0,499,1,10,510
20,5,20454,1967,3,3,52,72,0,1,128,0,5,133
20,5,20466,2004,3,68,283,67,1,2,421,0,32,453
20,5,20471,2050,3,58,243,86,3,2,392,2,16,410
20,5,20471,2051,3,33,224,64,1,0,322,0,13,335
20,5,20515,2054,3,27,244,99,5,0,375,0,19,394
20,5,20471,2055,3,6,36,14,0,0,56,0,0,56
20,5,20473,2058,3,10,428,339,6,4,787,0,6,793
20,5,20473,2059,3,3,119,54,2,2,180,0,3,183
20,5,20507,2175,3,24,430,401,5,5,865,1,10,876
20,5,20513,2190,3,6,226,218,0,0,450,0,5,455
20,5,20513,2191,3,11,247,351,1,0,610,0,4,614
20,5,20513,2194,3,2,220,193,1,3,419,0,4,423
20,5,20513,2195,3,0,188,187,0,0,375,0,0,375
20,5,20513,2198,3,1,77,70,0,0,148,0,4,152
20,5,20515,2200,3,122,248,379,13,15,777,3,40,820
20,5,20515,2202,3,77,410,439,10,8,944,3,16,963
20,5,20515,2203,3,89,237,263,7,7,603,3,12,618
20,5,20515,2206,3,84,226,372,10,6,698,1,21,720
20,5,20515,2207,3,119,572,417,18,15,1141,10,38,1189
20,5,20515,2210,3,109,384,500,8,12,1013,1,18,1032
20,5,20515,2211,3,22,104,156,3,3,288,0,7,295
20,5,20515,2214,3,154,280,448,21,14,917,2,23,942
20,5,20515,2215,3,148,325,560,19,6,1058,0,16,1074
20,5,20515,2218,3,199,466,446,19,8,1138,2,38,1178
20,5,20515,2219,3,170,406,659,31,9,1275,4,15,1294
20,5,20515,2222,3,26,274,224,3,2,529,0,7,536
20,5,20515,2223,3,27,157,93,0,1,278,1,21,300
20,5,20515,2226,3,108,452,312,1,4,877,0,13,890
20,5,20515,2227,3,26,377,290,0,2,695,2,15,712
20,6,20013,87,3,20,86,94,4,3,207,0,8,215
20,6,20016,104,3,29,204,217,3,4,457,3,20,480
20,6,20016,106,3,19,136,191,7,7,360,0,19,379
20,6,20016,107,3,25,187,238,7,5,462,0,23,485
20,6,20016,110,3,90,197,132,3,2,424,3,34,461
20,6,20019,117,3,33,146,131,4,6,320,0,39,359
20,6,20019,118,3,2,4,84,0,0,90,0,2,92
20,6,20019,119,3,6,48,328,9,4,395,3,26,424
20,6,20023,131,3,37,156,129,15,4,341,1,23,365
20,6,20031,187,3,2,114,62,0,1,179,0,8,187
20,6,20032,190,3,21,61,87,0,0,169,0,4,173
20,6,20032,191,3,11,89,104,2,1,207,0,2,209
20,6,20036,198,3,97,251,321,7,8,684,1,36,721
20,6,20036,199,3,0,25,14,0,0,39,1,5,45
20,6,20040,255,3,20,138,159,2,7,326,3,20,349
20,6,20049,375,3,30,45,251,6,6,338,0,21,359
20,6,20055,389,3,28,206,205,2,3,444,0,14,458
20,6,20055,390,3,11,83,93,1,4,192,0,6,198
20,6,20055,391,3,18,95,100,3,0,216,0,7,223
20,6,20055,394,3,3,85,29,0,1,118,0,4,122
20,6,20055,395,3,6,41,46,1,0,94,0,10,104
20,6,20071,643,3,78,210,541,28,15,872,7,19,898
20,6,20071,646,3,67,233,753,15,11,1079,4,24,1107
20,6,20071,647,3,84,144,512,22,7,769,0,15,784
20,6,20071,650,3,27,163,295,1,5,491,4,11,506
20,6,20071,651,3,10,113,114,2,3,242,3,19,264
20,6,20071,654,3,37,306,218,13,8,582,0,27,609
20,6,20071,655,3,57,181,246,8,5,497,0,19,516
20,6,20071,658,3,7,87,93,0,0,187,0,11,198
20,6,20071,659,3,26,279,268,5,3,581,2,15,598
20,6,20078,712,3,17,242,231,2,6,498,1,19,518
20,6,20083,734,3,10,21,78,2,3,114,0,10,124
20,6,20083,735,3,20,24,116,3,4,167,0,6,173
20,6,20085,738,3,32,331,42,0,0,405,1,13,419
20,6,20085,739,3,36,21,96,1,0,154,0,7,161
20,6,20096,761,3,13,121,13,1,1,149,2,5,156
20,6,20102,772,3,41,350,188,8,6,593,7,71,671
20,6,20102,774,3,1,665,5,0,1,672,0,45,717
20,6,20102,775,3,14,331,33,3,4,385,0,38,423
20,6,20107,789,3,20,242,83,4,1,350,5,41,396
20,6,20124,835,3,19,59,201,1,2,282,0,19,301
20,6,20130,847,3,18,49,292,3,4,366,1,18,385
20,6,20130,850,3,2,17,245,0,3,267,0,23,290
20,6,20149,907,3,47,126,215,5,4,397,4,52,453
20,6,20162,938,3,28,133,168,3,2,334,0,27,361
20,6,20162,939,3,7,17,89,2,4,119,0,23,142
20,6,20180,1007,3,102,121,44,6,3,276,0,16,292
20,6,20188,1110,3,39,118,50,1,0,208,1,9,218
20,6,20200,1162,3,88,68,9,2,0,167,0,5,172
20,6,20200,1163,3,32,63,2,0,0,97,0,3,100
20,6,20208,1193,3,8,73,71,5,2,159,0,8,167
20,6,20208,1194,3,17,73,124,2,6,222,2,13,237
20,6,20208,1195,3,26,141,203,5,5,380,0,23,403
20,6,20208,1198,3,3,181,60,3,0,247,0,14,261
20,6,20208,1199,3,15,81,267,2,3,368,0,23,391
20,6,20208,1202,3,12,14,243,3,1,273,5,14,292
20,6,20208,1203,3,7,138,76,1,2,224,0,12,236
20,6,20210,1206,3,18,495,67,0,1,581,2,34,617
20,6,20210,1207,3,13,79,151,5,3,251,0,16,267
20,6,20218,1225,3,3,160,38,0,0,201,0,5,206
20,6,20230,1251,3,18,103,46,0,2,169,1,5,175
20,6,20237,1278,3,35,84,106,5,2,232,1,7,240
20,6,20237,1279,3,17,58,85,2,2,164,0,4,168
20,6,20240,1284,3,11,128,423,4,5,571,0,61,632
20,6,20242,1286,3,92,80,211,9,5,397,9,51,457
20,6,20242,1287,3,100,73,261,10,9,453,9,30,492
20,6,20242,1290,3,33,130,143,6,5,317,6,65,388
20,6,20245,1294,3,16,211,142,1,0,370,0,9,379
20,6,20245,1295,3,2,90,99,0,0,191,0,12,203
20,6,20249,1303,3,95,84,45,7,4,235,0,46,281
20,6,20258,1320,3,235,279,15,0,1,530,2,11,543
20,6,20268,1354,3,9,78,140,2,7,236,0,7,243
20,6,20268,1355,3,17,90,168,0,3,278,0,24,302
20,6,20268,1358,3,5,24,203,2,2,236,0,7,243
20,6,20284,1411,3,50,96,194,2,3,345,1,24,370
20,6,20284,1414,3,41,36,52,1,2,132,0,12,144
20,6,20288,1418,3,8,144,226,0,1,379,0,9,388
20,6,20295,1438,3,25,73,60,7,2,167,1,27,195
20,6,20295,1439,3,14,94,67,3,1,179,0,32,211
20,6,20318,1512,3,24,50,161,3,4,242,0,15,257
20,6,20343,1613,3,64,169,180,4,1,418,2,24,444
20,6,20345,1617,3,112,135,222,3,6,478,12,16,506
20,6,20345,1618,3,95,91,211,5,10,412,6,6,424
20,6,20345,1619,3,48,69,138,1,5,261,4,20,285
20,6,20345,1622,3,10,24,45,2,1,82,0,2,84
20,6,20345,1623,3,7,17,69,3,0,96,0,0,96
20,6,20349,1636,3,21,526,60,8,2,617,10,82,709
20,6,20372,1678,3,17,39,86,3,2,147,0,7,154
20,6,20372,1679,3,24,55,137,3,3,222,0,17,239
20,6,20373,1682,3,8,19,127,4,2,160,2,25,187
20,6,20377,1690,3,8,91,35,1,2,137,0,13,150
20,6,20378,1691,3,17,240,191,2,5,455,2,17,474
20,6,20378,1694,3,31,360,183,2,3,579,0,25,604
20,6,20378,1695,3,25,127,165,2,1,320,3,23,346
20,6,20378,1698,3,25,177,322,8,8,540,0,30,570
20,6,20380,1702,3,52,172,414,7,8,653,3,56,712
20,6,20382,1704,3,57,201,231,2,3,494,0,8,502
20,6,20382,1706,3,1,61,120,1,1,184,0,3,187
20,6,20383,1707,3,10,149,226,2,6,393,6,21,420
20,6,20394,1771,3,35,64,126,5,2,232,0,17,249
20,6,20394,1774,3,20,43,381,7,0,451,1,33,485
20,6,20394,1775,3,15,29,255,6,5,310,3,55,368
20,6,20445,1935,3,22,29,82,0,0,133,0,4,137
20,6,20447,1938,3,100,164,321,15,20,620,2,63,685
20,6,20447,1939,3,80,71,318,7,19,495,1,46,542
20,6,20448,1942,3,25,213,398,7,4,647,3,26,676
20,6,20448,1943,3,8,119,296,6,1,430,0,19,449
20,6,20448,1946,3,32,104,244,5,3,388,0,25,413
20,6,20448,1947,3,43,68,245,5,4,365,1,34,400
20,6,20451,1955,3,69,481,273,13,14,850,1,55,906
20,6,20451,1958,3,27,65,67,7,2,168,2,22,192
20,6,20451,1959,3,11,12,75,0,2,100,0,11,111
20,6,20457,1973,3,125,139,17,1,0,282,0,8,290
20,6,20457,1974,3,99,81,11,1,3,195,1,4,200
20,6,20457,1975,3,27,200,2,0,1,230,0,0,230
20,6,20462,1993,3,7,50,145,2,0,204,0,8,212
20,6,20462,1994,3,7,11,32,1,0,51,0,4,55
20,6,20470,2033,3,130,204,345,20,24,723,3,27,753
20,6,20470,2034,3,143,237,347,13,19,759,14,37,810
20,6,20470,2035,3,100,137,455,8,24,724,12,47,783
20,6,20470,2038,3,26,38,79,2,3,148,4,17,169
20,6,20470,2039,3,99,138,111,10,10,368,1,39,408
20,6,20470,2042,3,29,386,265,8,2,690,2,56,748
20,6,20470,2043,3,41,391,62,6,7,507,13,81,601
20,6,20470,2046,3,0,0,0,0,0,0,0,0,0
20,6,20470,2047,3,10,298,21,1,0,330,0,8,338
20,6,20482,2084,3,9,97,64,0,2,172,1,11,184
20,6,20483,2086,3,31,37,165,2,8,243,0,27,270
20,6,20483,2087,3,38,54,237,6,10,345,0,35,380
20,6,20486,2117,3,64,144,102,2,2,314,0,18,332
20,6,20486,2118,3,70,187,39,7,4,307,5,26,338
20,6,20486,2119,3,60,122,31,3,2,218,0,5,223
20,6,20486,2122,3,12,115,106,0,0,233,0,20,253
20,6,20501,2158,3,42,164,314,12,10,542,1,18,561
20,6,20501,2159,3,41,136,122,6,5,310,0,16,326
20,6,20501,2162,3,42,124,163,2,3,334,0,40,374
20,6,20501,2163,3,14,101,126,5,5,251,0,16,267
20,6,20502,2166,3,14,40,78,4,4,140,0,8,148
20,6,20510,2185,3,11,405,62,1,3,482,0,8,490
20,6,20520,2237,3,40,75,156,3,7,281,0,7,288
20,6,20520,2238,3,44,125,150,14,5,338,0,39,377
20,6,20520,2239,3,25,110,174,9,6,324,0,38,362
20,6,20520,2242,3,11,31,376,0,2,420,0,18,438
20,6,20520,2243,3,16,78,356,0,3,453,0,6,459
20,6,20528,2262,3,39,74,310,10,11,444,1,34,479
20,6,20528,2263,3,17,47,179,5,5,253,2,13,268
20,6,20532,2273,3,16,25,406,1,3,451,0,1,452
20,6,20533,2274,3,24,120,62,3,1,210,2,33,245
20,6,20534,2275,3,29,274,333,2,6,644,0,17,661
20,6,20534,2278,3,36,42,97,1,1,177,0,6,183
20,6,20534,2279,3,13,35,89,1,1,139,0,0,139
20,6,20534,2282,3,19,44,28,1,1,93,0,4,97
20,6,20534,2283,3,5,63,13,0,1,82,1,11,94
20,6,20534,2286,3,2,12,53,0,2,69,0,1,70
20,6,20534,2287,3,6,32,29,0,0,67,0,5,72
20,6,20549,2339,3,179,255,202,18,5,659,0,26,685
20,6,20549,2342,3,51,43,54,4,4,156,0,0,156
20,6,20549,2343,3,68,83,82,2,4,239,1,8,248
20,6,20549,2346,3,34,146,326,4,8,518,0,58,576
20,6,20549,2347,3,21,63,11,0,1,96,0,8,104
20,6,20549,2350,3,10,46,95,3,0,154,3,7,164
20,6,20549,2351,3,7,64,115,2,3,191,6,24,221
20,6,20553,2367,3,103,395,835,18,31,1382,2,40,1424
20,6,20553,2370,3,55,95,336,10,6,502,0,7,509
20,6,20553,2371,3,53,208,496,15,11,783,0,22,805
20,6,20553,2374,3,79,268,587,13,16,963,1,32,996
20,6,20553,2375,3,80,281,639,9,13,1022,0,34,1056
20,6,20553,2378,3,2,46,34,0,0,82,0,2,84
20,6,20553,2379,3,13,50,158,1,2,224,0,16,240
20,6,20553,2382,3,19,80,346,5,2,452,3,48,503
20,6,20553,2383,3,19,39,285,3,4,350,3,17,370
20,6,20568,2432,3,137,129,69,1,5,341,0,26,367
20,6,20568,2434,3,35,136,18,1,2,192,3,12,207
20,6,20553,2452,3,28,72,34,1,3,138,0,7,145
20,7,20015,97,3,83,146,145,3,2,379,0,11,390
20,7,20015,98,3,106,194,182,5,0,487,0,10,497
20,7,20015,99,3,131,187,191,0,1,510,0,10,520
20,7,20015,102,3,209,235,254,2,3,703,0,15,718
20,7,20015,103,3,141,161,140,0,3,445,1,14,460
20,7,20030,180,3,12,313,265,11,3,604,0,11,615
20,7,20030,182,3,14,341,231,4,2,592,0,15,607
20,7,20030,183,3,19,345,265,7,9,645,0,14,659
20,7,20030,186,3,30,342,254,2,0,628,0,14,642
20,7,20043,283,3,75,342,182,9,8,616,0,11,627
20,7,20043,286,3,32,359,297,4,4,696,1,13,710
20,7,20043,287,3,37,357,345,7,4,750,1,7,758
20,7,20043,290,3,27,265,935,7,1,1235,3,15,1253
20,7,20043,291,3,50,334,489,4,8,885,3,14,902
20,7,20043,294,3,72,653,614,12,6,1357,2,19,1378
20,7,20043,295,3,18,143,217,7,7,392,1,14,407
20,7,20043,298,3,10,253,175,4,1,443,0,5,448
20,7,20043,299,3,18,331,349,11,2,711,1,15,727
20,7,20043,302,3,49,411,270,6,2,738,1,11,750
20,7,20043,303,3,17,245,348,9,3,622,0,9,631
20,7,20043,306,3,21,296,294,4,2,617,1,9,627
20,7,20043,307,3,21,253,400,4,7,685,0,9,694
20,7,20043,310,3,13,291,560,9,2,875,1,19,895
20,7,20043,311,3,27,251,464,2,6,750,1,2,753
20,7,20043,314,3,14,178,471,1,1,665,0,4,669
20,7,20043,315,3,11,181,418,4,3,617,1,6,624
20,7,20043,318,3,34,227,412,9,1,683,0,9,692
20,7,20043,319,3,49,260,513,1,1,824,0,15,839
20,7,20043,322,3,24,228,416,1,2,671,1,8,680
20,7,20043,323,3,10,267,243,1,3,524,0,3,527
20,7,20043,326,3,17,495,378,3,2,895,0,13,908
20,7,20043,327,3,3,208,254,1,0,466,0,9,475
20,7,20043,330,3,4,359,546,0,1,910,0,10,920
20,7,20043,331,3,0,234,477,0,0,711,0,4,715
20,7,20057,397,3,300,325,256,9,13,903,1,24,928
20,7,20057,398,3,183,141,171,10,3,508,0,16,524
20,7,20057,399,3,273,193,151,10,2,629,5,16,650
20,7,20057,402,3,294,201,238,9,4,746,5,7,758
20,7,20057,403,3,275,135,211,41,4,666,1,17,684
20,7,20057,406,3,301,208,183,13,8,713,3,9,725
20,7,20057,407,3,257,429,230,20,5,941,0,21,962
20,7,20057,410,3,119,516,134,13,4,786,0,35,821
20,7,20057,411,3,80,208,93,5,7,393,1,15,409
20,7,20057,414,3,145,139,143,18,3,448,6,25,479
20,7,20057,415,3,351,383,103,11,5,853,2,30,885
20,7,20057,418,3,44,47,16,1,2,110,3,5,118
20,7,20057,419,3,79,119,64,1,1,264,0,5,269
20,7,20072,661,3,48,259,247,5,2,561,1,13,575
20,7,20072,662,3,50,316,271,6,4,647,0,14,661
20,7,20127,838,3,5,480,417,1,0,903,0,15,918
20,7,20127,839,3,1,343,272,0,0,616,0,3,619
20,7,20138,877,3,14,399,367,3,5,788,0,2,790
20,7,20138,878,3,13,449,224,2,1,689,0,4,693
20,7,20138,879,3,4,158,164,0,0,326,0,3,329
20,7,20140,883,3,27,291,307,5,2,632,0,8,640
20,7,20140,886,3,32,259,257,1,3,552,0,7,559
20,7,20140,887,3,59,316,224,1,1,601,2,20,623
20,7,20140,890,3,5,33,18,0,0,56,0,0,56
20,7,20192,1120,3,98,430,163,17,9,717,3,14,734
20,7,20192,1122,3,122,451,227,18,7,825,0,21,846
20,7,20192,1123,3,71,282,482,3,4,842,3,31,876
20,7,20192,1126,3,86,83,234,3,6,412,0,18,430
20,7,20192,1127,3,79,285,353,4,7,728,7,20,755
20,7,20199,1139,3,27,243,319,14,4,607,0,14,621
20,7,20199,1142,3,8,468,469,1,1,947,0,4,951
20,7,20199,1143,3,23,182,71,2,1,279,0,8,287
20,7,20199,1146,3,29,53,189,3,5,279,1,17,297
20,7,20199,1147,3,23,169,209,1,2,404,1,29,434
20,7,20199,1150,3,37,152,272,5,2,468,2,14,484
20,7,20199,1151,3,5,354,277,1,0,637,0,28,665
20,7,20199,1154,3,5,327,275,0,4,611,0,9,620
20,7,20199,1155,3,1,306,332,0,1,640,0,0,640
20,7,20199,1158,3,21,312,403,3,5,744,0,25,769
20,7,20199,1159,3,14,288,256,0,0,558,0,14,572
20,7,20206,1177,3,41,572,94,1,4,712,3,31,746
20,7,20206,1178,3,111,434,339,3,3,890,3,28,921
20,7,20206,1179,3,39,472,459,2,3,975,0,34,1009
20,7,20206,1182,3,44,284,902,1,2,1233,0,28,1261
20,7,20206,1183,3,142,762,259,1,6,1170,0,49,1219
20,7,20207,1186,3,190,245,196,8,16,655,4,37,696
20,7,20207,1187,3,74,285,178,4,4,545,2,41,588
20,7,20207,1190,3,3,352,94,0,0,449,0,4,453
20,7,20207,1191,3,18,121,63,0,1,203,0,31,234
20,7,20263,1338,3,31,225,249,2,5,512,0,22,534
20,7,20263,1339,3,13,155,179,4,2,353,0,7,360
20,7,20263,1342,3,0,110,106,0,0,216,0,0,216
20,7,20263,1343,3,13,359,146,3,0,521,0,12,533
20,7,20325,1544,3,95,346,147,5,6,599,0,10,609
20,7,20325,1546,3,96,305,112,3,3,519,0,3,522
20,7,20325,1547,3,76,218,125,2,1,422,1,16,439
20,7,20325,1550,3,165,322,245,4,5,741,2,23,766
20,7,20325,1551,3,27,73,11,0,0,111,0,2,113
20,7,20405,1810,3,97,283,395,10,7,792,8,73,873
20,7,20405,1811,3,83,105,113,1,2,304,2,4,310
20,7,20405,1814,3,11,39,12,0,0,62,0,0,62
20,7,20405,1815,3,70,221,61,2,3,357,0,32,389
20,7,20427,1888,3,28,220,201,2,3,454,0,5,459
20,7,20427,1890,3,118,302,217,6,2,645,2,12,659
20,7,20427,1891,3,162,273,229,12,9,685,8,14,707
20,7,20427,1894,3,104,359,249,14,4,730,4,18,752
20,7,20427,1895,3,38,371,194,0,1,604,1,10,615
20,7,20460,1987,3,96,188,86,0,3,373,1,28,402
20,7,20460,1990,3,9,212,96,0,0,317,2,8,327
20,7,20481,2077,3,14,104,173,0,2,293,0,9,302
20,7,20481,2078,3,21,226,257,2,3,509,1,7,517
20,7,20481,2079,3,16,350,201,3,1,571,2,5,578
20,7,20481,2082,3,5,52,66,0,0,123,1,15,139
20,7,20481,2083,3,32,130,93,0,0,255,0,17,272
20,7,20499,2151,3,39,166,116,3,2,326,1,14,341
20,7,20499,2154,3,102,108,57,3,3,273,3,31,307
20,7,20499,2155,3,38,214,71,3,4,330,5,44,379
20,7,20509,2180,3,28,416,137,3,0,584,0,11,595
20,7,20509,2182,3,83,523,325,5,7,943,3,2,948
20,7,20509,2183,3,43,256,175,5,3,482,0,8,490
20,7,20525,2249,3,26,389,277,4,1,697,0,17,714
20,7,20525,2250,3,20,358,344,3,1,726,0,9,735
20,7,20525,2251,3,26,312,234,2,0,574,0,4,578
20,7,20525,2254,3,2,253,78,3,1,337,2,0,339
20,7,20525,2255,3,4,165,194,1,0,364,0,5,369
20,7,20557,2394,3,51,171,256,5,3,486,2,25,513
20,7,20557,2395,3,48,172,271,3,3,497,0,1,498
20,7,20557,2398,3,62,142,300,0,1,505,2,4,511
20,7,20557,2399,3,35,108,302,2,2,449,0,7,456
20,7,20557,2402,3,38,253,363,1,0,655,0,12,667
20,7,20557,2403,3,21,192,359,10,1,583,1,5,589
20,8,20386,37,3,149,199,390,47,43,828,2,11,841
20,8,20386,38,3,121,123,309,13,19,585,1,9,595
20,8,20066,470,3,596,447,1379,88,66,2576,17,45,2638
20,8,20066,471,3,530,589,1193,88,59,2459,6,41,2506
20,8,20066,474,3,198,188,499,34,24,943,2,33,978
20,8,20066,475,3,164,189,462,48,21,884,2,31,917
20,8,20066,478,3,224,338,581,47,41,1231,19,6,1256
20,8,20066,479,3,186,164,490,58,42,940,1,20,961
20,8,20066,482,3,545,634,916,62,64,2221,10,40,2271
20,8,20066,483,3,273,181,478,30,34,996,3,11,1010
20,8,20066,486,3,191,145,355,38,23,752,2,10,764
20,8,20066,487,3,178,245,401,41,30,895,4,26,925
20,8,20066,490,3,236,215,433,33,27,944,1,15,960
20,8,20066,491,3,204,161,483,22,19,889,1,9,899
20,8,20066,494,3,170,215,496,46,27,954,1,21,976
20,8,20066,495,3,235,227,503,39,27,1031,2,22,1055
20,8,20066,498,3,332,244,345,60,39,1020,6,12,1038
20,8,20066,499,3,308,298,400,46,46,1098,7,25,1130
20,8,20066,502,3,275,268,557,59,30,1189,7,26,1222
20,8,20066,503,3,202,121,308,32,18,681,4,11,696
20,8,20066,506,3,168,119,353,30,29,699,1,11,711
20,8,20066,507,3,311,231,441,40,38,1061,2,15,1078
20,8,20066,510,3,314,269,456,53,54,1146,3,21,1170
20,8,20066,511,3,449,303,474,53,48,1327,3,16,1346
20,8,20066,514,3,291,208,431,35,21,986,1,13,1000
20,8,20066,515,3,148,153,304,43,17,665,2,9,676
20,8,20066,518,3,194,166,332,43,32,767,3,7,777
20,8,20066,519,3,296,219,398,55,28,996,1,20,1017
20,8,20066,522,3,163,128,367,22,17,697,3,10,710
20,8,20066,523,3,211,151,368,32,27,789,7,18,814
20,8,20066,526,3,121,118,283,41,24,587,3,18,608
20,8,20066,527,3,149,140,355,32,21,697,1,19,717
20,8,20066,530,3,240,163,385,31,30,849,2,4,855
20,8,20066,531,3,164,159,218,12,13,566,0,8,574
20,8,20066,534,3,339,225,282,39,33,918,3,19,940
20,8,20066,535,3,260,216,415,57,24,972,1,13,986
20,8,20066,538,3,165,147,411,29,25,777,0,8,785
20,8,20066,539,3,159,106,245,33,17,560,0,5,565
20,8,20066,542,3,125,99,344,37,23,628,7,9,644
20,8,20066,543,3,463,389,1070,88,87,2097,8,28,2133
20,8,20066,546,3,106,67,207,18,18,416,0,11,427
20,8,20066,547,3,293,176,414,33,43,959,2,9,970
20,8,20066,550,3,120,119,186,6,6,437,0,8,445
20,8,20066,551,3,257,198,265,39,31,790,2,18,810
20,8,20066,554,3,196,146,363,45,27,777,1,18,796
20,8,20066,555,3,359,142,292,31,22,846,5,8,859
20,8,20066,558,3,120,143,249,32,14,558,3,9,570
20,8,20066,559,3,216,130,472,34,32,884,5,17,906
20,8,20066,562,3,134,109,329,35,11,618,1,13,632
20,8,20066,563,3,140,94,316,20,10,580,4,14,598
20,8,20066,566,3,220,127,358,42,31,778,4,10,792
20,8,20066,567,3,144,97,232,26,11,510,5,7,522
20,8,20066,570,3,219,184,303,35,27,768,2,7,777
20,8,20066,571,3,174,138,207,25,30,574,0,7,581
20,8,20066,574,3,255,160,507,39,41,1002,1,20,1023
20,8,20066,575,3,156,143,315,27,23,664,0,12,676
20,8,20066,578,3,222,234,336,33,24,849,4,36,889
20,8,20066,579,3,168,142,331,43,11,695,6,21,722
20,8,20066,582,3,241,176,438,39,51,945,4,20,969
20,8,20066,583,3,391,319,728,55,49,1542,0,24,1566
20,8,20066,586,3,223,176,422,38,39,898,6,12,916
20,8,20066,587,3,194,186,428,41,31,880,0,11,891
20,8,20066,590,3,199,124,353,43,17,736,0,14,750
20,8,20066,591,3,220,100,329,37,25,711,6,14,731
20,8,20066,594,3,182,205,363,40,24,814,5,40,859
20,8,20066,595,3,163,155,275,36,26,655,6,13,674
20,8,20066,598,3,181,100,222,20,18,541,2,8,551
20,8,20066,599,3,164,118,244,39,41,606,1,22,629
20,8,20066,602,3,199,176,394,35,32,836,1,18,855
20,8,20066,603,3,213,138,166,21,14,552,2,4,558
20,8,20066,606,3,189,157,345,30,27,748,0,8,756
20,8,20066,607,3,219,88,361,33,27,728,1,11,740
20,8,20066,610,3,191,177,247,26,29,670,15,12,697
20,8,20066,611,3,152,137,381,9,19,698,6,18,722
20,8,20066,614,3,155,138,347,22,21,683,1,8,692
20,8,20066,615,3,127,139,199,21,16,502,2,8,512
20,8,20154,917,3,238,378,722,38,38,1414,1,22,1437
20,8,20154,918,3,290,244,646,51,52,1283,4,26,1313
20,8,20154,919,3,270,359,741,53,39,1462,4,12,1478
20,8,20339,1605,3,168,152,274,22,22,638,8,9,655
20,8,20386,1712,3,220,152,442,36,23,873,2,10,885
20,8,20386,1714,3,202,139,414,34,26,815,5,12,832
20,8,20386,1715,3,194,254,523,43,35,1049,14,16,1079
20,8,20386,1718,3,252,386,759,71,38,1506,5,49,1560
20,8,20386,1719,3,321,291,753,68,46,1479,6,43,1528
20,8,20386,1722,3,446,588,1333,90,81,2538,15,55,2608
20,8,20386,1723,3,169,217,520,38,27,971,2,39,1012
20,8,20386,1726,3,383,336,844,96,61,1720,14,35,1769
20,8,20386,1727,3,242,400,534,42,25,1243,15,45,1303
20,9,20003,35,3,113,214,267,24,19,637,0,17,654
20,9,20010,70,3,166,137,233,19,13,568,1,40,609
20,9,20010,71,3,127,60,179,20,6,392,1,18,411
20,9,20017,111,3,91,197,338,12,12,650,0,22,672
20,9,20018,114,3,147,75,88,0,1,311,0,27,338
20,9,20018,115,3,26,232,20,5,2,285,2,17,304
20,9,20020,121,3,29,329,63,2,2,425,1,28,454
20,9,20020,122,3,35,109,36,4,3,187,1,8,196
20,9,20020,123,3,72,225,83,2,4,386,0,20,406
20,9,20026,147,3,116,293,214,11,16,650,1,23,674
20,9,20026,150,3,115,257,332,22,18,744,1,19,764
20,9,20026,151,3,204,341,535,25,27,1132,4,39,1175
20,9,20028,157,3,376,377,232,55,9,1049,18,33,1100
20,9,20028,158,3,465,268,182,30,10,955,3,34,992
20,9,20028,159,3,283,154,109,11,7,564,1,17,582
20,9,20028,162,3,48,43,37,3,2,133,0,14,147
20,9,20028,163,3,27,56,27,0,2,112,0,6,118
20,9,20028,166,3,296,152,146,8,3,605,0,39,644
20,9,20028,167,3,111,132,69,3,3,318,0,16,334
20,9,20028,170,3,205,50,22,2,1,280,2,16,298
20,9,20028,171,3,83,16,3,0,0,102,0,3,105
20,9,20028,174,3,118,82,15,2,3,220,0,4,224
20,9,20028,175,3,83,157,14,0,1,255,1,14,270
20,9,20047,373,3,9,169,107,0,1,286,0,19,305
20,9,20048,374,3,33,225,195,0,8,461,0,15,476
20,9,20068,632,3,153,334,78,6,4,575,0,46,621
20,9,20077,710,3,67,105,198,0,3,373,0,23,396
20,9,20077,711,3,76,195,161,3,3,438,0,18,456
20,9,20080,717,3,283,349,454,40,40,1166,0,33,1199
20,9,20080,718,3,298,238,402,54,22,1014,4,17,1035
20,9,20098,763,3,15,155,34,6,3,213,0,30,243
20,9,20101,770,3,104,299,148,12,8,571,0,48,619
20,9,20101,771,3,19,52,55,5,2,133,0,1,134
20,9,20104,777,3,400,221,344,47,30,1042,8,47,1097
20,9,20104,778,3,365,326,465,49,27,1232,8,50,1290
20,9,20104,779,3,272,154,452,40,31,949,13,18,980
20,9,20105,782,3,9,20,238,0,0,267,0,25,292
20,9,20105,783,3,17,23,282,1,3,326,0,12,338
20,9,20105,786,3,22,11,152,1,2,188,0,4,192
20,9,20105,787,3,7,6,128,0,1,142,0,8,150
20,9,20112,798,3,188,108,268,23,16,603,6,12,621
20,9,20112,799,3,236,138,325,16,27,742,6,12,760
20,9,20120,812,3,28,192,110,8,4,342,2,27,371
20,9,20134,871,3,89,53,144,0,0,286,1,26,313
20,9,20146,899,3,95,152,119,4,6,376,0,38,414
20,9,20152,913,3,29,151,18,3,6,207,0,9,216
20,9,20155,920,3,53,119,422,6,7,607,0,31,638
20,9,20169,958,3,107,191,134,10,7,449,0,30,479
20,9,20169,959,3,135,262,100,9,11,517,0,38,555
20,9,20204,1172,3,50,203,17,1,5,276,2,39,317
20,9,20204,1174,3,58,34,176,1,6,275,0,18,293
20,9,20204,1175,3,12,55,50,4,0,121,0,9,130
20,9,20229,1249,3,126,172,302,4,3,607,1,56,664
20,9,20229,1250,3,126,56,78,2,1,263,1,24,288
20,9,20238,1282,3,12,194,153,0,3,362,0,11,373
20,9,20241,1285,3,116,206,71,6,4,403,0,26,429
20,9,20267,1353,3,87,208,44,2,3,344,0,3,347
20,9,20270,1361,3,42,70,179,8,5,304,2,22,328
20,9,20270,1362,3,57,70,253,19,1,400,2,38,440
20,9,20272,1365,3,122,346,86,6,3,563,1,54,618
20,9,20272,1366,3,94,275,116,8,5,498,7,66,571
20,9,20287,1417,3,207,219,33,7,2,468,0,27,495
20,9,20290,1422,3,39,368,29,9,5,450,2,32,484
20,9,20293,1431,3,170,246,243,20,12,691,0,11,702
20,9,20293,1434,3,111,188,185,7,9,500,0,32,532
20,9,20293,1435,3,145,166,147,8,3,469,2,14,485
20,9,20326,1553,3,124,146,41,1,2,314,0,26,340
20,9,20347,1627,3,495,433,709,77,44,1758,2,26,1786
20,9,20347,1630,3,157,142,363,30,32,724,0,3,727
20,9,20347,1631,3,215,147,330,25,32,749,0,7,756
20,9,20350,1637,3,41,86,65,1,1,194,3,10,207
20,9,20350,1638,3,68,118,108,4,5,303,3,29,335
20,9,20351,1639,3,75,159,242,7,7,490,0,39,529
20,9,20358,1647,3,79,218,178,9,9,493,0,19,512
20,9,20369,1675,3,102,177,294,15,11,599,0,15,614
20,9,20376,1686,3,263,345,624,43,34,1309,1,41,1351
20,9,20376,1687,3,203,172,295,33,19,722,1,4,727
20,9,20379,1699,3,36,182,249,32,6,505,1,21,527
20,9,20387,1730,3,33,50,265,6,3,357,1,36,394
20,9,20387,1731,3,73,95,246,9,2,425,1,15,441
20,9,20387,1734,3,37,135,427,4,2,605,1,30,636
20,9,20387,1735,3,56,59,129,4,3,251,0,21,272
20,9,20388,1738,3,22,253,293,11,5,584,0,18,602
20,9,20388,1739,3,30,239,263,8,9,549,0,21,570
20,9,20392,1746,3,191,141,485,43,30,890,0,13,903
20,9,20392,1747,3,113,251,279,22,8,673,2,7,682
20,9,20392,1750,3,229,137,347,28,34,775,2,8,785
20,9,20392,1751,3,246,295,404,45,32,1022,0,19,1041
20,9,20392,1754,3,243,155,392,36,36,862,0,23,885
20,9,20392,1755,3,260,239,459,36,32,1026,2,15,1043
20,9,20392,1758,3,255,176,548,55,36,1070,2,30,1102
20,9,20392,1759,3,220,186,507,52,49,1014,1,23,1038
20,9,20392,1762,3,381,318,977,66,52,1794,10,42,1846
20,9,20392,1763,3,107,134,368,39,25,673,1,13,687
20,9,20392,1766,3,156,126,395,26,23,726,3,9,738
20,9,20392,1767,3,261,259,523,33,30,1106,0,15,1121
20,9,20408,1827,3,196,222,293,26,30,767,0,16,783
20,9,20421,1874,3,57,118,150,6,3,334,0,5,339
20,9,20430,1904,3,158,247,95,4,4,508,0,38,546
20,9,20449,1950,3,30,119,159,3,3,314,0,26,340
20,9,20478,2071,3,87,233,48,4,5,377,0,43,420
20,9,20492,2133,3,50,358,350,9,5,772,1,37,810
20,9,20492,2134,3,9,20,135,0,0,164,0,7,171
20,9,20516,2229,3,84,74,529,13,9,709,1,24,734
20,9,20516,2230,3,67,286,113,1,0,467,0,32,499
20,9,20536,2291,3,43,92,82,1,1,219,1,15,235
20,9,20536,2294,3,106,73,80,9,5,273,0,34,307
20,9,20536,2295,3,78,78,77,0,3,236,2,23,261
20,9,20536,2298,3,47,189,90,0,5,331,0,19,350
20,9,20536,2299,3,53,241,55,1,3,353,3,10,366
20,9,20538,2304,3,54,146,63,2,5,270,0,11,281
20,9,20555,2391,3,62,190,257,16,9,534,4,18,556
20,9,20563,2419,3,38,171,79,7,3,298,0,15,313
20,9,20566,2423,3,190,214,879,65,43,1391,3,42,1436
20,9,20566,2426,3,125,143,728,30,24,1050,8,38,1096
20,9,20566,2427,3,101,236,474,22,22,855,0,20,875
20,9,20567,2430,3,26,115,88,1,1,231,0,9,240
20,9,20567,2431,3,44,260,177,6,8,495,7,47,549
20,9,20570,2436,3,67,146,249,6,7,475,0,15,490
20,9,20570,2438,3,62,101,313,4,9,489,3,12,504
20,9,20570,2439,3,113,175,476,28,13,805,0,29,834
20,9,20570,2442,3,115,264,494,25,7,905,0,31,936
20,9,20570,2443,3,34,80,7,6,0,127,5,18,150
20,9,20570,2446,3,30,48,71,1,1,151,0,9,160
20,9,20570,2447,3,72,158,169,13,9,421,1,25,447
20,10,20014,90,3,74,228,362,7,11,682,8,40,730
20,10,20014,91,3,40,151,400,3,7,601,3,51,655
20,10,20014,94,3,21,82,46,0,1,150,0,10,160
20,10,20014,95,3,39,173,311,5,4,532,0,34,566
20,10,20059,432,3,273,137,203,13,9,635,6,35,676
20,10,20059,434,3,360,144,346,16,16,882,5,19,906
20,10,20059,435,3,217,91,188,10,14,520,4,21,545
20,10,20059,438,3,320,165,367,19,20,891,4,35,930
20,10,20059,439,3,262,132,245,13,15,667,5,14,686
20,10,20059,442,3,198,355,72,2,2,629,0,22,651
20,10,20059,443,3,26,42,82,1,2,153,0,8,161
20,10,20059,446,3,253,157,112,8,8,538,3,35,576
20,10,20059,447,3,115,109,76,2,4,306,8,21,335
20,10,20059,450,3,111,39,80,1,1,232,0,22,254
20,10,20059,451,3,36,29,91,1,3,160,3,9,172
20,10,20061,456,3,85,182,100,9,3,379,3,18,400
20,10,20064,461,3,49,190,86,3,3,331,0,13,344
20,10,20064,462,3,67,241,79,5,4,396,1,6,403
20,10,20064,463,3,127,97,159,2,7,392,6,18,416
20,10,20064,466,3,51,95,151,3,6,306,7,9,322
20,10,20064,467,3,13,76,50,2,1,142,4,6,152
20,10,20070,638,3,68,292,295,6,6,667,4,61,732
20,10,20070,639,3,6,23,16,0,0,45,0,2,47
20,10,20070,642,3,18,118,147,3,0,286,0,15,301
20,10,20082,721,3,23,304,195,4,4,530,1,13,544
20,10,20082,722,3,35,331,240,4,12,622,5,37,664
20,10,20082,723,3,39,446,98,5,3,591,1,40,632
20,10,20082,726,3,22,126,219,2,3,372,3,13,388
20,10,20082,727,3,11,202,144,1,1,359,4,25,388
20,10,20082,730,3,56,188,201,6,4,455,1,23,479
20,10,20082,731,3,12,132,216,1,0,361,3,17,381
20,10,20092,753,3,57,330,66,3,3,459,1,74,534
20,10,20092,754,3,93,105,81,2,3,284,4,61,349
20,10,20092,755,3,66,44,39,3,4,156,0,18,174
20,10,20110,794,3,138,234,404,7,8,791,1,37,829
20,10,20114,803,3,59,192,96,7,7,361,7,12,380
20,10,20116,807,3,43,70,156,2,4,275,0,24,299
20,10,20122,820,3,69,192,53,3,2,319,0,14,333
20,10,20122,822,3,15,62,73,1,1,152,0,5,157
20,10,20122,823,3,19,18,214,1,4,256,0,19,275
20,10,20122,826,3,26,65,243,1,3,338,2,18,358
20,10,20122,827,3,40,186,14,0,2,242,0,26,268
20,10,20122,830,3,17,25,7,0,0,49,0,1,50
20,10,20123,831,3,76,62,308,5,12,463,1,37,501
20,10,20123,834,3,45,143,50,2,0,240,2,12,254
20,10,20143,894,3,72,154,72,7,11,316,1,31,348
20,10,20143,895,3,116,54,82,3,8,263,0,32,295
20,10,20145,898,3,26,47,132,2,3,210,0,14,224
20,10,20151,911,3,93,270,29,0,1,393,1,28,422
20,10,20156,921,3,134,279,136,10,7,566,7,16,589
20,10,20156,922,3,91,131,62,5,4,293,0,10,303
20,10,20156,923,3,70,136,159,5,7,377,0,28,405
20,10,20165,949,3,31,387,22,1,1,442,4,10,456
20,10,20165,950,3,8,110,8,0,1,127,0,2,129
20,10,20168,955,3,44,524,54,3,10,635,2,18,655
20,10,20205,1176,3,23,100,192,2,2,319,0,5,324
20,10,20209,1204,3,48,122,75,7,5,257,0,31,288
20,10,20211,1210,3,25,17,225,2,1,270,0,16,286
20,10,20211,1211,3,15,33,65,0,3,116,1,13,130
20,10,20235,1271,3,59,83,104,3,1,250,0,21,271
20,10,20235,1274,3,41,397,23,2,2,465,0,8,473
20,10,20235,1275,3,16,24,13,0,0,53,0,2,55
20,10,20251,1306,3,13,169,184,2,2,370,0,31,401
20,10,20251,1307,3,18,51,102,1,1,173,0,12,185
20,10,20252,1310,3,265,233,57,1,0,556,4,23,583
20,10,20252,1311,3,100,77,92,3,6,278,1,18,297
20,10,20264,1345,3,194,149,134,8,6,491,1,26,518
20,10,20264,1346,3,71,85,68,0,4,228,2,19,249
20,10,20265,1347,3,24,261,305,2,3,595,0,9,604
20,10,20265,1350,3,35,196,190,0,1,422,0,16,438
20,10,20265,1351,3,8,95,69,1,3,176,2,12,190
20,10,20277,1396,3,90,69,320,14,11,504,4,45,553
20,10,20289,1419,3,75,104,314,7,6,506,2,26,534
20,10,20304,1463,3,45,257,263,4,7,576,3,81,660
20,10,20314,1495,3,66,76,118,5,3,268,1,5,274
20,10,20317,1511,3,33,163,170,4,3,373,3,10,386
20,10,20322,1516,3,135,189,423,11,17,775,0,28,803
20,10,20322,1518,3,228,311,695,11,11,1256,2,50,1308
20,10,20322,1519,3,202,466,806,22,13,1509,0,65,1574
20,10,20322,1522,3,163,335,535,12,9,1054,6,33,1093
20,10,20322,1523,3,38,79,187,5,8,317,3,47,367
20,10,20322,1527,3,71,338,517,14,9,949,0,57,1006
20,10,20322,1530,3,51,242,358,3,4,658,0,30,688
20,10,20322,1531,3,54,367,375,4,7,807,4,40,851
20,10,20322,1534,3,91,235,404,18,14,762,1,43,806
20,10,20331,1561,3,167,104,102,10,13,396,3,9,408
20,10,20331,1562,3,101,76,72,6,3,258,0,6,264
20,10,20331,1563,3,38,56,126,3,1,224,0,11,235
20,10,20341,1607,3,180,297,56,5,4,542,0,24,566
20,10,20344,1614,3,69,248,90,12,4,423,4,27,454
20,10,20344,1615,3,36,187,45,5,1,274,1,7,282
20,10,20348,1634,3,191,175,75,3,9,453,5,46,504
20,10,20348,1635,3,80,102,81,14,8,285,2,25,312
20,10,20353,1641,3,172,364,40,8,2,586,2,24,612
20,10,20357,1646,3,110,229,40,3,4,386,0,22,408
20,10,20361,1652,3,54,75,110,1,5,245,0,25,270
20,10,20366,1668,3,50,145,267,5,3,470,0,34,504
20,10,20366,1670,3,18,54,59,0,0,131,0,22,153
20,10,20370,1676,3,18,74,70,0,1,163,0,2,165
20,10,20385,1709,3,32,306,27,1,2,368,3,31,402
20,10,20385,1710,3,34,277,46,2,0,359,0,21,380
20,10,20385,1711,3,80,46,65,3,2,196,1,8,205
20,10,20393,1769,3,23,152,46,5,1,227,0,24,251
20,10,20393,1770,3,41,252,59,1,3,356,0,23,379
20,10,20411,1834,3,117,161,155,9,5,447,7,16,470
20,10,20411,1835,3,43,36,90,5,0,174,0,7,181
20,10,20414,1841,3,177,395,408,11,14,1005,1,34,1040
20,10,20414,1842,3,287,723,795,10,9,1824,0,58,1882
20,10,20414,1843,3,24,108,28,0,3,163,0,5,168
20,10,20414,1846,3,1162,857,1768,78,70,3935,21,75,4031
20,10,20414,1847,3,76,93,128,3,3,303,1,8,312
20,10,20414,1850,3,171,189,244,12,10,626,3,11,640
20,10,20425,1882,3,102,158,141,2,5,408,2,25,435
20,10,20425,1883,3,20,26,44,2,1,93,0,16,109
20,10,20425,1886,3,60,42,92,6,4,204,2,51,257
20,10,20429,1903,3,70,189,231,11,6,507,0,59,566
20,10,20440,1919,3,161,374,509,4,8,1056,1,38,1095
20,10,20440,1922,3,214,378,299,9,3,903,5,55,963
20,10,20440,1923,3,154,270,162,2,6,594,4,29,627
20,10,20440,1926,3,44,321,248,14,9,636,2,10,648
20,10,20440,1927,3,143,518,566,24,19,1270,10,47,1327
20,10,20450,1951,3,100,123,162,8,3,396,4,7,407
20,10,20450,1954,3,14,23,107,0,0,144,0,1,145
20,10,20496,2144,3,9,113,124,1,4,251,4,11,266
20,10,20496,2146,3,25,85,85,1,0,196,0,9,205
20,10,20496,2147,3,27,51,48,3,3,132,9,15,156
20,10,20508,2176,3,35,161,308,11,2,517,6,34,557
20,10,20508,2178,3,20,67,196,2,0,285,0,23,308
20,10,20508,2179,3,25,216,180,5,3,429,6,18,453
20,10,20512,2189,3,56,135,159,2,5,357,0,0,357
20,10,20529,2264,3,165,81,215,11,6,478,1,20,499
20,10,20535,2290,3,51,102,56,2,0,211,0,15,226
20,10,20265,2450,3,96,128,244,7,4,479,2,20,501
20,11,20056,396,3,23,258,278,21,4,584,2,40,626
20,11,20069,633,3,10,358,283,13,2,666,1,27,694
20,11,20069,634,3,18,229,317,12,4,580,1,21,602
20,11,20069,635,3,5,252,109,1,3,370,0,18,388
20,11,20073,663,3,12,156,140,1,3,312,0,27,339
20,11,20079,714,3,12,211,240,4,3,470,1,26,497
20,11,20079,715,3,17,290,258,5,9,579,0,43,622
20,11,20087,744,3,50,243,370,24,6,693,0,31,724
20,11,20087,746,3,48,282,359,42,7,738,2,26,766
20,11,20108,790,3,25,124,438,5,2,594,3,29,626
20,11,20108,791,3,6,16,258,2,1,283,0,16,299
20,11,20150,908,3,23,189,197,0,1,410,2,12,424
20,11,20150,910,3,36,385,158,1,2,582,3,17,602
20,11,20166,951,3,74,133,128,2,2,339,2,27,368
20,11,20178,1003,3,82,150,144,7,4,387,0,15,402
20,11,20184,1099,3,42,274,329,14,8,667,5,26,698
20,11,20184,1102,3,26,169,210,10,3,418,1,31,450
20,11,20184,1103,3,9,119,140,2,5,275,1,11,287
20,11,20190,1112,3,18,372,489,1,6,886,0,23,909
20,11,20190,1114,3,10,303,256,2,3,574,1,14,589
20,11,20190,1115,3,18,221,301,7,7,554,0,35,589
20,11,20203,1170,3,73,400,226,9,10,718,0,45,763
20,11,20203,1171,3,78,362,114,0,1,555,4,21,580
20,11,20213,1215,3,160,92,276,12,7,547,0,95,642
20,11,20225,1238,3,280,213,225,0,5,723,0,26,749
20,11,20225,1239,3,94,249,258,0,5,606,0,37,643
20,11,20271,1363,3,38,138,413,4,6,599,10,73,682
20,11,20283,1409,3,63,396,286,5,5,755,0,0,755
20,11,20283,1410,3,54,189,127,5,2,377,2,26,405
20,11,20298,1449,3,22,511,578,4,1,1116,1,36,1153
20,11,20298,1450,3,6,280,336,1,3,626,0,31,657
20,11,20298,1451,3,8,350,286,1,1,646,0,20,666
20,11,20300,1454,3,11,240,138,0,0,389,3,12,404
20,11,20300,1455,3,29,364,264,3,2,662,1,17,680
20,11,20310,1485,3,33,240,220,1,3,497,1,22,520
20,11,20310,1486,3,90,266,231,2,2,591,3,29,623
20,11,20310,1487,3,49,222,186,0,6,463,4,28,495
20,11,20310,1490,3,3,78,211,1,0,293,0,13,306
20,11,20310,1491,3,21,149,138,0,1,309,0,32,341
20,11,20316,1498,3,187,475,547,3,6,1218,2,48,1268
20,11,20316,1499,3,112,635,404,1,4,1156,1,38,1195
20,11,20316,1502,3,166,212,274,3,3,658,1,19,678
20,11,20316,1503,3,624,719,1329,43,33,2748,12,69,2829
20,11,20316,1506,3,283,374,462,14,10,1143,1,19,1163
20,11,20316,1507,3,208,290,393,14,10,915,1,13,929
20,11,20316,1510,3,245,347,565,23,14,1194,1,5,1200
20,11,20332,1564,3,33,235,231,6,7,512,4,49,565
20,11,20332,1566,3,31,330,193,5,4,563,0,80,643
20,11,20332,1567,3,29,251,151,2,1,434,3,56,493
20,11,20332,1570,3,97,411,600,11,7,1126,2,15,1143
20,11,20332,1571,3,49,202,270,3,5,529,0,25,554
20,11,20332,1574,3,49,229,384,8,9,679,0,35,714
20,11,20332,1575,3,77,271,337,4,8,697,16,34,747
20,11,20332,1578,3,103,207,370,11,21,712,9,71,792
20,11,20332,1579,3,36,259,301,6,4,606,1,40,647
20,11,20332,1582,3,18,121,180,3,3,325,3,19,347
20,11,20332,1583,3,82,185,235,5,3,510,4,14,528
20,11,20342,1609,3,7,290,265,6,4,572,2,18,592
20,11,20342,1610,3,12,237,168,3,1,421,0,8,429
20,11,20342,1611,3,3,81,90,1,0,175,1,7,183
20,11,20364,1658,3,246,426,505,12,13,1202,8,17,1227
20,11,20364,1659,3,289,762,713,13,10,1787,8,20,1815
20,11,20364,1662,3,51,322,132,10,2,517,2,9,528
20,11,20364,1663,3,89,282,59,1,3,434,0,10,444
20,11,20367,1671,3,39,237,211,0,3,490,0,43,533
20,11,20406,1816,3,60,203,349,4,5,621,3,9,633
20,11,20406,1818,3,146,176,290,12,6,630,1,13,644
20,11,20406,1819,3,86,99,182,2,2,371,3,7,381
20,11,20406,1822,3,42,262,216,3,5,528,1,15,544
20,11,20406,1823,3,58,226,132,7,2,425,3,25,453
20,11,20407,1826,3,68,215,139,4,5,431,0,12,443
20,11,20415,1851,3,45,382,539,14,4,984,2,24,1010
20,11,20415,1854,3,76,265,312,8,13,674,2,36,712
20,11,20415,1855,3,34,246,144,4,4,432,0,36,468
20,11,20416,1858,3,11,178,143,6,2,340,0,14,354
20,11,20434,1908,3,22,342,222,3,0,589,2,26,617
20,11,20467,2005,3,17,312,486,5,2,822,0,83,905
20,11,20467,2006,3,3,3,116,0,0,122,0,5,127
20,11,20467,2007,3,0,53,352,0,2,407,1,20,428
20,11,20467,2010,3,23,100,673,1,2,799,1,41,841
20,11,20467,2011,3,4,79,152,0,0,235,0,18,253
20,11,20468,2014,3,36,127,357,7,4,531,0,8,539
20,11,20468,2015,3,34,138,359,10,2,543,0,16,559
20,11,20468,2018,3,75,275,304,6,5,665,0,16,681
20,11,20468,2019,3,11,27,244,15,2,299,0,11,310
20,11,20468,2022,3,34,165,258,7,2,466,0,25,491
20,11,20468,2023,3,20,199,107,7,0,333,0,27,360
20,11,20475,2062,3,8,391,456,3,0,858,0,13,871
20,11,20475,2063,3,5,146,72,2,0,225,0,0,225
20,11,20484,2088,3,73,223,413,19,2,730,4,17,751
20,11,20484,2090,3,45,137,290,8,4,484,0,9,493
20,11,20484,2091,3,50,140,378,11,4,583,0,24,607
20,11,20484,2094,3,86,238,491,22,13,850,3,25,878
20,11,20484,2095,3,74,305,361,13,10,763,0,27,790
20,11,20484,2098,3,60,207,571,9,12,859,0,112,971
20,11,20484,2099,3,84,353,537,17,4,995,2,33,1030
20,11,20484,2102,3,38,79,91,1,4,213,0,13,226
20,11,20484,2103,3,59,260,220,6,11,556,0,37,593
20,11,20484,2106,3,46,270,201,4,5,526,3,20,549
20,11,20484,2107,3,23,149,211,6,2,391,2,15,408
20,11,20484,2110,3,27,182,248,4,3,464,0,23,487
20,11,20484,2111,3,31,242,356,5,3,637,0,28,665
20,11,20487,2123,3,87,264,86,1,4,442,2,29,473
20,11,20490,2128,3,88,363,204,3,5,663,2,39,704
20,11,20490,2130,3,35,219,100,0,0,354,1,7,362
20,11,20498,2150,3,107,655,408,5,6,1181,0,109,1290
20,11,20506,2173,3,111,245,167,1,1,525,0,8,533
20,11,20506,2174,3,77,278,108,2,2,467,0,16,483
20,11,20530,2265,3,36,642,308,4,4,994,1,33,1028
20,11,20530,2266,3,26,348,227,2,1,604,0,19,623
20,11,20530,2267,3,28,209,209,1,1,448,0,17,465
20,11,20530,2270,3,28,325,352,2,9,716,1,12,729
20,11,20530,2271,3,38,415,215,3,4,675,1,34,710
20,11,20542,2318,3,63,206,274,7,9,559,9,30,598
20,11,20542,2319,3,39,130,133,2,2,306,8,25,339
21,1,21050,423,3,299,292,126,18,5,740,0,54,794
21,1,21050,426,3,123,270,71,2,6,472,1,45,518
21,1,21050,427,3,156,192,58,7,8,421,5,57,483
21,1,21058,502,3,295,140,170,14,9,628,8,34,670
21,1,21058,503,3,97,262,199,5,0,563,0,27,590
21,1,21065,535,3,308,297,309,58,5,977,3,18,998
21,1,21065,538,3,137,295,203,24,3,662,3,24,689
21,1,21065,539,3,131,99,187,5,2,424,0,15,439
21,1,21065,542,3,188,249,181,14,10,642,4,23,669
21,1,21065,543,3,92,165,99,7,2,365,0,0,365
21,1,21072,594,3,161,208,178,60,11,618,0,14,632
21,1,21072,595,3,98,121,216,45,19,499,0,22,521
21,1,21072,598,3,258,307,469,84,19,1137,7,18,1162
21,1,21072,599,3,154,291,281,64,17,807,0,19,826
21,1,21072,602,3,162,179,244,40,18,643,2,21,666
21,1,21072,603,3,406,738,674,291,45,2154,2,54,2210
21,1,21072,606,3,138,108,146,32,6,430,5,8,443
21,1,21072,607,3,203,382,302,91,16,994,2,19,1015
21,1,21072,610,3,248,213,302,78,15,856,3,32,891
21,1,21072,611,3,244,295,371,101,16,1027,5,29,1061
21,1,21072,614,3,198,263,186,11,8,666,9,39,714
21,1,21072,615,3,180,197,807,58,20,1262,4,42,1308
21,1,21072,618,3,157,289,465,27,7,945,0,47,992
21,1,21072,619,3,141,273,292,21,8,735,0,38,773
21,1,21072,622,3,118,248,342,23,3,734,1,35,770
21,1,21072,623,3,176,349,513,18,4,1060,2,30,1092
21,1,21072,626,3,57,216,70,9,6,358,6,38,402
21,1,21072,627,3,171,85,169,10,2,437,11,36,484
21,1,21072,630,3,88,64,91,4,2,249,3,15,267
21,1,21088,764,3,212,283,238,23,7,763,5,53,821
21,1,21088,766,3,151,160,55,5,1,372,4,26,402
21,1,21088,767,3,187,244,249,74,8,762,11,19,792
21,1,21091,779,3,261,396,89,6,1,753,2,25,780
21,1,21091,782,3,103,124,223,1,1,452,4,19,475
21,1,21091,783,3,245,284,153,7,2,691,1,49,741
21,1,21093,792,3,110,157,599,49,18,933,1,15,949
21,1,21093,794,3,95,90,315,32,9,541,1,13,555
21,1,21093,795,3,66,105,339,27,6,543,0,30,573
21,1,21101,830,3,190,280,87,12,4,573,2,28,603
21,1,21101,831,3,143,297,97,13,6,556,4,45,605
21,1,21101,834,3,169,167,142,13,5,496,0,52,548
21,1,21110,883,3,52,230,169,14,1,466,3,23,492
21,1,21110,886,3,33,99,41,0,0,173,0,11,184
21,1,21110,887,3,46,253,234,5,4,542,2,32,576
21,1,21110,890,3,82,267,564,13,3,929,4,39,972
21,1,21110,891,3,8,63,134,0,0,205,1,12,218
21,1,21110,894,3,29,105,153,2,3,292,4,19,315
21,1,21110,895,3,23,80,41,0,1,145,0,2,147
21,1,21112,912,3,80,219,119,21,4,443,1,38,482
21,1,21112,914,3,82,137,71,37,2,329,1,0,330
21,1,21112,915,3,36,339,310,13,1,699,1,27,727
21,1,21112,918,3,141,139,210,166,2,658,0,62,720
21,1,21112,919,3,182,164,320,86,6,758,2,56,816
21,1,21178,2209,3,229,237,239,26,6,737,0,27,764
21,1,21178,2210,3,189,203,34,13,3,442,0,40,482
21,1,21178,2211,3,51,75,385,4,2,517,0,38,555
21,1,21178,2214,3,149,139,56,0,0,344,0,13,357
21,1,21178,2215,3,220,210,202,7,2,641,3,26,670
21,1,21178,2218,3,246,184,51,13,1,495,0,32,527
21,1,21183,2253,3,323,221,54,13,3,614,1,29,644
21,1,21183,2254,3,459,522,88,13,4,1086,3,72,1161
21,1,21183,2255,3,259,200,19,1,4,483,0,16,499
21,1,21183,2258,3,307,292,53,9,1,662,2,25,689
21,1,21183,2259,3,499,371,36,3,2,911,1,52,964
21,1,21187,2295,3,316,156,53,8,3,536,0,9,545
21,1,21187,2298,3,92,218,64,8,2,384,4,21,409
21,1,21194,2333,3,227,109,337,52,14,739,5,25,769
21,1,21194,2334,3,185,142,146,39,12,524,4,13,541
21,1,21194,2335,3,189,172,163,43,7,574,1,18,593
21,1,21194,2338,3,89,105,244,9,4,451,2,36,489
21,1,21194,2339,3,48,80,54,2,4,188,2,13,203
21,1,21194,2342,3,348,266,232,86,7,939,13,37,989
21,1,21194,2343,3,234,241,219,81,14,789,7,22,818
21,1,21194,2346,3,213,199,214,47,9,682,12,27,721
21,1,21194,2347,3,67,142,100,69,4,382,0,14,396
21,1,21197,2362,3,370,156,151,20,20,717,13,16,746
21,1,21197,2363,3,468,189,213,25,13,908,16,23,947
21,1,21197,2366,3,592,254,254,53,15,1168,11,38,1217
21,1,21197,2367,3,558,236,256,75,14,1139,8,25,1172
21,1,21197,2370,3,388,264,171,54,13,890,4,24,918
21,1,21197,2371,3,400,218,160,54,24,856,1,20,877
21,1,21197,2374,3,236,155,102,43,13,549,3,14,566
21,1,21197,2375,3,364,172,141,41,11,729,8,25,762
21,1,21197,2378,3,230,192,387,123,7,939,7,42,988
21,1,21197,2379,3,132,121,160,69,4,486,1,12,499
21,1,21197,2382,3,62,288,301,3,1,655,1,25,681
21,1,21197,2383,3,379,317,194,41,9,940,7,62,1009
21,1,21197,2386,3,99,136,162,5,1,403,0,14,417
21,1,21197,2387,3,117,204,65,7,1,394,0,18,412
21,1,21197,2390,3,282,222,170,15,7,696,2,53,751
21,1,21213,2520,3,262,243,386,39,13,943,3,46,992
21,1,21213,2522,3,265,119,299,15,4,702,0,33,735
21,1,21213,2523,3,98,143,137,7,1,386,2,25,413
21,1,21213,2526,3,234,274,338,44,9,899,7,17,923
21,2,21008,75,3,302,151,178,18,9,658,3,16,677
21,2,21008,78,3,87,122,123,3,5,340,2,10,352
21,2,21016,134,3,340,290,213,23,7,873,16,38,927
21,2,21016,135,3,82,80,59,2,1,224,3,9,236
21,2,21016,138,3,114,209,37,2,5,367,4,17,388
21,2,21054,461,3,332,266,183,26,5,812,0,25,837
21,2,21054,462,3,273,219,196,16,18,722,8,18,748
21,2,21054,463,3,160,202,242,24,11,639,2,26,667
21,2,21054,466,3,407,226,183,20,22,858,28,41,927
21,2,21054,467,3,334,329,239,59,30,991,3,23,1017
21,2,21054,470,3,170,256,128,3,6,563,6,51,620
21,2,21054,471,3,209,209,152,4,1,575,3,30,608
21,2,21054,474,3,109,212,87,2,5,415,4,28,447
21,2,21054,475,3,144,116,158,3,8,429,2,14,445
21,2,21054,478,3,76,65,170,3,5,319,10,13,342
21,2,21054,479,3,151,295,204,11,7,668,11,41,720
21,2,21054,482,3,304,419,253,28,12,1016,27,54,1097
21,2,21054,483,3,321,336,195,21,22,895,8,35,938
21,2,21054,486,3,316,216,178,9,11,730,7,30,767
21,2,21054,487,3,256,117,122,10,5,510,15,23,548
21,2,21085,712,3,208,131,117,4,5,465,2,20,487
21,2,21085,714,3,84,121,84,1,8,298,0,41,339
21,2,21085,715,3,241,277,172,7,8,705,8,29,742
21,2,21085,718,3,213,150,159,10,18,550,1,33,584
21,2,21085,719,3,199,250,181,9,4,643,4,36,683
21,2,21085,722,3,121,142,134,0,5,402,4,22,428
21,2,21085,723,3,319,282,184,22,21,828,6,37,871
21,2,21085,726,3,182,201,159,11,3,556,2,25,583
21,2,21096,809,3,430,339,226,35,24,1054,8,21,1083
21,2,21096,810,3,523,432,276,69,31,1331,3,42,1376
21,2,21096,811,3,460,430,261,43,25,1219,6,22,1247
21,2,21096,814,3,188,284,198,11,10,691,4,29,724
21,2,21096,815,3,307,206,200,22,10,745,8,51,804
21,2,21096,818,3,149,149,95,14,5,412,6,15,433
21,2,21096,819,3,272,247,176,17,6,718,1,21,740
21,2,21098,822,3,260,231,76,1,7,575,1,21,597
21,2,21105,846,3,339,228,209,30,10,816,15,26,857
21,2,21105,847,3,532,302,196,31,24,1085,21,31,1137
21,2,21105,850,3,396,189,176,20,8,789,20,34,843
21,2,21105,851,3,492,150,159,16,12,829,37,29,895
21,2,21106,854,3,224,160,209,36,11,640,0,20,660
21,2,21106,855,3,174,378,197,35,9,793,0,38,831
21,2,21109,875,3,241,215,164,10,2,632,14,11,657
21,2,21109,878,3,210,185,85,6,7,493,1,17,511
21,2,21109,879,3,251,155,157,21,9,593,0,26,619
21,2,21109,882,3,134,123,73,20,2,352,4,25,381
21,2,21118,1636,3,340,275,123,20,21,779,19,15,813
21,2,21118,1638,3,336,255,157,10,7,765,13,33,811
21,2,21118,1639,3,208,269,104,9,13,603,19,14,636
21,2,21118,1642,3,462,317,91,13,7,890,28,29,947
21,2,21129,1702,3,90,103,107,10,3,313,0,0,313
21,2,21129,1703,3,113,107,134,16,8,378,0,23,401
21,2,21129,1706,3,141,295,65,8,5,514,20,15,549
21,2,21129,1707,3,54,122,74,20,5,275,0,32,307
21,2,21138,1789,3,258,313,93,5,11,680,2,17,699
21,2,21138,1790,3,298,271,151,9,5,734,15,17,766
21,2,21138,1791,3,300,401,261,13,8,983,17,35,1035
21,2,21143,1848,3,239,265,229,26,18,777,3,44,824
21,2,21143,1850,3,216,172,351,38,11,788,3,39,830
21,2,21143,1851,3,199,140,302,34,18,693,5,31,729
21,2,21143,1854,3,242,145,247,43,24,701,4,14,719
21,2,21143,1855,3,340,285,291,28,14,958,13,52,1023
21,2,21151,1891,3,82,89,67,5,3,246,13,11,270
21,2,21151,1894,3,169,181,96,9,3,458,5,31,494
21,2,21151,1895,3,138,240,51,8,2,439,2,13,454
21,2,21171,2117,3,355,330,201,49,15,950,4,27,981
21,2,21171,2118,3,360,279,256,42,18,955,5,35,995
21,2,21171,2119,3,140,244,84,6,5,479,7,26,512
21,2,21171,2122,3,198,436,230,8,17,889,3,73,965
21,2,21171,2123,3,82,112,69,0,5,268,4,35,307
21,2,21171,2126,3,240,330,220,11,6,807,0,41,848
21,2,21171,2127,3,184,277,96,11,8,576,0,31,607
21,2,21171,2130,3,72,112,32,0,2,218,1,15,234
21,2,21171,2131,3,92,153,70,4,2,321,1,47,369
21,2,21208,2460,3,323,202,212,119,19,875,2,25,902
21,2,21208,2462,3,287,220,176,128,15,826,4,23,853
21,2,21208,2463,3,299,216,191,151,19,876,2,13,891
21,2,21208,2466,3,250,205,93,109,20,677,5,5,687
21,2,21208,2467,3,223,154,128,94,13,612,3,11,626
21,2,21208,2470,3,213,150,165,10,7,545,2,28,575
21,2,21208,2471,3,170,141,419,13,7,750,1,62,813
21,2,21208,2474,3,227,246,175,14,3,665,3,52,720
21,2,21208,2475,3,272,276,202,51,7,808,13,52,873
21,2,21208,2478,3,439,336,191,70,16,1052,12,48,1112
21,2,21208,2479,3,324,346,242,86,16,1014,17,50,1081
21,2,21208,2482,3,241,192,183,53,14,683,11,24,718
21,2,21208,2483,3,167,139,118,14,6,444,9,36,489
21,2,21208,2486,3,165,251,178,15,19,628,8,32,668
21,2,21208,2487,3,224,235,247,11,8,725,2,66,793
21,3,21002,20,3,230,216,251,18,9,724,1,22,747
21,3,21002,22,3,60,89,133,4,4,290,0,14,304
21,3,21002,23,3,94,82,105,3,4,288,1,4,293
21,3,21002,26,3,114,85,223,5,8,435,4,24,463
21,3,21002,27,3,78,157,281,14,7,537,0,20,557
21,3,21045,364,3,293,310,155,26,6,790,0,30,820
21,3,21045,366,3,204,139,163,3,5,514,4,50,568
21,3,21045,367,3,314,442,230,13,13,1012,11,54,1077
21,3,21045,370,3,169,212,234,43,17,675,13,26,714
21,3,21051,430,3,327,619,350,11,5,1312,0,57,1369
21,3,21051,431,3,35,111,17,2,0,165,1,10,176
21,3,21051,434,3,33,102,57,1,2,195,0,3,198
21,3,21051,435,3,79,309,78,13,1,480,3,20,503
21,3,21051,438,3,160,339,320,4,3,826,0,84,910
21,3,21059,505,3,439,187,90,10,10,736,7,32,775
21,3,21059,506,3,254,328,187,7,6,782,2,42,826
21,3,21059,507,3,147,201,120,5,5,478,0,46,524
21,3,21059,510,3,689,241,77,8,4,1019,6,41,1066
21,3,21059,511,3,155,261,103,7,2,528,1,32,561
21,3,21068,555,3,524,280,97,12,10,923,5,28,956
21,3,21068,558,3,346,189,79,8,3,625,3,8,636
21,3,21068,559,3,219,249,193,11,11,683,13,38,734
21,3,21068,562,3,98,56,20,2,1,177,1,5,183
21,3,21068,563,3,54,163,14,3,2,236,0,12,248
21,3,21078,678,3,391,368,189,21,16,985,0,42,1027
21,3,21078,679,3,220,331,172,16,8,747,5,20,772
21,3,21078,682,3,336,270,122,13,8,749,1,55,805
21,3,21078,683,3,205,320,183,7,5,720,1,47,768
21,3,21078,686,3,348,199,86,7,13,653,3,29,685
21,3,21078,687,3,401,331,149,9,8,898,1,46,945
21,3,21078,690,3,433,282,190,14,10,929,2,48,979
21,3,21078,691,3,146,154,56,5,0,361,5,11,377
21,3,21095,801,3,21,232,98,3,1,355,1,5,361
21,3,21095,802,3,279,132,276,12,6,705,1,25,731
21,3,21095,803,3,23,38,29,3,1,94,2,14,110
21,3,21095,806,3,65,115,42,3,1,226,0,0,226
21,3,21095,807,3,83,245,43,2,0,373,0,7,380
21,3,21117,1626,3,212,413,77,10,3,715,8,33,756
21,3,21117,1627,3,195,113,37,4,2,351,0,11,362
21,3,21117,1630,3,186,200,25,2,6,419,2,14,435
21,3,21117,1631,3,113,148,48,1,1,311,0,16,327
21,3,21117,1634,3,115,427,56,5,2,605,0,37,642
21,3,21117,1635,3,355,229,80,7,4,675,0,39,714
21,3,21157,2025,3,143,152,142,17,6,460,5,19,484
21,3,21157,2026,3,178,246,210,29,8,671,13,29,713
21,3,21157,2027,3,87,111,232,11,2,443,3,15,461
21,3,21157,2030,3,36,61,43,5,0,145,0,10,155
21,3,21157,2031,3,76,93,98,7,1,275,1,18,294
21,3,21169,2109,3,276,325,224,15,10,850,2,44,896
21,3,21169,2110,3,476,242,178,6,6,908,7,31,946
21,3,21169,2111,3,129,316,133,10,3,591,1,21,613
21,3,21169,2114,3,309,217,109,28,5,668,0,34,702
21,3,21169,2115,3,250,224,116,7,6,603,10,13,626
21,3,21173,2134,3,294,234,219,95,26,868,7,19,894
21,3,21173,2135,3,232,168,186,43,22,651,2,14,667
21,3,21173,2138,3,294,178,190,45,19,726,3,13,742
21,3,21173,2139,3,378,231,179,43,24,855,0,24,879
21,3,21173,2142,3,469,270,262,62,38,1101,1,27,1129
21,3,21173,2143,3,127,88,95,23,10,343,0,13,356
21,3,21173,2146,3,394,207,223,52,20,896,3,27,926
21,3,21173,2147,3,337,268,253,46,28,932,1,19,952
21,3,21173,2150,3,328,200,179,37,25,769,0,28,797
21,3,21173,2151,3,315,238,196,35,23,807,4,18,829
21,3,21173,2154,3,356,172,187,17,15,747,3,27,777
21,3,21173,2155,3,198,136,119,23,10,486,3,7,496
21,3,21173,2158,3,546,302,281,49,47,1225,1,21,1247
21,3,21173,2159,3,321,229,142,32,24,748,0,19,767
21,3,21173,2162,3,405,234,185,67,24,915,0,20,935
21,3,21173,2163,3,512,300,305,46,33,1196,7,46,1249
21,3,21173,2166,3,122,271,238,26,8,665,3,13,681
21,3,21173,2167,3,500,312,272,20,24,1128,3,81,1212
21,3,21173,2170,3,238,185,153,24,15,615,7,38,660
21,3,21173,2171,3,134,128,44,2,1,309,1,12,322
21,3,21173,2174,3,323,206,197,64,5,795,0,27,822
21,3,21186,2272,3,289,199,219,81,15,803,11,20,834
21,3,21186,2274,3,355,204,197,113,23,892,0,31,923
21,3,21186,2275,3,387,226,276,120,26,1035,7,34,1076
21,3,21186,2278,3,91,56,77,23,5,252,0,19,271
21,3,21186,2279,3,184,168,225,9,6,592,12,41,645
21,3,21186,2282,3,276,377,217,57,19,946,0,48,994
21,3,21186,2283,3,277,251,162,27,13,730,5,38,773
21,3,21186,2286,3,325,289,370,33,29,1046,10,90,1146
21,3,21186,2287,3,249,327,260,41,17,894,1,46,941
21,3,21186,2290,3,100,157,121,13,11,402,0,43,445
21,3,21186,2291,3,198,191,440,27,16,872,6,97,975
21,3,21186,2294,3,333,184,78,8,3,606,14,24,644
21,3,21199,2393,3,555,361,216,37,29,1198,4,23,1225
21,3,21199,2394,3,527,341,191,29,16,1104,18,28,1150
21,3,21199,2395,3,412,289,149,33,14,897,2,27,926
21,3,21199,2398,3,259,194,181,11,11,656,1,32,689
21,3,21199,2399,3,381,319,140,13,16,869,3,53,925
21,3,21199,2402,3,284,205,128,13,12,642,2,58,702
21,3,21199,2403,3,270,356,114,2,7,749,0,56,805
21,3,21211,2502,3,180,207,236,71,20,714,3,25,742
21,3,21211,2503,3,282,269,304,109,22,986,3,37,1026
21,3,21211,2506,3,223,204,213,25,17,682,15,25,722
21,3,21211,2507,3,71,181,105,12,7,376,0,26,402
21,4,21006,64,3,123,201,134,54,0,512,2,37,551
21,4,21006,66,3,223,171,315,27,7,743,0,43,786
21,4,21006,67,3,348,181,185,17,7,738,3,38,779
21,4,21006,70,3,236,235,156,8,2,637,3,39,679
21,4,21014,113,3,93,346,170,141,9,759,3,89,851
21,4,21014,114,3,38,120,65,87,4,314,1,23,338
21,4,21014,115,3,82,276,118,74,1,551,1,68,620
21,4,21017,139,3,360,302,212,215,24,1113,2,20,1135
21,4,21017,142,3,28,16,3,1,0,48,0,2,50
21,4,21017,143,3,299,211,435,31,12,988,7,63,1058
21,4,21017,146,3,154,198,201,22,7,582,0,28,610
21,4,21017,147,3,47,30,65,8,1,151,1,8,160
21,4,21025,241,3,243,352,81,61,5,742,2,17,761
21,4,21025,242,3,264,283,82,22,2,653,11,15,679
21,4,21025,243,3,230,129,133,10,0,502,3,10,515
21,4,21028,260,3,222,244,89,142,4,701,0,38,739
21,4,21030,271,3,66,407,230,229,13,945,0,82,1027
21,4,21040,319,3,284,427,238,133,9,1091,1,124,1216
21,4,21040,322,3,135,107,93,52,4,391,0,39,430
21,4,21044,344,3,156,164,82,151,3,556,3,24,583
21,4,21044,346,3,131,180,118,225,13,667,2,39,708
21,4,21044,347,3,136,123,88,172,8,527,0,9,536
21,4,21044,350,3,102,186,115,41,4,448,1,27,476
21,4,21044,351,3,140,285,130,157,7,719,0,37,756
21,4,21044,354,3,184,331,283,141,15,954,4,60,1018
21,4,21044,355,3,243,219,202,79,11,754,6,61,821
21,4,21044,358,3,75,188,117,95,5,480,1,69,550
21,4,21044,359,3,513,232,149,184,14,1092,3,128,1223
21,4,21044,362,3,118,137,109,70,5,439,1,10,450
21,4,21044,363,3,127,285,90,101,8,611,3,62,676
21,4,21055,489,3,524,355,267,114,31,1291,13,26,1330
21,4,21055,490,3,388,317,179,67,20,971,10,45,1026
21,4,21055,491,3,430,352,297,136,32,1247,7,56,1310
21,4,21055,494,3,294,457,203,111,14,1079,18,64,1161
21,4,21055,495,3,248,272,161,65,11,757,10,51,818
21,4,21069,565,3,293,269,131,89,4,786,7,76,869
21,4,21069,566,3,126,276,44,33,1,480,3,48,531
21,4,21069,567,3,50,53,14,21,4,142,1,26,169
21,4,21073,631,3,173,365,223,72,1,834,3,27,864
21,4,21073,634,3,133,236,209,6,2,586,0,15,601
21,4,21073,635,3,55,116,123,20,0,314,0,16,330
21,4,21073,638,3,70,309,144,51,5,579,0,15,594
21,4,21073,639,3,84,292,165,68,5,614,2,33,649
21,4,21077,673,3,80,244,189,5,2,520,5,34,559
21,4,21077,674,3,214,488,272,98,15,1087,17,48,1152
21,4,21077,675,3,16,83,52,4,1,156,0,16,172
21,4,21079,693,3,147,289,82,107,3,628,0,82,710
21,4,21079,694,3,64,154,43,72,0,333,0,36,369
21,4,21079,695,3,92,479,48,322,13,954,3,100,1057
21,4,21080,698,3,237,560,75,22,1,895,3,47,945
21,4,21080,699,3,101,147,31,93,1,373,0,35,408
21,4,21082,704,3,83,262,234,120,4,703,0,15,718
21,4,21086,727,3,81,264,234,153,5,737,1,62,800
21,4,21090,776,3,198,226,67,62,8,561,4,54,619
21,4,21090,778,3,209,250,200,92,6,757,0,66,823
21,4,21102,835,3,136,342,117,138,9,742,5,67,814
21,4,21108,867,3,224,307,45,46,2,624,0,40,664
21,4,21108,870,3,120,208,42,51,1,422,0,49,471
21,4,21108,871,3,187,398,75,54,4,718,0,70,788
21,4,21108,874,3,147,176,4,18,1,346,0,33,379
21,4,21124,1682,3,147,122,239,70,4,582,0,78,660
21,4,21124,1683,3,48,93,86,77,4,308,2,60,370
21,4,21161,2049,3,221,259,163,143,3,789,0,56,845
21,4,21161,2050,3,201,224,157,146,4,732,2,40,774
21,4,21166,2089,3,109,190,47,45,2,393,0,25,418
21,4,21166,2090,3,133,264,80,82,6,565,6,64,635
21,4,21166,2091,3,109,77,25,58,1,270,3,17,290
21,4,21166,2094,3,48,117,37,3,5,210,0,12,222
21,4,21172,2132,3,344,259,341,197,20,1161,3,44,1208
21,4,21184,2262,3,271,180,103,57,4,615,0,28,643
21,4,21184,2263,3,161,119,22,36,2,340,1,25,366
21,4,21184,2266,3,164,63,22,6,5,260,0,11,271
21,4,21192,2326,3,269,365,80,71,2,787,2,34,823
21,4,21192,2327,3,170,294,74,161,2,701,1,54,756
21,4,21200,2405,3,68,212,273,305,4,862,0,86,948
21,4,21200,2406,3,28,96,86,159,2,371,1,33,405
21,4,21202,2409,3,199,257,80,186,13,735,1,105,841
21,4,21202,2410,3,315,247,116,121,9,808,1,92,901
21,4,21202,2411,3,169,205,101,246,6,727,10,112,849
21,4,21204,2416,3,42,193,161,66,6,468,5,9,482
21,4,21204,2418,3,52,112,75,47,7,293,2,15,310
21,4,21204,2419,3,76,272,338,118,9,813,2,33,848
21,4,21207,2433,3,130,126,77,294,10,637,4,25,666
21,4,21207,2434,3,167,132,118,302,9,728,1,41,770
21,4,21207,2435,3,248,147,121,347,5,868,1,33,902
21,4,21207,2438,3,106,189,68,61,3,427,0,66,493
21,4,21207,2439,3,49,194,96,58,0,397,0,52,449
21,4,21207,2442,3,46,123,33,22,1,225,0,16,241
21,4,21207,2443,3,60,218,112,106,3,499,9,59,567
21,4,21207,2446,3,164,141,94,325,12,736,0,58,794
21,4,21207,2447,3,170,109,222,198,9,708,9,53,770
21,4,21207,2450,3,116,80,57,27,1,281,2,18,301
21,4,21207,2451,3,81,53,81,72,0,287,9,20,316
21,4,21207,2454,3,61,146,93,57,4,361,5,38,404
21,4,21207,2455,3,12,112,58,111,1,294,1,12,307
21,4,21207,2458,3,148,103,372,95,11,729,0,83,812
21,4,21207,2459,3,67,75,36,50,3,231,2,8,241
21,4,21210,2499,3,125,286,317,178,5,911,0,33,944
21,4,21212,2508,3,165,136,119,55,1,476,1,22,499
21,4,21212,2510,3,100,134,75,49,4,362,4,26,392
21,4,21212,2511,3,53,125,166,70,4,418,3,47,468
21,4,21212,2514,3,33,50,48,22,3,156,0,15,171
21,4,21212,2515,3,133,425,266,97,11,932,17,30,979
21,4,21212,2518,3,62,148,63,30,4,307,1,28,336
21,4,21212,2519,3,99,89,62,103,6,359,3,64,426
21,4,21215,2533,3,417,463,167,95,1,1143,2,47,1192
21,4,21215,2534,3,256,283,85,55,1,680,0,16,696
21,4,21216,2535,3,176,253,88,74,3,594,4,64,662
21,5,21026,245,3,167,147,76,13,8,411,0,8,419
21,5,21026,246,3,231,210,179,36,18,674,2,20,696
21,5,21026,247,3,259,165,121,29,14,588,8,12,608
21,5,21026,250,3,55,210,109,5,6,385,1,13,399
21,5,21026,251,3,82,124,101,5,3,315,3,37,355
21,5,21049,415,3,420,377,165,27,8,997,7,35,1039
21,5,21049,418,3,131,263,322,24,14,754,11,20,785
21,5,21049,419,3,424,56,68,12,6,566,6,22,594
21,5,21049,422,3,109,422,49,7,2,589,4,18,611
21,5,21061,515,3,62,131,193,8,3,397,1,13,411
21,5,21076,651,3,384,156,188,56,21,805,7,15,827
21,5,21076,654,3,322,265,179,70,21,857,4,20,881
21,5,21076,655,3,352,205,233,65,28,883,8,20,911
21,5,21076,658,3,304,162,142,60,33,701,5,15,721
21,5,21076,659,3,317,113,179,45,22,676,5,6,687
21,5,21076,662,3,479,183,187,39,13,901,1,12,914
21,5,21076,663,3,476,190,229,32,14,941,4,15,960
21,5,21076,666,3,434,142,180,56,17,829,7,18,854
21,5,21076,667,3,338,227,251,19,17,852,3,16,871
21,5,21076,670,3,367,361,76,7,4,815,1,22,838
21,5,21076,671,3,39,156,61,7,3,266,7,7,280
21,5,21103,838,3,309,313,168,19,13,822,7,8,837
21,5,21103,839,3,240,199,210,25,10,684,1,17,702
21,5,21123,1677,3,173,221,159,30,9,592,3,6,601
21,5,21123,1678,3,242,333,131,74,11,791,1,24,816
21,5,21123,1679,3,169,273,110,53,7,612,1,14,627
21,5,21133,1720,3,916,370,380,101,47,1814,2,34,1850
21,5,21133,1722,3,482,177,176,53,31,919,4,6,929
21,5,21133,1723,3,412,164,142,48,22,788,1,14,803
21,5,21133,1726,3,336,137,117,58,15,663,2,9,674
21,5,21133,1727,3,498,212,166,76,26,978,1,19,998
21,5,21133,1730,3,450,218,144,47,21,880,1,10,891
21,5,21133,1731,3,195,89,64,29,9,386,0,12,398
21,5,21133,1734,3,442,236,199,81,31,989,2,16,1007
21,5,21133,1735,3,420,193,154,86,14,867,3,22,892
21,5,21133,1738,3,280,100,94,32,7,513,1,10,524
21,5,21133,1739,3,283,207,137,41,17,685,2,14,701
21,5,21133,1742,3,401,189,232,76,19,917,4,22,943
21,5,21133,1743,3,467,216,176,60,29,948,3,22,973
21,5,21133,1746,3,359,383,203,33,27,1005,5,16,1026
21,5,21133,1747,3,329,380,116,24,21,870,4,20,894
21,5,21133,1750,3,746,550,286,72,37,1691,5,35,1731
21,5,21133,1751,3,548,268,190,37,18,1061,0,22,1083
21,5,21133,1754,3,533,418,254,74,24,1303,4,35,1342
21,5,21133,1755,3,426,365,331,76,28,1226,12,27,1265
21,5,21133,1758,3,393,389,281,65,28,1156,10,19,1185
21,5,21133,1759,3,309,377,252,34,13,985,11,24,1020
21,5,21133,1762,3,433,301,180,26,15,955,6,22,983
21,5,21133,1763,3,338,372,168,32,13,923,6,23,952
21,5,21133,1766,3,494,399,222,62,27,1204,4,38,1246
21,5,21133,1767,3,166,341,224,33,20,784,1,11,796
21,5,21133,1770,3,245,475,297,23,13,1053,8,36,1097
21,5,21133,1771,3,329,541,389,44,17,1320,11,35,1366
21,5,21135,1775,3,352,345,168,21,9,895,2,12,909
21,5,21135,1778,3,375,251,266,37,108,1037,7,24,1068
21,5,21135,1779,3,225,246,164,22,20,677,2,18,697
21,5,21135,1782,3,135,127,87,9,6,364,3,8,375
21,5,21135,1783,3,202,186,62,9,1,460,1,5,466
21,5,21139,1793,3,137,270,182,28,6,623,0,6,629
21,5,21139,1794,3,96,312,393,26,2,829,5,16,850
21,5,21139,1795,3,92,124,148,14,6,384,0,5,389
21,5,21144,1858,3,337,355,258,57,15,1022,7,26,1055
21,5,21144,1859,3,270,235,157,25,11,698,3,5,706
21,5,21144,1862,3,254,177,124,27,14,596,2,6,604
21,5,21144,1863,3,319,178,162,46,17,722,4,26,752
21,5,21144,1866,3,242,270,245,56,18,831,5,25,861
21,5,21144,1867,3,323,339,337,59,23,1081,8,51,1140
21,5,21180,2233,3,418,380,359,24,12,1193,12,45,1250
21,5,21180,2234,3,360,314,332,22,18,1046,14,28,1088
21,5,21180,2235,3,254,96,184,18,11,563,3,20,586
21,5,21180,2238,3,89,317,57,2,1,466,5,18,489
21,5,21180,2239,3,151,302,210,11,7,681,5,17,703
21,5,21180,2242,3,90,191,117,7,6,411,3,11,425
21,5,21180,2243,3,43,138,69,0,0,250,1,15,266
21,5,21180,2246,3,246,354,171,24,13,808,13,53,874
21,5,21180,2247,3,437,570,263,39,16,1325,14,48,1387
21,6,21115,933,3,119,68,60,13,5,265,1,8,274
21,6,21115,969,3,102,63,60,19,12,256,0,9,265
21,6,21115,989,3,131,70,67,25,7,300,0,10,310
21,6,21115,990,3,118,60,58,9,13,258,0,12,270
21,6,21115,1261,3,81,31,60,14,2,188,0,4,192
21,6,21115,1262,3,107,47,75,17,5,251,2,6,259
21,6,21115,1263,3,146,83,68,16,9,322,0,6,328
21,6,21115,1266,3,33,17,14,4,3,71,0,3,74
21,6,21115,1267,3,225,139,104,20,29,517,2,7,526
21,6,21115,1270,3,141,75,65,15,5,301,2,7,310
21,6,21115,1271,3,275,104,125,37,20,561,0,10,571
21,6,21115,1274,3,215,79,42,20,13,369,1,8,378
21,6,21115,1275,3,42,27,44,10,4,127,0,5,132
21,6,21115,1278,3,237,112,123,22,21,515,0,1,516
21,6,21115,1279,3,218,110,113,31,22,494,0,9,503
21,6,21115,1282,3,316,150,126,24,19,635,1,11,647
21,6,21115,1283,3,168,74,65,12,13,332,1,3,336
21,6,21115,1286,3,176,111,116,23,26,452,13,0,465
21,6,21115,1287,3,377,163,136,38,32,746,1,14,761
21,6,21115,1290,3,375,116,154,48,24,717,0,17,734
21,6,21115,1291,3,441,191,273,66,45,1016,2,19,1037
21,6,21115,1294,3,298,146,157,24,16,641,1,14,656
21,6,21115,1295,3,376,196,211,41,24,848,3,14,865
21,6,21115,1298,3,148,102,89,14,12,365,0,13,378
21,6,21115,1299,3,349,202,192,41,24,808,4,12,824
21,6,21115,1302,3,240,120,118,34,31,543,0,8,551
21,6,21115,1303,3,413,222,293,61,36,1025,5,24,1054
21,6,21115,1306,3,353,210,199,48,34,844,1,32,877
21,6,21115,1307,3,402,258,277,55,30,1022,0,33,1055
21,6,21115,1313,3,583,306,222,75,44,1230,14,29,1273
21,6,21115,1314,3,633,212,233,62,39,1179,2,14,1195
21,6,21115,1315,3,249,164,147,36,19,615,19,22,656
21,6,21115,1318,3,49,14,13,1,2,79,0,0,79
21,6,21115,1319,3,391,179,292,73,35,970,5,24,999
21,6,21115,1322,3,363,275,212,53,34,937,0,28,965
21,6,21115,1323,3,313,237,182,56,31,819,1,13,833
21,6,21115,1331,3,298,174,213,26,27,738,12,11,761
21,6,21115,1334,3,316,151,215,51,28,761,0,19,780
21,6,21115,1335,3,185,170,141,42,19,557,2,10,569
21,6,21115,1338,3,318,219,260,49,32,878,2,27,907
21,6,21115,1339,3,431,280,252,77,48,1088,1,22,1111
21,6,21115,1342,3,248,171,191,50,22,682,1,16,699
21,6,21115,1343,3,77,88,101,38,12,316,0,8,324
21,6,21115,1346,3,316,199,199,50,24,788,0,28,816
21,6,21115,1347,3,376,159,270,55,34,894,3,22,919
21,6,21115,1353,3,366,170,228,40,31,835,0,36,871
21,6,21115,1354,3,345,277,185,58,25,890,0,19,909
21,6,21115,1355,3,518,428,333,100,75,1454,4,32,1490
21,6,21115,1358,3,371,239,209,96,45,960,4,13,977
21,6,21115,1359,3,477,290,378,110,53,1308,2,26,1336
21,6,21115,1362,3,288,142,173,35,32,670,1,20,691
21,6,21115,1370,3,430,252,279,65,51,1077,9,17,1103
21,6,21115,1371,3,326,270,224,55,49,924,8,20,952
21,6,21115,1374,3,580,437,409,75,67,1568,7,49,1624
21,6,21115,1375,3,534,450,390,80,52,1506,12,51,1569
21,6,21115,1382,3,612,260,287,69,55,1283,3,13,1299
21,6,21115,1383,3,277,164,173,72,28,714,4,17,735
21,6,21115,1386,3,445,272,369,72,54,1212,2,32,1246
21,6,21115,1387,3,379,166,198,46,24,813,0,18,831
21,6,21115,1396,3,604,426,424,118,52,1624,2,42,1668
21,6,21115,1398,3,715,470,561,135,71,1952,7,56,2015
21,6,21115,1399,3,329,161,234,52,37,813,0,11,824
21,6,21115,1402,3,323,194,184,47,31,779,2,18,799
21,6,21115,1403,3,318,185,159,44,24,730,3,15,748
21,6,21115,1408,3,680,463,427,100,74,1744,8,45,1797
21,6,21115,1410,3,486,407,251,46,45,1235,8,29,1272
21,6,21115,1411,3,676,801,673,75,47,2272,20,68,2360
21,6,21115,1414,3,467,589,304,36,13,1409,3,20,1432
21,6,21115,1415,3,948,711,782,152,80,2673,9,65,2747
21,6,21115,1418,3,359,346,240,37,23,1005,0,31,1036
21,6,21115,1419,3,417,399,269,21,23,1129,6,45,1180
21,6,21115,1422,3,361,249,252,16,7,885,1,35,921
21,6,21115,1542,3,378,183,288,85,38,972,1,10,983
21,6,21115,1543,3,257,148,151,37,25,618,0,18,636
21,6,21115,1546,3,260,201,166,62,22,711,2,15,728
21,6,21115,1547,3,340,180,181,61,26,788,1,21,810
21,6,21115,1568,3,281,288,186,38,29,822,4,10,836
21,6,21115,1570,3,435,182,263,32,33,945,1,18,964
21,6,21115,1571,3,464,191,277,47,42,1021,0,11,1032
21,6,21115,1574,3,427,246,257,50,46,1026,1,24,1051
21,6,21115,1575,3,439,311,294,61,58,1163,1,25,1189
21,6,21115,1578,3,441,316,373,92,53,1275,2,21,1298
21,6,21115,1579,3,431,222,255,81,41,1030,10,19,1059
21,6,21115,1583,3,462,317,304,50,32,1165,2,38,1205
21,6,21115,1586,3,1104,511,715,150,140,2620,7,53,2680
21,6,21115,1587,3,1195,630,689,149,100,2763,4,56,2823
21,6,21115,1594,3,515,355,277,44,39,1230,7,26,1263
21,6,21115,1595,3,747,519,520,103,108,1997,27,76,2100
21,6,21115,1598,3,215,165,117,20,30,547,2,14,563
21,6,21115,1601,3,282,229,69,9,2,591,0,23,614
21,7,21001,1,3,325,281,262,24,11,903,2,16,921
21,7,21001,2,3,402,149,283,26,14,874,11,29,914
21,7,21001,3,3,301,165,212,28,9,715,0,9,724
21,7,21001,6,3,197,146,283,19,8,653,0,19,672
21,7,21001,7,3,311,180,330,9,5,835,2,21,858
21,7,21001,10,3,480,260,153,41,30,964,2,19,985
21,7,21001,11,3,414,193,185,38,18,848,3,17,868
21,7,21001,14,3,221,158,283,16,10,688,4,23,715
21,7,21001,15,3,221,301,505,31,9,1067,7,28,1102
21,7,21001,18,3,161,380,253,22,17,833,11,32,876
21,7,21001,19,3,140,224,234,39,16,653,5,22,680
21,7,21004,45,3,376,352,315,54,10,1107,3,31,1141
21,7,21004,46,3,396,463,383,68,18,1328,11,46,1385
21,7,21004,47,3,338,305,301,50,21,1015,0,29,1044
21,7,21004,50,3,160,335,327,40,12,874,3,29,906
21,7,21004,51,3,250,272,256,43,17,838,5,37,880
21,7,21004,54,3,114,242,135,10,4,505,2,7,514
21,7,21004,55,3,147,304,200,12,6,669,2,28,699
21,7,21004,58,3,111,266,185,28,7,597,18,17,632
21,7,21004,59,3,88,328,197,30,5,648,4,29,681
21,7,21015,116,3,498,400,293,52,17,1260,16,37,1313
21,7,21015,118,3,535,269,296,66,26,1192,8,24,1224
21,7,21015,119,3,335,228,276,48,27,914,1,16,931
21,7,21015,122,3,556,362,357,69,34,1378,5,31,1414
21,7,21015,123,3,613,320,352,55,29,1369,9,37,1415
21,7,21015,126,3,544,294,352,70,24,1284,1,34,1319
21,7,21015,127,3,955,484,482,110,59,2090,6,61,2157
21,7,21015,130,3,382,238,184,42,18,864,7,15,886
21,7,21015,131,3,620,299,277,65,26,1287,1,41,1329
21,7,21039,317,3,426,419,312,19,12,1188,0,40,1228
21,7,21039,318,3,169,428,274,33,12,916,4,28,948
21,7,21041,323,3,338,326,243,38,15,960,5,38,1003
21,7,21099,823,3,133,260,106,18,8,525,2,25,552
21,7,21119,1643,3,108,166,253,35,4,566,1,19,586
21,7,21119,1646,3,143,336,302,20,8,809,6,16,831
21,7,21119,1647,3,26,83,67,5,1,182,7,4,193
21,7,21119,1650,3,245,208,380,47,5,885,9,34,928
21,7,21145,1868,3,316,341,352,26,7,1042,3,30,1075
21,7,21145,1870,3,294,325,315,41,15,990,2,32,1024
21,7,21145,1871,3,246,238,253,14,9,760,0,21,781
21,7,21150,1888,3,277,291,152,25,20,765,1,32,798
21,7,21150,1890,3,186,335,353,35,15,924,1,34,959
21,7,21152,1897,3,428,331,197,53,15,1024,5,33,1062
21,7,21152,1898,3,574,361,180,69,15,1199,0,21,1220
21,7,21152,1899,3,150,141,142,27,10,470,1,6,477
21,7,21152,1902,3,139,269,169,21,6,604,0,19,623
21,7,21152,1903,3,349,277,209,39,11,885,4,31,920
21,7,21162,2051,3,164,263,175,22,9,633,0,15,648
21,7,21162,2054,3,181,161,180,29,8,559,1,11,571
21,7,21162,2055,3,286,198,258,38,9,789,10,9,808
21,7,21163,2058,3,168,163,70,33,12,446,0,11,457
21,7,21163,2059,3,446,406,231,101,30,1214,7,51,1272
21,7,21163,2062,3,508,281,161,91,25,1066,0,31,1097
21,7,21163,2063,3,357,320,169,83,20,949,3,29,981
21,7,21163,2066,3,452,337,274,116,55,1234,10,33,1277
21,7,21163,2067,3,309,314,68,14,5,710,2,38,750
21,7,21163,2070,3,317,295,215,67,12,906,1,23,930
21,7,21163,2071,3,357,211,86,42,8,704,14,37,755
21,7,21163,2074,3,150,267,249,89,6,761,1,39,801
21,7,21163,2075,3,508,334,140,80,8,1070,3,57,1130
21,7,21163,2078,3,267,181,186,39,36,709,3,13,725
21,7,21163,2079,3,249,73,81,41,26,470,0,9,479
21,7,21182,2251,3,196,242,263,21,11,733,3,34,770
21,7,21115,2550,3,78,179,62,8,8,335,0,5,340
21,8,21012,103,3,246,130,82,9,5,472,2,18,492
21,8,21012,106,3,232,188,45,7,7,479,1,22,502
21,8,21023,234,3,130,316,308,18,6,778,2,21,801
21,8,21023,235,3,82,189,283,7,0,561,2,14,577
21,8,21023,238,3,27,161,216,5,0,409,2,8,419
21,8,21046,371,3,506,254,117,26,9,912,4,59,975
21,8,21046,374,3,429,333,221,94,20,1097,5,40,1142
21,8,21046,375,3,420,301,187,71,21,1000,4,38,1042
21,8,21046,378,3,217,165,95,29,5,511,1,31,543
21,8,21046,379,3,402,249,237,64,15,967,0,27,994
21,8,21046,382,3,152,199,127,8,3,489,0,14,503
21,8,21046,383,3,56,77,23,4,0,160,1,15,176
21,8,21046,386,3,362,273,216,26,7,884,0,37,921
21,8,21046,387,3,40,25,122,3,0,190,1,4,195
21,8,21046,390,3,287,184,88,7,2,568,1,30,599
21,8,21046,391,3,258,174,87,14,10,543,2,32,577
21,8,21046,394,3,40,80,11,3,1,135,1,12,148
21,8,21064,526,3,299,186,240,56,10,791,2,30,823
21,8,21064,527,3,219,100,150,31,5,505,3,13,521
21,8,21064,530,3,25,279,41,11,0,356,0,8,364
21,8,21064,531,3,272,348,253,23,12,908,11,44,963
21,8,21064,534,3,38,70,86,7,2,203,1,19,223
21,8,21066,544,3,186,139,350,23,23,721,2,28,751
21,8,21066,546,3,127,150,144,10,9,440,2,5,447
21,8,21066,547,3,250,134,211,24,11,630,6,33,669
21,8,21066,550,3,246,116,320,11,11,704,4,29,737
21,8,21111,897,3,210,168,222,27,16,643,9,28,680
21,8,21111,898,3,156,153,155,20,9,493,6,24,523
21,8,21111,899,3,274,341,199,16,12,842,7,22,871
21,8,21111,902,3,308,241,266,13,10,838,1,26,865
21,8,21111,903,3,137,110,158,4,3,412,5,24,441
21,8,21111,906,3,83,127,70,4,0,284,0,13,297
21,8,21111,907,3,312,153,275,12,15,767,4,28,799
21,8,21111,910,3,397,146,164,14,5,726,2,15,743
21,8,21111,911,3,250,123,138,7,4,522,1,17,540
21,8,21116,1610,3,354,229,318,32,25,958,2,32,992
21,8,21116,1611,3,257,279,227,9,15,787,10,14,811
21,8,21116,1614,3,106,241,237,12,10,606,0,17,623
21,8,21116,1615,3,106,185,181,21,15,508,5,16,529
21,8,21116,1618,3,135,35,233,7,6,416,0,37,453
21,8,21116,1619,3,342,302,475,29,14,1162,9,51,1222
21,8,21116,1622,3,263,81,372,28,10,754,3,30,787
21,8,21116,1623,3,251,62,440,22,18,793,5,9,807
21,8,21131,1715,3,128,128,78,8,3,345,1,19,365
21,8,21131,1718,3,104,58,61,6,3,232,0,8,240
21,8,21153,1906,3,306,173,373,74,26,952,2,20,974
21,8,21153,1907,3,229,176,371,60,32,868,0,14,882
21,8,21153,1910,3,424,292,476,63,43,1298,2,18,1318
21,8,21153,1911,3,472,236,617,116,39,1480,6,25,1511
21,8,21153,1914,3,192,102,416,41,21,772,0,13,785
21,8,21153,1915,3,316,90,225,20,17,668,1,8,677
21,8,21153,1918,3,283,126,301,41,15,766,9,24,799
21,8,21153,1919,3,222,209,523,37,13,1004,2,37,1043
21,8,21153,1922,3,149,93,253,13,8,516,0,19,535
21,8,21153,1923,3,55,78,202,9,7,351,0,9,360
21,8,21153,1926,3,198,190,801,24,18,1231,4,17,1252
21,8,21153,1927,3,151,258,190,8,5,612,1,17,630
21,8,21179,2219,3,342,232,162,34,13,783,1,27,811
21,8,21179,2222,3,223,97,188,26,14,548,3,19,570
21,8,21179,2223,3,181,92,96,10,9,388,1,18,407
21,8,21179,2226,3,191,138,41,6,9,385,3,15,403
21,8,21179,2227,3,375,111,106,6,2,600,0,18,618
21,8,21179,2230,3,147,164,100,17,7,435,1,14,450
21,8,21179,2231,3,357,232,53,29,4,675,13,27,715
21,8,21189,2310,3,383,100,669,37,20,1209,1,31,1241
21,8,21189,2311,3,382,81,479,24,21,987,6,20,1013
21,8,21189,2314,3,229,107,224,42,30,632,8,14,654
21,8,21189,2315,3,220,89,155,14,12,490,3,13,506
21,8,21203,2413,3,233,339,201,36,5,814,3,21,838
21,8,21203,2414,3,115,337,181,17,10,660,0,25,685
21,8,21203,2415,3,26,54,40,3,0,123,2,4,129
21,8,21205,2420,3,501,330,278,23,17,1149,4,15,1168
21,8,21205,2422,3,144,128,148,13,10,443,0,15,458
21,8,21205,2423,3,240,122,249,16,14,641,3,11,655
21,8,21205,2426,3,337,166,394,26,9,932,0,28,960
21,8,21205,2427,3,84,80,32,1,0,197,4,5,206
21,9,21115,934,3,110,62,67,29,11,279,1,8,288
21,9,21115,935,3,155,82,99,30,16,382,0,8,390
21,9,21115,938,3,105,31,47,9,4,196,0,3,199
21,9,21115,939,3,111,46,78,9,9,253,0,8,261
21,9,21115,942,3,466,201,232,56,38,993,2,26,1021
21,9,21115,943,3,362,153,178,70,29,792,1,13,806
21,9,21115,946,3,199,125,131,24,7,486,1,11,498
21,9,21115,947,3,353,190,203,41,21,808,2,17,827
21,9,21115,950,3,468,205,294,74,38,1079,0,29,1108
21,9,21115,951,3,524,267,283,59,33,1166,1,24,1191
21,9,21115,954,3,259,187,181,36,20,683,0,15,698
21,9,21115,955,3,235,137,150,21,12,555,1,10,566
21,9,21115,958,3,590,163,203,42,27,1025,1,18,1044
21,9,21115,959,3,410,169,187,48,34,848,4,22,874
21,9,21115,962,3,380,189,207,33,21,830,1,8,839
21,9,21115,963,3,259,110,156,44,22,591,0,12,603
21,9,21115,966,3,82,63,60,13,3,221,0,7,228
21,9,21115,967,3,119,55,61,19,7,261,0,7,268
21,9,21115,970,3,192,107,156,25,7,487,2,10,499
21,9,21115,971,3,85,59,64,22,7,237,0,6,243
21,9,21115,974,3,281,156,205,33,14,689,3,14,706
21,9,21115,975,3,247,156,119,24,12,558,1,12,571
21,9,21115,978,3,306,176,194,24,15,715,2,23,740
21,9,21115,979,3,281,175,220,47,15,738,1,11,750
21,9,21115,982,3,659,252,231,51,28,1221,1,24,1246
21,9,21115,983,3,602,242,297,67,28,1236,2,18,1256
21,9,21115,986,3,257,207,181,41,28,714,0,12,726
21,9,21115,987,3,126,76,107,11,10,330,0,13,343
21,9,21115,991,3,128,76,78,18,8,308,1,21,330
21,9,21115,994,3,186,88,121,31,6,432,1,5,438
21,9,21115,995,3,264,117,179,51,21,632,0,15,647
21,9,21115,998,3,370,124,250,65,25,834,1,10,845
21,9,21115,999,3,283,138,114,22,15,572,0,14,586
21,9,21115,1002,3,468,256,383,82,42,1231,2,25,1258
21,9,21115,1003,3,412,225,275,40,20,972,0,20,992
21,9,21115,1006,3,420,179,185,31,18,833,2,15,850
21,9,21115,1007,3,293,225,238,35,12,803,3,11,817
21,9,21115,1010,3,721,300,230,39,35,1325,4,11,1340
21,9,21115,1011,3,562,318,303,92,44,1319,2,22,1343
21,9,21115,1014,3,225,123,131,48,18,545,1,17,563
21,9,21115,1015,3,323,202,215,55,39,834,0,20,854
21,9,21115,1018,3,314,145,168,31,19,677,0,14,691
21,9,21115,1019,3,245,112,179,27,15,578,0,6,584
21,9,21115,1022,3,262,108,149,37,12,568,0,17,585
21,9,21115,1023,3,229,116,115,36,17,513,1,11,525
21,9,21115,1026,3,419,182,256,64,32,953,0,17,970
21,9,21115,1027,3,533,218,272,69,28,1120,2,23,1145
21,9,21115,1030,3,434,148,229,50,31,892,2,13,907
21,9,21115,1031,3,447,227,270,65,32,1041,2,23,1066
21,9,21115,1034,3,495,259,322,97,26,1199,0,24,1223
21,9,21115,1035,3,685,311,516,98,50,1660,1,31,1692
21,9,21115,1038,3,280,154,194,43,20,691,3,20,714
21,9,21115,1039,3,294,165,170,55,15,699,3,5,707
21,9,21115,1042,3,392,134,212,67,23,828,0,16,844
21,9,21115,1043,3,378,223,273,46,31,951,4,19,974
21,9,21115,1046,3,224,179,138,31,15,587,1,19,607
21,9,21115,1047,3,533,223,345,67,26,1194,0,11,1205
21,9,21115,1050,3,621,407,360,86,36,1510,6,21,1537
21,9,21115,1051,3,494,356,338,59,20,1267,4,16,1287
21,9,21115,1054,3,421,218,226,55,30,950,8,20,978
21,9,21115,1055,3,881,478,498,136,48,2041,2,47,2090
21,9,21115,1058,3,635,406,407,125,30,1603,0,37,1640
21,9,21115,1059,3,493,305,233,59,19,1109,3,29,1141
21,9,21115,1062,3,547,390,341,80,30,1388,7,63,1458
21,9,21115,1063,3,347,217,228,52,32,876,10,10,896
21,9,21115,1066,3,108,74,60,9,5,256,2,5,263
21,9,21115,1067,3,292,247,215,44,16,814,2,14,830
21,9,21115,1070,3,683,466,459,96,50,1754,12,44,1810
21,9,21115,1071,3,367,212,257,40,22,898,10,37,945
21,9,21115,1074,3,193,163,135,24,7,522,3,22,547
21,9,21115,1075,3,199,172,177,28,10,586,2,16,604
21,9,21115,1078,3,394,305,245,57,14,1015,4,29,1048
21,9,21115,1079,3,162,159,113,31,10,475,2,19,496
21,9,21115,1309,3,229,120,197,45,16,607,0,16,623
21,9,21115,1310,3,305,144,179,38,21,687,3,14,704
21,9,21115,1311,3,267,118,150,40,20,595,2,17,614
21,9,21115,1326,3,218,132,179,42,20,591,1,14,606
21,9,21115,1327,3,410,189,231,121,18,969,5,23,997
21,9,21115,1330,3,277,116,143,27,9,572,1,7,580
21,9,21115,1348,3,373,185,236,62,20,876,1,21,898
21,9,21115,1350,3,412,163,231,53,39,898,1,29,928
21,9,21115,1351,3,356,189,219,56,30,850,4,16,870
21,9,21115,1363,3,278,145,175,43,26,667,0,20,687
21,9,21115,1366,3,419,227,294,69,41,1050,0,32,1082
21,9,21115,1367,3,368,152,196,50,19,785,3,28,816
21,9,21115,1377,3,463,300,284,64,20,1131,5,25,1161
21,9,21115,1378,3,366,168,234,35,20,823,3,21,847
21,9,21115,1379,3,424,266,253,76,30,1049,4,19,1072
21,9,21115,1390,3,730,509,551,108,46,1944,15,57,2016
21,9,21115,1391,3,450,315,417,54,27,1263,5,46,1314
21,9,21115,1394,3,317,184,144,48,30,723,1,13,737
21,9,21115,1395,3,304,181,187,51,25,748,0,17,765
21,9,21115,1406,3,367,202,168,66,24,827,5,11,843
21,9,21115,1407,3,1741,1213,1243,361,134,4692,7,113,4812
21,9,21042,2549,3,86,38,61,12,1,198,4,5,207
21,10,21035,282,3,276,129,163,16,10,594,3,11,608
21,10,21035,283,3,341,390,527,48,23,1329,5,25,1359
21,10,21035,286,3,166,155,170,19,13,523,2,15,540
21,10,21035,287,3,193,210,163,15,13,594,1,8,603
21,10,21035,290,3,416,158,89,6,10,679,6,11,696
21,10,21035,291,3,259,338,210,18,13,838,0,33,871
21,10,21042,325,3,910,439,544,109,62,2064,3,57,2124
21,10,21042,326,3,474,287,339,59,27,1186,2,36,1224
21,10,21042,327,3,628,303,317,71,28,1347,6,36,1389
21,10,21042,330,3,691,319,368,98,52,1528,6,18,1552
21,10,21042,331,3,235,121,283,42,24,705,3,8,716
21,10,21042,334,3,233,86,176,24,21,540,5,7,552
21,10,21042,335,3,205,98,146,21,10,480,2,10,492
21,10,21042,338,3,417,245,349,44,13,1068,7,14,1089
21,10,21042,339,3,1789,795,882,196,116,3778,12,67,3857
21,10,21092,786,3,419,267,406,58,25,1175,3,35,1213
21,10,21092,787,3,145,266,180,15,4,610,1,25,636
21,10,21092,790,3,474,249,351,76,36,1186,4,13,1203
21,10,21092,791,3,333,158,419,31,13,954,2,25,981
21,10,21107,857,3,188,171,321,29,5,714,0,30,744
21,10,21107,858,3,170,175,289,23,13,670,2,28,700
21,10,21107,859,3,476,261,210,36,17,1000,6,26,1032
21,10,21107,862,3,91,221,348,27,10,697,0,13,710
21,10,21107,863,3,86,88,54,6,2,236,0,16,252
21,10,21107,866,3,85,258,114,15,5,477,1,20,498
21,10,21120,1651,3,494,236,240,61,32,1063,1,18,1082
21,10,21120,1654,3,584,280,271,60,22,1217,1,19,1237
21,10,21120,1655,3,361,219,279,82,18,959,1,20,980
21,10,21120,1658,3,340,148,254,40,28,810,0,20,830
21,10,21120,1659,3,337,125,196,30,10,698,2,7,707
21,10,21120,1662,3,294,135,206,29,17,681,0,28,709
21,10,21120,1663,3,1586,417,552,144,84,2783,7,44,2834
21,10,21120,1666,3,406,161,185,24,22,798,4,17,819
21,10,21120,1667,3,452,360,261,50,30,1153,4,29,1186
21,10,21120,1670,3,452,228,124,26,18,848,0,19,867
21,10,21120,1671,3,673,369,230,51,29,1352,2,18,1372
21,10,21126,1691,3,153,93,84,19,10,359,0,11,370
21,10,21126,1694,3,533,86,39,29,7,694,1,9,704
21,10,21127,1695,3,187,329,295,42,13,866,4,13,883
21,10,21137,1785,3,398,373,196,66,25,1058,1,14,1073
21,10,21137,1786,3,447,262,179,51,37,976,5,13,994
21,10,21137,1787,3,369,238,169,42,30,848,4,27,879
21,10,21141,1800,3,429,248,192,84,25,978,1,21,1000
21,10,21141,1802,3,460,221,196,73,31,981,0,18,999
21,10,21141,1803,3,533,338,241,130,38,1280,5,29,1314
21,10,21141,1806,3,235,137,108,61,11,552,0,11,563
21,10,21141,1807,3,416,300,198,95,34,1043,1,25,1069
21,10,21141,1810,3,270,174,116,80,27,667,2,23,692
21,10,21141,1811,3,266,275,169,144,23,877,1,31,909
21,10,21141,1814,3,165,113,92,47,10,427,0,21,448
21,10,21141,1815,3,476,253,250,127,25,1131,2,40,1173
21,10,21141,1818,3,602,318,280,156,36,1392,7,36,1435
21,10,21141,1819,3,350,182,146,110,18,806,5,18,829
21,10,21141,1822,3,306,145,357,36,10,854,0,15,869
21,10,21141,1823,3,302,204,95,25,10,636,2,10,648
21,10,21141,1826,3,550,193,165,72,13,993,2,30,1025
21,10,21141,1827,3,434,172,163,49,17,835,4,15,854
21,10,21141,1830,3,331,298,312,62,19,1022,6,34,1062
21,10,21141,1831,3,339,186,230,72,18,845,2,22,869
21,10,21141,1834,3,307,227,133,45,24,736,0,16,752
21,10,21141,1835,3,209,149,147,40,13,558,1,13,572
21,10,21141,1838,3,325,213,196,59,22,815,0,13,828
21,10,21141,1839,3,768,505,405,96,53,1827,3,21,1851
21,10,21141,1842,3,195,107,127,31,9,469,0,24,493
21,10,21141,1843,3,263,187,181,84,13,728,1,11,740
21,10,21181,2248,3,144,176,109,15,3,447,5,17,469
21,10,21181,2250,3,144,206,131,24,7,512,0,12,524
21,11,21115,1082,3,71,31,54,12,0,168,0,4,172
21,11,21115,1083,3,67,55,41,12,5,180,0,6,186
21,11,21115,1086,3,469,195,167,43,14,888,2,17,907
21,11,21115,1087,3,355,119,95,23,9,601,1,10,612
21,11,21115,1090,3,436,193,269,66,39,1003,2,17,1022
21,11,21115,1091,3,578,353,369,90,51,1441,1,41,1483
21,11,21115,1094,3,332,223,192,39,26,812,1,16,829
21,11,21115,1095,3,371,93,74,19,6,563,1,4,568
21,11,21115,1098,3,295,146,131,31,14,617,3,15,635
21,11,21115,1099,3,685,320,231,64,33,1333,2,21,1356
21,11,21115,1102,3,377,178,159,47,17,778,2,32,812
21,11,21115,1103,3,200,79,101,36,15,431,0,6,437
21,11,21115,1106,3,161,95,74,28,12,370,2,9,381
21,11,21115,1107,3,117,74,44,11,4,250,2,3,255
21,11,21115,1113,3,99,64,82,8,2,255,1,8,264
21,11,21115,1114,3,148,101,67,19,14,349,2,2,353
21,11,21115,1115,3,124,68,65,26,11,294,2,18,314
21,11,21115,1118,3,332,150,176,35,23,716,0,14,730
21,11,21115,1119,3,165,63,58,17,7,310,0,6,316
21,11,21115,1122,3,272,124,137,36,20,589,6,11,606
21,11,21115,1123,3,237,120,133,26,9,525,0,8,533
21,11,21115,1126,3,327,136,159,28,15,665,1,16,682
21,11,21115,1127,3,744,361,386,125,39,1655,10,32,1697
21,11,21115,1130,3,459,181,227,63,23,953,3,20,976
21,11,21115,1131,3,632,257,146,73,44,1152,3,19,1174
21,11,21115,1134,3,426,174,233,50,24,907,1,15,923
21,11,21115,1135,3,257,164,202,48,22,693,4,5,702
21,11,21115,1138,3,292,147,135,30,16,620,1,7,628
21,11,21115,1139,3,229,70,76,31,13,419,1,7,427
21,11,21115,1143,3,264,90,101,29,24,508,3,11,522
21,11,21115,1146,3,375,160,117,49,27,728,2,11,741
21,11,21115,1147,3,468,152,136,28,15,799,0,5,804
21,11,21115,1150,3,350,214,196,58,27,845,0,24,869
21,11,21115,1151,3,360,189,171,47,29,796,2,13,811
21,11,21115,1154,3,865,213,128,44,22,1272,0,17,1289
21,11,21115,1155,3,875,198,118,54,20,1265,1,8,1274
21,11,21115,1158,3,602,185,123,41,18,969,3,10,982
21,11,21115,1159,3,569,143,126,42,22,902,1,12,915
21,11,21115,1162,3,444,127,89,27,23,710,1,6,717
21,11,21115,1163,3,571,158,145,51,21,946,2,16,964
21,11,21115,1166,3,323,135,127,39,15,639,0,7,646
21,11,21115,1167,3,438,182,140,30,17,807,0,11,818
21,11,21115,1170,3,380,176,131,41,14,742,0,9,751
21,11,21115,1171,3,494,152,203,48,23,920,0,4,924
21,11,21115,1174,3,460,228,183,64,33,968,0,13,981
21,11,21115,1175,3,584,280,223,103,35,1225,4,25,1254
21,11,21115,1178,3,509,245,237,69,31,1091,3,27,1121
21,11,21115,1183,3,357,172,151,53,16,749,0,0,749
21,11,21115,1186,3,695,227,239,81,30,1272,2,11,1285
21,11,21115,1187,3,724,264,271,65,32,1356,4,14,1374
21,11,21115,1190,3,499,360,341,137,33,1370,4,17,1391
21,11,21115,1191,3,572,338,344,89,36,1379,9,5,1393
21,11,21115,1194,3,680,335,359,89,38,1501,0,31,1532
21,11,21115,1204,3,689,532,446,130,38,1835,8,28,1871
21,11,21115,1206,3,907,569,452,220,51,2199,9,42,2250
21,11,21115,1207,3,188,238,132,51,16,625,6,20,651
21,11,21115,1210,3,244,183,149,59,19,654,1,19,674
21,11,21115,1215,3,432,269,232,88,28,1049,1,17,1067
21,11,21115,1218,3,388,259,179,70,34,930,3,25,958
21,11,21115,1219,3,516,339,347,114,45,1361,6,25,1392
21,11,21115,1222,3,318,187,183,49,25,762,3,20,785
21,11,21115,1223,3,134,149,92,30,10,415,0,4,419
21,11,21115,1226,3,180,162,112,42,17,513,2,14,529
21,11,21115,1227,3,283,193,160,48,25,709,2,16,727
21,11,21115,1230,3,289,186,112,69,11,667,2,9,678
21,11,21115,1231,3,224,135,95,79,16,549,1,9,559
21,11,21115,1234,3,2574,2015,1644,520,187,6940,39,122,7101
21,11,21115,1235,3,250,182,183,56,27,698,0,16,714
21,11,21115,1238,3,850,598,452,126,73,2099,8,37,2144
21,11,21115,1239,3,130,154,127,56,11,478,2,17,497
21,11,21115,1242,3,711,547,422,123,41,1844,7,21,1872
21,11,21115,1243,3,489,396,278,68,25,1256,7,38,1301
21,11,21115,1246,3,591,435,428,120,47,1621,10,40,1671
21,11,21115,1247,3,2286,1991,1575,386,152,6390,40,184,6614
21,11,21115,1250,3,1521,1206,969,253,119,4068,35,99,4202
21,11,21115,1251,3,504,332,400,110,37,1383,3,19,1405
21,11,21115,1254,3,271,459,234,57,17,1038,7,26,1071
21,11,21115,1255,3,200,512,190,46,20,968,1,41,1010
21,11,21115,1258,3,102,246,77,6,0,431,0,19,450
21,11,21115,1259,3,354,635,219,23,11,1242,5,76,1323
21,12,21115,1080,3,47,36,55,6,5,149,0,4,153
21,12,21115,1109,3,110,34,59,15,10,228,2,11,241
21,12,21115,1110,3,98,37,51,16,6,208,2,4,214
21,12,21115,1111,3,398,170,234,48,39,889,8,19,916
21,12,21115,1142,3,635,173,210,43,21,1082,2,17,1101
21,12,21115,1172,3,674,174,212,52,18,1130,0,16,1146
21,12,21115,1179,3,528,167,207,51,37,990,1,12,1003
21,12,21115,1182,3,654,231,317,56,50,1308,2,15,1325
21,12,21115,1195,3,561,252,311,80,37,1241,0,28,1269
21,12,21115,1198,3,452,195,392,69,39,1147,1,21,1169
21,12,21115,1199,3,460,246,397,70,43,1216,3,11,1230
21,12,21115,1202,3,396,217,279,52,34,978,1,26,1005
21,12,21115,1203,3,381,203,252,61,21,918,1,7,926
21,12,21115,1211,3,416,286,349,87,37,1175,2,40,1217
21,12,21115,1214,3,1157,711,753,210,95,2926,14,50,2990
21,12,21115,1256,3,61,416,43,4,2,526,1,19,546
21,12,21115,1260,3,297,693,150,10,6,1156,8,37,1201
21,12,21115,1423,3,88,50,62,8,5,213,1,5,219
21,12,21115,1426,3,200,67,113,30,15,425,4,8,437
21,12,21115,1427,3,126,143,122,19,18,428,4,12,444
21,12,21115,1430,3,264,113,142,59,10,588,4,18,610
21,12,21115,1431,3,201,121,143,53,15,533,2,18,553
21,12,21115,1434,3,483,193,217,32,26,951,1,20,972
21,12,21115,1435,3,450,124,126,29,18,747,2,7,756
21,12,21115,1438,3,371,155,182,114,14,836,2,25,863
21,12,21115,1439,3,275,123,111,19,10,538,0,9,547
21,12,21115,1442,3,314,114,143,35,11,617,4,11,632
21,12,21115,1443,3,315,140,169,40,18,682,2,13,697
21,12,21115,1446,3,312,157,176,62,25,732,1,13,746
21,12,21115,1447,3,372,180,218,41,32,843,4,11,858
21,12,21115,1450,3,441,121,100,22,14,698,1,6,705
21,12,21115,1451,3,357,85,89,17,16,564,1,4,569
21,12,21115,1454,3,454,231,257,54,28,1024,2,9,1035
21,12,21115,1455,3,682,184,131,37,16,1050,0,6,1056
21,12,21115,1458,3,483,177,197,43,33,933,4,13,950
21,12,21115,1459,3,435,282,269,56,37,1079,1,24,1104
21,12,21115,1462,3,296,155,192,49,20,712,3,16,731
21,12,21115,1463,3,275,137,166,38,25,641,0,20,661
21,12,21115,1466,3,256,155,194,40,15,660,0,20,680
21,12,21115,1467,3,263,191,204,46,24,728,7,8,743
21,12,21115,1470,3,345,214,178,33,21,791,3,13,807
21,12,21115,1471,3,445,227,335,64,23,1094,1,23,1118
21,12,21115,1474,3,389,196,271,55,27,938,1,14,953
21,12,21115,1475,3,317,181,207,31,21,757,4,15,776
21,12,21115,1478,3,441,148,176,21,18,804,0,9,813
21,12,21115,1479,3,416,196,176,22,18,828,0,8,836
21,12,21115,1482,3,499,215,277,45,43,1079,1,6,1086
21,12,21115,1483,3,331,215,221,69,30,866,0,21,887
21,12,21115,1486,3,184,201,163,35,6,589,4,11,604
21,12,21115,1487,3,198,173,169,36,21,597,3,10,610
21,12,21115,1490,3,307,204,184,57,22,774,6,30,810
21,12,21115,1491,3,515,264,272,80,50,1181,2,19,1202
21,12,21115,1494,3,396,200,261,65,34,956,1,15,972
21,12,21115,1495,3,197,134,117,21,7,476,0,7,483
21,12,21115,1498,3,439,208,272,34,27,980,2,14,996
21,12,21115,1499,3,221,149,115,29,17,531,4,6,541
21,12,21115,1502,3,369,235,215,32,16,867,2,13,882
21,12,21115,1503,3,533,127,170,20,14,864,1,10,875
21,12,21115,1506,3,442,197,266,37,19,961,0,22,983
21,12,21115,1507,3,400,152,222,57,19,850,0,7,857
21,12,21115,1510,3,397,190,310,63,27,987,1,17,1005
21,12,21115,1511,3,509,229,253,43,22,1056,0,10,1066
21,12,21115,1514,3,233,194,128,34,17,606,2,12,620
21,12,21115,1515,3,169,146,108,28,7,458,1,3,462
21,12,21115,1518,3,335,223,162,35,19,774,3,5,782
21,12,21115,1519,3,293,181,165,41,25,705,5,10,720
21,12,21115,1522,3,368,244,240,62,25,939,2,23,964
21,12,21115,1523,3,353,169,217,56,16,811,0,11,822
21,12,21115,1526,3,336,165,226,50,19,796,2,9,807
21,12,21115,1527,3,319,131,186,48,23,707,0,9,716
21,12,21115,1530,3,430,309,214,82,32,1067,5,20,1092
21,12,21115,1531,3,380,363,221,55,29,1048,5,16,1069
21,12,21115,1534,3,763,595,547,194,66,2165,6,48,2219
21,12,21115,1535,3,442,217,460,72,40,1231,3,30,1264
21,12,21115,1538,3,353,256,207,52,28,896,0,17,913
21,12,21115,1539,3,432,314,224,71,33,1074,0,17,1091
21,12,21115,1550,3,421,400,239,72,20,1152,16,41,1209
21,12,21115,1551,3,428,268,267,66,30,1059,4,31,1094
21,12,21115,1554,3,201,203,150,39,11,604,11,23,638
21,12,21115,1555,3,658,354,493,79,38,1622,2,32,1656
21,12,21115,1558,3,686,188,174,38,19,1105,3,9,1117
21,12,21115,1559,3,449,153,262,34,25,923,0,10,933
21,12,21115,1562,3,790,543,621,132,58,2144,14,40,2198
21,12,21115,1563,3,271,170,171,24,15,651,10,23,684
21,12,21115,1566,3,306,295,218,41,23,883,3,27,913
21,12,21115,1567,3,950,297,372,56,45,1720,0,19,1739
21,12,21115,1582,3,329,302,225,39,22,917,8,28,953
21,12,21115,1590,3,426,261,252,54,17,1010,5,23,1038
21,12,21115,1591,3,297,256,185,32,15,785,0,0,785
21,12,21115,1599,3,272,264,222,37,27,822,1,17,840
21,12,21115,1602,3,79,54,59,4,2,198,0,3,201
21,12,21115,1603,3,347,344,303,37,12,1043,2,32,1077
21,12,21115,1606,3,658,524,323,70,25,1600,7,41,1648
21,12,21115,1607,3,336,447,214,25,23,1045,1,13,1059
21,13,21005,61,3,63,305,57,2,5,432,0,23,455
21,13,21005,62,3,53,193,30,5,3,284,0,13,297
21,13,21005,63,3,42,123,15,2,0,182,1,5,188
21,13,21007,71,3,114,134,37,10,2,297,0,18,315
21,13,21007,74,3,23,83,22,3,0,131,0,11,142
21,13,21019,154,3,372,209,234,25,12,852,5,18,875
21,13,21019,155,3,99,53,49,8,3,212,1,5,218
21,13,21019,158,3,254,183,97,27,10,571,2,17,590
21,13,21019,159,3,407,156,257,77,13,910,6,21,937
21,13,21019,162,3,468,187,191,55,31,932,1,21,954
21,13,21019,163,3,734,364,487,117,42,1744,8,45,1797
21,13,21019,166,3,432,154,203,87,27,903,2,25,930
21,13,21019,167,3,305,181,198,80,18,782,2,13,797
21,13,21019,170,3,323,226,151,34,11,745,8,14,767
21,13,21019,171,3,148,77,77,12,14,328,4,7,339
21,13,21019,174,3,351,324,235,39,7,956,4,19,979
21,13,21019,175,3,252,107,133,42,12,546,2,12,560
21,13,21019,178,3,355,166,233,60,24,838,2,14,854
21,13,21019,179,3,224,105,120,28,13,490,0,8,498
21,13,21019,182,3,139,62,82,29,6,318,4,9,331
21,13,21019,183,3,133,54,69,25,4,285,0,7,292
21,13,21019,186,3,477,200,290,68,16,1051,0,28,1079
21,13,21019,187,3,233,146,146,41,11,577,2,8,587
21,13,21019,190,3,265,123,166,60,8,622,0,19,641
21,13,21019,191,3,255,158,176,35,11,635,1,11,647
21,13,21019,194,3,258,114,145,33,9,559,1,11,571
21,13,21019,195,3,182,57,82,10,5,336,2,6,344
21,13,21019,198,3,259,140,201,64,19,683,2,13,698
21,13,21019,199,3,220,188,179,57,14,658,0,16,674
21,13,21019,202,3,226,190,153,32,10,611,3,21,635
21,13,21019,203,3,237,167,105,10,4,523,6,21,550
21,13,21019,206,3,48,234,144,10,2,438,8,28,474
21,13,21019,207,3,274,241,93,15,4,627,2,16,645
21,13,21019,210,3,94,44,10,1,1,150,0,5,155
21,13,21019,211,3,194,213,5,4,2,418,2,4,424
21,13,21019,214,3,365,200,42,5,3,615,0,10,625
21,13,21019,215,3,461,94,110,24,5,694,2,19,715
21,13,21019,218,3,173,103,60,10,4,350,0,23,373
21,13,21019,219,3,361,180,64,22,0,627,0,17,644
21,13,21020,222,3,139,285,401,37,15,877,10,20,907
21,13,21020,223,3,161,336,538,35,9,1079,2,29,1110
21,13,21022,226,3,51,128,550,6,2,737,1,21,759
21,13,21022,227,3,62,270,209,5,4,550,0,21,571
21,13,21022,230,3,74,172,68,3,1,318,0,6,324
21,13,21022,231,3,39,51,74,8,3,175,0,10,185
21,13,21032,274,3,160,312,210,16,7,705,3,21,729
21,13,21032,275,3,73,203,120,6,11,413,0,17,430
21,13,21034,279,3,92,439,61,24,5,621,6,16,643
21,13,21053,459,3,62,178,45,12,4,301,0,0,301
21,13,21063,524,3,303,331,164,34,10,842,2,19,863
21,13,21070,569,3,155,323,136,14,6,634,1,15,650
21,13,21070,570,3,109,187,59,13,5,373,0,9,382
21,13,21070,571,3,163,178,26,9,3,379,0,8,387
21,13,21070,574,3,141,227,79,7,0,454,2,18,474
21,13,21070,575,3,84,199,87,19,3,392,6,25,423
21,13,21070,578,3,45,201,293,6,1,546,0,8,554
21,13,21070,579,3,140,193,84,25,1,443,3,21,467
21,13,21070,582,3,124,172,38,12,3,349,2,14,365
21,13,21070,583,3,236,82,64,20,5,407,4,5,416
21,13,21070,586,3,56,181,40,7,2,286,6,8,300
21,13,21070,587,3,38,51,34,2,4,129,2,9,140
21,13,21071,590,3,295,143,105,2,0,545,0,35,580
21,13,21071,591,3,103,178,174,15,3,473,0,30,503
21,13,21075,646,3,160,160,131,18,7,476,2,6,484
21,13,21075,647,3,153,302,130,20,6,611,3,28,642
21,13,21075,650,3,28,58,47,2,0,135,0,3,138
21,13,21081,701,3,187,184,232,23,13,639,0,10,649
21,13,21081,702,3,141,195,138,16,19,509,4,22,535
21,13,21081,703,3,76,261,284,19,13,653,0,16,669
21,13,21097,820,3,126,115,10,0,0,251,0,2,253
21,13,21100,825,3,112,145,352,22,10,641,1,9,651
21,13,21100,826,3,12,231,421,9,2,675,4,11,690
21,13,21100,827,3,16,149,151,5,4,325,4,6,335
21,13,21122,1674,3,74,106,119,5,1,305,0,8,313
21,13,21122,1675,3,16,33,24,1,2,76,2,2,80
21,13,21132,1719,3,120,154,40,6,4,324,0,6,330
21,13,21134,1774,3,11,130,124,8,1,274,0,4,278
21,13,21146,1872,3,64,197,114,6,7,388,0,11,399
21,13,21148,1877,3,257,167,196,21,14,655,6,13,674
21,13,21148,1878,3,106,122,128,14,11,381,0,16,397
21,13,21148,1879,3,47,82,41,9,8,187,0,11,198
21,13,21158,2033,3,167,405,57,6,5,640,4,113,757
21,13,21158,2034,3,218,283,76,5,5,587,2,31,620
21,13,21158,2035,3,76,50,20,0,0,146,0,0,146
21,13,21164,2082,3,28,170,47,3,0,248,0,10,258
21,13,21165,2083,3,148,156,143,21,4,472,2,26,500
21,13,21165,2086,3,50,84,135,6,4,279,0,10,289
21,13,21165,2087,3,28,287,57,0,2,374,1,9,384
21,13,21167,2095,3,92,185,225,26,3,531,0,9,540
21,13,21170,2116,3,278,321,530,78,17,1224,4,33,1261
21,13,21174,2175,3,97,139,70,7,4,317,0,4,321
21,13,21174,2178,3,168,190,70,4,5,437,0,15,452
21,13,21174,2179,3,144,195,24,8,1,372,0,8,380
21,13,21185,2267,3,274,120,153,8,3,558,5,14,577
21,13,21185,2270,3,115,267,154,13,11,560,2,7,569
21,13,21185,2271,3,76,137,167,14,12,406,9,23,438
21,13,21188,2299,3,126,279,30,5,0,440,4,23,467
21,13,21188,2302,3,44,193,130,3,2,372,1,10,383
21,13,21188,2303,3,130,223,42,3,2,400,4,8,412
21,13,21188,2306,3,321,329,126,12,2,790,0,19,809
21,13,21188,2307,3,84,80,83,1,1,249,0,4,253
21,13,21193,2329,3,142,347,40,11,2,542,0,4,546
21,13,21193,2330,3,369,197,48,6,2,622,2,13,637
21,13,21193,2331,3,202,101,53,3,6,365,1,26,392
21,13,21201,2407,3,209,300,112,11,4,636,2,22,660
21,13,21206,2429,3,181,158,69,11,2,421,1,13,435
21,13,21206,2430,3,59,80,54,4,8,205,0,13,218
21,13,21206,2431,3,132,328,111,5,6,582,7,6,595
21,14,21003,28,3,171,305,366,257,15,1114,2,34,1150
21,14,21003,30,3,158,210,223,178,8,777,1,29,807
21,14,21003,31,3,225,273,340,162,11,1011,4,33,1048
21,14,21003,34,3,265,261,476,160,11,1173,2,32,1207
21,14,21003,35,3,358,483,155,54,5,1055,1,55,1111
21,14,21003,38,3,99,205,126,56,6,492,0,42,534
21,14,21003,39,3,217,321,156,88,5,787,2,50,839
21,14,21003,42,3,14,24,57,11,3,109,1,5,115
21,14,21003,43,3,14,115,17,2,1,149,0,15,164
21,14,21009,79,3,47,350,362,52,3,814,0,24,838
21,14,21011,102,3,164,352,52,11,1,580,0,14,594
21,14,21021,224,3,83,300,80,12,2,477,4,16,497
21,14,21024,239,3,92,64,39,7,2,204,0,6,210
21,14,21033,277,3,85,227,40,18,5,375,0,27,402
21,14,21033,278,3,24,97,36,6,1,164,0,2,166
21,14,21043,340,3,80,416,121,15,1,633,0,14,647
21,14,21043,342,3,17,72,106,6,2,203,0,9,212
21,14,21043,343,3,11,88,50,2,0,151,0,10,161
21,14,21048,398,3,199,397,252,116,8,972,1,37,1010
21,14,21048,399,3,92,194,166,50,10,512,0,23,535
21,14,21048,402,3,133,235,163,66,10,607,2,22,631
21,14,21048,403,3,123,240,204,57,10,634,0,36,670
21,14,21048,406,3,82,179,29,4,3,297,0,15,312
21,14,21048,407,3,68,47,14,2,0,131,0,4,135
21,14,21048,410,3,3,54,10,4,0,71,0,3,74
21,14,21048,411,3,3,34,7,1,0,45,0,0,45
21,14,21048,414,3,10,101,18,1,0,130,0,4,134
21,14,21052,439,3,171,167,310,23,4,675,1,11,687
21,14,21052,442,3,110,169,163,6,7,455,2,14,471
21,14,21052,443,3,59,298,157,12,3,529,0,16,545
21,14,21052,446,3,80,241,250,28,10,609,2,15,626
21,14,21052,447,3,127,344,334,22,7,834,1,25,860
21,14,21052,450,3,111,446,462,46,14,1079,0,24,1103
21,14,21052,451,3,98,171,98,7,7,381,0,7,388
21,14,21052,454,3,66,110,214,44,2,436,2,9,447
21,14,21052,455,3,92,178,71,3,6,350,2,9,361
21,14,21052,458,3,178,192,135,4,8,517,0,25,542
21,14,21056,496,3,76,296,422,37,2,833,0,20,853
21,14,21056,498,3,21,199,146,5,1,372,0,12,384
21,14,21056,499,3,38,66,33,1,1,139,0,0,139
21,14,21060,512,3,158,225,111,73,7,574,2,18,594
21,14,21060,514,3,8,96,17,4,0,125,0,5,130
21,14,21067,551,3,179,467,239,12,4,901,0,42,943
21,14,21067,554,3,57,285,115,4,3,464,2,35,501
21,14,21074,640,3,266,344,179,31,4,824,1,33,858
21,14,21074,642,3,233,242,63,6,1,545,1,35,581
21,14,21074,643,3,178,268,53,7,3,509,3,26,538
21,14,21083,706,3,76,295,160,8,3,542,0,23,565
21,14,21083,707,3,83,208,101,15,6,413,0,14,427
21,14,21087,730,3,75,203,248,26,5,557,2,17,576
21,14,21087,731,3,102,158,278,39,9,586,1,10,597
21,14,21087,734,3,121,220,312,44,11,708,1,14,723
21,14,21087,735,3,100,235,359,41,6,741,3,22,766
21,14,21087,738,3,76,114,246,27,6,469,3,7,479
21,14,21087,739,3,134,290,509,113,18,1064,5,30,1099
21,14,21087,742,3,115,175,341,39,4,674,0,14,688
21,14,21087,743,3,100,410,354,39,11,914,4,20,938
21,14,21087,746,3,190,338,604,27,11,1170,2,46,1218
21,14,21087,747,3,52,210,242,28,8,540,7,21,568
21,14,21087,750,3,24,167,193,4,9,397,4,17,418
21,14,21087,751,3,50,159,310,17,1,537,1,15,553
21,14,21087,754,3,71,150,344,28,8,601,1,20,622
21,14,21087,755,3,30,148,255,40,5,478,0,19,497
21,14,21087,758,3,66,427,585,48,7,1133,0,30,1163
21,14,21087,759,3,25,171,344,12,2,554,0,17,571
21,14,21087,762,3,77,313,186,5,5,586,6,33,625
21,14,21087,763,3,36,172,80,3,1,292,0,18,310
21,14,21089,770,3,190,281,748,2,1,1222,0,24,1246
21,14,21089,771,3,91,393,310,3,2,799,1,11,811
21,14,21089,774,3,70,127,166,9,1,373,3,19,395
21,14,21089,775,3,45,103,129,3,2,282,0,16,298
21,14,21113,922,3,173,195,262,56,14,700,0,27,727
21,14,21113,923,3,129,176,134,44,8,491,2,20,513
21,14,21113,926,3,79,245,167,13,5,509,3,26,538
21,14,21113,927,3,44,309,146,8,2,509,1,19,529
21,14,21114,930,3,35,78,17,8,2,140,0,3,143
21,14,21114,931,3,18,99,64,5,0,186,0,5,191
21,14,21128,1698,3,37,218,149,55,7,466,0,16,482
21,14,21128,1699,3,34,199,113,104,13,463,0,28,491
21,14,21136,1784,3,63,197,28,5,2,295,0,5,300
21,14,21140,1798,3,53,435,576,46,2,1112,0,29,1141
21,14,21140,1799,3,14,172,172,8,1,367,0,5,372
21,14,21142,1846,3,235,323,78,39,6,681,0,8,689
21,14,21142,1847,3,159,387,185,25,3,759,0,31,790
21,14,21147,1873,3,194,266,143,49,4,656,0,32,688
21,14,21147,1874,3,75,147,93,41,4,360,0,14,374
21,14,21147,1875,3,158,361,54,26,14,613,2,24,639
21,14,21154,1929,3,62,342,104,14,5,527,1,17,545
21,14,21154,1930,3,40,352,91,15,6,504,0,7,511
21,14,21154,1931,3,64,138,114,16,4,336,0,19,355
21,14,21156,2017,3,125,250,261,115,4,755,0,31,786
21,14,21156,2018,3,152,326,216,63,9,766,0,19,785
21,14,21156,2019,3,163,283,218,112,4,780,0,33,813
21,14,21156,2022,3,47,200,115,8,1,371,0,23,394
21,14,21156,2023,3,113,269,161,30,3,576,0,42,618
21,14,21159,2038,3,168,200,130,16,5,519,0,24,543
21,14,21159,2039,3,35,144,22,8,5,214,1,26,241
21,14,21175,2181,3,269,541,289,21,8,1128,2,44,1174
21,14,21175,2182,3,141,363,261,11,2,778,7,37,822
21,14,21175,2183,3,148,357,443,50,11,1009,1,31,1041
21,14,21191,2319,3,69,205,163,9,9,455,1,19,475
21,14,21191,2322,3,32,255,146,10,0,443,0,9,452
21,14,21191,2323,3,12,232,20,2,1,267,0,13,280
21,14,21196,2360,3,46,122,86,54,2,310,0,14,324
21,14,21198,2391,3,45,169,20,2,1,237,0,7,244
21,15,21149,1882,3,388,271,249,32,6,946,0,28,974
21,15,21149,1883,3,422,256,210,40,16,944,1,22,967
21,15,21149,1886,3,26,125,21,1,1,174,0,0,174
21,15,21149,1887,3,190,304,219,17,11,741,5,13,759
21,15,21155,1934,3,1304,991,1068,235,71,3669,10,107,3786
21,15,21155,1935,3,429,369,336,82,25,1241,0,31,1272
21,15,21155,1938,3,774,539,553,215,41,2122,7,46,2175
21,15,21155,1939,3,141,78,72,55,4,350,0,7,357
21,15,21155,1942,3,525,427,474,85,25,1536,5,58,1599
21,15,21155,1943,3,474,261,278,65,28,1106,1,36,1143
21,15,21155,1946,3,271,183,234,77,13,778,2,34,814
21,15,21155,1947,3,243,211,175,64,10,703,1,26,730
21,15,21155,1950,3,383,187,173,51,21,815,1,16,832
21,15,21155,1951,3,417,227,202,69,15,930,0,20,950
21,15,21155,1954,3,332,152,121,68,26,699,0,14,713
21,15,21155,1955,3,542,225,251,122,27,1167,3,26,1196
21,15,21155,1958,3,433,160,157,67,25,842,0,28,870
21,15,21155,1959,3,394,208,206,78,22,908,0,26,934
21,15,21155,1962,3,448,259,295,209,36,1247,1,21,1269
21,15,21155,1963,3,241,169,194,45,13,662,0,19,681
21,15,21155,1966,3,297,151,142,55,19,664,0,14,678
21,15,21155,1967,3,295,128,64,29,11,527,4,9,540
21,15,21155,1970,3,397,171,201,66,18,853,4,20,877
21,15,21155,1971,3,901,347,279,87,36,1650,1,20,1671
21,15,21155,1974,3,151,99,78,32,8,368,0,9,377
21,15,21155,1975,3,178,105,135,55,13,486,1,9,496
21,15,21155,1978,3,543,302,218,91,27,1181,2,28,1211
21,15,21155,1979,3,503,237,239,62,19,1060,2,8,1070
21,15,21155,1982,3,302,141,198,49,10,700,0,17,717
21,15,21155,1983,3,133,86,87,16,10,332,0,7,339
21,15,21155,1986,3,890,884,753,109,39,2675,2,90,2767
21,15,21155,1987,3,400,285,255,35,18,993,4,37,1034
21,15,21155,1990,3,441,299,204,56,24,1024,1,26,1051
21,15,21155,1991,3,379,246,225,79,12,941,3,21,965
21,15,21155,1994,3,497,324,231,101,19,1172,10,29,1211
21,15,21155,1995,3,353,376,288,62,17,1096,6,26,1128
21,15,21155,1998,3,401,148,201,46,12,808,0,18,826
21,15,21155,1999,3,482,433,462,84,30,1491,1,37,1529
21,15,21155,2002,3,417,318,336,78,24,1173,10,34,1217
21,15,21155,2003,3,419,515,413,50,28,1425,3,53,1481
21,15,21155,2006,3,1073,703,495,130,42,2443,5,33,2481
21,15,21155,2007,3,416,276,142,21,12,867,1,27,895
21,15,21155,2010,3,367,233,48,13,0,661,0,7,668
21,15,21155,2011,3,517,565,353,67,19,1521,7,71,1599
21,15,21155,2014,3,177,200,170,9,4,560,1,18,579
21,15,21155,2015,3,318,325,108,3,4,758,1,16,775
21,15,21160,2042,3,444,192,304,65,9,1014,1,20,1035
21,15,21160,2043,3,123,252,246,31,6,658,4,30,692
21,15,21160,2046,3,291,298,160,39,14,802,0,23,825
21,15,21160,2047,3,164,404,308,33,15,924,2,29,955
21,15,21176,2184,3,259,172,191,44,22,688,1,7,696
21,15,21176,2186,3,119,39,139,5,9,311,2,11,324
21,15,21176,2187,3,88,120,81,3,5,297,0,13,310
21,15,21176,2190,3,355,178,396,30,15,974,6,48,1028
21,15,21176,2191,3,221,236,314,21,13,805,0,21,826
21,15,21176,2194,3,126,162,180,9,5,482,3,34,519
21,15,21176,2195,3,105,293,62,7,2,469,2,28,499
21,15,21176,2198,3,117,181,253,29,5,585,3,32,620
21,15,21176,2199,3,302,468,257,34,18,1079,1,33,1113
21,16,21010,80,3,394,680,237,92,12,1415,1,65,1481
21,16,21010,82,3,228,451,194,284,5,1162,3,42,1207
21,16,21010,83,3,472,381,165,119,7,1144,0,49,1193
21,16,21010,86,3,109,235,221,81,1,647,5,20,672
21,16,21010,87,3,51,187,31,0,8,277,1,55,333
21,16,21010,90,3,111,215,111,2,15,454,1,63,518
21,16,21010,91,3,90,262,55,3,9,419,0,52,471
21,16,21010,94,3,49,359,120,2,3,533,0,73,606
21,16,21010,95,3,77,170,75,3,0,325,0,55,380
21,16,21010,98,3,17,80,30,2,2,131,0,8,139
21,16,21010,99,3,17,155,83,24,0,279,4,11,294
21,16,21013,107,3,306,306,409,77,6,1104,2,15,1121
21,16,21013,110,3,287,283,339,45,5,959,1,22,982
21,16,21013,111,3,301,210,265,37,1,814,0,19,833
21,16,21018,148,3,118,249,81,18,6,472,2,9,483
21,16,21018,150,3,58,28,29,2,2,119,0,2,121
21,16,21018,151,3,62,63,73,3,1,202,2,2,206
21,16,21027,253,3,107,185,57,6,2,357,0,11,368
21,16,21027,254,3,143,238,91,13,13,498,2,24,524
21,16,21027,255,3,48,70,24,2,5,149,0,8,157
21,16,21027,258,3,81,82,50,0,0,213,0,3,216
21,16,21027,259,3,1,33,1,0,0,35,0,1,36
21,16,21029,262,3,237,323,165,30,7,762,1,26,789
21,16,21029,263,3,254,208,147,13,4,626,1,10,637
21,16,21029,266,3,79,67,91,10,3,250,0,10,260
21,16,21029,267,3,95,266,31,2,1,395,1,19,415
21,16,21029,270,3,250,582,306,23,10,1171,2,53,1226
21,16,21036,294,3,84,136,149,48,7,424,0,2,426
21,16,21036,295,3,57,99,116,22,0,294,0,11,305
21,16,21036,298,3,86,369,173,4,5,637,0,63,700
21,16,21036,299,3,92,491,51,8,6,648,1,22,671
21,16,21036,302,3,126,151,166,5,2,450,6,18,474
21,16,21036,303,3,46,97,108,17,1,269,3,8,280
21,16,21037,306,3,242,376,162,15,7,802,0,72,874
21,16,21037,307,3,170,340,128,30,5,673,1,63,737
21,16,21037,310,3,148,214,224,15,4,605,0,51,656
21,16,21037,311,3,106,151,149,13,5,424,0,55,479
21,16,21038,314,3,153,252,120,18,7,550,0,16,566
21,16,21038,315,3,31,139,72,25,3,270,0,2,272
21,16,21047,395,3,550,451,188,20,11,1220,0,26,1246
21,16,21062,518,3,71,267,284,9,5,636,0,33,669
21,16,21062,519,3,150,605,425,6,4,1190,2,80,1272
21,16,21062,522,3,162,200,218,1,1,582,0,29,611
21,16,21062,523,3,91,168,126,5,1,391,1,25,417
21,16,21084,709,3,237,412,360,90,13,1112,3,44,1159
21,16,21084,710,3,287,270,296,99,15,967,3,19,989
21,16,21084,711,3,43,331,130,20,4,528,0,14,542
21,16,21094,797,3,22,100,140,7,6,275,1,12,288
21,16,21094,798,3,28,97,101,7,5,238,0,0,238
21,16,21094,799,3,36,108,106,5,7,262,18,18,298
21,16,21104,842,3,57,131,61,2,0,251,0,3,254
21,16,21104,843,3,48,212,95,9,5,369,0,4,373
21,16,21121,1672,3,44,404,405,4,4,861,4,38,903
21,16,21125,1685,3,273,246,546,38,5,1108,0,10,1118
21,16,21125,1686,3,290,324,452,48,12,1126,1,15,1142
21,16,21125,1687,3,317,405,495,42,13,1272,1,23,1296
21,16,21125,1690,3,34,514,123,7,2,680,0,38,718
21,16,21130,1708,3,221,199,214,12,1,647,0,22,669
21,16,21130,1710,3,257,211,354,4,5,831,1,17,849
21,16,21130,1711,3,33,124,200,4,4,365,0,9,374
21,16,21130,1714,3,77,215,289,4,0,585,3,12,600
21,16,21168,2098,3,240,270,217,52,25,804,2,29,835
21,16,21168,2099,3,307,360,308,68,21,1064,9,48,1121
21,16,21168,2102,3,55,176,51,1,0,283,0,17,300
21,16,21168,2103,3,82,191,118,15,13,419,0,14,433
21,16,21168,2106,3,69,442,75,18,7,611,4,28,643
21,16,21168,2107,3,54,378,144,43,11,630,12,45,687
21,16,21177,2201,3,347,484,123,28,5,987,2,74,1063
21,16,21177,2202,3,89,166,4,0,1,260,0,6,266
21,16,21177,2203,3,285,360,42,0,0,687,0,30,717
21,16,21177,2206,3,227,320,32,3,6,588,0,37,625
21,16,21177,2207,3,203,162,53,4,2,424,0,12,436
21,16,21190,2317,3,46,198,96,19,4,363,2,10,375
21,16,21190,2318,3,13,73,31,13,3,133,0,5,138
21,16,21195,2349,3,188,153,166,25,4,536,1,32,569
21,16,21195,2350,3,187,101,127,7,4,426,5,23,454
21,16,21195,2351,3,68,291,125,10,4,498,7,19,524
21,16,21195,2354,3,43,96,66,5,2,212,0,20,232
21,16,21195,2355,3,308,523,207,23,9,1070,2,49,1121
21,16,21195,2358,3,10,78,69,0,0,157,0,9,166
21,16,21195,2359,3,100,385,56,1,1,543,3,48,594
21,16,21209,2490,3,395,251,425,97,39,1207,2,22,1231
21,16,21209,2491,3,160,176,105,37,4,482,1,16,499
21,16,21209,2494,3,124,183,89,6,2,404,0,8,412
21,16,21209,2495,3,6,45,17,0,1,69,0,4,73
21,16,21209,2498,3,3,25,35,0,0,63,0,7,70
21,16,21214,2527,3,503,372,212,58,5,1150,2,28,1180
21,16,21214,2530,3,199,366,195,34,8,802,0,27,829
21,16,21214,2531,3,223,276,124,38,8,669,1,12,682
21,16,21217,2537,3,61,221,106,9,3,400,4,36,440
21,16,21217,2538,3,105,159,142,6,4,416,3,39,458
21,16,21217,2539,3,164,330,221,11,7,733,7,53,793
21,16,21217,2542,3,51,58,129,5,1,244,0,47,291
21,16,21217,2543,3,8,25,174,1,1,209,0,15,224
21,16,21217,2546,3,29,15,99,0,0,143,1,10,154
21,16,21217,2547,3,41,215,299,3,2,560,0,31,591
22,1,22002,35,3,204,304,237,18,1,764,2,24,790
22,1,22002,38,3,8,61,43,2,1,115,0,4,119
22,1,22002,39,3,158,357,334,19,6,874,3,41,918
22,1,22002,42,3,68,205,198,15,0,486,1,19,506
22,1,22002,43,3,89,173,177,0,0,439,0,34,473
22,1,22003,46,3,414,485,162,73,16,1150,4,75,1229
22,1,22003,47,3,416,395,120,39,14,984,0,28,1012
22,1,22003,50,3,411,471,164,53,24,1123,0,53,1176
22,1,22003,51,3,330,377,142,56,13,918,0,43,961
22,1,22003,54,3,142,148,39,9,5,343,0,26,369
22,1,22003,55,3,216,311,56,9,5,597,0,19,616
22,1,22003,58,3,211,154,51,1,6,423,2,18,443
22,1,22003,59,3,68,203,74,12,5,362,0,31,393
22,1,22003,62,3,169,34,11,6,3,223,0,19,242
22,1,22003,63,3,122,183,55,16,2,378,1,44,423
22,1,22003,66,3,618,521,110,50,14,1313,3,70,1386
22,1,22003,67,3,87,151,60,20,2,320,1,19,340
22,1,22003,70,3,590,369,111,55,20,1145,4,60,1209
22,1,22003,71,3,294,497,76,21,4,892,2,9,903
22,1,22003,74,3,190,131,55,8,1,385,0,17,402
22,1,22003,75,3,368,221,144,38,9,780,1,33,814
22,1,22004,78,3,447,272,55,30,22,826,1,39,866
22,1,22004,79,3,800,403,151,87,56,1497,5,85,1587
22,1,22004,82,3,271,209,55,13,7,555,7,47,609
22,1,22004,83,3,558,521,201,20,20,1320,0,65,1385
22,1,22004,86,3,199,278,49,11,10,547,0,31,578
22,1,22004,87,3,442,305,81,21,11,860,0,48,908
22,1,22004,90,3,303,296,78,7,3,687,0,31,718
22,1,22004,91,3,391,221,34,13,1,660,6,20,686
22,1,22004,94,3,590,250,74,28,26,968,8,46,1022
22,1,22004,95,3,469,237,69,16,11,802,3,22,827
22,1,22006,122,3,350,294,209,48,10,911,1,40,952
22,1,22006,123,3,248,208,104,27,19,606,6,23,635
22,1,22006,126,3,466,322,142,35,19,984,2,37,1023
22,1,22006,127,3,400,299,187,56,10,952,2,16,970
22,1,22006,130,3,285,229,123,53,10,700,1,51,752
22,1,22006,131,3,272,180,86,45,11,594,1,42,637
22,1,22006,134,3,212,203,121,46,13,595,2,36,633
22,1,22006,135,3,232,306,86,59,6,689,0,56,745
22,1,22006,138,3,98,110,51,12,4,275,0,16,291
22,1,22008,153,3,503,571,150,60,17,1301,1,49,1351
22,1,22008,154,3,497,483,115,30,7,1132,3,44,1179
22,1,22008,155,3,445,331,92,36,6,910,1,45,956
22,1,22008,158,3,256,206,17,23,3,505,0,38,543
22,1,22008,159,3,134,77,4,1,3,219,1,10,230
22,1,22008,162,3,132,118,22,1,1,274,1,7,282
22,1,22008,163,3,171,188,36,4,5,404,0,26,430
22,1,22008,166,3,132,77,55,4,5,273,300,27,600
22,1,22008,167,3,378,223,16,3,2,622,0,57,679
22,1,22009,170,3,198,181,30,4,1,414,0,13,427
22,1,22009,171,3,360,213,154,6,2,735,1,37,773
22,1,22009,174,3,234,201,137,4,6,582,1,42,625
22,1,22009,175,3,256,131,81,4,4,476,1,20,497
22,1,22009,178,3,120,85,45,0,5,255,0,19,274
22,1,22009,179,3,128,87,26,1,1,243,0,18,261
22,1,22011,210,3,408,271,207,44,15,945,4,11,960
22,1,22011,211,3,434,171,143,48,18,814,2,18,834
22,1,22011,214,3,460,237,221,39,19,976,1,28,1005
22,1,22011,215,3,422,223,107,19,9,780,2,33,815
22,1,22011,218,3,318,193,89,16,6,622,1,16,639
22,1,22011,219,3,290,271,275,24,10,870,2,9,881
22,1,22011,222,3,663,370,197,24,10,1264,2,30,1296
22,1,22011,223,3,623,220,174,28,15,1060,1,34,1095
22,1,22011,226,3,484,309,207,36,15,1051,1,26,1078
22,1,22011,227,3,391,218,584,29,8,1230,9,51,1290
22,1,22011,230,3,691,405,336,44,11,1487,12,53,1552
22,1,22011,231,3,728,300,152,18,9,1207,7,44,1258
22,1,22012,234,3,172,329,184,10,6,701,0,41,742
22,1,22012,235,3,77,87,81,1,1,247,0,11,258
22,1,22012,238,3,127,62,60,0,4,253,1,14,268
22,1,22012,239,3,40,123,28,1,0,192,1,16,209
22,1,22012,242,3,195,140,90,3,4,432,0,20,452
22,1,22012,243,3,87,112,138,3,1,341,0,27,368
22,1,22012,246,3,6,57,13,1,0,77,0,7,84
22,1,22012,247,3,186,389,223,8,3,809,1,33,843
22,1,22013,250,3,313,347,40,2,0,702,2,31,735
22,1,22013,251,3,236,303,110,1,3,653,0,34,687
22,1,22013,254,3,271,180,81,3,1,536,0,20,556
22,1,22013,255,3,29,49,56,0,0,134,0,15,149
22,1,22013,258,3,284,145,141,0,1,571,0,42,613
22,1,22013,259,3,262,153,72,7,3,497,2,21,520
22,1,22013,262,3,286,175,193,0,3,657,2,33,692
22,1,22013,263,3,88,94,60,3,2,247,0,18,265
22,1,22015,556,3,228,277,73,17,9,604,1,24,629
22,1,22015,558,3,141,317,12,4,4,478,0,26,504
22,1,22015,559,3,44,133,5,0,1,183,0,7,190
22,1,22015,562,3,73,85,7,3,1,169,0,1,170
22,1,22017,644,3,205,30,34,8,10,287,0,3,290
22,1,22017,646,3,384,146,371,87,27,1015,4,46,1065
22,1,22017,647,3,351,330,203,72,17,973,1,43,1017
22,1,22017,650,3,326,280,200,58,19,883,4,24,911
22,1,22017,651,3,247,145,135,50,11,588,0,24,612
22,1,22017,654,3,299,173,184,44,10,710,4,29,743
22,1,22017,655,3,193,162,122,31,6,514,1,26,541
22,1,22017,658,3,354,188,193,64,20,819,1,41,861
22,1,22017,659,3,428,245,273,57,52,1055,0,45,1100
22,1,22017,662,3,176,161,94,34,23,488,5,52,545
22,1,22017,663,3,160,109,173,17,11,470,1,23,494
22,1,22017,666,3,571,148,251,43,8,1021,4,36,1061
22,1,22017,667,3,439,297,209,31,10,986,4,44,1034
22,1,22017,670,3,467,90,159,19,10,745,0,17,762
22,1,22017,671,3,262,225,194,48,7,736,3,33,772
22,1,22018,674,3,296,296,147,27,10,776,0,36,812
22,1,22018,675,3,242,256,161,21,7,687,0,49,736
22,1,22018,678,3,162,174,79,4,2,421,1,17,439
22,1,22018,679,3,423,328,135,34,5,925,5,94,1024
22,1,22018,682,3,385,379,167,28,19,978,1,42,1021
22,1,22018,683,3,344,278,184,22,14,842,0,20,862
22,1,22018,686,3,147,196,35,6,2,386,0,18,404
22,1,22018,687,3,399,343,129,23,16,910,1,31,942
22,2,22001,1,3,302,166,108,84,11,671,4,32,707
22,2,22001,2,3,208,168,78,65,16,535,1,19,555
22,2,22001,3,3,261,204,121,106,20,712,0,33,745
22,2,22001,6,3,144,107,107,10,3,371,2,18,391
22,2,22001,7,3,50,123,65,17,0,255,1,19,275
22,2,22001,10,3,92,171,155,17,3,438,1,32,471
22,2,22001,11,3,172,117,126,34,10,459,1,18,478
22,2,22001,14,3,249,336,247,51,6,889,5,65,959
22,2,22001,15,3,108,238,203,23,5,577,3,51,631
22,2,22001,18,3,66,137,50,19,5,277,6,18,301
22,2,22001,19,3,331,217,377,36,17,978,11,102,1091
22,2,22001,22,3,208,278,194,33,3,716,2,51,769
22,2,22001,23,3,268,362,166,26,13,835,1,36,872
22,2,22001,26,3,146,272,176,31,7,632,3,38,673
22,2,22001,27,3,18,185,219,13,2,437,1,40,478
22,2,22001,30,3,128,113,191,43,10,485,9,43,537
22,2,22001,31,3,30,61,187,8,0,286,4,23,313
22,2,22001,34,3,95,74,119,6,3,297,1,15,313
22,2,22005,97,3,441,327,166,98,16,1048,4,24,1076
22,2,22005,98,3,664,407,221,98,36,1426,7,31,1464
22,2,22005,99,3,767,469,223,87,35,1581,5,45,1631
22,2,22005,102,3,493,352,159,46,22,1072,1,27,1100
22,2,22005,103,3,754,500,267,88,52,1661,1,34,1696
22,2,22005,106,3,489,280,208,64,22,1063,9,17,1089
22,2,22005,107,3,463,308,157,51,14,993,3,21,1017
22,2,22005,110,3,791,386,188,70,24,1459,0,19,1478
22,2,22005,111,3,495,350,175,62,25,1107,3,22,1132
22,2,22005,114,3,516,444,209,68,25,1262,9,31,1302
22,2,22005,115,3,1165,588,291,61,36,2141,11,55,2207
22,2,22005,118,3,182,383,133,13,2,713,4,38,755
22,2,22005,119,3,185,291,38,7,7,528,4,21,553
22,2,22007,139,3,514,252,57,46,9,878,5,49,932
22,2,22007,142,3,280,127,45,9,3,464,0,0,464
22,2,22007,143,3,371,184,26,14,4,599,4,29,632
22,2,22007,146,3,316,101,16,7,3,443,3,16,462
22,2,22007,147,3,639,342,52,22,4,1059,5,45,1109
22,2,22007,150,3,265,259,17,18,2,561,4,37,602
22,2,22007,151,3,346,61,20,14,1,442,0,17,459
22,2,22016,563,3,517,158,162,36,7,880,2,23,905
22,2,22016,566,3,3497,681,1446,722,155,6501,21,102,6624
22,2,22016,567,3,525,152,291,108,16,1092,9,23,1124
22,2,22016,570,3,473,89,189,89,20,860,1,19,880
22,2,22016,571,3,595,129,198,115,23,1060,9,18,1087
22,2,22016,574,3,513,85,232,106,18,954,1,23,978
22,2,22016,575,3,314,57,144,68,15,598,6,9,613
22,2,22016,578,3,300,89,144,52,14,599,1,13,613
22,2,22016,579,3,525,98,143,57,23,846,4,18,868
22,2,22016,582,3,323,56,133,69,13,594,0,18,612
22,2,22016,583,3,445,66,260,122,18,911,4,17,932
22,2,22016,586,3,1097,293,561,206,40,2197,14,50,2261
22,2,22016,587,3,357,82,176,76,10,701,5,11,717
22,2,22016,590,3,481,132,231,86,16,946,1,31,978
22,2,22016,591,3,555,101,182,96,21,955,3,22,980
22,2,22016,594,3,375,64,160,78,13,690,5,22,717
22,2,22016,595,3,1135,242,474,212,49,2112,1,41,2154
22,2,22016,598,3,394,78,179,84,20,755,1,15,771
22,2,22016,599,3,792,137,457,211,55,1652,15,48,1715
22,2,22016,602,3,390,77,154,75,11,707,1,29,737
22,2,22016,603,3,294,80,143,67,12,596,0,23,619
22,2,22016,606,3,477,116,205,87,17,902,0,18,920
22,2,22016,607,3,425,189,199,117,15,945,2,32,979
22,2,22016,610,3,277,91,113,131,6,618,0,18,636
22,2,22016,611,3,555,216,152,98,6,1027,5,50,1082
22,2,22016,614,3,595,191,279,110,19,1194,10,35,1239
22,2,22016,615,3,271,394,66,33,8,772,3,44,819
22,2,22016,618,3,509,257,165,57,8,996,1,43,1040
22,2,22016,619,3,763,272,244,65,16,1360,13,39,1412
22,2,22016,622,3,708,223,106,44,10,1091,5,30,1126
22,2,22016,623,3,675,190,305,80,20,1270,8,32,1310
22,2,22016,626,3,421,124,72,58,19,694,2,23,719
22,2,22016,627,3,467,162,121,65,9,824,11,27,862
22,2,22016,630,3,222,169,149,39,9,588,11,53,652
22,2,22016,631,3,332,137,77,30,4,580,2,30,612
22,2,22016,634,3,310,342,158,93,24,927,14,45,986
22,2,22016,635,3,334,339,100,38,7,818,4,34,856
22,2,22016,638,3,285,249,123,62,5,724,6,15,745
22,2,22016,639,3,360,354,168,57,5,944,11,35,990
22,2,22016,642,3,487,317,161,48,10,1023,0,30,1053
22,2,22016,643,3,158,200,59,57,3,477,8,29,514
22,2,22005,688,3,183,57,64,21,17,342,2,3,347
22,2,22005,690,3,45,21,8,1,1,76,0,1,77
22,2,22005,694,3,174,62,64,9,6,315,1,7,323
22,2,22005,695,3,170,109,59,11,2,351,0,18,369
22,3,22014,266,3,689,502,147,30,10,1378,0,29,1407
22,3,22014,267,3,759,201,75,22,19,1076,0,15,1091
22,3,22014,270,3,877,493,377,66,26,1839,23,30,1892
22,3,22014,272,3,576,298,182,48,26,1130,1,42,1173
22,3,22014,274,3,552,286,221,39,21,1119,5,28,1152
22,3,22014,279,3,300,160,139,41,13,653,0,5,658
22,3,22014,282,3,1811,614,612,135,55,3227,10,31,3268
22,3,22014,283,3,445,230,141,32,9,857,0,16,873
22,3,22014,289,3,377,139,131,32,19,698,0,9,707
22,3,22014,290,3,328,157,127,26,16,654,0,17,671
22,3,22014,291,3,469,261,222,70,22,1044,3,14,1061
22,3,22014,294,3,402,133,119,23,10,687,3,7,697
22,3,22014,297,3,565,275,177,39,20,1076,6,16,1098
22,3,22014,298,3,442,202,116,37,10,807,3,23,833
22,3,22014,299,3,510,196,114,32,6,858,8,19,885
22,3,22014,302,3,568,296,158,30,20,1072,4,7,1083
22,3,22014,306,3,428,127,130,23,14,722,3,9,734
22,3,22014,307,3,394,104,111,27,15,651,1,14,666
22,3,22014,310,3,459,145,116,37,19,776,1,5,782
22,3,22014,311,3,304,115,104,33,10,566,0,5,571
22,3,22014,314,3,372,208,129,27,16,752,6,7,765
22,3,22014,315,3,333,178,106,31,13,661,0,14,675
22,3,22014,321,3,461,211,147,44,15,878,1,13,892
22,3,22014,322,3,339,168,117,35,11,670,2,11,683
22,3,22014,323,3,2174,694,746,215,73,3902,7,52,3961
22,3,22014,326,3,420,238,189,40,13,900,1,25,926
22,3,22014,328,3,870,346,268,59,25,1568,7,19,1594
22,3,22014,330,3,449,174,173,31,16,843,3,4,850
22,3,22014,331,3,588,296,258,40,22,1204,7,26,1237
22,3,22014,339,3,366,97,94,31,10,598,3,7,608
22,3,22014,342,3,313,125,110,14,9,571,1,3,575
22,3,22014,343,3,975,287,318,68,36,1684,1,22,1707
22,3,22014,346,3,485,266,197,42,13,1003,7,21,1031
22,3,22014,347,3,520,186,168,28,20,922,0,15,937
22,3,22014,355,3,349,170,210,34,7,770,2,6,778
22,3,22014,358,3,318,72,119,32,10,551,0,2,553
22,3,22014,359,3,784,263,340,57,33,1477,3,24,1504
22,3,22014,368,3,391,208,110,38,12,759,0,11,770
22,3,22014,370,3,327,134,106,18,18,603,0,18,621
22,3,22014,371,3,241,156,113,27,16,553,2,9,564
22,3,22014,380,3,483,211,174,36,15,919,0,21,940
22,3,22014,382,3,604,224,175,65,24,1092,6,15,1113
22,3,22014,383,3,415,121,145,18,18,717,2,13,732
22,3,22014,392,3,465,165,142,35,9,816,0,15,831
22,3,22014,394,3,378,220,121,28,13,760,7,14,781
22,3,22014,395,3,346,193,120,22,14,695,0,18,713
22,3,22014,398,3,184,134,72,13,13,416,4,5,425
22,3,22014,416,3,505,581,277,49,25,1437,19,37,1493
22,3,22014,427,3,573,127,165,28,28,921,8,9,938
22,3,22014,435,3,999,253,296,70,38,1656,5,14,1675
22,3,22014,438,3,366,104,96,26,8,600,3,9,612
22,3,22014,447,3,275,90,126,22,8,521,0,11,532
22,3,22014,450,3,599,114,145,24,23,905,1,6,912
22,3,22014,451,3,374,148,100,9,8,639,1,10,650
22,3,22014,454,3,664,147,93,28,12,944,2,4,950
22,3,22014,460,3,633,106,107,24,15,885,1,11,897
22,3,22014,462,3,332,204,101,27,8,672,2,5,679
22,3,22014,463,3,689,175,174,39,23,1100,0,8,1108
22,3,22014,467,3,402,162,157,33,19,773,1,8,782
22,3,22014,470,3,459,152,133,39,14,797,0,10,807
22,3,22014,471,3,324,141,127,27,14,633,1,20,654
22,3,22014,476,3,477,168,180,42,18,885,1,9,895
22,3,22014,478,3,336,177,116,34,9,672,3,14,689
22,3,22014,479,3,412,189,131,29,13,774,2,9,785
22,3,22014,482,3,548,129,136,27,14,854,3,11,868
22,3,22014,483,3,1036,147,236,34,38,1491,0,13,1504
22,3,22014,486,3,478,174,142,41,14,849,3,25,877
22,3,22014,487,3,446,243,116,33,17,855,3,14,872
22,3,22014,490,3,414,204,129,28,6,781,2,14,797
22,3,22014,493,3,378,196,202,29,18,823,5,21,849
22,3,22014,494,3,383,217,158,37,17,812,0,22,834
22,3,22014,495,3,869,368,463,75,34,1809,3,47,1859
22,3,22014,498,3,416,260,132,33,15,856,2,21,879
22,3,22014,499,3,373,184,155,30,11,753,8,18,779
22,3,22014,502,3,528,158,77,20,5,788,1,10,799
22,3,22014,503,3,416,193,155,35,11,810,5,15,830
22,3,22014,509,3,467,208,201,44,19,939,0,20,959
22,3,22014,510,3,610,272,245,44,14,1185,1,28,1214
22,3,22014,511,3,491,250,161,32,14,948,7,31,986
22,3,22014,521,3,226,141,24,9,6,406,1,14,421
22,3,22014,527,3,848,477,85,53,11,1474,6,89,1569
22,3,22014,530,3,209,130,29,2,5,375,2,15,392
22,3,22014,531,3,366,175,108,34,17,700,4,14,718
22,3,22014,534,3,438,303,137,37,17,932,2,24,958
22,3,22014,535,3,248,187,66,17,9,527,0,6,533
22,3,22014,538,3,239,205,123,27,12,606,4,27,637
22,3,22014,540,3,351,345,41,2,2,741,10,18,769
22,3,22014,542,3,459,152,132,24,7,774,5,23,802
22,3,22014,543,3,196,265,48,3,4,516,3,2,521
22,3,22014,546,3,519,423,100,25,8,1075,4,23,1102
22,3,22014,547,3,457,330,129,23,9,948,7,34,989
22,3,22014,551,3,1955,645,794,133,61,3588,20,51,3659
22,3,22014,691,3,213,81,58,13,10,375,2,7,384
22,3,22014,734,3,214,62,58,8,7,349,0,4,353
22,3,22014,735,3,238,68,47,10,3,366,0,2,368
22,3,22014,738,3,225,80,73,10,4,392,0,0,392
22,3,22014,739,3,231,78,117,14,15,455,1,1,457
22,3,22014,742,3,262,82,107,36,2,489,0,8,497
22,3,22014,743,3,267,59,89,19,9,443,0,8,451
22,3,22014,746,3,65,38,29,6,2,140,1,7,148
22,3,22014,747,3,208,72,90,16,11,397,0,4,401
22,3,22014,750,3,165,52,91,22,12,342,0,5,347
22,3,22014,751,3,140,38,66,10,8,262,2,1,265
22,3,22014,754,3,173,30,43,7,5,258,0,4,262
22,3,22014,755,3,251,100,74,23,8,456,2,2,460
22,3,22014,758,3,90,24,39,3,2,158,1,4,163
22,3,22014,759,3,53,17,25,1,1,97,0,3,100
22,4,22010,182,3,642,253,312,51,32,1290,0,31,1321
22,4,22010,183,3,688,318,283,45,19,1353,4,28,1385
22,4,22010,186,3,108,169,47,2,2,328,3,16,347
22,4,22010,187,3,213,111,81,8,0,413,0,14,427
22,4,22010,190,3,461,407,213,27,15,1123,16,30,1169
22,4,22010,191,3,534,414,355,34,15,1352,9,38,1399
22,4,22010,194,3,251,217,130,13,7,618,4,29,651
22,4,22010,195,3,383,654,211,14,12,1274,1,20,1295
22,4,22010,198,3,477,383,114,23,7,1004,4,24,1032
22,4,22010,199,3,482,353,124,18,10,987,13,29,1029
22,4,22010,202,3,472,442,291,38,15,1258,5,39,1302
22,4,22010,203,3,727,427,339,30,18,1541,3,22,1566
22,4,22010,206,3,380,223,206,26,25,860,1,6,867
22,4,22010,207,3,479,293,221,21,26,1040,4,19,1063
22,4,22014,269,3,1043,136,98,27,27,1331,2,9,1342
22,4,22014,275,3,331,259,190,29,14,823,5,29,857
22,4,22014,278,3,1410,540,664,95,81,2790,16,34,2840
22,4,22014,285,3,279,234,194,11,18,736,7,19,762
22,4,22014,286,3,256,250,207,18,24,755,5,32,792
22,4,22014,287,3,367,158,210,39,11,785,5,18,808
22,4,22014,295,3,363,382,240,25,23,1033,5,30,1068
22,4,22014,303,3,970,384,534,80,55,2023,10,39,2072
22,4,22014,313,3,851,169,170,37,35,1262,0,2,1264
22,4,22014,318,3,1239,531,412,94,99,2375,9,30,2414
22,4,22014,319,3,1248,519,480,72,55,2374,9,31,2414
22,4,22014,327,3,763,190,238,42,33,1266,3,11,1280
22,4,22014,333,3,806,183,95,24,29,1137,1,15,1153
22,4,22014,334,3,719,132,157,36,17,1061,2,8,1071
22,4,22014,335,3,319,196,102,31,11,659,1,19,679
22,4,22014,338,3,1161,330,223,52,43,1809,4,27,1840
22,4,22014,350,3,382,177,130,27,17,733,1,10,744
22,4,22014,351,3,705,174,95,33,14,1021,4,10,1035
22,4,22014,354,3,342,202,145,19,19,727,1,14,742
22,4,22014,362,3,298,183,135,25,13,654,1,14,669
22,4,22014,363,3,349,224,139,18,17,747,4,24,775
22,4,22014,366,3,167,121,80,12,10,390,0,11,401
22,4,22014,367,3,222,111,75,10,10,428,0,12,440
22,4,22014,372,3,593,274,199,37,32,1135,5,11,1151
22,4,22014,374,3,541,117,112,16,13,799,1,8,808
22,4,22014,375,3,645,257,135,37,23,1097,2,14,1113
22,4,22014,378,3,203,134,68,16,13,434,1,10,445
22,4,22014,379,3,354,151,116,27,23,671,0,10,681
22,4,22014,384,3,317,126,79,10,15,547,1,3,551
22,4,22014,386,3,418,292,159,35,16,920,4,15,939
22,4,22014,387,3,385,207,156,28,18,794,0,15,809
22,4,22014,390,3,249,100,77,26,7,459,0,12,471
22,4,22014,391,3,205,95,76,15,7,398,0,0,398
22,4,22014,399,3,415,174,116,24,32,761,2,17,780
22,4,22014,402,3,511,162,93,17,22,805,0,16,821
22,4,22014,403,3,549,231,91,29,12,912,0,5,917
22,4,22014,406,3,295,139,85,13,3,535,2,7,544
22,4,22014,407,3,484,252,141,32,12,921,1,11,933
22,4,22014,410,3,495,179,111,23,31,839,1,10,850
22,4,22014,411,3,234,89,63,13,14,413,0,10,423
22,4,22014,414,3,268,150,71,23,16,528,0,10,538
22,4,22014,415,3,401,125,98,19,18,661,3,10,674
22,4,22014,418,3,398,156,103,23,15,695,1,9,705
22,4,22014,419,3,257,111,48,24,9,449,0,5,454
22,4,22014,422,3,303,148,127,25,13,616,2,20,638
22,4,22014,423,3,279,129,114,25,7,554,0,8,562
22,4,22014,426,3,499,198,119,25,17,858,1,14,873
22,4,22014,429,3,361,154,80,14,12,621,6,8,635
22,4,22014,430,3,477,222,144,22,21,886,4,5,895
22,4,22014,431,3,232,111,96,27,16,482,2,9,493
22,4,22014,434,3,336,159,116,31,10,652,1,11,664
22,4,22014,439,3,497,178,92,31,14,812,0,7,819
22,4,22014,442,3,599,204,160,28,37,1028,0,10,1038
22,4,22014,443,3,490,222,114,31,24,881,0,9,890
22,4,22014,446,3,579,176,126,30,20,931,0,13,944
22,4,22014,455,3,510,254,147,42,37,990,5,12,1007
22,4,22014,458,3,544,289,162,53,20,1068,2,12,1082
22,4,22014,459,3,431,139,83,23,24,700,0,5,705
22,4,22014,464,3,485,175,129,19,19,827,2,15,844
22,4,22014,466,3,830,238,173,38,23,1302,1,18,1321
22,4,22014,474,3,483,192,118,21,19,833,1,10,844
22,4,22014,475,3,2084,619,653,121,109,3586,4,33,3623
22,4,22014,491,3,2082,441,355,86,60,3024,2,21,3047
22,4,22014,506,3,381,205,168,30,20,804,0,11,815
22,4,22014,507,3,380,211,199,39,33,862,0,8,870
22,4,22014,513,3,625,251,354,28,24,1282,7,32,1321
22,4,22014,514,3,559,332,303,60,35,1289,3,35,1327
22,4,22014,515,3,668,244,336,60,37,1345,4,16,1365
22,4,22014,518,3,646,374,137,18,13,1188,7,30,1225
22,4,22014,519,3,93,523,180,17,4,817,1,43,861
22,4,22014,522,3,744,436,141,27,19,1367,1,60,1428
22,4,22014,523,3,228,206,89,18,5,546,4,41,591
22,4,22014,526,3,430,257,64,9,5,765,12,26,803
22,4,22014,528,3,455,147,50,10,4,666,3,18,687
22,4,22014,539,3,324,497,138,22,7,988,2,41,1031
22,4,22014,549,3,721,449,209,42,22,1443,3,31,1477
22,4,22014,550,3,266,269,94,7,6,642,8,24,674
22,4,22014,554,3,461,454,204,24,26,1169,12,26,1207
22,4,22014,555,3,172,134,80,15,28,429,25,18,472
22,4,22014,696,3,102,102,59,6,4,273,5,11,289
22,4,22014,698,3,150,88,84,9,5,336,2,15,353
22,4,22014,699,3,203,69,192,11,4,479,3,6,488
22,4,22014,702,3,96,22,33,7,9,167,1,1,169
22,4,22014,703,3,207,57,70,18,20,372,1,0,373
22,4,22014,706,3,184,176,87,23,10,480,0,8,488
22,4,22014,707,3,171,157,90,13,12,443,2,10,455
22,4,22014,710,3,197,157,62,9,7,432,3,15,450
22,4,22014,711,3,250,122,101,15,15,503,1,9,513
22,4,22014,714,3,227,69,87,9,22,414,0,4,418
22,4,22014,715,3,90,23,45,4,1,163,0,4,167
22,4,22014,718,3,162,144,91,11,11,419,5,6,430
22,4,22014,719,3,255,71,102,19,18,465,0,0,465
22,4,22014,722,3,123,46,55,6,5,235,0,1,236
22,4,22014,723,3,95,35,44,4,15,193,0,0,193
22,4,22014,726,3,72,59,119,3,5,258,1,5,264
22,4,22014,727,3,83,27,44,5,1,160,0,2,162
22,4,22014,730,3,110,23,30,8,7,178,1,0,179
22,4,22014,731,3,118,18,29,7,6,178,2,2,182
23,1,23001,1,3,608,701,1704,79,62,3154,18,75,3247
23,1,23001,2,3,862,1129,2641,143,77,4852,27,106,4985
23,1,23001,3,3,1001,1779,3167,161,96,6204,39,144,6387
23,1,23001,11,3,2862,3802,7087,352,213,14316,49,220,14585
23,1,23001,14,3,116,131,269,8,16,540,4,8,552
23,1,23001,15,3,169,245,355,22,19,810,1,11,822
23,1,23001,21,3,241,229,197,28,16,711,3,11,725
23,1,23001,154,3,2145,1656,3203,277,255,7536,34,113,7683
23,1,23001,177,3,93,499,500,18,12,1122,1,37,1160
23,1,23001,178,3,73,294,338,10,6,721,6,15,742
23,1,23001,179,3,215,675,619,40,18,1567,9,22,1598
23,1,23002,182,3,392,643,103,22,11,1171,1,15,1187
23,1,23002,183,3,537,592,107,27,12,1275,1,17,1293
23,1,23002,186,3,302,259,38,8,4,611,0,8,619
23,1,23002,187,3,506,407,63,14,5,995,2,19,1016
23,1,23002,190,3,472,457,96,17,3,1045,4,26,1075
23,1,23002,191,3,279,407,88,17,9,800,0,4,804
23,1,23002,194,3,365,495,67,14,4,945,0,12,957
23,1,23002,195,3,966,936,164,40,15,2121,3,29,2153
23,1,23002,198,3,491,755,105,29,12,1392,1,14,1407
23,1,23002,199,3,637,583,115,37,11,1383,1,23,1407
23,1,23002,202,3,652,689,55,28,4,1428,1,15,1444
23,1,23002,203,3,1872,1872,348,121,30,4243,7,80,4330
23,1,23008,206,3,572,1283,967,67,49,2938,9,67,3014
23,1,23008,207,3,881,1553,1195,86,98,3813,13,50,3876
23,1,23008,210,3,80,628,453,9,8,1178,1,17,1196
23,1,23008,211,3,153,904,294,22,5,1378,1,18,1397
23,1,23008,214,3,16,49,21,7,2,95,0,4,99
23,1,23004,252,3,103,289,147,10,6,555,1,8,564
23,1,23004,254,3,54,206,77,17,2,356,0,10,366
23,1,23004,255,3,130,396,217,16,16,775,4,12,791
23,1,23004,258,3,232,650,466,32,9,1389,6,34,1429
23,1,23004,259,3,72,138,139,7,3,359,0,4,363
23,1,23006,284,3,111,472,155,5,5,748,0,10,758
23,1,23006,286,3,171,764,278,18,8,1239,0,32,1271
23,1,23006,287,3,179,377,57,66,7,686,0,22,708
23,1,23006,290,3,40,424,311,5,1,781,1,14,796
23,1,23006,291,3,43,266,226,4,2,541,1,19,561
23,1,23006,294,3,20,168,227,1,0,416,0,15,431
23,1,23006,295,3,54,206,163,1,1,425,0,19,444
23,2,23003,215,3,49,424,334,24,3,834,1,17,852
23,2,23003,218,3,92,417,242,42,6,799,0,16,815
23,2,23003,219,3,29,254,170,8,5,466,0,11,477
23,2,23003,222,3,121,493,265,29,3,911,2,13,926
23,2,23003,223,3,79,371,278,18,3,749,0,18,767
23,2,23003,226,3,74,354,231,40,4,703,1,16,720
23,2,23003,227,3,23,538,451,6,0,1018,0,17,1035
23,2,23003,230,3,12,211,219,5,1,448,0,20,468
23,2,23003,231,3,27,154,359,5,2,547,0,19,566
23,2,23003,234,3,67,484,832,16,2,1401,0,29,1430
23,2,23003,235,3,39,300,444,3,0,786,0,9,795
23,2,23003,238,3,32,359,512,4,1,908,0,19,927
23,2,23003,239,3,37,393,480,8,2,920,0,20,940
23,2,23003,242,3,45,375,234,36,1,691,0,20,711
23,2,23003,243,3,24,134,76,2,1,237,0,3,240
23,2,23003,247,3,83,412,605,10,2,1112,0,27,1139
23,2,23003,250,3,14,193,361,6,1,575,0,18,593
23,2,23003,251,3,48,288,556,15,5,912,0,27,939
23,2,23005,262,3,134,707,295,29,2,1167,2,25,1194
23,2,23005,263,3,150,491,267,28,4,940,2,17,959
23,2,23005,266,3,128,246,108,0,0,482,0,9,491
23,2,23005,267,3,18,185,244,2,1,450,0,8,458
23,2,23005,270,3,64,329,270,39,0,702,1,18,721
23,2,23005,271,3,51,310,174,22,2,559,0,10,569
23,2,23005,274,3,246,372,107,11,4,740,0,25,765
23,2,23005,275,3,209,266,161,0,1,637,0,13,650
23,2,23005,278,3,67,157,177,2,1,404,0,7,411
23,2,23005,279,3,131,114,63,1,1,310,1,5,316
23,2,23005,282,3,89,125,149,7,4,374,1,17,392
23,2,23005,283,3,35,86,151,5,2,279,0,13,292
23,2,23007,298,3,81,153,48,10,1,293,1,16,310
23,2,23007,299,3,82,149,75,2,2,310,0,16,326
23,2,23007,302,3,132,372,72,13,9,598,2,11,611
23,2,23007,303,3,163,325,99,20,5,612,2,15,629
23,2,23007,306,3,94,438,91,31,4,658,0,11,669
23,2,23007,307,3,513,1252,377,53,17,2212,8,46,2266
23,2,23007,310,3,173,408,110,19,5,715,0,29,744
23,2,23007,311,3,156,349,80,3,4,592,0,23,615
23,2,23007,314,3,56,175,40,3,0,274,0,13,287
23,2,23007,315,3,212,598,158,28,18,1014,0,20,1034
23,2,23007,318,3,196,362,77,25,8,668,4,23,695
23,2,23007,319,3,122,413,53,23,7,618,0,7,625
23,2,23007,322,3,75,271,81,26,3,456,0,0,456
23,2,23007,323,3,68,364,54,15,4,505,1,2,508
23,2,23007,326,3,162,389,78,14,4,647,0,15,662
23,2,23007,327,3,93,244,64,16,2,419,0,9,428
23,2,23007,330,3,174,475,74,25,9,757,1,20,778
23,2,23007,331,3,116,354,60,10,7,547,0,11,558
23,2,23007,334,3,237,616,104,45,6,1008,0,13,1021
23,2,23007,335,3,148,362,120,13,1,644,1,22,667
23,2,23007,338,3,86,365,90,12,2,555,4,18,577
23,2,23007,339,3,122,271,81,15,5,494,1,15,510
23,2,23007,342,3,139,447,99,24,10,719,1,11,731
23,2,23007,343,3,167,451,99,18,12,747,0,13,760
23,2,23007,346,3,129,297,62,18,11,517,0,20,537
23,2,23007,347,3,135,392,87,22,4,640,1,26,667
23,2,23007,350,3,75,168,32,4,2,281,0,8,289
23,2,23007,351,3,82,186,63,8,5,344,0,5,349
23,2,23007,354,3,124,327,67,10,6,534,2,16,552
23,2,23007,355,3,81,245,39,10,8,383,0,14,397
23,2,23007,358,3,155,387,76,16,8,642,0,5,647
23,2,23007,359,3,135,460,96,22,8,721,4,19,744
23,2,23007,362,3,123,348,63,16,1,551,2,16,569
23,2,23007,363,3,153,495,121,16,8,793,3,16,812
23,2,23007,366,3,70,275,54,9,3,411,0,30,441
23,2,23007,367,3,106,380,70,14,5,575,0,16,591
23,2,23007,370,3,106,286,56,10,3,461,1,8,470
23,2,23007,371,3,195,464,96,20,11,786,1,34,821
23,2,23007,374,3,83,268,46,19,1,417,0,6,423
23,2,23007,375,3,136,391,101,14,8,650,0,16,666
23,2,23007,378,3,132,389,94,23,4,642,1,12,655
23,2,23007,379,3,102,235,46,14,2,399,0,11,410
23,2,23007,382,3,96,332,91,8,5,532,1,16,549
23,2,23007,383,3,95,279,52,16,3,445,2,12,459
23,2,23007,386,3,37,90,51,4,1,183,2,6,191
23,2,23007,387,3,77,102,96,13,2,290,3,0,293
23,2,23007,390,3,66,86,62,56,6,276,1,18,295
23,2,23007,391,3,36,144,46,16,1,243,0,9,252
23,2,23007,394,3,79,213,160,13,5,470,1,14,485
23,2,23007,395,3,11,87,98,3,4,203,0,7,210
23,2,23007,398,3,25,58,152,4,1,240,1,12,253
23,2,23007,399,3,2,41,17,1,1,62,0,5,67
23,2,23007,402,3,71,174,152,18,5,420,0,0,420
23,2,23007,403,3,31,317,414,12,5,779,0,32,811
23,2,23007,406,3,49,278,108,54,6,495,3,21,519
23,2,23007,407,3,66,364,190,70,4,694,0,31,725
23,2,23007,410,3,50,118,57,7,3,235,0,3,238
23,2,23007,411,3,32,172,86,1,0,291,2,15,308
23,2,23007,414,3,45,157,185,11,5,403,0,22,425
23,2,23007,415,3,123,322,247,28,8,728,3,48,779
23,2,23007,418,3,83,315,199,14,3,614,0,22,636
23,2,23007,419,3,63,368,227,8,5,671,0,25,696
23,2,23007,422,3,93,410,168,9,7,687,1,13,701
23,2,23007,423,3,112,373,230,15,8,738,3,33,774
23,2,23007,426,3,209,295,134,16,5,659,1,42,702
23,2,23007,427,3,132,423,144,16,3,718,0,30,748
23,2,23007,430,3,37,161,153,3,3,357,0,9,366
23,2,23007,431,3,32,311,164,5,3,515,0,19,534
23,2,23007,434,3,3,32,15,2,0,52,0,1,53
23,2,23007,435,3,32,113,133,11,5,294,0,20,314
23,2,23007,438,3,96,320,234,8,3,661,0,9,670
23,2,23007,439,3,83,279,322,20,3,707,0,17,724
23,2,23007,442,3,25,73,41,0,2,141,0,4,145
23,2,23007,443,3,109,93,62,2,1,267,3,0,270
23,2,23007,446,3,89,162,154,11,3,419,10,11,440
23,2,23007,447,3,15,86,76,2,0,179,0,7,186
23,2,23007,450,3,8,123,93,1,2,227,0,11,238
23,3,23001,4,3,351,260,374,49,28,1062,0,23,1085
23,3,23001,6,3,158,126,197,29,10,520,1,6,527
23,3,23001,7,3,236,252,369,42,13,912,4,16,932
23,3,23001,10,3,84,129,232,17,18,480,2,4,486
23,3,23001,18,3,144,222,362,43,20,791,2,14,807
23,3,23001,19,3,210,238,368,38,20,874,2,19,895
23,3,23001,22,3,168,171,205,28,8,580,4,12,596
23,3,23001,23,3,130,149,183,21,12,495,2,13,510
23,3,23001,26,3,123,157,162,21,7,470,2,11,483
23,3,23001,27,3,138,174,209,34,8,563,3,17,583
23,3,23001,30,3,90,93,171,12,3,369,1,3,373
23,3,23001,31,3,97,157,163,26,9,452,2,8,462
23,3,23001,34,3,119,165,193,16,4,497,2,11,510
23,3,23001,35,3,134,200,206,31,4,575,3,10,588
23,3,23001,38,3,106,146,232,18,8,510,3,15,528
23,3,23001,39,3,94,95,202,13,6,410,1,8,419
23,3,23001,42,3,77,140,172,25,7,421,2,8,431
23,3,23001,43,3,170,117,223,32,12,554,1,11,566
23,3,23001,46,3,139,270,354,34,16,813,2,19,834
23,3,23001,47,3,142,164,268,22,8,604,8,15,627
23,3,23001,50,3,248,296,450,26,14,1034,4,15,1053
23,3,23001,51,3,132,213,245,21,5,616,7,6,629
23,3,23001,54,3,330,379,593,62,17,1381,4,23,1408
23,3,23001,55,3,141,209,249,29,8,636,2,15,653
23,3,23001,58,3,131,154,101,35,7,428,2,10,440
23,3,23001,59,3,253,122,130,32,20,557,1,11,569
23,3,23001,62,3,150,150,195,22,15,532,2,14,548
23,3,23001,63,3,124,130,187,34,9,484,0,11,495
23,3,23001,66,3,95,94,203,14,6,412,1,12,425
23,3,23001,67,3,88,90,187,14,6,385,2,6,393
23,3,23001,70,3,112,191,237,17,11,568,0,14,582
23,3,23001,71,3,164,206,292,12,9,683,0,19,702
23,3,23001,74,3,234,236,370,46,26,912,1,16,929
23,3,23001,75,3,125,126,279,28,16,574,1,15,590
23,3,23001,78,3,185,109,192,31,22,539,0,16,555
23,3,23001,79,3,134,159,244,29,17,583,1,13,597
23,3,23001,82,3,125,158,149,18,13,463,6,5,474
23,3,23001,83,3,146,202,266,28,10,652,5,14,671
23,3,23001,86,3,127,197,187,20,11,542,2,1,545
23,3,23001,87,3,96,125,180,30,9,440,1,5,446
23,3,23001,90,3,241,208,234,56,24,763,2,13,778
23,3,23001,91,3,240,158,236,33,22,689,0,7,696
23,3,23001,94,3,225,211,259,44,10,749,7,21,777
23,3,23001,95,3,67,140,144,19,6,376,0,8,384
23,3,23001,98,3,129,150,171,13,10,473,2,22,497
23,3,23001,99,3,101,131,115,20,6,373,0,7,380
23,3,23001,102,3,388,226,280,59,37,990,1,16,1007
23,3,23001,103,3,144,82,58,14,15,313,0,3,316
23,3,23001,106,3,228,162,160,33,17,600,0,11,611
23,3,23001,107,3,187,223,260,29,20,719,2,23,744
23,3,23001,110,3,165,104,146,21,14,450,1,10,461
23,3,23001,111,3,72,84,96,13,5,270,2,5,277
23,3,23001,114,3,80,115,117,11,6,329,3,4,336
23,3,23001,115,3,96,125,152,20,8,401,1,3,405
23,3,23001,118,3,73,85,92,11,6,267,1,5,273
23,3,23001,119,3,201,101,32,8,13,355,0,3,358
23,3,23001,122,3,196,128,85,33,23,465,1,2,468
23,3,23001,123,3,198,140,94,30,27,489,2,3,494
23,3,23001,126,3,950,472,482,96,69,2069,5,26,2100
23,3,23001,127,3,259,336,527,57,17,1196,3,21,1220
23,3,23001,130,3,212,81,50,25,21,389,1,10,400
23,3,23001,131,3,207,170,117,28,23,545,4,17,566
23,3,23001,134,3,193,134,152,17,14,510,3,7,520
23,3,23001,135,3,201,124,92,25,13,455,1,4,460
23,3,23001,138,3,195,123,69,27,16,430,0,2,432
23,3,23001,139,3,218,123,95,19,18,473,0,7,480
23,3,23001,142,3,208,99,88,31,18,444,2,2,448
23,3,23001,143,3,243,117,91,14,21,486,4,5,495
23,3,23001,146,3,1123,304,202,83,62,1774,4,13,1791
23,3,23001,147,3,1785,659,631,160,130,3365,6,36,3407
23,3,23001,151,3,797,418,540,93,78,1926,4,30,1960
23,3,23001,155,3,150,220,245,22,17,654,2,21,677
23,3,23001,158,3,149,216,243,26,21,655,3,14,672
23,3,23001,159,3,205,236,311,30,16,798,1,28,827
23,3,23001,162,3,173,49,34,11,10,277,0,2,279
23,3,23001,163,3,305,329,452,63,27,1176,5,15,1196
23,3,23001,166,3,273,371,522,137,28,1331,3,32,1366
23,3,23001,167,3,182,215,317,32,18,764,2,15,781
23,3,23001,170,3,471,140,74,30,22,737,1,7,745
23,3,23001,173,3,174,475,498,36,17,1200,9,20,1229
23,3,23001,174,3,186,337,277,16,13,829,1,19,849
23,3,23001,175,3,569,569,610,58,37,1843,7,35,1885
24,1,24001,1,3,270,220,62,25,18,595,0,86,681
24,1,24001,2,3,387,324,62,19,14,806,1,55,862
24,1,24001,3,3,63,56,6,2,1,128,0,17,145
24,1,24001,6,3,263,173,136,12,8,592,2,82,676
24,1,24001,7,3,273,142,144,8,2,569,0,62,631
24,1,24001,10,3,22,36,4,2,1,65,0,4,69
24,1,24001,11,3,306,131,94,8,2,541,3,46,590
24,1,24001,14,3,350,389,72,2,6,819,2,58,879
24,1,24006,98,3,259,204,70,9,7,549,0,27,576
24,1,24006,99,3,70,27,1,0,0,98,0,10,108
24,1,24006,102,3,29,84,15,1,2,131,0,6,137
24,1,24006,103,3,173,68,7,1,1,250,0,20,270
24,1,24006,106,3,294,212,44,22,0,572,0,32,604
24,1,24006,107,3,41,40,21,2,1,105,0,9,114
24,1,24006,110,3,82,34,6,0,0,122,0,5,127
24,1,24006,111,3,71,61,34,0,0,166,0,13,179
24,1,24006,114,3,41,28,20,0,0,89,0,9,98
24,1,24006,115,3,43,107,9,4,0,163,0,16,179
24,1,24006,118,3,150,52,63,0,0,265,0,15,280
24,1,24007,119,3,502,320,135,84,47,1088,0,43,1131
24,1,24007,122,3,484,315,114,67,26,1006,0,24,1030
24,1,24007,123,3,34,17,17,2,7,77,0,8,85
24,1,24007,126,3,110,50,29,7,19,215,0,13,228
24,1,24007,127,3,70,51,24,0,6,151,0,16,167
24,1,24007,130,3,71,53,16,2,13,155,0,4,159
24,1,24007,131,3,185,181,26,5,27,424,0,0,424
24,1,24007,134,3,89,48,50,3,8,198,0,8,206
24,1,24007,135,3,61,80,107,3,9,260,0,29,289
24,1,24015,384,3,198,141,63,22,4,428,3,12,443
24,1,24015,386,3,220,184,73,26,6,509,0,15,524
24,1,24015,387,3,232,221,115,27,5,600,3,39,642
24,1,24015,390,3,165,150,55,23,4,397,0,17,414
24,1,24015,391,3,250,112,87,21,5,475,0,7,482
24,1,24015,394,3,62,201,92,2,0,357,0,42,399
24,1,24015,395,3,43,73,25,2,0,143,1,19,163
24,1,24015,398,3,75,98,63,0,0,236,1,13,250
24,1,24015,399,3,62,33,5,1,2,103,1,9,113
24,1,24015,402,3,119,317,59,10,4,509,2,15,526
24,1,24015,403,3,106,237,56,17,4,420,0,29,449
24,1,24020,490,3,512,214,38,26,11,801,0,17,818
24,1,24020,491,3,370,155,26,17,6,574,0,5,579
24,1,24020,494,3,421,180,43,26,2,672,0,13,685
24,1,24020,495,3,306,107,86,14,22,535,0,13,548
24,1,24020,498,3,371,158,63,20,6,618,2,23,643
24,1,24020,499,3,177,67,16,18,2,280,0,7,287
24,1,24020,502,3,563,224,69,23,7,886,0,22,908
24,1,24020,503,3,371,180,46,23,5,625,1,12,638
24,1,24020,506,3,459,160,46,19,8,692,0,20,712
24,1,24020,507,3,501,173,42,27,7,750,0,7,757
24,1,24020,510,3,335,156,30,14,3,538,0,26,564
24,1,24020,511,3,555,225,65,24,2,871,0,27,898
24,1,24020,514,3,409,112,33,12,2,568,1,14,583
24,1,24020,515,3,491,195,58,47,3,794,0,16,810
24,1,24020,518,3,750,259,71,29,6,1115,0,37,1152
24,1,24020,519,3,348,141,38,24,0,551,0,11,562
24,1,24020,522,3,398,146,21,14,2,581,2,26,609
24,1,24020,523,3,416,126,26,22,5,595,0,25,620
24,1,24020,526,3,447,256,64,20,8,795,0,27,822
24,1,24020,527,3,546,283,43,30,12,914,1,31,946
24,1,24020,530,3,85,63,18,1,0,167,0,6,173
24,1,24020,531,3,345,126,30,6,4,511,1,31,543
24,1,24020,534,3,52,47,4,2,0,105,1,8,114
24,1,24020,535,3,30,45,4,1,0,80,0,2,82
24,1,24020,538,3,38,32,1,4,0,75,0,2,77
24,1,24020,539,3,109,50,29,2,0,190,0,8,198
24,1,24020,542,3,42,48,4,1,0,95,0,3,98
24,1,24020,543,3,36,52,2,0,0,90,0,8,98
24,1,24020,546,3,51,90,5,0,0,146,1,9,156
24,1,24020,547,3,120,96,12,6,1,235,0,13,248
24,1,24020,550,3,72,63,4,2,7,148,1,22,171
24,1,24020,551,3,60,39,3,3,0,105,1,5,111
24,1,24020,554,3,101,56,8,2,3,170,0,9,179
24,1,24021,555,3,460,222,69,39,7,797,2,51,850
24,1,24021,558,3,153,74,27,4,0,258,0,35,293
24,1,24021,559,3,445,201,105,29,10,790,4,61,855
24,1,24021,562,3,157,197,55,15,6,430,0,47,477
24,1,24021,563,3,57,27,16,1,1,102,0,12,114
24,1,24021,566,3,135,252,37,10,1,435,0,24,459
24,1,24021,567,3,55,127,20,3,2,207,3,17,227
24,1,24021,570,3,73,125,19,3,0,220,0,0,220
24,1,24021,571,3,65,175,28,10,2,280,1,27,308
24,1,24021,574,3,129,156,52,0,4,341,0,28,369
24,1,24021,575,3,65,55,26,5,2,153,4,7,164
24,1,24021,578,3,195,188,30,9,0,422,0,51,473
24,1,24021,579,3,186,178,94,12,8,478,1,37,516
24,1,24021,582,3,310,200,60,28,10,608,3,32,643
24,1,24021,583,3,80,168,76,0,0,324,0,38,362
24,1,24021,586,3,436,200,100,40,25,801,0,36,837
24,1,24021,587,3,283,195,37,18,5,538,4,31,573
24,1,24021,590,3,333,117,66,18,14,548,3,5,556
24,1,24022,591,3,169,102,74,8,10,363,0,15,378
24,1,24022,594,3,43,26,7,2,3,81,0,6,87
24,1,24022,595,3,9,13,10,0,0,32,0,3,35
24,1,24022,598,3,144,25,45,6,4,224,2,30,256
24,1,24022,599,3,77,35,34,5,4,155,0,9,164
24,1,24022,602,3,80,46,22,8,1,157,0,32,189
24,1,24022,603,3,124,39,25,8,6,202,7,34,243
24,1,24022,606,3,121,83,31,4,1,240,0,23,263
24,1,24022,607,3,88,99,71,11,9,278,0,63,341
24,1,24022,610,3,52,47,24,3,5,131,0,31,162
24,1,24022,611,3,46,59,41,11,10,167,0,20,187
24,1,24022,614,3,61,28,23,2,2,116,1,0,117
24,1,24022,615,3,54,50,48,9,3,164,2,27,193
24,1,24025,724,3,461,224,90,37,8,820,5,46,871
24,1,24025,726,3,432,264,89,34,13,832,2,38,872
24,1,24025,727,3,262,143,38,27,3,473,1,31,505
24,1,24025,730,3,654,370,129,56,13,1222,2,67,1291
24,1,24025,731,3,126,121,17,0,0,264,0,42,306
24,1,24025,734,3,43,53,16,5,1,118,0,16,134
24,1,24025,735,3,152,132,47,7,3,341,2,60,403
24,1,24025,738,3,16,77,7,0,1,101,1,14,116
24,1,24025,740,3,347,130,124,7,4,612,1,70,683
24,1,24025,742,3,104,117,40,6,0,267,0,0,267
24,1,24025,743,3,47,53,14,0,1,115,0,20,135
24,1,24025,746,3,403,81,48,9,4,545,2,68,615
24,1,24025,747,3,147,51,23,1,0,222,0,15,237
24,1,24034,1221,3,206,33,126,16,2,383,1,13,397
24,1,24034,1222,3,9,19,22,1,2,53,1,1,55
24,1,24034,1223,3,95,66,51,1,0,213,0,11,224
24,1,24034,1226,3,217,49,78,4,2,350,1,9,360
24,1,24034,1227,3,157,38,77,5,2,279,0,13,292
24,1,24034,1230,3,61,39,14,0,1,115,0,2,117
24,1,24034,1231,3,39,43,20,3,0,105,0,16,121
24,1,24034,1234,3,70,38,95,1,0,204,0,14,218
24,1,24034,1235,3,66,31,66,0,0,163,0,22,185
24,1,24034,1238,3,313,253,215,84,9,874,5,92,971
24,1,24034,1239,3,43,47,7,5,0,102,3,15,120
24,1,24044,1520,3,156,206,29,27,0,418,0,28,446
24,1,24044,1522,3,167,238,20,13,2,440,0,17,457
24,1,24044,1523,3,35,40,2,0,0,77,0,2,79
24,1,24044,1526,3,87,93,4,0,0,184,0,0,184
24,1,24044,1527,3,107,175,12,0,2,296,0,25,321
24,1,24044,1530,3,29,70,3,0,0,102,0,8,110
24,1,24044,1531,3,60,146,8,0,0,214,0,19,233
24,1,24044,1534,3,69,136,3,2,2,212,0,11,223
24,1,24044,1535,3,25,26,6,1,0,58,0,1,59
24,1,24045,1538,3,270,282,121,27,11,711,0,47,758
24,1,24045,1539,3,236,252,117,33,16,654,0,19,673
24,1,24045,1542,3,29,86,21,2,2,140,0,28,168
24,1,24045,1543,3,22,105,15,2,1,145,0,21,166
24,1,24045,1546,3,70,138,13,11,2,234,0,35,269
24,1,24045,1547,3,70,89,8,4,2,173,0,27,200
24,1,24045,1550,3,32,131,24,12,1,200,0,34,234
24,1,24045,1551,3,73,90,24,6,8,201,0,34,235
24,1,24045,1554,3,49,100,19,0,3,171,0,17,188
24,1,24045,1555,3,45,85,28,8,0,166,0,29,195
24,1,24048,1587,3,213,98,81,57,1,450,0,39,489
24,1,24048,1590,3,142,110,22,26,2,302,0,40,342
24,1,24048,1591,3,23,31,45,1,2,102,0,12,114
24,1,24048,1594,3,27,18,7,4,1,57,0,3,60
24,1,24048,1595,3,24,13,13,3,1,54,0,2,56
24,1,24048,1598,3,235,144,29,82,1,491,2,76,569
24,1,24048,1599,3,109,93,21,21,4,248,0,43,291
24,1,24048,1602,3,50,55,29,3,0,137,0,20,157
24,1,24048,1603,3,52,53,7,7,1,120,0,12,132
24,1,24049,1606,3,149,201,45,5,2,402,1,11,414
24,1,24049,1607,3,120,139,36,1,0,296,0,8,304
24,1,24049,1610,3,90,119,35,2,1,247,0,21,268
24,1,24049,1611,3,75,109,26,1,1,212,0,3,215
24,1,24050,1614,3,41,47,29,1,1,119,0,4,123
24,1,24050,1615,3,239,260,199,3,3,704,0,44,748
24,1,24050,1618,3,212,60,200,4,4,480,0,30,510
24,1,24050,1619,3,112,387,143,9,2,653,3,55,711
24,1,24050,1622,3,672,189,257,10,4,1132,1,35,1168
24,1,24050,1623,3,307,353,312,5,0,977,3,52,1032
24,1,24050,1626,3,10,35,16,0,0,61,0,4,65
24,1,24050,1627,3,69,158,30,4,0,261,0,23,284
24,1,24050,1630,3,54,221,84,6,1,366,0,24,390
24,1,24050,1631,3,194,298,340,17,4,853,2,79,934
24,1,24050,1634,3,48,38,69,3,4,162,1,10,173
24,1,24050,1635,3,35,59,49,2,0,145,3,0,148
24,2,24004,60,3,90,101,16,4,1,212,0,12,224
24,2,24004,62,3,59,3,0,0,0,62,0,0,62
24,2,24004,63,3,15,37,2,0,1,55,0,4,59
24,2,24004,66,3,35,22,8,0,3,68,0,3,71
24,2,24004,67,3,25,12,1,0,0,38,0,1,39
24,2,24004,70,3,103,95,29,0,5,232,0,36,268
24,2,24004,71,3,47,53,3,0,0,103,0,4,107
24,2,24004,74,3,25,6,1,0,0,32,0,1,33
24,2,24004,75,3,24,13,8,1,1,47,0,6,53
24,2,24009,165,3,65,41,47,7,7,167,0,23,190
24,2,24009,166,3,26,20,11,5,6,68,2,9,79
24,2,24009,167,3,50,25,15,2,5,97,1,21,119
24,2,24009,170,3,40,15,23,3,0,81,0,10,91
24,2,24009,171,3,559,152,185,37,25,958,4,44,1006
24,2,24033,1188,3,361,249,127,14,12,763,0,22,785
24,2,24033,1190,3,292,180,35,15,5,527,1,23,551
24,2,24033,1191,3,423,176,58,14,10,681,3,0,684
24,2,24033,1194,3,506,90,49,6,0,651,0,20,671
24,2,24033,1195,3,180,64,24,3,0,271,1,15,287
24,2,24033,1198,3,19,4,24,0,0,47,0,9,56
24,2,24033,1199,3,9,21,14,3,1,48,0,4,52
24,2,24033,1202,3,85,92,36,1,1,215,0,22,237
24,2,24033,1203,3,183,129,19,1,1,333,0,24,357
24,2,24033,1206,3,218,192,57,6,8,481,1,31,513
24,2,24033,1207,3,179,151,41,6,5,382,2,15,399
24,2,24033,1210,3,34,46,27,0,0,107,2,4,113
24,2,24033,1211,3,161,73,12,3,0,249,0,22,271
24,2,24033,1214,3,224,323,49,8,5,609,0,57,666
24,2,24033,1215,3,84,252,23,2,4,365,3,18,386
24,2,24033,1218,3,161,279,40,11,7,498,6,85,589
24,2,24033,1219,3,191,310,47,8,8,564,0,75,639
24,2,24035,1242,3,117,71,56,17,6,267,5,15,287
24,2,24035,1243,3,85,72,73,20,10,260,5,11,276
24,2,24035,1246,3,437,152,145,64,31,829,1,50,880
24,2,24035,1247,3,788,302,264,97,46,1497,0,58,1555
24,2,24035,1250,3,457,214,144,66,36,917,2,51,970
24,2,24035,1251,3,345,168,168,76,33,790,2,47,839
24,2,24035,1254,3,393,160,151,71,40,815,1,37,853
24,2,24035,1255,3,456,130,146,79,24,835,2,37,874
24,2,24035,1258,3,425,126,100,54,24,729,0,26,755
24,2,24035,1259,3,539,230,184,88,47,1088,0,26,1114
24,2,24035,1262,3,199,69,57,30,9,364,0,11,375
24,2,24035,1263,3,151,105,49,20,10,335,3,12,350
24,2,24035,1266,3,249,106,76,38,22,491,0,11,502
24,2,24035,1267,3,325,148,88,51,23,635,7,21,663
24,2,24035,1270,3,106,58,61,24,16,265,0,3,268
24,2,24035,1271,3,471,178,156,66,19,890,3,29,922
24,2,24035,1274,3,1318,580,544,166,75,2683,20,93,2796
24,2,24035,1275,3,566,210,245,52,16,1089,1,61,1151
24,2,24035,1278,3,594,169,159,82,25,1029,2,36,1067
24,2,24035,1279,3,426,129,138,60,41,794,0,25,819
24,2,24035,1282,3,525,230,172,70,28,1025,5,29,1059
24,2,24035,1283,3,540,162,185,58,42,987,6,29,1022
24,2,24035,1286,3,422,170,165,61,29,847,0,30,877
24,2,24035,1287,3,619,174,180,52,34,1059,4,33,1096
24,2,24035,1290,3,328,136,175,46,32,717,0,26,743
24,2,24035,1291,3,561,214,214,120,31,1140,4,45,1189
24,2,24035,1294,3,552,218,222,68,29,1089,2,26,1117
24,2,24035,1295,3,365,195,155,52,24,791,0,30,821
24,2,24035,1298,3,340,209,191,57,30,827,0,33,860
24,2,24035,1299,3,904,313,260,110,57,1644,2,79,1725
24,2,24035,1302,3,381,132,162,47,20,742,1,19,762
24,2,24035,1303,3,308,127,133,59,27,654,0,20,674
24,2,24035,1306,3,308,148,112,30,13,611,2,35,648
24,2,24035,1307,3,146,70,44,14,8,282,3,10,295
24,2,24035,1310,3,176,128,52,13,13,382,3,45,430
24,2,24035,1311,3,129,101,56,22,7,315,0,35,350
24,2,24035,1314,3,554,319,137,61,31,1102,0,77,1179
24,2,24035,1315,3,125,74,71,11,9,290,0,21,311
24,2,24035,1318,3,336,93,88,58,23,598,0,34,632
24,2,24043,1507,3,110,122,12,12,3,259,0,15,274
24,2,24043,1510,3,150,123,21,2,5,301,0,26,327
24,2,24043,1511,3,262,225,40,13,6,546,0,42,588
24,2,24043,1514,3,105,74,5,0,0,184,0,13,197
24,2,24043,1515,3,76,65,5,0,2,148,0,3,151
24,2,24043,1518,3,17,21,3,0,0,41,0,1,42
24,2,24047,1569,3,307,215,178,17,17,734,1,32,767
24,2,24047,1570,3,259,219,194,29,17,718,1,68,787
24,2,24047,1571,3,228,163,128,14,7,540,0,34,574
24,2,24047,1574,3,91,56,127,4,7,285,0,11,296
24,2,24047,1575,3,132,225,94,8,3,462,3,52,517
24,2,24047,1578,3,63,45,28,0,2,138,0,9,147
24,2,24047,1579,3,123,170,185,25,2,505,1,15,521
24,2,24047,1582,3,47,28,32,1,1,109,0,12,121
24,2,24047,1583,3,52,24,65,4,3,148,0,3,151
24,2,24047,1586,3,51,33,34,2,1,121,0,15,136
24,2,24051,1638,3,292,168,52,6,3,521,0,32,553
24,2,24051,1639,3,448,154,75,9,13,699,2,29,730
24,2,24051,1642,3,451,219,62,19,11,762,0,15,777
24,2,24051,1643,3,296,205,45,11,4,561,3,28,592
24,2,24051,1646,3,340,192,24,10,0,566,2,61,629
24,2,24051,1647,3,286,131,16,8,1,442,3,15,460
24,2,24051,1650,3,18,45,4,1,0,68,0,2,70
24,2,24051,1651,3,114,80,18,3,3,218,2,0,220
24,2,24051,1654,3,172,104,5,2,1,284,3,8,295
24,2,24051,1655,3,354,165,42,7,2,570,0,41,611
24,2,24051,1658,3,270,229,9,4,3,515,0,43,558
24,2,24051,1659,3,356,183,5,2,2,548,0,15,563
24,2,24051,1662,3,102,59,7,5,0,173,0,9,182
24,2,24051,1663,3,96,60,4,1,0,161,2,19,182
24,2,24051,1666,3,478,187,69,9,8,751,6,15,772
24,2,24051,1667,3,205,205,35,5,0,450,2,48,500
24,2,24056,1773,3,341,534,82,60,22,1039,2,148,1189
24,2,24056,1774,3,366,216,64,36,21,703,0,96,799
24,2,24056,1775,3,384,265,97,39,22,807,0,96,903
24,2,24056,1778,3,122,66,21,5,4,218,1,35,254
24,2,24056,1779,3,219,61,56,17,8,361,1,73,435
24,2,24056,1782,3,54,46,22,2,1,125,1,7,133
24,2,24056,1783,3,105,59,19,5,2,190,0,35,225
24,2,24056,1786,3,58,40,30,3,0,131,1,13,145
24,2,24056,1787,3,261,147,168,11,4,591,2,41,634
24,2,24056,1790,3,75,25,24,4,0,128,2,6,136
24,2,24056,1791,3,64,19,8,0,0,91,0,4,95
24,2,24056,1794,3,57,26,17,2,1,103,3,3,109
24,2,24056,1795,3,126,36,17,7,6,192,1,11,204
24,3,24002,15,3,95,46,23,5,4,173,0,9,182
24,3,24002,18,3,43,23,13,3,0,82,0,5,87
24,3,24002,19,3,70,75,26,7,3,181,1,11,193
24,3,24002,22,3,42,45,15,4,3,109,0,4,113
24,3,24002,23,3,145,105,37,17,1,305,0,45,350
24,3,24002,26,3,115,241,42,18,3,419,0,24,443
24,3,24002,27,3,13,51,17,4,2,87,0,11,98
24,3,24002,30,3,17,159,49,11,11,247,0,26,273
24,3,24002,31,3,65,92,18,6,1,182,1,22,205
24,3,24005,78,3,86,154,120,7,10,377,1,21,399
24,3,24005,79,3,191,413,189,10,4,807,2,98,907
24,3,24005,82,3,81,104,111,8,3,307,0,12,319
24,3,24005,83,3,168,140,97,13,3,421,2,16,439
24,3,24005,86,3,124,112,97,23,7,363,0,21,384
24,3,24005,87,3,100,94,86,8,3,291,1,16,308
24,3,24005,90,3,159,208,148,9,3,527,0,26,553
24,3,24005,91,3,34,66,64,7,7,178,1,18,197
24,3,24005,94,3,72,38,35,3,2,150,0,19,169
24,3,24005,95,3,54,53,64,12,3,186,1,28,215
24,3,24008,136,3,217,197,36,5,3,458,0,14,472
24,3,24008,138,3,203,161,40,2,2,408,0,15,423
24,3,24008,139,3,377,304,94,4,2,781,1,27,809
24,3,24008,142,3,333,216,40,7,1,597,0,13,610
24,3,24008,143,3,500,244,90,4,6,844,1,17,862
24,3,24008,146,3,18,16,0,0,0,34,0,1,35
24,3,24008,147,3,57,166,15,1,0,239,0,16,255
24,3,24008,150,3,36,39,10,0,0,85,0,12,97
24,3,24008,151,3,22,42,13,0,0,77,0,2,79
24,3,24008,154,3,33,13,34,0,0,80,0,3,83
24,3,24008,155,3,44,64,48,2,1,159,1,11,171
24,3,24008,158,3,144,81,12,2,3,242,0,10,252
24,3,24008,159,3,23,32,8,0,0,63,0,1,64
24,3,24008,162,3,18,19,18,0,0,55,0,3,58
24,3,24008,163,3,101,38,31,1,0,171,0,37,208
24,3,24010,173,3,530,447,68,10,8,1063,1,28,1092
24,3,24010,174,3,322,219,44,4,5,594,5,12,611
24,3,24010,175,3,379,365,66,3,9,822,1,11,834
24,3,24010,178,3,108,140,4,1,0,253,0,4,257
24,3,24010,179,3,253,211,63,3,9,539,0,20,559
24,3,24010,182,3,282,279,48,3,1,613,0,52,665
24,3,24010,183,3,90,114,6,0,1,211,0,1,212
24,3,24010,196,3,76,56,21,0,3,156,0,10,166
24,3,24010,198,3,219,349,6,0,1,575,1,45,621
24,3,24010,199,3,59,92,9,0,0,160,0,34,194
24,3,24010,202,3,238,349,19,1,0,607,0,36,643
24,3,24010,206,3,71,127,5,0,0,203,0,0,203
24,3,24010,207,3,45,68,9,0,0,122,0,8,130
24,3,24010,210,3,89,67,9,0,0,165,0,28,193
24,3,24010,211,3,96,189,24,0,1,310,0,27,337
24,3,24010,214,3,88,147,20,1,0,256,3,32,291
24,3,24010,215,3,86,135,11,0,2,234,0,23,257
24,3,24010,218,3,32,56,10,1,0,99,0,9,108
24,3,24011,220,3,271,204,36,10,4,525,0,33,558
24,3,24011,222,3,316,312,57,18,11,714,1,27,742
24,3,24011,223,3,178,257,46,4,4,489,0,15,504
24,3,24011,226,3,315,301,78,20,6,720,0,22,742
24,3,24011,227,3,300,150,38,133,2,623,3,65,691
24,3,24011,230,3,316,163,42,118,5,644,0,37,681
24,3,24011,231,3,282,180,62,68,6,598,3,34,635
24,3,24011,234,3,242,174,43,96,4,559,0,54,613
24,3,24011,235,3,53,31,4,13,0,101,5,7,113
24,3,24011,238,3,20,70,11,5,3,109,0,0,109
24,3,24011,239,3,27,33,6,0,0,66,0,3,69
24,3,24011,242,3,78,161,15,2,14,270,0,24,294
24,3,24011,243,3,248,397,32,20,3,700,4,43,747
24,3,24011,246,3,171,273,30,75,1,550,0,66,616
24,3,24011,247,3,117,264,39,17,3,440,2,26,468
24,3,24011,250,3,80,75,15,10,3,183,0,27,210
24,3,24017,437,3,111,140,10,4,4,269,0,16,285
24,3,24017,438,3,43,24,1,2,2,72,0,2,74
24,3,24017,439,3,118,133,15,1,1,268,0,5,273
24,3,24017,442,3,66,79,1,0,1,147,0,6,153
24,3,24017,443,3,190,129,19,2,0,340,1,41,382
24,3,24017,446,3,177,124,21,2,0,324,3,45,372
24,3,24017,447,3,427,337,38,17,2,821,2,90,913
24,3,24017,450,3,127,190,51,5,2,375,0,27,402
24,3,24017,451,3,455,257,167,9,5,893,1,88,982
24,3,24017,454,3,223,220,9,3,4,459,2,44,505
24,3,24017,455,3,13,65,0,0,0,78,0,2,80
24,3,24017,458,3,165,140,15,0,0,320,0,21,341
24,3,24017,459,3,35,50,2,1,0,88,0,2,90
24,3,24017,462,3,142,138,21,0,2,303,0,50,353
24,3,24017,463,3,192,159,9,1,1,362,0,28,390
24,3,24017,466,3,169,335,18,0,0,522,0,73,595
24,3,24017,467,3,55,46,5,0,0,106,0,18,124
24,3,24019,478,3,65,32,22,0,1,120,1,4,125
24,3,24019,479,3,59,39,26,0,1,125,0,17,142
24,3,24019,482,3,233,165,39,0,0,437,0,48,485
24,3,24019,483,3,80,66,26,0,0,172,0,17,189
24,3,24019,486,3,65,70,94,1,1,231,1,13,245
24,3,24019,487,3,80,50,9,0,0,139,0,16,155
24,3,24023,616,3,338,308,123,26,4,799,2,61,862
24,3,24023,618,3,344,327,148,9,5,833,0,66,899
24,3,24023,619,3,123,108,26,1,0,258,0,18,276
24,3,24023,622,3,94,106,54,0,3,257,0,28,285
24,3,24023,623,3,177,287,103,4,4,575,0,85,660
24,3,24023,626,3,113,213,71,2,6,405,0,52,457
24,3,24023,627,3,129,119,75,1,1,325,0,41,366
24,3,24023,630,3,27,26,11,0,0,64,0,10,74
24,3,24023,631,3,16,9,40,0,0,65,0,2,67
24,3,24024,634,3,273,104,34,5,1,417,2,22,441
24,3,24024,635,3,245,97,29,6,1,378,0,20,398
24,3,24024,638,3,515,417,98,15,23,1068,0,27,1095
24,3,24024,639,3,308,194,47,4,6,559,0,15,574
24,3,24024,642,3,322,243,59,3,7,634,0,27,661
24,3,24024,643,3,269,224,61,8,8,570,0,23,593
24,3,24024,646,3,420,231,70,4,6,731,3,39,773
24,3,24024,647,3,333,238,91,8,14,684,1,6,691
24,3,24024,650,3,327,193,57,8,11,596,0,15,611
24,3,24024,651,3,329,209,50,8,4,600,0,20,620
24,3,24024,654,3,290,166,70,7,8,541,2,14,557
24,3,24024,655,3,309,246,53,8,15,631,2,18,651
24,3,24024,658,3,372,222,52,9,11,666,0,26,692
24,3,24024,659,3,387,339,105,11,15,857,1,9,867
24,3,24024,662,3,319,264,75,4,9,671,2,53,726
24,3,24024,663,3,144,156,22,1,3,326,0,19,345
24,3,24024,666,3,134,181,24,1,2,342,0,38,380
24,3,24024,667,3,28,67,23,0,1,119,0,13,132
24,3,24024,670,3,172,286,15,4,1,478,4,52,534
24,3,24024,671,3,58,109,24,1,3,195,1,11,207
24,3,24024,674,3,82,37,5,0,2,126,0,5,131
24,3,24024,675,3,84,65,22,1,0,172,0,0,172
24,3,24024,678,3,189,153,16,0,0,358,0,17,375
24,3,24024,679,3,53,79,22,1,2,157,0,15,172
24,3,24024,682,3,30,54,11,0,0,95,0,7,102
24,3,24024,683,3,150,154,11,1,4,320,0,33,353
24,3,24024,686,3,148,91,20,1,4,264,0,33,297
24,3,24024,687,3,40,36,2,0,0,78,0,4,82
24,3,24024,690,3,124,147,49,3,2,325,0,21,346
24,3,24024,691,3,44,79,4,0,0,127,0,3,130
24,3,24024,694,3,89,34,4,0,0,127,0,0,127
24,3,24024,695,3,321,336,76,12,1,746,0,46,792
24,3,24024,698,3,138,87,26,1,0,252,0,22,274
24,3,24024,699,3,113,78,18,3,0,212,0,15,227
24,3,24024,702,3,51,51,5,0,0,107,0,10,117
24,3,24024,703,3,63,125,10,0,2,200,0,16,216
24,3,24024,706,3,338,248,25,8,4,623,0,65,688
24,3,24024,707,3,79,70,12,6,0,167,0,22,189
24,3,24024,710,3,60,32,16,0,2,110,0,1,111
24,3,24024,711,3,248,322,41,7,1,619,0,47,666
24,3,24024,714,3,43,41,12,0,3,99,0,6,105
24,3,24024,715,3,78,42,15,1,2,138,0,11,149
24,3,24024,718,3,47,41,18,1,0,107,1,1,109
24,3,24024,719,3,7,29,2,0,0,38,0,0,38
24,3,24024,722,3,25,97,9,1,1,133,0,23,156
24,3,24024,723,3,28,26,3,0,0,57,0,0,57
24,3,24027,757,3,226,141,29,5,4,405,0,21,426
24,3,24027,758,3,175,183,33,4,2,397,0,25,422
24,3,24027,759,3,258,292,43,1,4,598,0,34,632
24,3,24027,762,3,146,154,29,3,2,334,0,24,358
24,3,24027,763,3,152,162,21,2,1,338,0,31,369
24,3,24027,766,3,38,74,11,0,1,124,0,5,129
24,3,24027,767,3,98,141,9,5,1,254,0,18,272
24,3,24027,770,3,17,56,1,0,1,75,0,9,84
24,3,24027,771,3,92,107,3,0,0,202,0,8,210
24,3,24030,1148,3,254,47,47,7,0,355,0,16,371
24,3,24030,1150,3,32,31,29,0,0,92,0,7,99
24,3,24030,1151,3,79,82,13,0,1,175,0,2,177
24,3,24030,1154,3,31,16,17,0,0,64,0,3,67
24,3,24030,1155,3,60,55,63,1,2,181,0,24,205
24,3,24030,1158,3,34,72,67,2,0,175,0,13,188
24,3,24030,1159,3,200,194,306,8,0,708,1,61,770
24,3,24046,1556,3,457,400,187,9,5,1058,3,60,1121
24,3,24046,1558,3,297,223,150,2,0,672,0,32,704
24,3,24046,1559,3,30,40,17,0,2,89,0,7,96
24,3,24046,1562,3,125,102,41,4,0,272,2,0,274
24,3,24046,1563,3,67,82,5,1,1,156,0,6,162
24,3,24046,1566,3,53,21,40,2,0,116,0,9,125
24,3,24046,1567,3,287,125,68,2,2,484,0,14,498
24,3,24052,1670,3,334,199,38,5,6,582,3,28,613
24,3,24052,1671,3,282,179,29,6,1,497,0,30,527
24,3,24052,1674,3,249,219,30,1,1,500,1,26,527
24,3,24052,1675,3,152,123,17,1,1,294,0,22,316
24,3,24052,1678,3,21,54,6,0,0,81,0,6,87
24,3,24052,1679,3,68,95,51,2,0,216,2,23,241
24,3,24052,1682,3,87,56,5,0,0,148,0,7,155
24,3,24052,1683,3,132,168,1,1,1,303,0,15,318
24,3,24052,1686,3,134,122,18,0,1,275,1,11,287
24,3,24052,1687,3,83,95,5,0,0,183,0,6,189
24,3,24053,1690,3,192,88,12,1,1,294,0,18,312
24,3,24053,1691,3,215,121,18,4,2,360,0,23,383
24,3,24053,1694,3,73,32,5,0,0,110,1,3,114
24,3,24053,1695,3,230,228,1,1,2,462,0,17,479
24,3,24053,1698,3,207,251,10,0,1,469,1,21,491
24,3,24053,1699,3,92,77,10,0,1,180,0,19,199
24,3,24053,1702,3,49,46,0,0,0,95,0,11,106
24,3,24053,1703,3,40,24,1,0,0,65,0,3,68
24,4,24057,180,3,32,169,6,0,0,207,0,16,223
24,4,24057,186,3,159,393,18,9,0,579,0,37,616
24,4,24057,187,3,152,284,42,11,1,490,0,18,508
24,4,24057,190,3,378,418,93,79,7,975,2,24,1001
24,4,24057,191,3,405,207,77,76,4,769,0,34,803
24,4,24057,194,3,162,159,17,64,1,403,0,28,431
24,4,24057,195,3,160,173,33,8,0,374,1,19,394
24,4,24057,203,3,81,37,9,11,1,139,0,12,151
24,4,24057,212,3,295,127,38,28,2,490,0,47,537
24,4,24057,219,3,125,92,37,48,0,302,0,6,308
24,4,24013,266,3,738,468,397,213,14,1830,0,81,1911
24,4,24013,267,3,416,143,193,70,12,834,0,48,882
24,4,24013,270,3,246,143,102,65,6,562,0,7,569
24,4,24013,271,3,410,192,164,79,13,858,0,20,878
24,4,24013,274,3,400,182,208,72,12,874,0,51,925
24,4,24013,275,3,459,256,240,106,16,1077,1,44,1122
24,4,24013,278,3,367,156,118,65,10,716,0,15,731
24,4,24013,279,3,286,167,137,43,13,646,0,22,668
24,4,24013,282,3,696,217,163,144,21,1241,0,23,1264
24,4,24013,283,3,551,195,207,99,18,1070,1,37,1108
24,4,24013,286,3,328,203,134,69,11,745,9,24,778
24,4,24013,287,3,530,182,183,73,10,978,0,24,1002
24,4,24013,290,3,251,85,79,42,6,463,0,16,479
24,4,24013,291,3,397,143,92,44,4,680,0,14,694
24,4,24013,294,3,455,332,129,81,6,1003,0,27,1030
24,4,24013,295,3,320,142,105,76,12,655,0,23,678
24,4,24013,298,3,265,178,122,55,6,626,0,28,654
24,4,24013,299,3,366,157,95,60,12,690,0,28,718
24,4,24013,302,3,197,61,47,26,4,335,0,0,335
24,4,24013,303,3,265,144,67,40,6,522,0,5,527
24,4,24013,306,3,146,60,46,21,3,276,1,5,282
24,4,24013,307,3,191,81,48,22,3,345,0,13,358
24,4,24013,310,3,506,215,185,112,20,1038,0,24,1062
24,4,24013,311,3,388,127,143,34,9,701,0,37,738
24,4,24013,314,3,235,103,57,31,4,430,0,5,435
24,4,24013,315,3,102,41,24,19,2,188,0,8,196
24,4,24013,318,3,240,95,68,43,5,451,0,0,451
24,4,24013,319,3,401,154,89,62,6,712,0,24,736
24,4,24013,322,3,299,108,86,51,10,554,3,21,578
24,4,24013,323,3,312,125,81,54,10,582,0,16,598
24,4,24013,326,3,387,175,153,82,13,810,0,19,829
24,4,24013,327,3,245,101,113,59,11,529,0,9,538
24,4,24013,330,3,58,32,9,4,0,103,0,3,106
24,4,24013,331,3,205,30,38,9,2,284,0,0,284
24,4,24013,334,3,48,60,39,5,1,153,0,0,153
24,4,24013,335,3,174,106,75,10,2,367,0,13,380
24,4,24013,338,3,196,82,265,47,5,595,2,45,642
24,4,24013,339,3,65,63,57,12,0,197,1,9,207
24,4,24013,342,3,104,65,137,14,0,320,0,16,336
24,4,24013,343,3,124,62,27,10,0,223,1,9,233
24,4,24013,346,3,228,115,109,59,7,518,1,39,558
24,4,24013,347,3,196,52,19,24,2,293,0,11,304
24,4,24013,350,3,184,144,85,35,7,455,0,16,471
24,4,24013,351,3,133,70,58,12,5,278,0,14,292
24,4,24013,354,3,214,261,118,39,8,640,0,55,695
24,4,24013,355,3,213,84,55,12,1,365,0,0,365
24,4,24013,358,3,169,162,119,47,9,506,3,70,579
24,4,24013,359,3,210,106,135,21,9,481,0,15,496
24,4,24013,362,3,111,44,86,17,1,259,0,21,280
24,4,24013,363,3,71,49,57,10,3,190,4,15,209
24,4,24013,366,3,74,67,19,13,2,175,0,30,205
24,4,24013,367,3,163,112,183,89,6,553,2,41,596
24,4,24013,370,3,141,48,121,24,5,339,0,24,363
24,4,24016,405,3,209,145,87,6,2,449,0,28,477
24,4,24016,406,3,176,155,156,15,4,506,3,23,532
24,4,24016,407,3,280,240,187,19,6,732,1,38,771
24,4,24016,410,3,182,213,150,19,3,567,0,28,595
24,4,24016,411,3,215,193,197,37,7,649,2,17,668
24,4,24016,414,3,173,133,151,15,6,478,0,8,486
24,4,24016,415,3,136,223,275,30,8,672,1,11,684
24,4,24016,418,3,300,284,222,14,8,828,1,26,855
24,4,24016,419,3,163,167,261,13,5,609,0,21,630
24,4,24016,422,3,124,126,115,16,2,383,0,6,389
24,4,24016,423,3,182,175,173,23,3,556,1,22,579
24,4,24016,426,3,249,176,119,5,3,552,3,30,585
24,4,24016,427,3,369,223,183,13,3,791,7,43,841
24,4,24016,430,3,216,126,184,9,2,537,7,33,577
24,4,24016,431,3,165,102,138,6,5,416,9,27,452
24,4,24016,434,3,164,105,57,4,1,331,0,9,340
24,4,24016,435,3,81,63,60,4,0,208,0,12,220
24,4,24031,1160,3,252,132,106,23,8,521,3,56,580
24,4,24031,1162,3,289,144,83,30,18,564,1,40,605
24,4,24031,1163,3,283,146,83,29,9,550,4,43,597
24,4,24031,1166,3,35,23,10,3,1,72,0,6,78
24,4,24031,1167,3,166,73,39,8,3,289,0,19,308
24,4,24031,1170,3,48,31,27,5,1,112,0,16,128
24,4,24031,1171,3,46,55,55,8,3,167,2,11,180
24,4,24031,1174,3,105,165,29,7,4,310,5,19,334
24,4,24031,1175,3,44,62,32,4,2,144,2,10,156
24,4,24031,1178,3,189,191,125,24,16,545,0,106,651
24,4,24032,1179,3,49,13,37,2,0,101,0,8,109
24,4,24032,1182,3,22,21,10,0,0,53,0,14,67
24,4,24032,1183,3,155,153,102,1,3,414,0,64,478
24,4,24032,1186,3,136,114,172,0,1,423,0,67,490
24,4,24032,1187,3,74,228,323,2,6,633,0,126,759
24,4,24036,1319,3,499,201,102,35,5,842,0,52,894
24,4,24036,1322,3,118,82,49,1,3,253,0,28,281
24,4,24036,1323,3,170,100,72,9,0,351,0,26,377
24,4,24036,1326,3,311,559,106,16,12,1004,0,92,1096
24,4,24036,1327,3,346,417,110,22,18,913,4,37,954
24,4,24036,1330,3,406,325,63,10,6,810,1,101,912
24,4,24036,1331,3,183,129,37,4,3,356,0,48,404
24,4,24036,1334,3,241,91,28,8,6,374,1,59,434
24,4,24036,1335,3,429,203,41,5,5,683,2,81,766
24,4,24040,1445,3,285,169,204,60,7,725,2,26,753
24,4,24040,1446,3,276,118,149,33,4,580,0,20,600
24,4,24040,1447,3,306,179,161,33,2,681,1,20,702
24,4,24040,1450,3,200,118,106,33,2,459,1,12,472
24,4,24040,1451,3,163,101,89,25,1,379,0,23,402
24,4,24040,1454,3,220,97,158,27,6,508,6,16,530
24,4,24040,1455,3,365,152,278,35,1,831,29,61,921
24,4,24040,1458,3,90,84,90,5,1,270,0,26,296
24,4,24040,1459,3,39,23,64,3,1,130,0,11,141
24,4,24040,1462,3,107,95,245,18,5,470,5,32,507
24,4,24040,1463,3,148,71,134,8,0,361,0,27,388
24,4,24040,1466,3,39,41,9,0,1,90,2,5,97
24,4,24040,1467,3,154,29,56,7,0,246,1,18,265
24,4,24040,1470,3,39,95,17,2,2,155,0,15,170
24,4,24040,1471,3,70,83,50,4,6,213,1,17,231
24,4,24040,1474,3,179,80,71,10,3,343,2,13,358
24,4,24040,1475,3,165,83,212,6,2,468,2,23,493
24,4,24040,1478,3,74,21,56,7,3,161,0,0,161
24,4,24040,1479,3,129,41,23,7,4,204,0,22,226
24,4,24042,1496,3,715,432,43,7,3,1200,1,45,1246
24,4,24042,1498,3,390,426,41,9,1,867,0,20,887
24,4,24042,1499,3,430,289,23,10,6,758,2,27,787
24,4,24042,1502,3,217,154,35,5,1,412,0,26,438
24,4,24042,1503,3,89,88,6,0,0,183,0,9,192
24,4,24042,1506,3,67,31,4,1,0,103,0,7,110
24,5,24028,773,3,1245,454,409,156,49,2313,6,47,2366
24,5,24028,774,3,1214,453,493,112,61,2333,6,69,2408
24,5,24028,775,3,989,448,334,91,33,1895,3,85,1983
24,5,24028,778,3,648,259,245,83,37,1272,1,31,1304
24,5,24028,779,3,676,270,210,81,18,1255,14,32,1301
24,5,24028,782,3,526,162,138,44,29,899,2,31,932
24,5,24028,783,3,536,218,153,41,16,964,3,33,1000
24,5,24028,786,3,439,191,164,58,31,883,5,13,901
24,5,24028,787,3,1408,484,362,142,45,2441,8,91,2540
24,5,24028,790,3,581,276,195,58,20,1130,0,32,1162
24,5,24028,791,3,586,140,129,48,13,916,5,29,950
24,5,24028,794,3,597,170,214,55,16,1052,8,28,1088
24,5,24028,795,3,612,188,189,59,29,1077,4,23,1104
24,5,24028,798,3,381,75,122,34,19,631,3,17,651
24,5,24028,799,3,226,130,116,42,18,532,1,9,542
24,5,24028,802,3,470,166,174,55,22,887,2,14,903
24,5,24028,803,3,1013,303,251,89,50,1706,5,32,1743
24,5,24028,806,3,410,156,111,35,23,735,1,6,742
24,5,24028,807,3,445,160,151,42,20,818,0,20,838
24,5,24028,810,3,363,143,111,24,18,659,3,12,674
24,5,24028,811,3,323,106,78,32,22,561,1,12,574
24,5,24028,814,3,267,118,80,49,9,523,4,14,541
24,5,24028,815,3,258,90,86,40,13,487,0,12,499
24,5,24028,818,3,305,95,61,20,9,490,0,5,495
24,5,24028,819,3,369,155,97,21,9,651,2,13,666
24,5,24028,822,3,429,162,134,40,20,785,2,11,798
24,5,24028,823,3,422,157,180,44,16,819,2,19,840
24,5,24028,826,3,600,204,171,48,19,1042,4,28,1074
24,5,24028,827,3,484,189,151,58,25,907,1,26,934
24,5,24028,830,3,517,167,128,52,9,873,4,17,894
24,5,24028,831,3,488,151,129,51,14,833,4,14,851
24,5,24028,834,3,614,205,159,46,23,1047,5,25,1077
24,5,24028,835,3,625,237,167,49,27,1105,2,12,1119
24,5,24028,838,3,357,106,96,31,13,603,0,4,607
24,5,24028,839,3,405,152,127,52,17,753,5,11,769
24,5,24028,842,3,530,200,188,34,36,988,3,37,1028
24,5,24028,843,3,630,177,173,62,20,1062,3,32,1097
24,5,24028,846,3,838,249,118,38,24,1267,3,23,1293
24,5,24028,847,3,759,199,167,61,29,1215,18,38,1271
24,5,24028,850,3,261,101,96,15,12,485,1,19,505
24,5,24028,852,3,334,118,103,19,11,585,0,5,590
24,5,24028,854,3,274,110,132,36,4,556,8,22,586
24,5,24028,855,3,217,85,77,20,9,408,0,12,420
24,5,24028,858,3,498,158,100,27,14,797,2,17,816
24,5,24028,859,3,408,94,108,37,16,663,7,17,687
24,5,24028,862,3,242,108,79,14,5,448,0,16,464
24,5,24028,864,3,148,78,51,11,16,304,0,14,318
24,5,24028,866,3,461,132,112,38,17,760,7,23,790
24,5,24028,867,3,421,159,124,28,19,751,2,12,765
24,5,24028,870,3,668,199,165,56,31,1119,1,30,1150
24,5,24028,871,3,513,170,148,35,23,889,1,23,913
24,5,24028,874,3,201,76,70,19,9,375,0,16,391
24,5,24028,880,3,146,92,74,15,6,333,2,4,339
24,5,24028,882,3,136,64,62,10,12,284,0,9,293
24,5,24028,883,3,497,159,90,21,15,782,2,10,794
24,5,24028,886,3,614,174,99,27,21,935,3,13,951
24,5,24028,887,3,426,123,77,18,18,662,0,12,674
24,5,24028,890,3,613,143,140,29,30,955,0,10,965
24,5,24028,891,3,212,58,60,11,11,352,0,11,363
24,5,24028,894,3,73,24,25,7,4,133,0,2,135
24,5,24028,895,3,115,45,58,16,1,235,4,8,247
24,5,24028,903,3,277,95,79,20,12,483,2,15,500
24,5,24028,906,3,570,194,196,20,19,999,1,11,1011
24,5,24028,907,3,684,163,150,23,15,1035,6,23,1064
24,5,24028,910,3,691,178,90,13,19,991,2,22,1015
24,5,24028,911,3,378,107,43,6,11,545,0,20,565
24,5,24028,914,3,676,162,96,31,21,986,0,12,998
24,5,24028,915,3,606,164,79,8,21,878,2,25,905
24,5,24028,918,3,222,57,70,11,15,375,0,6,381
24,5,24028,928,3,179,67,61,17,8,332,1,15,348
24,5,24028,930,3,346,95,53,14,14,522,0,0,522
24,5,24028,982,3,639,184,94,26,13,956,3,16,975
24,5,24028,983,3,737,150,158,22,18,1085,2,15,1102
24,5,24028,986,3,287,90,84,14,8,483,1,11,495
24,5,24028,987,3,344,117,116,32,17,626,3,12,641
24,5,24028,997,3,540,231,170,43,20,1004,1,23,1028
24,5,24028,998,3,686,203,139,37,26,1091,6,12,1109
24,5,24028,999,3,838,271,144,41,36,1330,2,25,1357
24,5,24028,1002,3,320,133,70,18,17,558,1,7,566
24,5,24028,1003,3,137,66,53,8,2,266,1,2,269
24,5,24028,1021,3,552,224,136,41,39,992,1,19,1012
24,5,24028,1022,3,688,181,133,33,19,1054,1,14,1069
24,5,24028,1023,3,897,357,191,50,25,1520,3,34,1557
24,5,24028,1037,3,507,160,157,28,27,879,1,11,891
24,5,24028,1039,3,1666,450,308,76,67,2567,4,32,2603
24,5,24028,1042,3,669,226,186,52,29,1162,3,21,1186
24,5,24028,1076,3,138,57,16,2,0,213,1,12,226
24,5,24028,1078,3,34,21,3,0,0,58,0,5,63
24,5,24028,1079,3,98,15,11,0,1,125,0,17,142
24,5,24028,1082,3,74,28,26,0,0,128,0,2,130
24,5,24028,1083,3,42,13,8,0,0,63,0,3,66
24,5,24028,1086,3,256,95,36,5,1,393,3,10,406
24,5,24028,1087,3,78,13,9,4,3,107,2,2,111
24,5,24028,1090,3,98,66,38,10,3,215,1,9,225
24,5,24028,1091,3,31,50,7,1,1,90,0,6,96
24,5,24028,1094,3,40,6,6,0,0,52,0,1,53
24,5,24028,1095,3,70,0,6,3,1,80,0,0,80
24,5,24028,1098,3,60,4,0,1,1,66,0,1,67
24,5,24028,1099,3,47,13,2,0,0,62,1,0,63
24,5,24028,1102,3,52,7,4,1,0,64,0,3,67
24,5,24028,1103,3,70,36,18,7,1,132,2,9,143
24,5,24028,1106,3,343,52,75,14,6,490,5,23,518
24,5,24028,1115,3,344,154,60,1,0,559,9,0,568
24,5,24028,1118,3,365,256,46,14,4,685,0,11,696
24,5,24028,1119,3,256,51,23,9,2,341,1,7,349
24,5,24028,1122,3,45,7,1,1,1,55,0,1,56
24,5,24028,1123,3,260,64,42,3,2,371,6,17,394
24,6,24028,851,3,579,216,198,59,19,1071,3,25,1099
24,6,24028,863,3,663,256,167,59,20,1165,6,30,1201
24,6,24028,875,3,259,88,63,35,13,458,4,13,475
24,6,24028,878,3,335,140,94,52,4,625,3,17,645
24,6,24028,879,3,249,113,90,35,5,492,3,7,502
24,6,24028,896,3,395,183,96,27,9,710,2,21,733
24,6,24028,898,3,246,101,96,27,11,481,2,19,502
24,6,24028,899,3,203,76,42,14,7,342,0,7,349
24,6,24028,902,3,227,64,80,21,16,408,1,13,422
24,6,24028,919,3,201,115,83,21,9,429,0,9,438
24,6,24028,922,3,585,232,185,56,29,1087,0,24,1111
24,6,24028,923,3,88,56,24,10,2,180,1,3,184
24,6,24028,926,3,342,156,109,30,17,654,7,17,678
24,6,24028,927,3,288,141,84,30,16,559,3,15,577
24,6,24028,931,3,519,230,157,46,34,986,6,20,1012
24,6,24028,934,3,642,211,193,64,25,1135,6,33,1174
24,6,24028,935,3,489,178,128,67,22,884,2,20,906
24,6,24028,938,3,374,186,131,42,39,772,0,12,784
24,6,24028,939,3,522,201,194,62,39,1018,6,18,1042
24,6,24028,942,3,408,193,128,56,24,809,3,18,830
24,6,24028,943,3,1038,339,321,109,51,1858,16,49,1923
24,6,24028,946,3,350,108,109,36,11,614,4,7,625
24,6,24028,947,3,1161,324,337,104,50,1976,6,34,2016
24,6,24028,950,3,515,182,172,57,23,949,1,39,989
24,6,24028,951,3,305,118,88,23,18,552,0,4,556
24,6,24028,954,3,340,161,93,30,14,638,0,23,661
24,6,24028,955,3,1058,322,281,89,41,1791,8,21,1820
24,6,24028,958,3,478,166,108,41,17,810,0,19,829
24,6,24028,959,3,613,184,132,51,24,1004,4,17,1025
24,6,24028,962,3,394,125,104,28,13,664,0,14,678
24,6,24028,963,3,417,167,92,39,22,737,2,23,762
24,6,24028,966,3,460,114,96,40,19,729,1,15,745
24,6,24028,967,3,768,243,202,43,19,1275,5,44,1324
24,6,24028,970,3,574,177,142,48,27,968,2,20,990
24,6,24028,971,3,268,81,89,22,12,472,5,15,492
24,6,24028,974,3,538,192,166,53,33,982,6,13,1001
24,6,24028,975,3,181,56,36,8,8,289,0,4,293
24,6,24028,978,3,186,66,55,21,7,335,0,11,346
24,6,24028,979,3,346,129,88,25,16,604,14,21,639
24,6,24028,988,3,318,158,78,33,16,603,5,13,621
24,6,24028,990,3,215,99,79,22,11,426,3,0,429
24,6,24028,991,3,194,90,58,12,5,359,2,9,370
24,6,24028,994,3,372,138,80,25,25,640,0,18,658
24,6,24028,995,3,232,122,88,34,18,494,1,17,512
24,6,24028,1006,3,304,134,103,26,12,579,1,20,600
24,6,24028,1007,3,336,143,100,26,14,619,5,9,633
24,6,24028,1010,3,97,83,54,9,1,244,1,3,248
24,6,24028,1011,3,222,101,60,32,14,429,0,17,446
24,6,24028,1014,3,268,121,80,35,6,510,3,17,530
24,6,24028,1015,3,294,125,88,31,12,550,0,20,570
24,6,24028,1018,3,457,198,114,47,14,830,7,25,862
24,6,24028,1019,3,508,235,156,37,18,954,2,26,982
24,6,24028,1024,3,462,221,104,27,11,825,3,16,844
24,6,24028,1026,3,444,132,155,35,18,784,11,20,815
24,6,24028,1027,3,361,138,106,39,24,668,10,10,688
24,6,24028,1030,3,423,127,85,34,10,679,3,28,710
24,6,24028,1031,3,562,187,153,48,24,974,6,14,994
24,6,24028,1034,3,430,157,109,36,18,750,0,22,772
24,6,24028,1035,3,537,168,109,42,31,887,2,15,904
24,6,24028,1038,3,404,145,98,29,18,694,1,19,714
24,6,24028,1043,3,428,120,89,30,12,679,0,11,690
24,6,24028,1046,3,284,118,106,29,11,548,9,21,578
24,6,24028,1047,3,374,161,104,50,22,711,2,13,726
24,6,24028,1050,3,610,151,156,34,35,986,12,8,1006
24,6,24028,1051,3,568,174,143,36,38,959,2,21,982
24,6,24028,1054,3,316,61,92,27,15,511,3,5,519
24,6,24028,1055,3,566,185,153,59,25,988,11,25,1024
24,6,24028,1058,3,480,149,103,34,10,776,1,19,796
24,6,24028,1059,3,625,200,174,57,24,1080,9,23,1112
24,6,24028,1062,3,582,147,150,31,23,933,9,33,975
24,6,24028,1063,3,615,143,145,39,11,953,10,7,970
24,6,24028,1066,3,247,116,71,41,12,487,0,5,492
24,6,24028,1067,3,382,138,102,35,15,672,1,9,682
24,6,24028,1070,3,580,179,175,47,34,1015,8,29,1052
24,6,24028,1071,3,351,153,82,45,11,642,6,13,661
24,6,24028,1074,3,2145,871,568,188,87,3859,19,78,3956
24,6,24028,1075,3,1192,426,318,106,60,2102,22,56,2180
24,6,24028,1107,3,167,94,33,9,6,309,2,21,332
24,6,24028,1110,3,429,197,85,30,4,745,2,39,786
24,6,24028,1111,3,311,161,63,13,10,558,0,0,558
24,6,24028,1114,3,426,155,75,21,9,686,2,17,705
24,6,24028,1124,3,298,127,44,14,7,490,5,23,518
24,6,24028,1126,3,314,146,70,10,3,543,0,30,573
24,6,24028,1127,3,129,30,8,2,3,172,0,7,179
24,7,24003,34,3,576,336,168,4,11,1095,1,87,1183
24,7,24003,35,3,184,139,107,10,2,442,0,14,456
24,7,24003,38,3,210,141,38,3,2,394,2,37,433
24,7,24003,39,3,322,350,22,6,2,702,0,90,792
24,7,24003,42,3,174,203,12,1,1,391,0,53,444
24,7,24003,43,3,525,259,22,0,2,808,1,39,848
24,7,24003,46,3,491,240,36,2,0,769,2,110,881
24,7,24003,47,3,215,126,45,0,2,388,2,63,453
24,7,24003,50,3,208,130,10,1,1,350,0,30,380
24,7,24003,51,3,394,108,103,2,2,609,5,51,665
24,7,24003,54,3,258,133,27,1,8,427,7,50,484
24,7,24003,55,3,245,100,16,3,3,367,3,26,396
24,7,24003,58,3,206,192,38,1,4,441,0,49,490
24,7,24003,59,3,279,250,43,13,5,590,0,19,609
24,7,24012,251,3,179,247,134,2,4,566,0,29,595
24,7,24012,254,3,72,104,67,1,4,248,0,17,265
24,7,24012,255,3,79,75,195,7,0,356,2,25,383
24,7,24012,258,3,144,92,108,8,0,352,0,27,379
24,7,24012,259,3,178,310,410,7,8,913,5,68,986
24,7,24012,262,3,121,68,75,2,0,266,0,30,296
24,7,24012,263,3,66,68,92,1,2,229,0,35,264
24,7,24014,371,3,254,524,113,46,8,945,0,53,998
24,7,24014,374,3,76,145,149,2,1,373,0,25,398
24,7,24014,375,3,189,132,134,3,5,463,1,32,496
24,7,24014,378,3,197,139,120,3,2,461,0,24,485
24,7,24014,379,3,266,208,108,3,3,588,0,40,628
24,7,24014,382,3,115,164,113,5,2,399,2,35,436
24,7,24014,383,3,202,131,312,5,4,654,1,45,700
24,7,24018,468,3,143,85,24,21,1,274,0,20,294
24,7,24018,470,3,256,89,29,1,4,379,0,61,440
24,7,24018,471,3,179,131,13,8,0,331,0,46,377
24,7,24018,474,3,398,352,106,13,1,870,0,133,1003
24,7,24018,475,3,556,320,84,3,4,967,0,123,1090
24,7,24026,748,3,377,213,61,1,3,655,1,29,685
24,7,24026,750,3,65,64,35,1,1,166,0,5,171
24,7,24026,751,3,199,177,25,1,1,403,6,25,434
24,7,24026,754,3,274,148,24,0,0,446,0,26,472
24,7,24026,755,3,98,68,52,1,1,220,0,19,239
24,7,24029,1128,3,396,205,175,9,1,786,0,31,817
24,7,24029,1130,3,99,84,153,0,1,337,0,61,398
24,7,24029,1131,3,274,256,50,4,0,584,0,48,632
24,7,24029,1134,3,261,95,79,2,1,438,0,35,473
24,7,24029,1135,3,52,55,34,1,0,142,0,13,155
24,7,24029,1138,3,31,23,21,0,1,76,0,2,78
24,7,24029,1139,3,66,27,83,0,1,177,0,17,194
24,7,24029,1142,3,220,208,210,6,4,648,0,31,679
24,7,24029,1143,3,153,145,402,2,0,702,0,38,740
24,7,24029,1146,3,61,42,52,0,2,157,0,15,172
24,7,24029,1147,3,409,191,177,4,2,783,0,86,869
24,7,24037,1336,3,180,245,214,184,4,827,0,51,878
24,7,24037,1338,3,88,82,52,82,2,306,0,12,318
24,7,24037,1339,3,199,191,234,112,4,740,6,58,804
24,7,24037,1342,3,159,143,116,151,5,574,0,23,597
24,7,24037,1343,3,187,205,234,142,2,770,0,32,802
24,7,24037,1346,3,224,186,186,127,3,726,0,42,768
24,7,24037,1347,3,250,259,292,140,10,951,1,58,1010
24,7,24058,1350,3,186,59,141,6,2,394,2,49,445
24,7,24058,1351,3,218,33,244,7,0,502,1,77,580
24,7,24058,1354,3,43,11,56,1,1,112,0,4,116
24,7,24058,1355,3,441,135,277,109,4,966,7,18,991
24,7,24058,1358,3,731,142,294,8,6,1181,7,57,1245
24,7,24058,1359,3,386,76,246,21,2,731,2,71,804
24,7,24058,1362,3,313,144,139,5,8,609,2,111,722
24,7,24058,1363,3,423,271,99,1,3,797,0,25,822
24,7,24058,1366,3,232,117,161,10,2,522,1,61,584
24,7,24037,1367,3,71,193,120,6,3,393,29,63,485
24,7,24037,1370,3,20,77,54,0,1,152,0,16,168
24,7,24037,1371,3,202,172,149,11,2,536,0,32,568
24,7,24037,1374,3,32,80,77,0,0,189,0,19,208
24,7,24037,1375,3,141,132,171,88,5,537,0,26,563
24,7,24037,1378,3,147,170,162,15,1,495,0,58,553
24,7,24037,1379,3,45,41,41,2,2,131,0,0,131
24,7,24037,1382,3,72,214,185,10,4,485,2,44,531
24,7,24037,1383,3,69,264,190,11,5,539,0,114,653
24,7,24037,1386,3,72,191,197,48,8,516,4,37,557
24,7,24037,1387,3,35,127,98,2,2,264,0,42,306
24,7,24037,1390,3,109,201,253,8,0,571,1,92,664
24,7,24037,1391,3,59,237,307,12,4,619,0,63,682
24,7,24037,1394,3,39,109,150,14,2,314,0,65,379
24,7,24037,1395,3,219,326,339,41,8,933,2,50,985
24,7,24037,1398,3,149,183,229,19,0,580,3,58,641
24,7,24037,1399,3,26,86,103,6,4,225,0,56,281
24,7,24037,1402,3,15,148,238,7,4,412,0,89,501
24,7,24037,1403,3,88,78,55,3,1,225,0,17,242
24,7,24037,1406,3,35,131,127,12,6,311,0,51,362
24,7,24037,1407,3,75,95,123,2,5,300,0,56,356
24,7,24037,1410,3,79,357,218,6,2,662,0,74,736
24,7,24037,1411,3,314,214,160,238,6,932,3,49,984
24,7,24038,1414,3,133,228,122,13,25,521,0,42,563
24,7,24038,1415,3,74,155,79,4,6,318,0,19,337
24,7,24038,1418,3,424,138,111,10,56,739,0,59,798
24,7,24038,1419,3,91,51,20,3,38,203,0,0,203
24,7,24038,1422,3,97,149,100,15,37,398,0,95,493
24,7,24038,1423,3,154,160,111,8,43,476,0,58,534
24,7,24038,1426,3,124,97,50,6,31,308,0,58,366
24,7,24038,1427,3,328,281,173,14,19,815,1,57,873
24,7,24039,1430,3,97,45,22,9,30,203,0,29,232
24,7,24039,1431,3,125,73,17,0,10,225,3,8,236
24,7,24039,1434,3,102,30,11,2,7,152,0,10,162
24,7,24039,1435,3,129,69,17,3,26,244,4,29,277
24,7,24039,1438,3,149,69,98,4,4,324,0,29,353
24,7,24039,1439,3,153,83,191,4,7,438,2,0,440
24,7,24039,1442,3,78,61,61,0,0,200,0,16,216
24,7,24039,1443,3,118,63,106,1,1,289,0,24,313
24,7,24041,1480,3,306,246,263,78,4,897,1,80,978
24,7,24041,1482,3,46,109,40,7,0,202,0,17,219
24,7,24041,1483,3,102,60,214,4,3,383,0,23,406
24,7,24041,1486,3,150,77,102,7,2,338,0,21,359
24,7,24041,1487,3,110,71,144,64,2,391,0,47,438
24,7,24041,1490,3,239,129,198,33,6,605,0,45,650
24,7,24041,1491,3,144,125,93,109,2,473,1,22,496
24,7,24041,1494,3,132,83,49,12,4,280,1,45,326
24,7,24041,1495,3,129,126,126,0,0,381,0,54,435
24,7,24054,1705,3,418,198,96,63,9,784,3,43,830
24,7,24054,1706,3,322,258,97,99,18,794,0,45,839
24,7,24054,1707,3,363,139,74,48,16,640,0,55,695
24,7,24054,1710,3,239,48,31,15,2,335,0,26,361
24,7,24054,1711,3,431,169,115,29,28,772,1,74,847
24,7,24054,1714,3,305,129,94,10,9,547,0,66,613
24,7,24054,1715,3,249,43,49,4,10,355,1,16,372
24,7,24054,1718,3,211,123,72,20,17,443,0,41,484
24,7,24054,1719,3,275,114,53,10,44,496,4,55,555
24,7,24054,1722,3,135,155,195,29,12,526,1,46,573
24,7,24054,1723,3,236,105,281,14,38,674,0,37,711
24,7,24055,1726,3,323,290,130,25,6,774,5,52,831
24,7,24055,1727,3,242,292,81,49,7,671,5,32,708
24,7,24055,1730,3,239,288,122,13,2,664,2,58,724
24,7,24055,1731,3,192,232,44,2,2,472,0,64,536
24,7,24055,1734,3,84,91,35,2,0,212,4,11,227
24,7,24055,1735,3,208,107,24,1,0,340,1,20,361
24,7,24055,1738,3,95,99,26,2,0,222,0,0,222
24,7,24055,1739,3,328,179,69,1,2,579,1,25,605
24,7,24055,1742,3,93,1,11,0,0,105,0,22,127
24,7,24055,1743,3,77,102,65,6,3,253,0,17,270
24,7,24055,1746,3,82,65,30,0,1,178,3,19,200
24,7,24055,1747,3,195,166,28,0,0,389,0,41,430
24,7,24055,1750,3,168,128,34,34,1,365,0,29,394
24,7,24055,1751,3,131,239,29,2,0,401,2,46,449
24,7,24055,1754,3,148,76,33,0,3,260,4,9,273
24,7,24055,1755,3,77,242,27,5,3,354,2,53,409
24,7,24055,1758,3,44,74,32,0,0,150,0,32,182
24,7,24055,1759,3,155,106,27,2,1,291,1,33,325
24,7,24055,1762,3,150,222,17,2,1,392,0,64,456
24,7,24055,1763,3,134,121,70,2,0,327,0,57,384
24,7,24055,1766,3,121,127,34,1,1,284,0,45,329
24,7,24055,1767,3,217,154,8,0,2,381,2,24,407
24,7,24055,1770,3,72,147,10,2,0,231,0,21,252
24,7,24055,1771,3,89,139,16,2,2,248,0,35,283
25,1,25003,563,3,99,134,11,3,2,249,0,9,258
25,1,25003,566,3,59,144,10,2,2,217,0,5,222
25,1,25003,567,3,56,46,6,0,0,108,0,4,112
25,1,25003,570,3,7,258,11,1,0,277,0,0,277
25,1,25003,571,3,31,102,23,1,1,158,0,3,161
25,1,25003,574,3,165,444,43,1,1,654,0,19,673
25,1,25003,575,3,42,247,34,2,3,328,0,14,342
25,1,25003,578,3,2,55,6,0,0,63,0,1,64
25,1,25003,579,3,12,127,30,2,3,174,0,15,189
25,1,25003,582,3,8,103,5,1,0,117,0,1,118
25,1,25003,583,3,12,58,2,0,2,74,0,2,76
25,1,25003,586,3,5,66,8,0,0,79,0,2,81
25,1,25003,587,3,37,72,7,0,0,116,0,1,117
25,1,25003,590,3,57,104,5,2,0,168,1,4,173
25,1,25003,591,3,7,34,3,0,0,44,0,4,48
25,1,25003,594,3,59,77,19,0,1,156,0,6,162
25,1,25003,595,3,32,59,10,0,0,101,0,3,104
25,1,25003,598,3,23,37,4,0,0,64,0,1,65
25,1,25003,599,3,3,46,1,0,0,50,0,2,52
25,1,25003,602,3,5,36,3,0,0,44,0,2,46
25,1,25003,603,3,41,106,5,2,0,154,1,2,157
25,1,25003,607,3,24,70,4,0,0,98,0,1,99
25,1,25003,610,3,8,50,15,0,0,73,0,1,74
25,1,25003,611,3,10,39,1,0,0,50,0,3,53
25,1,25003,614,3,33,95,11,0,0,139,0,2,141
25,1,25003,615,3,8,40,12,0,0,60,0,4,64
25,1,25003,618,3,15,92,29,0,1,137,2,0,139
25,1,25003,619,3,14,99,0,1,0,114,0,4,118
25,1,25003,622,3,23,69,7,1,0,100,0,2,102
25,1,25003,623,3,14,43,11,0,0,68,0,3,71
25,1,25003,626,3,22,29,7,0,0,58,0,1,59
25,1,25003,627,3,17,37,7,0,0,61,0,3,64
25,1,25007,1726,3,178,161,18,10,2,369,0,12,381
25,1,25007,1727,3,155,177,28,2,2,364,1,13,378
25,1,25007,1730,3,168,115,16,3,0,302,0,6,308
25,1,25007,1731,3,90,90,12,4,0,196,0,2,198
25,1,25007,1734,3,69,82,14,1,1,167,0,2,169
25,1,25007,1735,3,226,169,20,1,0,416,1,15,432
25,1,25007,1738,3,5,7,1,0,1,14,0,2,16
25,1,25007,1739,3,10,25,0,0,0,35,0,0,35
25,1,25007,1742,3,19,29,25,0,0,73,0,4,77
25,1,25007,1743,3,56,26,24,0,0,106,0,12,118
25,1,25007,1746,3,114,61,9,0,0,184,0,4,188
25,1,25007,1747,3,39,26,6,0,0,71,0,5,76
25,1,25007,1750,3,96,79,0,0,0,175,0,1,176
25,1,25007,1751,3,59,48,2,1,0,110,0,0,110
25,1,25007,1754,3,65,39,4,0,0,108,0,11,119
25,1,25007,1755,3,149,57,6,0,0,212,0,8,220
25,1,25007,1758,3,68,65,2,2,0,137,0,2,139
25,1,25007,1759,3,41,29,3,1,1,75,0,4,79
25,1,25007,1762,3,52,18,5,0,1,76,0,1,77
25,1,25007,1763,3,32,61,1,0,0,94,0,5,99
25,1,25007,1766,3,76,17,1,0,0,94,0,2,96
25,1,25007,1767,3,44,6,0,0,0,50,0,0,50
25,1,25007,1770,3,108,73,9,0,0,190,0,2,192
25,1,25007,1771,3,87,115,1,0,0,203,0,7,210
25,1,25007,1774,3,111,47,4,1,0,163,0,5,168
25,1,25007,1775,3,97,54,7,5,0,163,0,2,165
25,1,25007,1778,3,63,103,11,0,0,177,1,3,181
25,1,25007,1779,3,64,36,3,0,0,103,0,1,104
25,1,25007,1782,3,53,98,38,3,0,192,0,5,197
25,1,25007,1783,3,26,72,15,0,0,113,0,7,120
25,1,25007,1786,3,73,90,4,1,1,169,0,6,175
25,1,25007,1787,3,186,86,3,0,1,276,1,0,277
25,1,25007,1790,3,55,83,4,1,0,143,0,1,144
25,1,25007,1791,3,24,57,12,0,0,93,0,0,93
25,1,25007,1794,3,37,62,3,0,0,102,0,1,103
25,1,25007,1795,3,33,23,4,2,0,62,0,0,62
25,1,25007,1798,3,42,41,19,1,0,103,0,8,111
25,1,25010,1925,3,99,92,23,3,0,217,0,3,220
25,1,25010,1926,3,121,89,18,6,2,236,0,2,238
25,1,25010,1927,3,88,112,13,8,0,221,0,4,225
25,1,25010,1930,3,114,105,26,4,0,249,1,11,261
25,1,25010,1931,3,71,92,28,6,0,197,1,1,199
25,1,25010,1934,3,116,90,43,4,2,255,0,8,263
25,1,25010,1935,3,96,62,16,6,4,184,0,4,188
25,1,25010,1938,3,198,174,58,4,3,437,0,13,450
25,1,25010,1939,3,101,74,29,6,1,211,1,8,220
25,1,25010,1942,3,151,118,22,8,0,299,0,6,305
25,1,25010,1943,3,58,61,11,6,0,136,0,0,136
25,1,25010,1946,3,17,25,7,0,0,49,0,1,50
25,1,25010,1947,3,31,20,8,0,0,59,0,0,59
25,1,25010,1950,3,16,27,1,0,0,44,0,1,45
25,1,25010,1951,3,12,108,7,0,0,127,0,0,127
25,1,25010,1954,3,23,48,6,0,0,77,0,2,79
25,1,25010,1955,3,60,101,12,27,0,200,0,7,207
25,1,25010,1958,3,22,23,2,3,1,51,0,0,51
25,1,25010,1959,3,12,37,3,0,0,52,0,1,53
25,1,25010,1962,3,78,140,10,2,0,230,0,5,235
25,1,25010,1963,3,34,35,19,4,0,92,0,5,97
25,1,25010,1966,3,37,55,10,3,0,105,0,5,110
25,1,25010,1967,3,33,38,17,1,1,90,0,5,95
25,1,25010,1970,3,103,55,31,2,1,192,0,5,197
25,1,25010,1971,3,106,90,11,5,0,212,1,2,215
25,1,25010,1974,3,55,69,14,0,0,138,0,3,141
25,1,25010,1975,3,13,26,12,1,0,52,0,4,56
25,1,25010,1978,3,75,63,4,0,0,142,0,4,146
25,1,25010,1979,3,13,38,10,2,0,63,0,0,63
25,1,25010,1982,3,43,63,15,0,1,122,0,0,122
25,1,25010,1983,3,11,29,28,3,1,72,0,1,73
25,1,25010,1986,3,38,57,33,3,1,132,0,12,144
25,1,25010,1987,3,25,34,7,2,1,69,0,1,70
25,1,25010,1990,3,46,78,19,2,0,145,0,4,149
25,1,25010,1991,3,69,160,25,2,0,256,1,4,261
25,1,25010,1994,3,79,86,32,2,0,199,0,5,204
25,1,25010,1995,3,24,28,21,3,0,76,0,4,80
25,1,25010,1998,3,43,90,48,2,1,184,0,6,190
25,1,25010,1999,3,21,33,16,0,0,70,0,8,78
25,1,25010,2002,3,101,41,29,3,1,175,0,4,179
25,1,25010,2003,3,56,46,13,2,0,117,0,4,121
25,1,25010,2006,3,56,111,79,7,3,256,0,10,266
25,1,25010,2007,3,91,114,84,15,2,306,1,10,317
25,1,25010,2010,3,53,176,73,21,0,323,0,8,331
25,1,25010,2011,3,49,123,63,28,1,264,0,15,279
25,1,25010,2014,3,104,131,50,10,1,296,0,8,304
25,1,25010,2015,3,104,83,24,1,0,212,0,6,218
25,1,25010,2018,3,51,32,8,3,1,95,0,1,96
25,1,25010,2019,3,33,141,78,17,4,273,0,17,290
25,1,25010,2022,3,25,43,15,2,0,85,0,1,86
25,1,25010,2023,3,97,109,13,6,0,225,0,5,230
25,1,25010,2026,3,88,82,7,6,0,183,0,0,183
25,1,25010,2027,3,44,55,14,10,0,123,0,6,129
25,1,25010,2030,3,69,85,13,5,1,173,0,3,176
25,1,25010,2031,3,86,140,13,2,2,243,0,7,250
25,1,25010,2034,3,82,93,36,3,1,215,0,10,225
25,1,25010,2035,3,37,71,7,0,0,115,0,3,118
25,1,25010,2038,3,14,35,5,0,0,54,0,1,55
25,1,25010,2039,3,81,197,46,6,1,331,0,13,344
25,1,25010,2042,3,38,71,12,9,1,131,0,2,133
25,1,25010,2043,3,104,177,31,23,0,335,0,0,335
25,1,25010,2046,3,58,126,31,2,0,217,0,15,232
25,1,25010,2047,3,90,132,45,16,1,284,0,11,295
25,1,25010,2050,3,135,127,63,6,1,332,1,10,343
25,1,25010,2051,3,26,30,17,0,3,76,0,5,81
25,1,25010,2054,3,79,62,23,3,3,170,0,6,176
25,1,25010,2055,3,151,148,28,11,0,338,1,5,344
25,1,25010,2058,3,79,142,31,14,0,266,0,8,274
25,1,25010,2059,3,86,104,19,7,0,216,0,6,222
25,1,25010,2062,3,114,126,57,6,2,305,0,6,311
25,1,25010,2063,3,81,18,73,4,2,178,0,12,190
25,1,25010,2066,3,116,143,38,9,4,310,0,9,319
25,1,25010,2067,3,112,163,59,22,3,359,0,4,363
25,1,25010,2070,3,103,99,49,5,1,257,1,5,263
25,1,25010,2071,3,59,60,34,0,0,153,0,0,153
25,1,25010,2074,3,93,178,71,13,0,355,0,5,360
25,1,25010,2075,3,78,130,40,9,1,258,1,5,264
25,1,25010,2078,3,88,86,54,2,3,233,0,0,233
25,1,25010,2079,3,64,62,31,3,2,162,0,2,164
25,1,25010,2082,3,114,145,84,8,0,351,0,12,363
25,1,25010,2083,3,78,83,27,2,1,191,0,12,203
25,1,25010,2086,3,145,77,28,6,3,259,0,2,261
25,1,25010,2087,3,73,126,26,0,1,226,1,8,235
25,1,25010,2090,3,85,95,27,4,2,213,0,8,221
25,1,25010,2091,3,57,51,50,4,1,163,0,1,164
25,1,25010,2094,3,61,113,11,0,0,185,0,1,186
25,1,25010,2095,3,148,182,48,1,1,380,1,14,395
25,1,25010,2098,3,104,79,31,5,4,223,0,5,228
25,1,25010,2099,3,117,149,54,11,2,333,1,7,341
25,1,25013,2997,3,88,148,41,9,1,287,0,0,287
25,1,25013,2998,3,20,43,8,1,0,72,0,0,72
25,1,25013,2999,3,58,87,25,4,3,177,0,3,180
25,1,25013,3002,3,30,65,12,1,0,108,0,4,112
25,1,25013,3003,3,29,66,10,2,1,108,0,2,110
25,1,25013,3006,3,40,97,27,4,1,169,0,4,173
25,1,25013,3007,3,108,157,38,10,1,314,1,4,319
25,1,25013,3010,3,16,42,16,1,0,75,0,7,82
25,1,25013,3011,3,19,27,10,0,0,56,0,4,60
25,1,25013,3014,3,43,181,7,0,2,233,0,5,238
25,1,25013,3015,3,77,107,8,0,0,192,1,7,200
25,1,25013,3018,3,47,40,4,0,0,91,0,5,96
25,1,25013,3019,3,20,22,3,0,0,45,0,0,45
25,1,25013,3022,3,39,46,2,1,0,88,0,0,88
25,1,25013,3023,3,19,57,9,2,0,87,0,4,91
25,1,25013,3026,3,27,75,18,1,0,121,1,1,123
25,1,25013,3027,3,76,63,11,2,0,152,0,1,153
25,1,25013,3030,3,21,28,3,0,0,52,0,0,52
25,1,25013,3031,3,49,63,14,1,1,128,0,4,132
25,1,25013,3034,3,14,80,5,0,0,99,0,2,101
25,1,25013,3035,3,13,77,14,0,0,104,0,6,110
25,1,25013,3038,3,9,35,4,0,0,48,0,0,48
25,1,25013,3039,3,29,58,8,0,1,96,0,1,97
25,1,25013,3042,3,80,108,13,0,0,201,0,12,213
25,1,25013,3043,3,44,75,4,2,0,125,0,4,129
25,1,25013,3046,3,54,176,0,0,0,230,0,17,247
25,1,25013,3047,3,18,53,30,0,0,101,0,2,103
25,1,25013,3050,3,18,33,3,0,0,54,0,4,58
25,1,25013,3051,3,61,110,18,1,1,191,0,5,196
25,1,25013,3054,3,54,90,24,1,0,169,0,0,169
25,1,25013,3055,3,79,141,22,1,0,243,0,6,249
25,1,25013,3058,3,60,67,8,0,0,135,0,3,138
25,1,25013,3059,3,38,56,12,0,0,106,1,2,109
25,1,25013,3063,3,31,50,11,0,0,92,0,2,94
25,1,25013,3066,3,47,46,31,0,1,125,0,4,129
25,1,25013,3067,3,69,35,15,2,0,121,0,5,126
25,1,25013,3070,3,39,56,7,1,0,103,0,1,104
25,1,25013,3071,3,31,37,5,0,0,73,0,0,73
25,1,25013,3074,3,21,52,5,0,0,78,0,3,81
25,1,25013,3075,3,38,80,17,1,0,136,0,4,140
25,1,25013,3078,3,15,28,8,0,1,52,0,1,53
25,1,25013,3079,3,37,31,16,1,2,87,0,1,88
25,1,25013,3082,3,39,34,9,3,1,86,0,8,94
25,1,25013,3083,3,8,42,10,0,0,60,0,0,60
25,1,25013,3086,3,53,86,13,0,0,152,7,4,163
25,1,25013,3087,3,77,102,31,1,0,211,0,10,221
25,1,25013,3090,3,35,72,78,1,0,186,0,2,188
25,1,25013,3091,3,25,76,47,3,0,151,0,7,158
25,1,25013,3094,3,29,50,3,0,0,82,0,1,83
25,1,25013,3095,3,55,33,17,4,3,112,0,2,114
25,1,25013,3098,3,104,92,21,1,0,218,0,3,221
25,1,25013,3099,3,30,45,2,0,0,77,0,2,79
25,1,25013,3102,3,67,101,54,8,1,231,0,5,236
25,1,25013,3103,3,48,62,14,0,6,130,0,4,134
25,1,25013,3106,3,59,114,39,0,3,215,0,4,219
25,1,25013,3107,3,52,88,18,3,0,161,1,2,164
25,1,25013,3110,3,24,12,12,0,2,50,0,0,50
25,1,25013,3111,3,113,94,38,5,1,251,0,9,260
25,1,25013,3114,3,29,54,161,1,2,247,1,7,255
25,1,25013,3115,3,69,68,215,0,7,359,3,0,362
25,1,25013,3118,3,30,35,18,0,0,83,0,4,87
25,1,25013,3119,3,74,48,12,1,1,136,0,1,137
25,1,25013,3122,3,68,78,72,5,2,225,0,5,230
25,1,25013,3123,3,52,52,39,1,1,145,1,1,147
25,1,25013,3126,3,101,168,65,7,5,346,2,10,358
25,1,25013,3127,3,68,59,39,1,1,168,0,3,171
25,1,25013,3130,3,25,69,10,0,0,104,0,3,107
25,1,25017,3420,3,137,169,45,3,0,354,1,5,360
25,1,25017,3422,3,135,163,25,4,2,329,0,1,330
25,1,25017,3423,3,235,299,57,4,0,595,0,27,622
25,1,25017,3426,3,57,8,1,0,1,67,0,0,67
25,1,25017,3429,3,30,2,5,0,0,37,0,0,37
25,1,25017,3430,3,39,21,5,1,0,66,0,1,67
25,1,25017,3431,3,104,37,24,1,1,167,0,4,171
25,1,25017,3434,3,83,8,8,0,1,100,0,1,101
25,1,25017,3435,3,193,14,8,0,0,215,0,1,216
25,1,25017,3439,3,63,52,8,0,0,123,0,3,126
25,1,25017,3442,3,44,21,3,0,0,68,0,1,69
25,1,25017,3443,3,81,44,7,0,0,132,0,1,133
25,1,25017,3446,3,121,85,20,1,1,228,1,8,237
25,1,25017,3447,3,113,42,19,1,0,175,0,3,178
25,1,25017,3450,3,113,66,2,0,0,181,0,8,189
25,1,25017,3451,3,205,177,33,4,1,420,1,12,433
25,1,25017,3454,3,10,31,7,0,1,49,0,4,53
25,1,25017,3455,3,94,90,9,0,0,193,0,0,193
25,1,25017,3458,3,11,38,4,0,0,53,0,2,55
25,1,25017,3459,3,82,45,9,0,0,136,0,0,136
25,1,25017,3462,3,29,33,4,0,0,66,0,2,68
25,1,25017,3463,3,16,14,3,0,0,33,0,3,36
25,1,25017,3466,3,42,19,1,0,0,62,0,4,66
25,1,25017,3467,3,57,32,2,0,0,91,0,1,92
25,1,25017,3470,3,150,91,20,0,1,262,0,10,272
25,1,25017,3471,3,215,72,52,1,0,340,1,4,345
25,1,25017,3474,3,70,38,17,0,0,125,0,2,127
25,1,25017,3475,3,58,16,9,0,3,86,0,2,88
25,1,25017,3478,3,151,127,59,1,2,340,0,9,349
25,1,25017,3479,3,63,28,14,0,2,107,0,4,111
25,1,25017,3482,3,86,70,35,0,2,193,0,9,202
25,1,25017,3483,3,152,116,7,0,0,275,0,4,279
25,1,25017,3486,3,33,67,12,0,0,112,0,5,117
25,1,25017,3487,3,41,20,24,0,1,86,0,3,89
25,1,25017,3490,3,134,78,12,0,0,224,0,6,230
25,1,25017,3491,3,79,64,38,1,0,182,0,12,194
25,1,25017,3494,3,57,50,3,0,0,110,0,7,117
25,1,25017,3495,3,25,21,0,0,0,46,0,1,47
25,1,25017,3498,3,29,43,4,0,0,76,0,0,76
25,1,25017,3499,3,44,39,5,0,1,89,0,3,92
25,1,25017,3502,3,61,148,5,0,0,214,0,2,216
25,1,25017,3503,3,72,88,14,0,0,174,0,4,178
25,1,25017,3506,3,29,63,12,1,0,105,0,1,106
25,1,25017,3507,3,46,15,6,0,0,67,0,2,69
25,1,25017,3510,3,129,27,12,0,0,168,0,10,178
25,1,25017,3511,3,86,56,36,2,1,181,2,7,190
25,1,25017,3514,3,21,37,4,0,0,62,0,2,64
25,1,25017,3515,3,140,117,44,1,1,303,0,3,306
25,1,25017,3518,3,267,119,35,0,0,421,0,11,432
25,1,25017,3519,3,174,73,12,2,0,261,0,7,268
25,1,25017,3522,3,25,44,18,0,0,87,0,8,95
25,1,25017,3523,3,45,38,37,0,0,120,0,2,122
25,1,25017,3526,3,111,89,15,2,1,218,0,2,220
25,1,25017,3527,3,131,100,22,3,1,257,0,4,261
25,1,25017,3530,3,63,26,28,0,1,118,0,2,120
25,1,25017,3532,3,145,46,41,0,0,232,0,7,239
25,1,25017,3534,3,92,80,25,0,3,200,0,10,210
25,1,25017,3535,3,31,55,8,1,0,95,0,1,96
25,1,25017,3538,3,69,90,35,1,0,195,0,7,202
25,1,25017,3539,3,67,31,37,0,0,135,0,9,144
25,1,25017,3542,3,62,40,0,0,0,102,0,5,107
25,1,25017,3543,3,56,67,5,0,0,128,0,0,128
25,1,25017,3546,3,56,137,4,0,0,197,0,1,198
25,1,25017,3547,3,57,29,19,0,0,105,0,2,107
25,1,25017,3550,3,33,62,7,0,1,103,0,1,104
25,1,25017,3551,3,54,107,5,0,0,166,0,2,168
25,1,25017,3554,3,85,59,16,0,0,160,0,7,167
25,1,25017,3555,3,34,46,1,0,0,81,0,3,84
25,1,25017,3558,3,92,54,0,0,0,146,0,0,146
25,1,25017,3559,3,128,85,3,0,0,216,0,6,222
25,1,25017,3562,3,87,136,8,0,0,231,0,5,236
25,1,25017,3563,3,50,85,13,1,0,149,0,0,149
25,1,25017,3566,3,137,104,15,0,0,256,0,15,271
25,1,25017,3567,3,47,49,7,0,0,103,0,2,105
25,1,25017,3570,3,56,83,19,1,0,159,0,7,166
25,1,25017,3571,3,93,130,6,1,0,230,0,7,237
25,1,25017,3574,3,33,13,19,1,0,66,0,3,69
25,1,25017,3575,3,72,46,11,0,0,129,0,6,135
25,1,25017,3578,3,115,79,22,1,1,218,0,9,227
25,1,25017,3579,3,103,58,20,0,0,181,0,5,186
25,1,25017,3582,3,128,73,33,2,0,236,0,4,240
25,1,25017,3583,3,126,45,13,0,3,187,0,9,196
25,1,25017,3586,3,86,33,36,0,0,155,0,3,158
25,1,25017,3587,3,116,173,62,3,2,356,0,7,363
25,1,25017,3590,3,151,193,34,3,1,382,0,8,390
25,1,25017,3591,3,82,139,38,8,1,268,0,0,268
25,1,25017,3594,3,113,110,23,1,0,247,0,6,253
25,1,25017,3595,3,104,70,21,1,0,196,0,3,199
25,1,25017,3598,3,65,62,16,0,0,143,0,8,151
25,1,25017,3599,3,78,53,8,0,0,139,0,11,150
25,1,25017,3602,3,39,26,5,0,1,71,0,3,74
25,1,25017,3603,3,51,98,15,0,0,164,0,3,167
25,1,25017,3606,3,60,26,13,0,0,99,0,2,101
25,1,25017,3607,3,103,144,11,0,2,260,0,5,265
25,1,25017,3610,3,100,187,31,3,1,322,0,13,335
25,1,25017,3611,3,120,128,19,1,1,269,0,16,285
25,2,25001,1,3,1166,1118,342,147,33,2806,6,29,2841
25,2,25001,2,3,76,73,17,10,4,180,0,1,181
25,2,25001,3,3,131,108,46,48,2,335,0,2,337
25,2,25001,6,3,75,68,21,6,0,170,2,1,173
25,2,25001,7,3,178,154,52,28,4,416,0,8,424
25,2,25001,10,3,130,95,32,21,0,278,1,11,290
25,2,25001,11,3,92,98,31,4,0,225,0,11,236
25,2,25001,14,3,136,122,41,19,3,321,0,9,330
25,2,25001,15,3,60,84,24,7,6,181,0,6,187
25,2,25001,18,3,70,58,17,7,1,153,0,8,161
25,2,25001,19,3,338,90,107,21,1,557,1,1,559
25,2,25001,22,3,188,114,56,23,7,388,1,1,390
25,2,25001,23,3,192,120,71,21,1,405,1,1,407
25,2,25001,26,3,106,172,46,17,0,341,0,5,346
25,2,25001,27,3,50,77,21,11,2,161,1,12,174
25,2,25001,30,3,160,84,24,10,5,283,1,2,286
25,2,25001,31,3,96,68,14,5,0,183,0,4,187
25,2,25001,34,3,65,76,22,3,1,167,0,5,172
25,2,25001,35,3,308,263,83,46,2,702,1,6,709
25,2,25001,38,3,51,47,23,7,0,128,0,7,135
25,2,25001,39,3,386,358,117,63,14,938,0,15,953
25,2,25001,42,3,95,125,35,19,2,276,0,6,282
25,2,25001,43,3,425,399,119,47,5,995,1,11,1007
25,2,25001,46,3,89,120,44,19,0,272,1,9,282
25,2,25001,47,3,98,131,31,13,2,275,0,7,282
25,2,25001,50,3,72,27,9,2,1,111,0,1,112
25,2,25001,51,3,121,53,25,7,1,207,0,3,210
25,2,25001,54,3,117,66,24,8,1,216,0,3,219
25,2,25001,55,3,115,150,34,30,8,337,0,15,352
25,2,25001,58,3,87,74,29,18,1,209,0,6,215
25,2,25001,59,3,67,59,19,5,0,150,0,0,150
25,2,25001,62,3,76,74,21,9,0,180,1,0,181
25,2,25001,63,3,203,129,88,19,3,442,0,3,445
25,2,25001,66,3,83,83,27,12,2,207,1,2,210
25,2,25001,67,3,119,93,18,10,8,248,0,10,258
25,2,25001,70,3,55,96,23,16,1,191,0,6,197
25,2,25001,71,3,39,30,22,4,3,98,0,7,105
25,2,25001,74,3,68,89,36,12,0,205,0,9,214
25,2,25001,75,3,94,82,28,12,3,219,2,9,230
25,2,25001,78,3,60,68,9,7,2,146,0,3,149
25,2,25001,79,3,106,88,27,20,1,242,0,5,247
25,2,25001,82,3,120,122,29,15,4,290,2,6,298
25,2,25001,83,3,199,211,65,24,2,501,1,18,520
25,2,25001,86,3,356,423,143,57,5,984,5,15,1004
25,2,25001,87,3,403,459,170,148,12,1192,2,30,1224
25,2,25001,90,3,103,100,32,10,4,249,0,7,256
25,2,25001,91,3,134,158,23,29,1,345,0,13,358
25,2,25001,94,3,51,51,19,5,2,128,0,4,132
25,2,25001,95,3,127,116,67,11,3,324,0,10,334
25,2,25001,98,3,144,146,60,25,5,380,0,8,388
25,2,25001,99,3,147,140,51,30,2,370,0,5,375
25,2,25001,102,3,109,108,35,16,0,268,1,10,279
25,2,25001,103,3,218,211,64,32,5,530,0,6,536
25,2,25001,106,3,41,49,23,9,2,124,0,4,128
25,2,25001,107,3,51,45,19,2,1,118,0,7,125
25,2,25001,110,3,86,86,43,6,2,223,1,12,236
25,2,25001,111,3,204,148,73,30,5,460,0,5,465
25,2,25001,114,3,295,201,93,41,9,639,0,13,652
25,2,25001,115,3,187,160,57,17,7,428,0,8,436
25,2,25001,118,3,82,90,42,11,4,229,0,5,234
25,2,25001,119,3,153,129,59,16,3,360,0,22,382
25,2,25001,122,3,220,148,81,38,6,493,0,11,504
25,2,25001,123,3,102,87,32,11,2,234,0,4,238
25,2,25001,126,3,103,141,40,13,4,301,1,12,314
25,2,25001,127,3,70,102,33,5,4,214,0,6,220
25,2,25001,130,3,92,69,49,11,4,225,1,0,226
25,2,25001,131,3,86,65,22,14,1,188,0,7,195
25,2,25001,134,3,73,52,14,7,0,146,1,0,147
25,2,25001,135,3,77,48,30,5,4,164,0,0,164
25,2,25001,138,3,92,116,43,6,3,260,0,9,269
25,2,25001,139,3,88,124,54,7,1,274,1,18,293
25,2,25001,142,3,188,228,75,24,6,521,4,18,543
25,2,25001,143,3,167,122,84,22,2,397,0,15,412
25,2,25001,146,3,202,110,46,18,3,379,0,5,384
25,2,25001,147,3,191,143,57,4,2,397,0,3,400
25,2,25001,150,3,116,99,32,12,2,261,0,6,267
25,2,25001,151,3,199,95,24,11,5,334,0,3,337
25,2,25001,154,3,282,125,52,10,3,472,0,2,474
25,2,25001,155,3,160,64,26,8,1,259,1,5,265
25,2,25001,158,3,295,173,63,31,3,565,0,3,568
25,2,25001,159,3,30,41,19,6,0,96,0,3,99
25,2,25001,162,3,251,234,89,25,5,604,0,11,615
25,2,25001,163,3,169,132,43,16,6,366,0,5,371
25,2,25001,166,3,129,136,48,17,3,333,0,3,336
25,2,25001,167,3,77,56,26,10,4,173,0,0,173
25,2,25001,170,3,179,207,55,43,6,490,0,15,505
25,2,25001,171,3,142,188,59,15,2,406,0,9,415
25,2,25001,174,3,187,88,49,18,2,344,2,6,352
25,2,25001,175,3,102,94,41,11,4,252,0,0,252
25,2,25001,178,3,103,48,24,3,0,178,0,3,181
25,2,25001,179,3,199,96,59,11,5,370,0,3,373
25,2,25001,182,3,110,80,53,8,2,253,1,0,254
25,2,25001,183,3,84,65,21,11,1,182,0,6,188
25,2,25001,186,3,69,101,28,10,2,210,1,2,213
25,2,25001,187,3,64,77,35,6,4,186,0,3,189
25,2,25001,190,3,73,62,14,5,0,154,0,4,158
25,2,25001,191,3,172,74,70,12,1,329,0,7,336
25,2,25001,194,3,162,82,18,3,0,265,0,1,266
25,2,25001,195,3,147,85,22,12,2,268,0,0,268
25,2,25001,198,3,102,41,27,2,0,172,1,1,174
25,2,25001,199,3,231,280,68,20,5,604,1,13,618
25,2,25001,202,3,184,196,94,92,5,571,3,5,579
25,2,25001,203,3,83,66,34,10,0,193,0,0,193
25,2,25001,206,3,148,172,63,12,3,398,0,11,409
25,2,25001,207,3,228,180,77,22,3,510,1,10,521
25,2,25001,210,3,131,105,47,10,2,295,0,5,300
25,2,25001,211,3,87,96,42,7,1,233,3,6,242
25,2,25001,214,3,145,98,32,16,4,295,0,2,297
25,2,25001,215,3,135,141,58,28,3,365,0,6,371
25,2,25001,218,3,125,120,47,9,2,303,2,12,317
25,2,25001,219,3,250,134,58,19,3,464,0,14,478
25,2,25001,222,3,97,101,22,10,1,231,0,7,238
25,2,25001,223,3,106,132,47,14,2,301,0,7,308
25,2,25001,226,3,221,246,96,143,4,710,2,12,724
25,2,25001,227,3,47,71,26,6,5,155,0,10,165
25,2,25001,230,3,88,88,29,10,5,220,0,5,225
25,2,25001,231,3,69,79,11,10,0,169,0,9,178
25,2,25001,234,3,69,113,30,5,1,218,0,3,221
25,2,25001,235,3,66,61,23,3,1,154,0,3,157
25,2,25001,238,3,34,58,19,0,6,117,0,7,124
25,2,25001,239,3,50,68,22,3,2,145,2,4,151
25,2,25001,242,3,44,116,17,7,1,185,0,8,193
25,2,25001,243,3,30,114,47,7,2,200,0,8,208
25,2,25001,246,3,57,112,22,11,0,202,0,6,208
25,2,25001,247,3,107,129,36,9,4,285,0,6,291
25,2,25001,250,3,75,132,40,16,1,264,1,10,275
25,2,25001,251,3,48,127,28,11,0,214,1,2,217
25,2,25001,254,3,99,83,37,4,3,226,1,6,233
25,2,25001,255,3,90,158,44,10,3,305,1,5,311
25,2,25001,258,3,118,156,27,40,1,342,0,8,350
25,2,25001,259,3,97,121,29,69,2,318,0,7,325
25,2,25001,262,3,96,108,38,31,4,277,1,8,286
25,2,25001,263,3,50,70,19,50,0,189,0,7,196
25,2,25001,266,3,28,34,10,1,0,73,0,1,74
25,2,25001,267,3,56,134,25,0,0,215,2,4,221
25,2,25001,270,3,118,122,28,6,1,275,1,7,283
25,2,25001,271,3,81,190,37,26,4,338,1,8,347
25,2,25001,274,3,68,23,2,1,0,94,0,2,96
25,2,25001,275,3,27,76,8,5,0,116,0,3,119
25,2,25001,278,3,62,175,28,17,1,283,0,8,291
25,2,25001,279,3,103,161,17,9,1,291,0,0,291
25,2,25001,282,3,178,159,37,12,0,386,0,13,399
25,2,25001,283,3,316,172,47,12,3,550,0,5,555
25,2,25001,286,3,65,95,18,7,1,186,0,5,191
25,2,25001,287,3,50,173,38,10,0,271,0,0,271
25,2,25001,290,3,78,283,62,18,2,443,0,14,457
25,2,25001,291,3,86,164,29,12,4,295,0,0,295
25,2,25001,294,3,122,132,44,21,2,321,0,5,326
25,2,25001,295,3,93,108,33,19,1,254,0,8,262
25,2,25001,298,3,204,275,97,48,5,629,0,14,643
25,2,25001,299,3,90,239,22,15,1,367,0,12,379
25,2,25001,302,3,45,178,14,5,0,242,0,5,247
25,2,25001,303,3,44,172,25,18,2,261,0,8,269
25,2,25001,306,3,102,170,31,6,3,312,3,4,319
25,2,25001,307,3,57,116,21,1,1,196,0,6,202
25,2,25001,310,3,12,41,2,4,3,62,1,0,63
25,2,25001,311,3,71,136,20,8,1,236,0,6,242
25,2,25001,314,3,78,172,18,2,2,272,0,8,280
25,2,25001,315,3,114,193,17,1,1,326,1,5,332
25,2,25001,318,3,132,160,22,14,0,328,0,9,337
25,2,25001,319,3,67,121,14,11,0,213,0,10,223
25,2,25001,322,3,68,103,29,21,2,223,0,0,223
25,2,25001,323,3,102,161,14,9,0,286,0,0,286
25,2,25001,326,3,73,295,20,17,0,405,0,3,408
25,2,25001,327,3,64,144,18,14,1,241,0,9,250
25,2,25001,330,3,106,121,29,4,2,262,0,2,264
25,2,25001,331,3,107,97,11,2,1,218,0,7,225
25,2,25001,334,3,151,152,18,10,1,332,0,5,337
25,2,25001,335,3,59,195,19,16,4,293,0,0,293
25,2,25001,338,3,13,30,22,1,0,66,3,0,69
25,2,25001,339,3,89,96,54,2,1,242,0,5,247
25,2,25001,342,3,43,162,20,10,8,243,1,11,255
25,2,25001,343,3,42,153,67,1,4,267,0,0,267
25,2,25001,346,3,107,192,30,25,3,357,0,11,368
25,2,25001,347,3,46,87,18,10,1,162,0,1,163
25,2,25001,350,3,39,157,29,20,3,248,0,14,262
25,2,25001,351,3,49,170,45,22,2,288,1,10,299
25,2,25001,354,3,174,153,25,15,1,368,0,9,377
25,2,25001,355,3,142,203,53,13,4,415,0,12,427
25,2,25001,358,3,101,202,28,7,0,338,1,13,352
25,2,25001,359,3,89,125,28,4,3,249,0,8,257
25,2,25001,362,3,101,295,32,10,3,441,4,20,465
25,2,25001,363,3,153,338,50,9,4,554,0,5,559
25,2,25001,366,3,51,284,50,11,1,397,0,12,409
25,2,25001,367,3,18,103,46,5,2,174,0,7,181
25,2,25001,370,3,123,144,75,20,3,365,0,0,365
25,2,25001,371,3,124,161,99,25,4,413,0,6,419
25,2,25001,374,3,72,95,46,12,3,228,0,6,234
25,2,25001,375,3,19,28,90,3,0,140,0,4,144
25,2,25001,378,3,25,72,85,3,3,188,0,7,195
25,2,25001,379,3,38,70,41,1,1,151,0,5,156
25,2,25001,382,3,40,78,56,4,1,179,0,4,183
25,2,25001,383,3,39,101,57,10,1,208,0,0,208
25,2,25001,386,3,41,66,46,1,0,154,0,0,154
25,2,25001,387,3,25,39,38,5,2,109,0,5,114
25,2,25001,390,3,106,148,80,20,0,354,1,23,378
25,2,25001,391,3,103,85,90,10,2,290,1,6,297
25,2,25001,394,3,42,45,73,2,2,164,0,4,168
25,2,25001,395,3,53,73,89,9,3,227,0,5,232
25,2,25001,398,3,103,85,61,30,7,286,0,11,297
25,2,25001,399,3,123,112,40,10,5,290,0,7,297
25,2,25001,402,3,92,72,34,4,3,205,0,15,220
25,2,25001,403,3,73,131,44,9,1,258,0,7,265
25,2,25001,406,3,120,200,33,15,2,370,1,16,387
25,2,25001,407,3,92,137,40,5,0,274,0,9,283
25,2,25001,410,3,117,149,27,20,0,313,2,19,334
25,2,25001,411,3,314,415,85,80,4,898,4,22,924
25,2,25001,414,3,60,93,10,5,2,170,1,4,175
25,2,25001,415,3,67,147,16,10,1,241,0,2,243
25,2,25001,418,3,101,110,25,16,1,253,0,10,263
25,2,25001,419,3,50,106,18,13,1,188,0,1,189
25,2,25001,422,3,30,41,7,2,0,80,0,1,81
25,2,25001,423,3,59,71,15,3,2,150,0,5,155
25,2,25001,426,3,33,80,8,8,0,129,1,1,131
25,2,25001,427,3,19,20,6,0,1,46,0,1,47
25,2,25001,430,3,101,101,34,39,1,276,0,6,282
25,2,25001,431,3,49,54,21,5,1,130,0,2,132
25,2,25001,434,3,144,104,41,31,1,321,0,0,321
25,2,25001,435,3,119,66,46,14,1,246,1,7,254
25,2,25001,438,3,75,77,18,43,1,214,0,19,233
25,2,25001,439,3,50,62,29,74,2,217,0,17,234
25,2,25001,442,3,77,124,17,150,0,368,0,3,371
25,2,25001,443,3,76,111,9,69,0,265,0,10,275
25,2,25001,446,3,61,127,10,25,1,224,0,0,224
25,2,25001,447,3,19,55,15,27,0,116,0,6,122
25,2,25001,450,3,183,107,28,42,1,361,0,13,374
25,2,25001,451,3,139,76,24,23,0,262,0,7,269
25,2,25001,454,3,59,133,16,11,1,220,0,8,228
25,2,25001,455,3,49,78,17,4,1,149,0,1,150
25,3,25002,456,3,128,249,33,7,1,418,1,14,433
25,3,25002,458,3,61,76,7,2,0,146,0,0,146
25,3,25002,459,3,52,119,21,1,2,195,0,3,198
25,3,25002,462,3,51,165,42,0,1,259,0,5,264
25,3,25002,463,3,72,145,37,4,0,258,0,5,263
25,3,25002,466,3,19,65,10,2,0,96,0,3,99
25,3,25002,467,3,14,81,27,2,0,124,0,4,128
25,3,25002,470,3,66,66,43,26,0,201,0,13,214
25,3,25002,471,3,57,111,30,4,1,203,0,4,207
25,3,25002,474,3,45,87,48,8,0,188,1,8,197
25,3,25002,475,3,65,76,45,5,0,191,0,7,198
25,3,25002,478,3,39,106,31,1,0,177,0,4,181
25,3,25002,479,3,12,47,27,0,0,86,0,0,86
25,3,25002,482,3,15,116,34,0,0,165,0,4,169
25,3,25002,483,3,25,144,74,0,0,243,0,0,243
25,3,25002,486,3,95,196,30,0,1,322,0,5,327
25,3,25002,487,3,118,242,45,4,0,409,0,9,418
25,3,25002,490,3,50,99,22,1,1,173,0,7,180
25,3,25002,491,3,52,121,25,1,0,199,0,1,200
25,3,25002,494,3,19,76,10,0,0,105,0,3,108
25,3,25002,495,3,55,117,49,2,1,224,0,6,230
25,3,25002,498,3,26,32,24,0,1,83,0,8,91
25,3,25002,499,3,35,19,63,0,0,117,0,8,125
25,3,25002,502,3,78,193,30,1,0,302,0,11,313
25,3,25002,503,3,12,51,13,0,0,76,0,3,79
25,3,25002,506,3,34,56,30,0,0,120,0,5,125
25,3,25002,507,3,46,96,80,0,0,222,1,6,229
25,3,25002,510,3,51,14,71,1,1,138,0,18,156
25,3,25002,511,3,23,61,48,0,1,133,0,4,137
25,3,25002,514,3,47,30,17,3,0,97,0,2,99
25,3,25002,515,3,69,43,54,2,1,169,0,12,181
25,3,25002,518,3,37,18,96,5,0,156,0,0,156
25,3,25002,519,3,39,96,49,1,0,185,0,4,189
25,3,25002,522,3,38,92,75,0,1,206,0,0,206
25,3,25002,523,3,38,53,40,1,1,133,0,0,133
25,3,25002,526,3,108,160,75,1,2,346,0,16,362
25,3,25002,527,3,52,99,28,1,0,180,0,4,184
25,3,25002,530,3,95,59,54,3,2,213,0,5,218
25,3,25002,531,3,20,67,41,4,0,132,0,2,134
25,3,25002,534,3,9,60,16,0,1,86,0,2,88
25,3,25002,535,3,14,82,27,1,1,125,0,2,127
25,3,25002,538,3,17,88,35,5,1,146,0,2,148
25,3,25002,539,3,238,344,172,6,2,762,0,17,779
25,3,25002,542,3,114,114,88,1,0,317,10,15,342
25,3,25002,543,3,50,83,38,0,0,171,2,2,175
25,3,25002,546,3,43,64,7,1,0,115,3,3,121
25,3,25002,547,3,103,147,53,2,1,306,3,13,322
25,3,25002,550,3,61,109,46,2,0,218,3,7,228
25,3,25002,551,3,47,71,47,0,1,166,2,14,182
25,3,25002,554,3,16,59,67,0,1,143,5,4,152
25,3,25002,555,3,27,58,64,1,0,150,5,8,163
25,3,25002,558,3,28,63,98,1,1,191,0,4,195
25,3,25002,559,3,29,60,30,0,1,120,0,4,124
25,3,25002,562,3,47,70,76,3,0,196,1,5,202
25,3,25006,990,3,97,91,34,11,2,235,1,3,239
25,3,25006,991,3,79,96,37,5,7,224,0,8,232
25,3,25006,994,3,92,131,41,9,6,279,0,14,293
25,3,25006,995,3,88,107,54,10,6,265,1,6,272
25,3,25006,998,3,44,55,11,9,0,119,1,6,126
25,3,25006,999,3,401,281,131,63,20,896,3,12,911
25,3,25006,1002,3,135,141,73,34,5,388,4,4,396
25,3,25006,1003,3,168,126,89,28,4,415,0,8,423
25,3,25006,1280,3,74,75,24,2,0,175,0,1,176
25,3,25006,1282,3,153,139,65,11,5,373,0,8,381
25,3,25006,1283,3,97,67,46,6,1,217,0,3,220
25,3,25006,1286,3,70,160,34,10,3,277,0,0,277
25,3,25006,1287,3,165,173,103,19,4,464,0,9,473
25,3,25006,1290,3,39,87,40,5,2,173,0,3,176
25,3,25006,1291,3,114,101,56,12,4,287,1,2,290
25,3,25006,1294,3,23,63,20,1,0,107,0,1,108
25,3,25006,1507,3,244,127,43,11,5,430,1,1,432
25,3,25006,1510,3,121,72,25,13,2,233,1,7,241
25,3,25006,1511,3,253,210,94,15,5,577,7,14,598
25,3,25006,1535,3,67,120,37,5,2,231,0,2,233
25,3,25006,1538,3,33,27,4,0,2,66,0,6,72
25,3,25006,1539,3,37,32,13,4,0,86,1,3,90
25,3,25006,1542,3,46,32,7,2,0,87,0,3,90
25,3,25006,1543,3,21,24,45,1,0,91,0,4,95
25,3,25006,1553,3,84,89,75,5,5,258,0,3,261
25,3,25006,1554,3,41,69,34,3,0,147,0,0,147
25,3,25006,1555,3,93,144,63,11,2,313,0,10,323
25,3,25006,1558,3,127,111,45,9,3,295,0,9,304
25,3,25006,1559,3,85,94,39,9,2,229,0,1,230
25,3,25006,1562,3,74,81,56,4,3,218,0,7,225
25,3,25006,1563,3,113,92,83,6,7,301,2,8,311
25,3,25006,1566,3,48,94,30,8,3,183,2,5,190
25,3,25006,1567,3,32,56,18,4,0,110,1,4,115
25,3,25006,1570,3,106,113,61,5,5,290,0,13,303
25,3,25006,1571,3,44,62,40,3,2,151,1,12,164
25,3,25006,1574,3,131,139,70,8,4,352,0,0,352
25,3,25006,1575,3,90,142,50,9,6,297,1,10,308
25,3,25006,1578,3,64,65,12,3,1,145,0,3,148
25,3,25006,1579,3,65,73,29,5,3,175,0,9,184
25,3,25006,1582,3,196,177,100,14,8,495,1,12,508
25,3,25006,1583,3,124,177,68,12,2,383,0,4,387
25,3,25006,1586,3,89,105,39,6,0,239,2,7,248
25,3,25006,1587,3,49,29,22,0,0,100,2,2,104
25,3,25006,1590,3,41,53,21,2,1,118,0,2,120
25,3,25015,3220,3,171,349,92,5,4,621,1,17,639
25,3,25015,3222,3,237,385,81,4,6,713,0,20,733
25,3,25015,3223,3,51,153,22,7,0,233,0,0,233
25,3,25015,3226,3,75,117,54,2,1,249,0,9,258
25,3,25015,3227,3,84,95,53,2,0,234,0,12,246
25,3,25015,3230,3,45,82,6,0,1,134,0,3,137
25,3,25015,3231,3,16,96,7,0,0,119,0,4,123
25,3,25015,3234,3,50,110,27,3,1,191,0,6,197
25,3,25015,3235,3,59,125,49,2,4,239,1,4,244
25,3,25015,3238,3,69,100,24,3,1,197,1,2,200
25,3,25015,3239,3,157,247,64,7,0,475,1,4,480
25,3,25015,3242,3,60,100,19,5,1,185,0,3,188
25,3,25015,3243,3,27,70,17,2,0,116,0,3,119
25,3,25015,3246,3,62,84,22,1,4,173,2,5,180
25,3,25015,3247,3,50,158,34,3,1,246,0,12,258
25,3,25015,3250,3,52,120,19,5,0,196,0,1,197
25,3,25015,3251,3,39,61,8,3,0,111,0,1,112
25,3,25015,3254,3,49,95,19,4,1,168,0,8,176
25,3,25015,3255,3,40,64,15,0,0,119,0,2,121
25,3,25015,3258,3,79,127,22,6,3,237,1,4,242
25,3,25015,3259,3,38,66,15,4,1,124,1,3,128
25,3,25015,3262,3,37,76,4,2,0,119,0,1,120
25,3,25015,3263,3,25,56,12,4,0,97,0,3,100
25,3,25015,3266,3,29,33,7,4,2,75,0,3,78
25,3,25015,3267,3,30,53,12,3,1,99,1,2,102
25,3,25015,3270,3,33,85,12,7,0,137,0,3,140
25,3,25015,3271,3,62,96,19,8,0,185,0,2,187
25,3,25015,3274,3,105,199,44,11,1,360,1,4,365
25,3,25015,3275,3,324,632,148,77,5,1186,0,16,1202
25,3,25015,3278,3,41,84,43,3,0,171,0,3,174
25,3,25015,3279,3,81,102,35,6,1,225,0,5,230
25,3,25015,3282,3,80,92,35,5,0,212,0,9,221
25,3,25015,3283,3,55,113,25,2,0,195,0,3,198
25,3,25015,3286,3,73,109,49,1,1,233,0,5,238
25,3,25015,3287,3,135,220,79,6,0,440,1,8,449
25,3,25015,3290,3,40,81,10,3,0,134,1,1,136
25,3,25015,3291,3,36,86,9,6,1,138,0,8,146
25,3,25015,3294,3,33,85,16,6,2,142,0,2,144
25,3,25015,3295,3,44,113,12,1,1,171,0,2,173
25,3,25015,3298,3,39,118,34,6,0,197,7,0,204
25,3,25015,3299,3,36,65,51,0,0,152,0,4,156
25,3,25015,3302,3,52,104,4,1,1,162,0,2,164
25,3,25015,3303,3,43,78,17,2,5,145,0,0,145
25,3,25015,3306,3,83,165,52,7,1,308,0,10,318
25,3,25015,3307,3,106,226,98,11,5,446,2,7,455
25,3,25015,3310,3,51,116,16,3,0,186,0,4,190
25,3,25015,3311,3,74,113,11,2,1,201,0,7,208
25,3,25015,3314,3,50,105,25,3,1,184,0,2,186
25,3,25015,3315,3,46,89,24,3,0,162,0,4,166
25,3,25015,3318,3,38,89,20,4,0,151,0,3,154
25,3,25015,3319,3,61,110,31,0,2,204,0,3,207
25,3,25015,3322,3,65,116,36,5,0,222,0,1,223
25,3,25015,3323,3,64,167,51,12,2,296,0,7,303
25,3,25015,3326,3,29,28,3,1,0,61,0,4,65
25,3,25015,3327,3,74,55,21,1,1,152,0,3,155
25,3,25015,3330,3,46,65,12,1,0,124,1,4,129
25,3,25015,3331,3,17,86,15,1,0,119,1,2,122
25,3,25015,3334,3,39,46,20,1,0,106,0,2,108
25,3,25015,3335,3,22,18,17,2,0,59,0,2,61
25,3,25015,3338,3,31,108,20,3,1,163,0,1,164
25,3,25015,3339,3,40,87,11,2,0,140,0,1,141
25,3,25015,3342,3,32,64,7,0,0,103,1,3,107
25,3,25015,3343,3,38,74,17,2,1,132,0,3,135
25,3,25015,3346,3,60,80,9,2,0,151,0,5,156
25,3,25015,3347,3,28,53,11,1,0,93,0,3,96
25,3,25015,3350,3,71,75,179,9,1,335,1,8,344
25,3,25015,3351,3,49,76,12,0,0,137,0,2,139
25,3,25015,3354,3,57,88,24,0,0,169,0,4,173
25,3,25015,3355,3,86,145,51,4,1,287,0,6,293
25,3,25015,3358,3,91,113,28,3,0,235,0,5,240
25,3,25015,3359,3,56,104,19,0,0,179,0,1,180
25,3,25015,3362,3,56,68,18,6,0,148,0,3,151
25,3,25015,3363,3,62,49,3,0,0,114,0,0,114
25,3,25015,3366,3,15,60,2,2,2,81,0,5,86
25,3,25015,3367,3,43,73,7,2,0,125,0,4,129
25,3,25018,3614,3,78,36,15,6,2,137,0,1,138
25,3,25018,3615,3,109,63,41,4,0,217,0,11,228
25,3,25018,3618,3,50,60,22,4,1,137,0,7,144
25,3,25018,3619,3,198,163,57,16,6,440,1,6,447
25,3,25018,3622,3,196,181,49,16,6,448,1,4,453
25,3,25018,3623,3,133,91,38,5,1,268,1,3,272
25,3,25018,3626,3,135,106,43,4,1,289,0,6,295
25,3,25018,3627,3,132,85,33,3,1,254,0,3,257
25,3,25018,3630,3,52,35,8,3,1,99,0,1,100
25,3,25018,3631,3,161,108,90,2,3,364,0,7,371
25,3,25018,3634,3,220,259,114,17,4,614,1,10,625
25,3,25018,3635,3,121,157,57,15,8,358,1,6,365
25,3,25018,3638,3,86,54,28,4,2,174,0,2,176
25,3,25018,3639,3,98,97,33,1,4,233,0,4,237
25,3,25018,3642,3,131,120,57,4,2,314,0,0,314
25,3,25018,3643,3,114,124,40,9,3,290,1,3,294
25,3,25018,3646,3,516,448,224,42,14,1244,1,22,1267
25,3,25018,3647,3,268,261,137,20,11,697,0,7,704
25,3,25018,3650,3,34,22,19,0,0,75,0,2,77
25,3,25018,3651,3,177,143,122,5,3,450,0,12,462
25,3,25018,3654,3,93,88,77,3,0,261,0,3,264
25,3,25018,3655,3,258,64,33,4,3,362,0,10,372
25,3,25018,3658,3,148,90,50,8,3,299,3,5,307
25,3,25018,3659,3,117,119,54,11,2,303,1,8,312
25,3,25018,3662,3,96,122,57,5,1,281,1,10,292
25,3,25018,3663,3,143,115,34,5,2,299,1,7,307
25,3,25018,3666,3,209,104,27,4,1,345,0,4,349
25,3,25018,3667,3,142,98,39,8,2,289,1,3,293
25,3,25018,3670,3,169,127,48,3,4,351,0,3,354
25,3,25018,3671,3,121,72,48,3,0,244,0,3,247
25,3,25018,3674,3,109,82,18,7,2,218,1,0,219
25,3,25018,3675,3,81,145,43,5,0,274,0,7,281
25,3,25018,3678,3,58,44,25,2,3,132,1,2,135
25,3,25018,3679,3,158,99,27,6,0,290,2,6,298
25,3,25018,3682,3,130,55,64,1,1,251,0,7,258
25,3,25018,3683,3,106,74,25,6,1,212,3,8,223
25,3,25018,3686,3,134,63,25,6,0,228,2,7,237
25,3,25018,3687,3,42,23,7,1,0,73,0,0,73
25,3,25018,3690,3,74,107,42,1,2,226,1,1,228
25,3,25018,3691,3,135,84,93,5,3,320,1,0,321
25,3,25018,3694,3,144,68,31,12,1,256,0,5,261
25,3,25018,3695,3,110,116,38,12,3,279,0,9,288
25,3,25018,3698,3,92,89,30,5,0,216,0,7,223
25,3,25018,3699,3,247,154,69,2,2,474,0,17,491
25,3,25018,3702,3,92,162,29,13,2,298,1,0,299
25,3,25018,3703,3,67,100,40,6,1,214,1,4,219
25,3,25018,3706,3,52,112,38,6,1,209,1,3,213
25,3,25018,3707,3,83,99,35,12,5,234,2,6,242
25,3,25018,3710,3,135,92,32,1,1,261,4,5,270
25,3,25018,3711,3,203,159,91,0,3,456,0,12,468
25,3,25018,3714,3,55,75,26,10,2,168,0,4,172
25,3,25018,3715,3,87,58,48,0,1,194,0,4,198
25,3,25018,3718,3,45,100,37,3,0,185,0,4,189
25,3,25018,3719,3,85,86,14,3,1,189,1,10,200
25,3,25018,3722,3,93,28,52,2,2,177,0,3,180
25,3,25018,3723,3,77,46,11,2,0,136,0,5,141
25,3,25018,3726,3,74,177,69,1,1,322,0,9,331
25,3,25018,3727,3,139,99,128,6,3,375,1,9,385
25,3,25018,3730,3,50,13,75,3,0,141,0,2,143
25,3,25018,3731,3,215,121,24,5,2,367,2,6,375
25,3,25018,3734,3,112,99,43,3,3,260,0,6,266
25,3,25018,3735,3,145,88,17,4,0,254,0,4,258
25,3,25018,3738,3,106,48,40,1,0,195,0,2,197
25,3,25018,3739,3,159,104,41,6,0,310,4,5,319
25,3,25018,3742,3,96,143,37,2,1,279,0,2,281
25,3,25018,3743,3,146,195,35,4,7,387,0,10,397
25,3,25018,3746,3,166,164,52,5,6,393,0,3,396
25,3,25018,3747,3,158,186,41,5,4,394,2,13,409
25,3,25018,3750,3,77,71,30,2,0,180,0,3,183
25,3,25018,3751,3,75,61,41,1,1,179,0,6,185
25,3,25018,3754,3,78,57,27,2,0,164,4,5,173
25,3,25018,3755,3,11,15,2,0,1,29,0,0,29
25,3,25018,3758,3,246,101,62,3,3,415,2,11,428
25,3,25018,3759,3,223,108,74,12,4,421,2,12,435
25,3,25018,3762,3,349,254,119,16,6,744,5,26,775
25,3,25018,3763,3,101,102,67,2,1,273,1,9,283
25,3,25018,3766,3,75,50,44,3,0,172,0,5,177
25,3,25018,3767,3,68,67,37,1,1,174,0,3,177
25,3,25018,3770,3,46,55,22,2,0,125,1,0,126
25,3,25018,3772,3,63,33,19,1,1,117,2,3,122
25,3,25018,3774,3,73,43,8,1,1,126,0,7,133
25,3,25018,3775,3,29,50,25,2,1,107,1,1,109
25,3,25018,3778,3,102,151,23,2,4,282,0,13,295
25,3,25018,3779,3,121,60,22,2,0,205,0,7,212
25,3,25018,3782,3,13,34,44,0,0,91,0,1,92
25,3,25018,3783,3,46,65,8,0,0,119,0,2,121
25,3,25018,3786,3,161,119,29,6,0,315,2,6,323
25,3,25018,3787,3,94,77,20,8,0,199,0,1,200
25,4,25011,2101,3,207,203,123,175,5,713,0,14,727
25,4,25011,2102,3,75,88,67,82,1,313,0,12,325
25,4,25011,2103,3,72,47,61,30,2,212,0,7,219
25,4,25011,2106,3,106,62,95,24,0,287,0,7,294
25,4,25011,2107,3,87,111,48,31,1,278,6,6,290
25,4,25011,2110,3,133,128,101,149,2,513,0,21,534
25,4,25011,2111,3,292,273,152,141,5,863,0,29,892
25,4,25011,2114,3,78,101,52,11,0,242,0,4,246
25,4,25011,2115,3,61,71,17,3,0,152,0,4,156
25,4,25011,2118,3,167,147,67,26,1,408,0,4,412
25,4,25011,2119,3,292,267,128,122,3,812,0,10,822
25,4,25011,2122,3,120,78,27,13,0,238,1,1,240
25,4,25011,2123,3,119,56,29,14,1,219,0,3,222
25,4,25011,2126,3,94,132,46,22,3,297,0,9,306
25,4,25011,2127,3,94,52,26,12,1,185,0,1,186
25,4,25011,2130,3,107,67,13,4,0,191,0,2,193
25,4,25011,2131,3,71,67,18,11,0,167,0,3,170
25,4,25011,2134,3,120,123,39,31,3,316,0,2,318
25,4,25011,2135,3,94,86,47,23,0,250,2,7,259
25,4,25011,2138,3,93,71,124,2,4,294,2,0,296
25,4,25011,2139,3,136,101,49,45,2,333,0,5,338
25,4,25011,2142,3,136,87,17,8,0,248,0,0,248
25,4,25011,2143,3,45,44,10,10,1,110,0,0,110
25,4,25011,2146,3,108,72,45,10,0,235,0,4,239
25,4,25011,2147,3,77,101,35,11,0,224,0,5,229
25,4,25011,2150,3,79,56,11,4,0,150,0,3,153
25,4,25011,2151,3,88,62,37,20,1,208,0,3,211
25,4,25011,2154,3,138,128,48,13,0,327,0,7,334
25,4,25011,2155,3,324,298,145,166,6,939,0,16,955
25,4,25011,2158,3,131,139,64,39,2,375,0,6,381
25,4,25011,2159,3,68,63,24,8,0,163,0,1,164
25,4,25011,2162,3,77,43,10,5,0,135,0,2,137
25,4,25011,2163,3,87,55,38,5,2,187,0,1,188
25,4,25011,2166,3,69,34,5,7,0,115,0,5,120
25,4,25011,2167,3,85,73,8,15,1,182,0,5,187
25,4,25011,2170,3,106,60,20,2,0,188,0,2,190
25,4,25011,2171,3,113,72,23,7,2,217,0,2,219
25,4,25011,2174,3,118,95,30,67,1,311,0,5,316
25,4,25011,2175,3,127,100,46,18,0,291,0,6,297
25,4,25011,2178,3,179,87,49,14,1,330,0,9,339
25,4,25011,2179,3,132,129,55,12,1,329,0,6,335
25,4,25011,2182,3,92,85,30,11,0,218,0,7,225
25,4,25011,2183,3,113,78,16,20,2,229,0,11,240
25,4,25011,2186,3,99,64,35,41,0,239,0,7,246
25,4,25011,2187,3,22,52,15,0,1,90,0,1,91
25,4,25011,2190,3,66,123,38,14,1,242,0,9,251
25,4,25011,2191,3,59,96,71,11,3,240,0,7,247
25,4,25011,2194,3,87,77,39,13,1,217,0,3,220
25,4,25011,2195,3,29,102,45,7,2,185,1,4,190
25,4,25011,2198,3,50,82,45,12,4,193,0,4,197
25,4,25011,2199,3,52,57,38,17,1,165,0,4,169
25,4,25011,2202,3,43,71,42,26,1,183,0,6,189
25,4,25011,2203,3,71,117,41,45,1,275,0,6,281
25,4,25011,2206,3,69,88,36,19,5,217,1,0,218
25,4,25011,2207,3,57,103,113,27,1,301,0,8,309
25,4,25011,2210,3,87,116,74,23,1,301,0,8,309
25,4,25011,2211,3,145,124,60,20,1,350,0,10,360
25,4,25011,2214,3,135,135,98,19,3,390,0,14,404
25,4,25011,2215,3,69,83,71,12,2,237,0,3,240
25,4,25011,2218,3,93,82,78,13,2,268,0,11,279
25,4,25011,2219,3,88,82,65,22,2,259,0,0,259
25,4,25011,2222,3,54,81,54,6,3,198,1,5,204
25,4,25011,2223,3,69,42,14,5,0,130,0,5,135
25,4,25011,2226,3,61,73,57,14,3,208,0,10,218
25,4,25011,2227,3,43,70,85,37,3,238,0,8,246
25,4,25011,2230,3,48,59,112,8,2,229,1,10,240
25,4,25011,2231,3,33,122,58,7,3,223,0,4,227
25,4,25011,2234,3,172,79,57,9,2,319,1,0,320
25,4,25011,2235,3,67,78,70,16,1,232,0,11,243
25,4,25011,2238,3,89,97,122,6,1,315,0,0,315
25,4,25011,2239,3,15,37,8,1,0,61,0,2,63
25,4,25011,2242,3,90,74,36,11,0,211,0,3,214
25,4,25011,2243,3,96,55,46,13,0,210,0,3,213
25,4,25011,2246,3,197,54,100,5,2,358,1,7,366
25,4,25011,2247,3,58,48,98,4,1,209,1,10,220
25,4,25011,2250,3,67,70,97,7,0,241,0,7,248
25,4,25011,2251,3,43,80,121,11,2,257,0,5,262
25,4,25011,2254,3,33,43,85,41,1,203,0,8,211
25,4,25011,2255,3,46,74,80,9,0,209,0,8,217
25,4,25011,2258,3,87,54,117,27,0,285,0,6,291
25,4,25011,2259,3,38,67,45,10,0,160,0,5,165
25,4,25011,2262,3,80,99,85,34,0,298,0,5,303
25,4,25011,2263,3,64,66,42,25,0,197,0,2,199
25,4,25011,2266,3,40,64,34,9,2,149,0,9,158
25,4,25011,2267,3,47,84,63,12,2,208,0,12,220
25,4,25011,2270,3,93,110,64,14,4,285,1,10,296
25,4,25011,2271,3,43,58,60,3,3,167,0,12,179
25,4,25011,2274,3,60,55,38,15,2,170,0,5,175
25,4,25011,2275,3,74,85,43,22,0,224,0,6,230
25,4,25011,2278,3,21,31,31,24,0,107,0,3,110
25,4,25011,2279,3,43,43,52,13,0,151,0,4,155
25,4,25011,2282,3,39,41,59,21,3,163,0,5,168
25,4,25011,2283,3,35,56,124,16,2,233,0,2,235
25,4,25011,2286,3,63,41,102,10,1,217,0,4,221
25,4,25011,2287,3,49,60,77,17,4,207,0,4,211
25,4,25011,2290,3,17,56,70,24,1,168,0,3,171
25,4,25011,2291,3,78,109,102,43,1,333,0,5,338
25,4,25011,2294,3,41,74,56,14,0,185,0,9,194
25,4,25011,2295,3,109,67,49,10,1,236,1,5,242
25,4,25011,2298,3,21,191,71,12,1,296,0,23,319
25,4,25011,2299,3,6,93,21,4,0,124,0,9,133
25,4,25011,2302,3,15,51,70,12,1,149,0,4,153
25,4,25011,2303,3,32,82,37,12,1,164,0,17,181
25,4,25011,2306,3,43,93,81,3,0,220,0,7,227
25,4,25011,2307,3,31,63,55,8,1,158,0,1,159
25,4,25011,2310,3,22,82,55,8,1,168,2,2,172
25,4,25011,2311,3,27,70,21,13,0,131,0,8,139
25,4,25011,2314,3,63,83,126,7,2,281,0,0,281
25,4,25011,2315,3,48,162,75,12,0,297,0,8,305
25,4,25011,2318,3,96,137,91,26,0,350,0,7,357
25,4,25011,2319,3,15,102,47,11,5,180,0,8,188
25,4,25011,2322,3,72,77,25,10,0,184,0,9,193
25,4,25011,2323,3,62,76,33,7,1,179,0,11,190
25,4,25011,2326,3,69,79,22,9,0,179,0,4,183
25,4,25011,2327,3,83,65,29,8,1,186,0,5,191
25,4,25011,2330,3,86,86,31,16,3,222,5,12,239
25,4,25011,2331,3,43,36,28,26,2,135,0,0,135
25,4,25011,2334,3,72,56,82,37,3,250,2,14,266
25,4,25011,2335,3,71,62,50,41,3,227,0,12,239
25,4,25011,2338,3,47,74,50,23,1,195,0,2,197
25,4,25011,2339,3,36,38,22,14,0,110,2,7,119
25,4,25011,2342,3,33,22,33,16,4,108,1,2,111
25,4,25011,2343,3,57,52,112,14,3,238,1,13,252
25,4,25011,2346,3,150,104,49,43,2,348,1,12,361
25,4,25011,2347,3,76,109,72,23,2,282,4,8,294
25,4,25011,2350,3,35,85,28,7,0,155,1,3,159
25,4,25011,2351,3,56,79,55,18,1,209,0,18,227
25,4,25011,2354,3,49,70,58,14,0,191,0,5,196
25,4,25011,2355,3,47,124,73,24,0,268,0,6,274
25,4,25011,2358,3,19,8,44,2,1,74,0,2,76
25,4,25011,2359,3,61,30,98,10,0,199,0,4,203
25,4,25011,2362,3,36,41,68,16,1,162,0,2,164
25,4,25011,2363,3,14,15,59,4,0,92,0,1,93
25,4,25011,2366,3,61,73,34,8,0,176,0,13,189
25,4,25011,2367,3,72,127,111,7,4,321,1,15,337
25,4,25011,2370,3,12,46,20,5,0,83,0,4,87
25,4,25011,2371,3,44,31,60,5,0,140,0,6,146
25,4,25011,2374,3,57,89,70,51,0,267,0,10,277
25,4,25011,2375,3,90,83,91,43,1,308,0,10,318
25,4,25011,2379,3,63,47,126,25,0,261,0,6,267
25,4,25011,2382,3,19,42,50,5,0,116,0,5,121
25,4,25011,2383,3,25,43,79,9,2,158,0,5,163
25,4,25011,2386,3,12,26,38,10,0,86,0,9,95
25,4,25011,2387,3,6,49,33,14,0,102,0,3,105
25,4,25011,2390,3,26,158,107,36,0,327,0,12,339
25,4,25011,2391,3,21,161,149,12,1,344,0,9,353
25,4,25011,2394,3,45,90,69,35,2,241,1,7,249
25,4,25011,2395,3,27,66,92,31,1,217,0,14,231
25,4,25011,2398,3,66,75,81,25,1,248,0,16,264
25,4,25011,2399,3,22,88,21,10,0,141,0,2,143
25,4,25011,2402,3,59,75,106,8,2,250,2,10,262
25,4,25011,2403,3,66,45,87,4,0,202,0,5,207
25,4,25011,2406,3,29,44,44,2,5,124,0,0,124
25,4,25011,2407,3,84,102,68,18,1,273,0,10,283
25,4,25011,2410,3,123,143,101,24,0,391,0,8,399
25,4,25011,2411,3,69,75,44,16,1,205,0,9,214
25,4,25011,2414,3,26,125,28,11,2,192,1,1,194
25,4,25011,2415,3,27,75,75,1,3,181,5,5,191
25,4,25011,2418,3,119,62,36,9,0,226,0,1,227
25,4,25011,2419,3,213,198,51,23,1,486,0,27,513
25,4,25011,2422,3,96,83,69,14,0,262,0,13,275
25,4,25011,2423,3,95,98,51,16,4,264,0,7,271
25,4,25011,2426,3,66,83,133,54,0,336,0,13,349
25,4,25011,2427,3,76,85,39,31,0,231,0,7,238
25,4,25011,2430,3,63,40,41,13,2,159,0,0,159
25,4,25011,2431,3,47,64,42,8,0,161,0,4,165
25,4,25011,2434,3,37,69,84,39,0,229,0,5,234
25,4,25011,2435,3,63,102,51,0,0,216,0,6,222
25,4,25011,2438,3,36,31,17,13,0,97,0,2,99
25,4,25011,2439,3,131,101,87,34,5,358,0,8,366
25,4,25011,2442,3,41,22,10,3,0,76,0,2,78
25,4,25011,2443,3,21,25,22,4,2,74,1,0,75
25,4,25011,2446,3,61,63,37,9,2,172,0,6,178
25,4,25011,2447,3,15,17,22,8,1,63,2,0,65
25,4,25011,2450,3,99,150,74,28,0,351,0,0,351
25,4,25011,2451,3,105,75,47,22,1,250,0,6,256
25,4,25011,2454,3,92,105,71,13,0,281,0,5,286
25,4,25011,2455,3,43,134,59,13,3,252,1,11,264
25,4,25011,2458,3,11,34,22,14,0,81,0,8,89
25,4,25011,2459,3,28,98,90,12,1,229,0,5,234
25,4,25011,2462,3,9,56,53,1,1,120,0,6,126
25,4,25011,2463,3,42,75,64,8,0,189,1,3,193
25,4,25011,2466,3,6,22,49,10,2,89,0,1,90
25,4,25011,2467,3,48,25,22,13,0,108,0,3,111
25,4,25011,2470,3,57,156,39,12,0,264,0,8,272
25,4,25011,2471,3,47,112,63,13,1,236,0,7,243
25,4,25011,2474,3,50,206,145,80,1,482,2,13,497
25,4,25011,2475,3,80,154,43,13,1,291,0,6,297
25,4,25011,2478,3,53,121,94,22,2,292,0,6,298
25,4,25011,2479,3,65,135,42,21,0,263,1,7,271
25,4,25011,2482,3,17,61,54,27,1,160,0,6,166
25,4,25011,2483,3,11,52,107,24,0,194,0,3,197
25,4,25011,2486,3,37,84,49,22,1,193,2,5,200
25,4,25011,2487,3,31,92,53,37,3,216,0,5,221
25,4,25011,2490,3,7,345,48,1,0,401,0,4,405
25,4,25011,2491,3,7,89,20,1,0,117,0,11,128
25,4,25011,2494,3,63,283,78,14,1,439,1,17,457
25,4,25011,2495,3,19,95,57,6,0,177,0,11,188
25,4,25011,2498,3,24,184,48,12,0,268,0,9,277
25,4,25011,2499,3,5,47,19,9,0,80,0,4,84
25,4,25011,2502,3,9,129,126,11,2,277,0,12,289
25,4,25011,2503,3,37,107,135,9,0,288,0,16,304
25,4,25011,2506,3,30,69,43,14,1,157,1,7,165
25,4,25011,2507,3,52,97,72,27,0,248,0,6,254
25,4,25011,2510,3,22,161,70,9,0,262,0,17,279
25,4,25011,2511,3,19,280,145,24,0,468,0,9,477
25,4,25011,2514,3,6,44,31,1,1,83,1,4,88
25,4,25011,2515,3,40,116,84,8,1,249,0,0,249
25,4,25011,2518,3,19,143,38,1,1,202,0,3,205
25,4,25011,2519,3,19,81,46,0,0,146,0,0,146
25,4,25011,2522,3,35,117,36,7,2,197,1,12,210
25,4,25011,2523,3,16,70,29,6,1,122,0,3,125
25,4,25011,2526,3,47,166,79,5,0,297,0,4,301
25,4,25011,2527,3,44,129,62,14,1,250,0,8,258
25,4,25011,2530,3,38,73,76,12,1,200,0,6,206
25,4,25011,2531,3,32,110,64,16,0,222,0,7,229
25,4,25011,2534,3,22,113,48,18,1,202,0,1,203
25,4,25011,2535,3,28,97,31,15,2,173,0,3,176
25,4,25011,2538,3,13,74,33,25,1,146,0,6,152
25,4,25011,2539,3,55,89,81,9,1,235,0,9,244
25,5,25006,710,3,114,152,52,32,5,355,1,5,361
25,5,25006,711,3,125,171,81,37,4,418,1,8,427
25,5,25006,714,3,106,109,64,35,4,318,0,13,331
25,5,25006,715,3,188,182,159,103,5,637,1,17,655
25,5,25006,718,3,96,125,60,23,1,305,0,9,314
25,5,25006,719,3,112,96,65,16,5,294,4,6,304
25,5,25006,722,3,57,108,43,34,2,244,0,7,251
25,5,25006,723,3,76,97,48,29,8,258,0,16,274
25,5,25006,726,3,354,210,181,70,10,825,1,7,833
25,5,25006,727,3,67,86,38,27,1,219,0,9,228
25,5,25006,730,3,210,160,115,59,7,551,1,8,560
25,5,25006,731,3,42,80,40,16,0,178,0,8,186
25,5,25006,734,3,273,185,111,56,8,633,0,1,634
25,5,25006,735,3,74,47,197,31,3,352,0,6,358
25,5,25006,738,3,101,87,56,35,1,280,0,2,282
25,5,25006,739,3,80,53,40,31,4,208,0,2,210
25,5,25006,742,3,91,97,57,48,4,297,0,6,303
25,5,25006,743,3,120,107,65,41,2,335,0,12,347
25,5,25006,746,3,70,65,58,26,2,221,0,7,228
25,5,25006,747,3,47,40,24,3,14,128,0,1,129
25,5,25006,750,3,148,88,56,34,6,332,0,5,337
25,5,25006,751,3,93,32,43,19,2,189,1,2,192
25,5,25006,754,3,73,70,46,28,0,217,0,5,222
25,5,25006,755,3,105,101,78,32,5,321,0,2,323
25,5,25006,758,3,215,72,34,16,1,338,0,2,340
25,5,25006,759,3,88,66,38,24,0,216,0,4,220
25,5,25006,762,3,53,56,31,23,2,165,0,2,167
25,5,25006,763,3,71,84,29,24,1,209,0,0,209
25,5,25006,766,3,126,63,26,10,5,230,1,0,231
25,5,25006,767,3,255,98,48,29,6,436,0,5,441
25,5,25006,770,3,176,62,23,8,3,272,0,4,276
25,5,25006,771,3,75,106,57,78,0,316,1,2,319
25,5,25006,774,3,332,204,73,45,6,660,1,6,667
25,5,25006,775,3,192,115,42,31,4,384,1,1,386
25,5,25006,778,3,77,105,49,53,1,285,0,2,287
25,5,25006,779,3,132,53,14,4,0,203,1,2,206
25,5,25006,782,3,126,69,48,19,2,264,0,3,267
25,5,25006,783,3,79,60,24,21,1,185,0,3,188
25,5,25006,786,3,156,125,52,22,3,358,0,1,359
25,5,25006,787,3,103,64,42,10,1,220,0,0,220
25,5,25006,790,3,116,91,35,12,1,255,0,5,260
25,5,25006,791,3,198,120,59,28,2,407,0,1,408
25,5,25006,794,3,249,132,90,21,3,495,0,3,498
25,5,25006,795,3,197,110,64,24,3,398,2,2,402
25,5,25006,798,3,143,119,52,32,2,348,0,3,351
25,5,25006,799,3,201,90,59,16,6,372,0,1,373
25,5,25006,802,3,178,129,43,24,4,378,0,0,378
25,5,25006,803,3,87,71,34,16,1,209,0,4,213
25,5,25006,806,3,126,91,67,56,0,340,0,6,346
25,5,25006,807,3,88,70,50,28,4,240,1,3,244
25,5,25006,810,3,109,93,37,30,1,270,0,3,273
25,5,25006,811,3,28,37,20,8,2,95,0,0,95
25,5,25006,814,3,41,47,29,21,1,139,1,5,145
25,5,25006,815,3,44,44,13,8,3,112,0,3,115
25,5,25006,818,3,72,73,43,40,3,231,0,3,234
25,5,25006,819,3,98,86,50,33,1,268,0,8,276
25,5,25006,822,3,110,75,51,32,2,270,0,2,272
25,5,25006,823,3,111,104,61,67,0,343,1,1,345
25,5,25006,826,3,108,111,89,26,5,339,6,9,354
25,5,25006,827,3,102,104,85,39,7,337,1,13,351
25,5,25006,830,3,154,113,61,57,6,391,0,4,395
25,5,25006,831,3,78,69,65,38,4,254,0,4,258
25,5,25006,834,3,66,69,54,33,3,225,0,8,233
25,5,25006,835,3,146,124,82,53,5,410,0,7,417
25,5,25006,838,3,33,38,49,47,2,169,2,5,176
25,5,25006,839,3,61,50,28,35,2,176,0,4,180
25,5,25006,842,3,84,36,48,33,2,203,0,1,204
25,5,25006,843,3,73,64,51,42,0,230,0,9,239
25,5,25006,846,3,60,57,36,122,1,276,0,6,282
25,5,25006,847,3,56,72,31,42,3,204,0,2,206
25,5,25006,850,3,83,60,40,153,1,337,0,15,352
25,5,25006,851,3,59,74,68,32,2,235,0,6,241
25,5,25006,854,3,71,36,24,17,0,148,1,1,150
25,5,25006,855,3,43,26,16,11,0,96,1,0,97
25,5,25006,858,3,69,42,27,20,0,158,4,4,166
25,5,25006,859,3,93,82,63,40,2,280,1,5,286
25,5,25006,862,3,57,77,33,8,3,178,1,1,180
25,5,25006,863,3,59,81,35,27,2,204,0,6,210
25,5,25006,866,3,54,81,81,39,3,258,0,3,261
25,5,25006,867,3,74,58,74,27,0,233,2,7,242
25,5,25006,870,3,54,80,39,11,3,187,0,2,189
25,5,25006,871,3,75,46,32,11,2,166,0,3,169
25,5,25006,874,3,104,51,28,13,1,197,0,5,202
25,5,25006,875,3,77,82,53,34,4,250,0,11,261
25,5,25006,878,3,44,42,30,11,1,128,0,1,129
25,5,25006,879,3,56,50,31,27,1,165,0,2,167
25,5,25006,882,3,83,31,10,12,0,136,0,1,137
25,5,25006,883,3,115,39,24,8,0,186,0,2,188
25,5,25006,887,3,788,674,494,389,29,2374,5,19,2398
25,5,25006,890,3,50,99,54,71,5,279,0,3,282
25,5,25006,891,3,74,174,70,98,5,421,0,10,431
25,5,25006,894,3,91,136,84,63,1,375,1,2,378
25,5,25006,895,3,103,131,109,88,6,437,0,4,441
25,5,25006,898,3,128,144,84,81,0,437,2,3,442
25,5,25006,899,3,135,148,104,85,2,474,0,11,485
25,5,25006,902,3,56,71,37,52,0,216,0,4,220
25,5,25006,903,3,1470,1146,1038,523,36,4213,6,40,4259
25,5,25006,906,3,180,133,101,42,7,463,0,5,468
25,5,25006,907,3,51,47,30,16,0,144,0,0,144
25,5,25006,910,3,109,93,59,28,1,290,0,0,290
25,5,25006,911,3,59,56,28,14,4,161,0,0,161
25,5,25006,914,3,81,122,66,64,2,335,1,5,341
25,5,25006,915,3,144,126,70,57,0,397,0,11,408
25,5,25006,918,3,157,126,59,34,2,378,0,5,383
25,5,25006,919,3,104,138,51,59,7,359,0,3,362
25,5,25006,922,3,120,103,74,46,5,348,0,0,348
25,5,25006,923,3,53,87,27,32,1,200,0,4,204
25,5,25006,926,3,87,104,51,33,4,279,0,7,286
25,5,25006,927,3,58,57,44,31,2,192,0,3,195
25,5,25006,930,3,99,116,48,39,3,305,2,1,308
25,5,25006,931,3,94,84,52,43,3,276,0,4,280
25,5,25006,934,3,434,353,194,119,8,1108,4,6,1118
25,5,25006,935,3,88,101,37,17,4,247,0,10,257
25,5,25006,938,3,42,39,29,14,1,125,1,1,127
25,5,25006,939,3,82,77,51,22,1,233,2,5,240
25,5,25006,942,3,87,26,20,3,1,137,0,4,141
25,5,25006,943,3,38,29,17,9,0,93,0,1,94
25,5,25006,946,3,70,53,27,10,2,162,0,3,165
25,5,25006,947,3,60,45,37,20,3,165,0,1,166
25,5,25006,950,3,55,49,33,27,1,165,0,2,167
25,5,25006,951,3,61,64,40,32,1,198,0,6,204
25,5,25006,954,3,84,67,32,12,3,198,0,3,201
25,5,25006,955,3,48,30,23,10,2,113,0,5,118
25,5,25006,958,3,33,27,11,14,1,86,0,1,87
25,5,25006,959,3,45,27,26,6,0,104,0,2,106
25,5,25006,962,3,45,19,12,11,2,89,0,1,90
25,5,25006,963,3,34,52,21,12,0,119,0,3,122
25,5,25006,966,3,60,69,21,21,2,173,0,2,175
25,5,25006,967,3,37,59,24,13,1,134,0,2,136
25,5,25006,970,3,56,46,29,20,2,153,0,1,154
25,5,25006,971,3,39,29,14,11,2,95,0,3,98
25,5,25006,974,3,37,38,13,10,2,100,0,2,102
25,5,25006,975,3,83,61,50,15,3,212,2,2,216
25,5,25006,978,3,72,51,38,40,1,202,1,3,206
25,5,25006,979,3,89,48,13,12,1,163,0,1,164
25,5,25006,982,3,85,35,27,12,0,159,0,5,164
25,5,25006,983,3,85,73,24,16,2,200,0,2,202
25,5,25006,986,3,101,71,29,25,2,228,1,2,231
25,5,25006,987,3,97,75,27,21,2,222,0,1,223
25,5,25006,1007,3,184,129,68,48,6,435,0,4,439
25,5,25006,1010,3,102,106,148,30,3,389,0,0,389
25,5,25006,1011,3,102,62,43,29,2,238,0,4,242
25,5,25006,1014,3,56,35,23,16,0,130,0,1,131
25,5,25006,1015,3,88,38,37,14,4,181,1,4,186
25,5,25006,1018,3,23,45,23,18,3,112,0,7,119
25,5,25006,1019,3,102,87,63,47,5,304,0,6,310
25,5,25006,1022,3,83,63,25,24,2,197,0,3,200
25,5,25006,1023,3,76,48,19,34,1,178,0,2,180
25,5,25006,1026,3,67,74,32,20,3,196,1,5,202
25,5,25006,1027,3,76,37,32,34,0,179,0,1,180
25,5,25006,1030,3,94,84,59,56,5,298,0,7,305
25,5,25006,1031,3,57,51,22,26,0,156,0,7,163
25,5,25006,1036,3,41,44,41,9,0,135,0,3,138
25,5,25006,1038,3,96,59,39,28,4,226,0,1,227
25,5,25006,1042,3,166,63,51,62,6,348,0,1,349
25,5,25006,1043,3,134,110,76,56,5,381,0,8,389
25,5,25006,1046,3,96,126,64,49,1,336,0,11,347
25,5,25006,1047,3,57,59,50,31,3,200,0,4,204
25,5,25006,1050,3,88,52,39,37,3,219,0,4,223
25,5,25006,1051,3,69,77,75,37,0,258,0,4,262
25,5,25006,1054,3,41,60,38,25,2,166,1,3,170
25,5,25006,1055,3,90,61,44,21,3,219,1,4,224
25,5,25006,1079,3,103,93,50,54,6,306,0,1,307
25,5,25006,1082,3,99,95,48,30,1,273,0,5,278
25,5,25006,1083,3,100,86,29,35,5,255,0,3,258
25,5,25006,1206,3,230,232,165,126,8,761,4,17,782
25,5,25006,1207,3,72,143,98,38,2,353,0,13,366
25,5,25006,1210,3,578,471,499,250,22,1820,5,65,1890
25,5,25006,1211,3,53,75,41,17,3,189,1,5,195
25,5,25006,1214,3,163,132,108,45,4,452,1,10,463
25,5,25006,1215,3,50,67,41,21,1,180,0,1,181
25,5,25006,1218,3,453,492,299,170,20,1434,4,31,1469
25,5,25006,1219,3,115,130,77,33,2,357,0,9,366
25,5,25006,1222,3,61,229,48,35,1,374,0,17,391
25,5,25006,1223,3,68,133,33,18,1,253,0,11,264
25,5,25006,1226,3,9,78,15,11,1,114,0,0,114
25,5,25006,1227,3,33,53,32,2,2,122,0,4,126
25,5,25006,1230,3,18,88,1,36,1,144,0,8,152
25,5,25006,1231,3,52,50,9,6,0,117,0,6,123
25,5,25006,1234,3,40,27,4,7,0,78,0,6,84
25,5,25006,1235,3,83,113,21,31,4,252,0,15,267
25,5,25006,1238,3,6,51,5,16,1,79,0,3,82
25,5,25006,1239,3,111,100,43,35,10,299,1,0,300
25,5,25006,1242,3,12,56,8,12,3,91,0,1,92
25,5,25006,1243,3,52,38,9,0,0,99,0,5,104
25,5,25006,1246,3,77,59,28,19,0,183,0,8,191
25,5,25006,1247,3,99,75,25,35,1,235,0,7,242
25,5,25006,1250,3,128,38,29,23,0,218,0,6,224
25,5,25006,1251,3,76,33,34,27,1,171,0,6,177
25,5,25006,1254,3,258,228,110,94,2,692,1,21,714
25,5,25006,1255,3,169,110,30,3,1,313,3,17,333
25,5,25006,1258,3,21,64,9,2,1,97,0,2,99
25,5,25006,1259,3,33,26,17,8,1,85,0,2,87
25,5,25006,1262,3,116,157,57,23,2,355,1,13,369
25,5,25006,1263,3,54,45,17,25,2,143,0,3,146
25,5,25006,1266,3,78,54,21,33,2,188,3,8,199
25,5,25006,1267,3,69,49,16,12,0,146,0,4,150
25,5,25006,1270,3,113,118,38,83,2,354,4,10,368
25,5,25006,1271,3,95,134,49,71,4,353,0,14,367
25,5,25006,1274,3,30,46,10,102,0,188,0,9,197
25,5,25006,1275,3,178,159,55,92,2,486,1,18,505
25,5,25006,1278,3,82,55,24,34,1,196,1,15,212
25,5,25006,1279,3,235,160,107,43,7,552,1,15,568
25,5,25006,1295,3,124,82,72,62,1,341,1,5,347
25,5,25006,1298,3,72,62,54,53,3,244,0,11,255
25,5,25006,1299,3,50,42,34,30,2,158,1,9,168
25,5,25006,1302,3,67,71,36,26,0,200,0,7,207
25,5,25006,1303,3,84,76,59,29,6,254,0,8,262
25,5,25006,1306,3,68,70,31,49,0,218,0,11,229
25,5,25006,1307,3,63,101,34,27,3,228,0,4,232
25,5,25006,1310,3,173,279,105,87,11,655,0,6,661
25,5,25006,1311,3,102,111,111,63,4,391,1,7,399
25,5,25006,1314,3,43,58,46,18,2,167,1,5,173
25,5,25006,1315,3,64,72,39,19,1,195,1,6,202
25,5,25006,1318,3,79,89,83,61,2,314,1,11,326
25,5,25006,1319,3,53,50,29,36,0,168,0,2,170
25,5,25006,1322,3,186,187,108,55,4,540,2,11,553
25,5,25006,1323,3,73,100,37,35,6,251,3,7,261
25,5,25006,1326,3,62,73,43,14,5,197,1,1,199
25,5,25006,1327,3,99,71,49,11,1,231,0,6,237
25,5,25006,1330,3,50,42,30,12,1,135,0,3,138
25,5,25006,1332,3,41,43,24,28,0,136,0,2,138
25,5,25006,1334,3,112,97,69,54,2,334,0,9,343
25,5,25006,1335,3,87,101,77,47,1,313,0,7,320
25,5,25006,1338,3,85,80,70,25,0,260,0,0,260
25,5,25006,1339,3,63,78,42,11,2,196,0,7,203
25,5,25006,1342,3,107,78,37,10,1,233,0,7,240
25,5,25006,1343,3,110,103,60,30,2,305,0,11,316
25,5,25006,1346,3,124,95,95,62,2,378,0,6,384
25,5,25006,1347,3,61,55,39,20,2,177,0,5,182
25,5,25006,1350,3,109,141,106,45,5,406,3,13,422
25,5,25006,1351,3,97,98,59,45,9,308,1,7,316
25,5,25006,1354,3,89,87,42,18,0,236,0,5,241
25,5,25006,1355,3,104,130,44,40,5,323,1,9,333
25,5,25006,1358,3,93,114,49,30,5,291,2,7,300
25,5,25006,1359,3,77,104,49,22,3,255,2,11,268
25,5,25006,1362,3,50,72,28,14,5,169,0,4,173
25,5,25006,1363,3,87,60,82,20,2,251,1,6,258
25,5,25006,1366,3,33,49,31,11,0,124,0,2,126
25,5,25006,1374,3,71,98,44,20,2,235,1,0,236
25,5,25006,1375,3,61,88,56,18,1,224,2,12,238
25,5,25006,1378,3,85,87,41,34,1,248,0,10,258
25,5,25006,1393,3,89,105,39,35,2,270,0,3,273
25,5,25006,1394,3,174,224,98,33,9,538,3,8,549
25,5,25006,1395,3,67,83,49,18,3,220,1,5,226
25,5,25006,1410,3,64,55,42,20,1,182,0,6,188
25,5,25006,1411,3,171,199,138,95,6,609,1,21,631
25,5,25006,1425,3,142,168,105,71,5,491,0,4,495
25,5,25006,1487,3,10,38,10,13,0,71,0,4,75
25,5,25006,1490,3,10,62,6,14,2,94,0,2,96
25,5,25006,1491,3,3,38,6,5,1,53,0,0,53
25,5,25006,1494,3,30,65,6,11,1,113,0,7,120
25,5,25006,1495,3,22,93,17,20,1,153,1,6,160
25,5,25006,1498,3,30,116,2,1,0,149,0,0,149
25,5,25006,1499,3,10,36,5,0,0,51,0,2,53
25,5,25006,1502,3,35,28,9,5,1,78,0,3,81
25,5,25006,1503,3,71,128,38,18,1,256,0,2,258
25,5,25006,1506,3,28,120,28,24,0,200,0,7,207
25,5,25006,1513,3,23,52,8,13,0,96,1,1,98
25,5,25006,1514,3,43,56,7,0,1,107,0,0,107
25,5,25006,1516,3,49,102,1,4,0,156,1,7,164
25,6,25004,629,3,117,147,49,0,1,314,0,11,325
25,6,25004,630,3,69,138,26,3,1,237,0,8,245
25,6,25004,631,3,150,194,46,2,3,395,0,12,407
25,6,25004,634,3,88,114,41,3,2,248,0,12,260
25,6,25004,635,3,192,192,62,4,0,450,0,19,469
25,6,25004,638,3,66,87,6,1,0,160,0,5,165
25,6,25004,639,3,44,105,5,0,0,154,0,0,154
25,6,25004,642,3,48,102,12,1,0,163,0,0,163
25,6,25004,643,3,40,135,23,1,1,200,2,2,204
25,6,25004,646,3,73,51,28,1,2,155,0,6,161
25,6,25004,647,3,44,40,1,0,0,85,0,1,86
25,6,25004,650,3,41,68,2,0,0,111,0,1,112
25,6,25004,651,3,137,96,8,0,1,242,0,5,247
25,6,25004,654,3,142,131,19,1,1,294,0,10,304
25,6,25004,655,3,89,137,13,0,1,240,1,10,251
25,6,25004,658,3,25,130,3,0,1,159,0,4,163
25,6,25004,659,3,87,59,8,0,2,156,0,2,158
25,6,25004,662,3,24,99,8,0,0,131,0,3,134
25,6,25004,663,3,50,73,9,0,1,133,0,4,137
25,6,25004,666,3,61,68,15,2,0,146,1,2,149
25,6,25004,667,3,89,156,14,1,0,260,0,4,264
25,6,25004,670,3,170,106,31,4,3,314,0,6,320
25,6,25004,671,3,145,108,16,4,0,273,0,8,281
25,6,25004,674,3,6,44,1,0,0,51,0,2,53
25,6,25005,675,3,117,128,8,1,1,255,0,10,265
25,6,25005,678,3,84,113,17,0,1,215,0,11,226
25,6,25005,679,3,132,82,9,3,1,227,2,3,232
25,6,25005,682,3,183,169,6,1,0,359,0,0,359
25,6,25005,683,3,16,108,15,0,1,140,0,7,147
25,6,25005,686,3,68,119,8,1,0,196,0,6,202
25,6,25005,687,3,11,55,11,0,0,77,0,1,78
25,6,25005,690,3,83,88,15,0,2,188,0,8,196
25,6,25005,691,3,41,127,4,0,0,172,0,3,175
25,6,25005,694,3,68,67,74,1,1,211,0,5,216
25,6,25005,695,3,48,53,7,0,0,108,0,2,110
25,6,25005,698,3,98,188,23,0,3,312,1,5,318
25,6,25005,699,3,24,62,18,3,1,108,0,4,112
25,6,25005,702,3,9,106,31,0,0,146,0,3,149
25,6,25005,703,3,115,85,8,0,3,211,0,6,217
25,6,25005,706,3,40,68,4,0,0,112,0,7,119
25,6,25005,707,3,22,47,14,0,1,84,1,6,91
25,6,25008,1799,3,132,318,35,1,3,489,0,10,499
25,6,25008,1802,3,149,404,42,4,0,599,0,13,612
25,6,25008,1803,3,32,132,13,1,1,179,0,5,184
25,6,25008,1806,3,46,155,19,1,1,222,1,5,228
25,6,25008,1807,3,49,123,11,0,0,183,1,2,186
25,6,25008,1810,3,35,106,10,1,0,152,0,0,152
25,6,25008,1811,3,92,293,27,1,1,414,1,8,423
25,6,25008,1814,3,88,146,11,3,1,249,0,2,251
25,6,25008,1815,3,12,49,3,0,0,64,0,2,66
25,6,25008,1818,3,28,34,2,0,0,64,0,1,65
25,6,25008,1819,3,7,18,2,1,0,28,0,1,29
25,6,25008,1822,3,103,167,9,1,1,281,0,8,289
25,6,25008,1823,3,81,80,12,2,2,177,0,6,183
25,6,25008,1826,3,10,88,5,0,1,104,0,4,108
25,6,25008,1827,3,31,108,15,0,0,154,0,3,157
25,6,25008,1830,3,65,108,15,1,0,189,1,8,198
25,6,25008,1831,3,24,74,1,1,0,100,0,5,105
25,6,25008,1834,3,37,215,3,0,0,255,0,4,259
25,6,25008,1835,3,86,174,20,1,0,281,3,5,289
25,6,25008,1838,3,42,85,45,0,2,174,3,7,184
25,6,25008,1839,3,19,134,44,4,0,201,2,8,211
25,6,25008,1842,3,43,122,8,1,0,174,0,7,181
25,6,25008,1843,3,88,113,24,1,0,226,0,3,229
25,6,25008,1846,3,137,116,13,1,0,267,0,3,270
25,6,25008,1847,3,78,205,103,2,2,390,1,8,399
25,6,25008,1850,3,115,158,8,1,0,282,1,4,287
25,6,25008,1851,3,100,143,8,1,1,253,3,10,266
25,6,25008,1854,3,43,78,145,2,0,268,4,9,281
25,6,25008,1855,3,41,132,37,0,1,211,0,7,218
25,6,25008,1858,3,53,91,75,0,3,222,1,6,229
25,6,25008,1859,3,95,234,40,0,2,371,5,14,390
25,6,25009,1862,3,123,77,37,4,4,245,1,8,254
25,6,25009,1863,3,107,59,29,10,2,207,0,8,215
25,6,25009,1866,3,122,110,33,5,2,272,0,1,273
25,6,25009,1867,3,123,98,31,7,3,262,0,4,266
25,6,25009,1870,3,56,108,31,6,3,204,1,0,205
25,6,25009,1871,3,110,154,15,12,3,294,0,6,300
25,6,25009,1874,3,87,120,32,11,4,254,1,5,260
25,6,25009,1875,3,63,144,37,7,1,252,0,2,254
25,6,25009,1878,3,48,159,42,3,1,253,0,4,257
25,6,25009,1879,3,81,136,30,5,3,255,0,5,260
25,6,25009,1882,3,81,121,29,8,3,242,0,4,246
25,6,25009,1883,3,189,299,69,19,3,579,1,12,592
25,6,25009,1886,3,160,108,44,7,0,319,0,7,326
25,6,25009,1887,3,49,104,23,1,1,178,0,3,181
25,6,25009,1890,3,121,155,36,13,1,326,2,2,330
25,6,25009,1891,3,163,210,51,19,4,447,0,14,461
25,6,25009,1894,3,214,137,78,7,1,437,2,12,451
25,6,25009,1895,3,91,67,37,6,0,201,4,5,210
25,6,25009,1898,3,11,14,2,2,0,29,0,1,30
25,6,25009,1899,3,7,22,4,2,0,35,1,3,39
25,6,25009,1902,3,190,72,56,5,1,324,0,6,330
25,6,25009,1903,3,254,122,72,13,2,463,1,12,476
25,6,25009,1906,3,133,149,30,29,0,341,0,22,363
25,6,25009,1907,3,50,66,24,2,0,142,0,0,142
25,6,25009,1910,3,104,123,35,6,1,269,0,0,269
25,6,25009,1911,3,106,76,26,3,2,213,2,1,216
25,6,25009,1914,3,60,49,40,8,0,157,0,5,162
25,6,25009,1915,3,58,83,49,14,2,206,0,10,216
25,6,25009,1918,3,70,85,42,23,2,222,0,9,231
25,6,25009,1919,3,105,102,80,11,4,302,0,16,318
25,6,25009,1922,3,46,106,53,7,2,214,0,11,225
25,6,25009,1923,3,32,100,33,1,2,168,0,8,176
25,6,25012,2623,3,54,178,32,0,0,264,0,0,264
25,6,25012,2667,3,587,206,182,18,21,1014,4,11,1029
25,6,25012,2670,3,88,75,70,5,6,244,0,0,244
25,6,25012,2671,3,101,40,38,5,1,185,1,3,189
25,6,25012,2674,3,220,86,83,16,8,413,2,8,423
25,6,25012,2675,3,196,72,90,6,4,368,0,6,374
25,6,25012,2678,3,293,98,31,6,9,437,0,3,440
25,6,25012,2679,3,203,74,32,0,5,314,0,2,316
25,6,25012,2682,3,218,81,37,7,12,355,0,6,361
25,6,25012,2683,3,415,138,84,5,2,644,1,7,652
25,6,25012,2687,3,206,136,85,17,5,449,0,10,459
25,6,25012,2691,3,776,507,347,66,38,1734,3,20,1757
25,6,25012,2694,3,1141,754,465,68,54,2482,2,21,2505
25,6,25012,2695,3,278,171,134,19,9,611,0,13,624
25,6,25012,2698,3,647,575,383,88,31,1724,5,17,1746
25,6,25012,2953,3,100,24,12,0,0,136,0,0,136
25,6,25012,2954,3,131,22,6,0,0,159,0,13,172
25,6,25012,2955,3,21,11,8,0,0,40,0,3,43
25,6,25012,2958,3,67,67,4,0,2,140,0,8,148
25,6,25012,2959,3,71,47,6,0,0,124,1,5,130
25,6,25012,2962,3,104,78,22,0,2,206,1,6,213
25,6,25012,2963,3,81,82,15,2,0,180,1,3,184
25,6,25012,2966,3,116,111,8,1,0,236,1,2,239
25,6,25012,2967,3,173,92,25,3,1,294,1,5,300
25,6,25012,2970,3,42,51,4,1,1,99,0,2,101
25,6,25012,2971,3,78,20,13,0,0,111,0,2,113
25,6,25012,2974,3,193,100,43,3,3,342,1,15,358
25,6,25012,2975,3,146,129,23,2,2,302,2,10,314
25,6,25012,2978,3,31,73,7,0,0,111,1,2,114
25,6,25012,2979,3,125,135,32,0,0,292,0,0,292
25,6,25012,2982,3,27,65,14,0,0,106,0,3,109
25,6,25012,2983,3,133,72,15,4,0,224,0,3,227
25,6,25012,2987,3,235,125,43,10,5,418,1,10,429
25,6,25012,2990,3,108,82,46,3,2,241,1,4,246
25,6,25012,2991,3,24,154,13,1,1,193,0,6,199
25,6,25012,2994,3,52,84,8,0,0,144,0,2,146
25,6,25014,3131,3,122,179,101,7,2,411,2,1,414
25,6,25014,3134,3,69,145,65,5,1,285,2,8,295
25,6,25014,3135,3,50,102,25,0,2,179,0,4,183
25,6,25014,3138,3,145,191,121,6,2,465,1,10,476
25,6,25014,3139,3,165,193,113,8,3,482,0,15,497
25,6,25014,3142,3,69,160,42,8,2,281,0,2,283
25,6,25014,3143,3,100,112,75,6,2,295,0,28,323
25,6,25014,3146,3,57,59,21,3,1,141,0,2,143
25,6,25014,3147,3,126,126,89,8,2,351,1,13,365
25,6,25014,3150,3,65,87,27,2,0,181,0,1,182
25,6,25014,3151,3,128,84,7,0,0,219,0,5,224
25,6,25014,3154,3,21,25,1,1,1,49,0,2,51
25,6,25014,3155,3,39,101,17,4,0,161,0,16,177
25,6,25014,3158,3,10,55,14,1,0,80,0,1,81
25,6,25014,3159,3,27,14,63,2,1,107,0,4,111
25,6,25014,3162,3,36,70,31,1,0,138,0,2,140
25,6,25014,3163,3,24,93,31,0,0,148,0,1,149
25,6,25014,3166,3,35,70,48,1,1,155,0,8,163
25,6,25014,3167,3,52,64,19,1,3,139,1,5,145
25,6,25014,3170,3,10,36,14,0,0,60,0,1,61
25,6,25014,3171,3,14,24,13,0,0,51,0,3,54
25,6,25014,3174,3,54,44,27,1,1,127,0,11,138
25,6,25014,3175,3,96,128,81,5,0,310,0,7,317
25,6,25014,3178,3,84,114,39,4,1,242,3,5,250
25,6,25014,3179,3,32,106,14,0,0,152,0,7,159
25,6,25014,3182,3,82,111,59,2,2,256,0,6,262
25,6,25014,3183,3,5,52,6,0,0,63,0,10,73
25,6,25014,3186,3,67,50,28,1,0,146,0,7,153
25,6,25014,3187,3,20,30,30,1,0,81,0,5,86
25,6,25014,3190,3,132,98,171,2,3,406,0,5,411
25,6,25014,3191,3,76,85,65,0,0,226,0,9,235
25,6,25014,3194,3,49,61,39,1,3,153,1,6,160
25,6,25014,3195,3,54,67,38,2,0,161,2,7,170
25,6,25014,3198,3,8,33,9,0,0,50,0,2,52
25,6,25014,3199,3,58,78,47,1,1,185,0,6,191
25,6,25014,3202,3,48,60,31,2,1,142,0,3,145
25,6,25014,3203,3,41,28,18,4,0,91,0,4,95
25,6,25014,3206,3,174,69,21,5,0,269,0,8,277
25,6,25014,3207,3,144,199,58,4,2,407,1,19,427
25,6,25014,3210,3,63,124,76,3,1,267,1,7,275
25,6,25014,3211,3,96,77,59,2,0,234,0,4,238
25,6,25014,3214,3,24,88,74,0,0,186,0,2,188
25,6,25014,3215,3,24,132,65,3,1,225,0,2,227
25,6,25014,3218,3,23,32,34,1,0,90,0,3,93
25,6,25014,3219,3,122,110,83,2,4,321,3,7,331
25,6,25016,3370,3,155,495,38,9,4,701,0,8,709
25,6,25016,3371,3,81,125,10,2,0,218,0,5,223
25,6,25016,3374,3,191,244,54,5,3,497,0,20,517
25,6,25016,3381,3,33,27,12,0,0,72,0,2,74
25,6,25016,3382,3,53,27,5,0,0,85,0,3,88
25,6,25016,3383,3,38,17,15,0,0,70,0,9,79
25,6,25016,3387,3,25,28,4,0,1,58,0,1,59
25,6,25016,3390,3,17,11,6,0,0,34,0,1,35
25,6,25016,3392,3,110,80,6,0,1,197,0,8,205
25,6,25016,3394,3,52,132,16,0,1,201,2,4,207
25,6,25016,3395,3,23,88,39,1,2,153,0,7,160
25,6,25016,3398,3,45,69,6,3,0,123,0,4,127
25,6,25016,3399,3,28,29,24,0,0,81,1,4,86
25,6,25016,3402,3,93,188,34,2,2,319,0,8,327
25,6,25016,3403,3,104,129,39,4,0,276,0,6,282
25,6,25016,3406,3,139,110,12,1,0,262,0,9,271
25,6,25016,3407,3,51,52,5,1,0,109,0,2,111
25,6,25016,3410,3,141,172,9,3,0,325,2,3,330
25,6,25016,3411,3,26,70,78,0,2,176,1,11,188
25,6,25016,3414,3,96,129,25,0,1,251,2,8,261
25,6,25016,3415,3,104,156,37,1,2,300,0,7,307
25,6,25016,3418,3,38,67,24,1,1,131,1,5,137
25,6,25016,3419,3,32,86,6,1,1,126,0,3,129
25,7,25006,885,3,890,404,150,42,28,1514,3,8,1525
25,7,25006,886,3,198,143,61,29,9,440,1,12,453
25,7,25006,1005,3,108,98,32,10,10,258,5,3,266
25,7,25006,1006,3,255,188,110,24,16,593,2,24,619
25,7,25006,1034,3,81,58,36,11,2,188,0,7,195
25,7,25006,1035,3,78,85,46,13,5,227,1,4,232
25,7,25006,1039,3,95,98,36,13,7,249,1,5,255
25,7,25006,1056,3,124,72,51,8,2,257,0,0,257
25,7,25006,1058,3,102,82,58,19,12,273,0,13,286
25,7,25006,1059,3,82,75,34,6,8,205,0,3,208
25,7,25006,1062,3,58,103,38,9,0,208,0,7,215
25,7,25006,1063,3,79,46,23,10,1,159,0,2,161
25,7,25006,1066,3,57,51,19,11,3,141,1,0,142
25,7,25006,1067,3,62,46,46,9,2,165,2,6,173
25,7,25006,1070,3,58,70,68,11,5,212,0,4,216
25,7,25006,1071,3,41,55,45,4,4,149,1,8,158
25,7,25006,1074,3,39,80,43,6,3,171,1,5,177
25,7,25006,1075,3,124,87,56,17,9,293,1,2,296
25,7,25006,1078,3,201,148,59,48,14,470,0,7,477
25,7,25006,1085,3,124,112,62,27,9,334,1,4,339
25,7,25006,1086,3,217,133,74,17,16,457,0,7,464
25,7,25006,1087,3,307,311,148,35,17,818,3,6,827
25,7,25006,1090,3,156,160,56,20,10,402,0,5,407
25,7,25006,1091,3,219,145,105,15,11,495,4,4,503
25,7,25006,1094,3,128,96,70,16,6,316,0,2,318
25,7,25006,1095,3,173,99,65,13,11,361,0,8,369
25,7,25006,1098,3,72,146,45,18,1,282,0,6,288
25,7,25006,1099,3,54,77,30,4,3,168,0,4,172
25,7,25006,1102,3,50,60,47,17,4,178,1,8,187
25,7,25006,1103,3,140,129,43,14,5,331,1,4,336
25,7,25006,1106,3,85,97,53,3,4,242,0,3,245
25,7,25006,1107,3,58,90,44,6,3,201,0,6,207
25,7,25006,1110,3,67,70,36,3,1,177,0,6,183
25,7,25006,1111,3,53,84,37,8,2,184,2,3,189
25,7,25006,1114,3,74,102,51,11,1,239,2,8,249
25,7,25006,1115,3,96,80,47,4,4,231,1,16,248
25,7,25006,1118,3,91,66,35,9,2,203,0,6,209
25,7,25006,1119,3,730,421,252,62,34,1499,0,14,1513
25,7,25006,1122,3,28,57,26,5,1,117,2,3,122
25,7,25006,1123,3,73,52,45,8,5,183,2,16,201
25,7,25006,1126,3,95,87,37,14,2,235,0,3,238
25,7,25006,1127,3,34,54,30,0,0,118,0,8,126
25,7,25006,1130,3,107,74,29,10,5,225,1,0,226
25,7,25006,1131,3,70,51,14,0,3,138,0,3,141
25,7,25006,1134,3,95,49,29,3,2,178,0,8,186
25,7,25006,1135,3,96,53,32,7,3,191,0,5,196
25,7,25006,1138,3,84,87,50,8,4,233,1,7,241
25,7,25006,1139,3,65,55,36,5,0,161,1,1,163
25,7,25006,1142,3,86,71,44,11,8,220,2,9,231
25,7,25006,1143,3,92,62,34,9,1,198,0,2,200
25,7,25006,1146,3,111,79,54,12,3,259,0,9,268
25,7,25006,1147,3,84,82,41,6,4,217,0,3,220
25,7,25006,1150,3,211,140,94,18,12,475,3,7,485
25,7,25006,1151,3,566,492,270,51,17,1396,3,40,1439
25,7,25006,1154,3,81,69,49,0,1,200,1,5,206
25,7,25006,1155,3,84,84,38,6,3,215,0,3,218
25,7,25006,1158,3,87,60,36,5,2,190,0,4,194
25,7,25006,1159,3,71,63,44,3,1,182,0,10,192
25,7,25006,1162,3,87,85,51,8,4,235,2,1,238
25,7,25006,1163,3,78,75,34,4,6,197,0,0,197
25,7,25006,1166,3,65,82,32,5,5,189,2,0,191
25,7,25006,1167,3,77,36,32,6,4,155,0,8,163
25,7,25006,1170,3,179,145,73,18,6,421,3,3,427
25,7,25006,1171,3,104,108,47,12,6,277,2,8,287
25,7,25006,1174,3,61,84,35,2,3,185,4,1,190
25,7,25006,1175,3,81,78,25,11,3,198,0,3,201
25,7,25006,1178,3,239,188,78,17,4,526,1,13,540
25,7,25006,1179,3,81,82,54,9,2,228,0,5,233
25,7,25006,1182,3,173,155,65,6,5,404,5,9,418
25,7,25006,1183,3,51,75,40,4,2,172,1,5,178
25,7,25006,1186,3,439,394,188,40,18,1079,8,27,1114
25,7,25006,1187,3,74,79,38,2,4,197,0,8,205
25,7,25006,1190,3,148,138,52,19,9,366,4,6,376
25,7,25006,1191,3,287,260,140,30,13,730,1,13,744
25,7,25006,1194,3,194,206,100,8,12,520,2,11,533
25,7,25006,1195,3,130,105,50,10,6,301,0,8,309
25,7,25006,1198,3,302,225,100,25,9,661,2,8,671
25,7,25006,1199,3,343,244,109,32,18,746,0,4,750
25,7,25006,1202,3,121,109,59,8,0,297,0,3,300
25,7,25006,1203,3,59,106,41,6,8,220,0,6,226
25,7,25006,1367,3,69,104,40,12,1,226,0,3,229
25,7,25006,1370,3,64,81,45,6,1,197,0,5,202
25,7,25006,1371,3,113,130,84,21,14,362,0,10,372
25,7,25006,1379,3,89,112,76,13,2,292,1,4,297
25,7,25006,1382,3,65,110,37,6,3,221,0,6,227
25,7,25006,1383,3,77,93,45,10,3,228,0,0,228
25,7,25006,1386,3,54,70,27,0,6,157,0,7,164
25,7,25006,1387,3,75,69,64,1,5,214,0,0,214
25,7,25006,1390,3,83,79,58,21,4,245,1,0,246
25,7,25006,1391,3,128,119,52,1,7,307,1,4,312
25,7,25006,1396,3,111,80,48,25,1,265,0,0,265
25,7,25006,1398,3,79,103,51,10,2,245,0,3,248
25,7,25006,1399,3,94,68,37,7,4,210,0,4,214
25,7,25006,1402,3,67,77,34,12,2,192,0,3,195
25,7,25006,1403,3,83,69,66,9,5,232,0,5,237
25,7,25006,1406,3,85,57,37,9,3,191,1,10,202
25,7,25006,1407,3,95,115,47,16,3,276,0,9,285
25,7,25006,1412,3,84,90,58,18,6,256,2,2,260
25,7,25006,1414,3,57,64,35,8,1,165,0,3,168
25,7,25006,1415,3,87,56,53,9,8,213,1,4,218
25,7,25006,1418,3,64,52,50,9,4,179,0,4,183
25,7,25006,1419,3,100,92,53,14,9,268,0,9,277
25,7,25006,1422,3,93,102,60,11,4,270,0,10,280
25,7,25006,1423,3,95,100,48,12,4,259,2,3,264
25,7,25006,1426,3,213,241,124,32,14,624,0,6,630
25,7,25006,1427,3,75,78,50,10,3,216,1,0,217
25,7,25006,1430,3,94,99,57,12,2,264,2,9,275
25,7,25006,1431,3,98,101,55,8,1,263,1,5,269
25,7,25006,1434,3,81,128,52,9,3,273,2,10,285
25,7,25006,1435,3,98,132,72,9,9,320,1,10,331
25,7,25006,1438,3,104,74,49,14,6,247,0,3,250
25,7,25006,1439,3,101,95,52,13,1,262,0,5,267
25,7,25006,1442,3,77,79,38,8,3,205,0,9,214
25,7,25006,1443,3,54,98,30,5,1,188,0,5,193
25,7,25006,1446,3,48,58,33,5,2,146,0,2,148
25,7,25006,1447,3,74,76,40,15,4,209,0,7,216
25,7,25006,1450,3,80,86,27,14,4,211,0,4,215
25,7,25006,1451,3,49,73,23,2,1,148,0,4,152
25,7,25006,1454,3,106,58,39,10,4,217,1,5,223
25,7,25006,1455,3,69,64,24,6,3,166,1,2,169
25,7,25006,1458,3,137,86,66,10,6,305,0,9,314
25,7,25006,1459,3,101,84,58,0,0,243,0,5,248
25,7,25006,1462,3,107,126,63,13,3,312,4,5,321
25,7,25006,1463,3,86,81,44,14,2,227,0,6,233
25,7,25006,1466,3,123,110,67,12,9,321,0,12,333
25,7,25006,1467,3,97,99,54,4,3,257,4,9,270
25,7,25006,1470,3,91,105,71,0,0,267,0,3,270
25,7,25006,1471,3,89,111,62,6,5,273,0,14,287
25,7,25006,1474,3,88,66,23,11,1,189,3,6,198
25,7,25006,1475,3,80,134,30,3,1,248,0,2,250
25,7,25006,1478,3,477,404,212,39,17,1149,6,17,1172
25,7,25006,1479,3,87,109,72,7,3,278,1,5,284
25,7,25006,1482,3,104,101,48,9,0,262,0,1,263
25,7,25006,1483,3,97,81,52,4,0,234,2,8,244
25,7,25006,1486,3,78,65,35,0,2,180,0,8,188
25,7,25006,1512,3,44,84,20,6,0,154,0,4,158
25,7,25006,1515,3,20,46,6,0,1,73,0,2,75
25,7,25006,1518,3,24,87,6,0,0,117,0,4,121
25,7,25006,1519,3,13,50,9,0,1,73,0,2,75
25,7,25006,1522,3,51,51,11,0,1,114,0,2,116
25,7,25006,1523,3,5,25,13,4,0,47,0,2,49
25,7,25006,1526,3,41,23,5,0,1,70,0,3,73
25,7,25006,1527,3,18,81,8,0,0,107,0,1,108
25,7,25006,1530,3,21,28,3,1,0,53,0,1,54
25,7,25006,1531,3,36,33,13,0,0,82,0,2,84
25,7,25006,1534,3,49,129,31,1,1,211,1,3,215
25,7,25006,1545,3,13,108,4,0,0,125,0,2,127
25,7,25006,1546,3,19,65,5,0,2,91,0,2,93
25,7,25006,1547,3,48,67,12,1,0,128,0,3,131
25,7,25006,1550,3,44,89,13,2,0,148,0,13,161
25,7,25006,1551,3,16,66,16,1,0,99,0,0,99
25,7,25006,1588,3,59,75,12,1,2,149,0,3,152
25,7,25006,1591,3,84,172,34,4,7,301,0,6,307
25,7,25006,1594,3,61,170,4,1,0,236,0,7,243
25,7,25006,1595,3,21,39,6,1,1,68,0,3,71
25,7,25006,1598,3,81,137,24,4,3,249,0,10,259
25,7,25006,1599,3,23,57,23,0,2,105,0,5,110
25,7,25006,1602,3,21,9,6,0,1,37,1,1,39
25,7,25006,1603,3,68,39,19,0,0,126,0,3,129
25,7,25006,1606,3,34,54,27,1,1,117,0,4,121
25,7,25006,1607,3,53,126,36,1,3,219,0,2,221
25,7,25006,1610,3,26,61,11,1,0,99,2,1,102
25,7,25006,1611,3,36,49,6,0,0,91,0,0,91
25,7,25006,1614,3,92,115,51,0,2,260,0,9,269
25,7,25006,1615,3,57,131,32,1,1,222,0,10,232
25,7,25006,1618,3,24,55,29,0,0,108,0,2,110
25,7,25006,1619,3,97,93,41,5,2,238,1,0,239
25,7,25006,1622,3,52,94,38,2,2,188,0,1,189
25,7,25006,1623,3,79,185,38,0,2,304,0,5,309
25,7,25006,1626,3,77,108,20,0,2,207,0,10,217
25,7,25006,1627,3,58,71,24,2,0,155,0,7,162
25,7,25006,1630,3,83,159,37,1,3,283,1,12,296
25,7,25006,1631,3,43,206,26,2,1,278,0,0,278
25,7,25006,1634,3,153,125,24,1,1,304,0,5,309
25,7,25006,1635,3,150,224,40,0,0,414,0,0,414
25,7,25006,1638,3,170,129,41,4,0,344,1,15,360
25,7,25006,1639,3,17,91,6,0,0,114,0,3,117
25,7,25006,1642,3,74,94,47,3,1,219,0,7,226
25,7,25006,1643,3,30,54,19,3,1,107,0,0,107
25,7,25006,1646,3,201,126,79,2,5,413,2,9,424
25,7,25006,1647,3,25,71,8,0,1,105,0,0,105
25,7,25006,1650,3,92,181,21,5,1,300,0,14,314
25,7,25006,1651,3,21,81,4,0,0,106,0,3,109
25,7,25006,1654,3,145,176,65,8,1,395,0,14,409
25,7,25006,1655,3,66,193,22,1,1,283,2,14,299
25,7,25006,1658,3,146,186,20,4,1,357,0,4,361
25,7,25006,1659,3,67,68,27,3,2,167,0,0,167
25,7,25006,1662,3,87,149,83,1,1,321,1,7,329
25,7,25006,1663,3,95,194,56,5,5,355,1,5,361
25,7,25006,1666,3,74,145,19,5,0,243,0,8,251
25,7,25006,1667,3,20,75,24,0,1,120,0,2,122
25,7,25006,1670,3,58,58,8,0,0,124,0,7,131
25,7,25006,1671,3,111,115,32,3,6,267,0,3,270
25,7,25006,1674,3,100,112,25,2,1,240,0,8,248
25,7,25006,1675,3,94,136,24,3,1,258,0,7,265
25,7,25006,1678,3,68,72,22,1,1,164,0,3,167
25,7,25006,1679,3,151,116,30,3,3,303,2,3,308
25,7,25006,1682,3,78,74,15,4,1,172,0,2,174
25,7,25006,1683,3,131,112,34,3,6,286,0,0,286
25,7,25006,1686,3,96,100,37,4,1,238,0,4,242
25,7,25006,1687,3,77,116,24,4,2,223,0,1,224
25,7,25006,1690,3,104,118,27,4,2,255,0,4,259
25,7,25006,1691,3,88,98,31,5,0,222,0,7,229
25,7,25006,1694,3,25,31,48,2,2,108,0,4,112
25,7,25006,1695,3,46,38,112,2,3,201,0,1,202
25,7,25006,1698,3,97,134,52,0,0,283,0,6,289
25,7,25006,1699,3,80,76,36,0,1,193,0,5,198
25,7,25006,1702,3,43,33,28,0,1,105,0,10,115
25,7,25006,1703,3,96,217,18,3,4,338,0,14,352
25,7,25006,1706,3,70,102,43,3,5,223,0,7,230
25,7,25006,1707,3,54,172,24,1,1,252,0,1,253
25,7,25006,1710,3,43,96,46,4,1,190,0,0,190
25,7,25006,1711,3,73,49,112,6,2,242,0,0,242
25,7,25006,1714,3,64,140,14,1,3,222,0,0,222
25,7,25006,1715,3,130,306,77,3,2,518,1,19,538
25,7,25006,1718,3,15,45,11,0,0,71,0,1,72
25,7,25006,1719,3,88,206,102,9,3,408,0,11,419
25,7,25006,1722,3,19,29,26,1,0,75,0,2,77
25,7,25006,1723,3,16,49,11,1,1,78,1,0,79
25,8,25012,2540,3,84,40,38,17,1,180,1,5,186
25,8,25012,2542,3,44,48,50,7,1,150,0,4,154
25,8,25012,2543,3,107,89,44,10,3,253,0,3,256
25,8,25012,2546,3,99,93,65,7,8,272,2,9,283
25,8,25012,2547,3,59,51,54,7,4,175,3,6,184
25,8,25012,2550,3,126,67,47,14,2,256,0,5,261
25,8,25012,2551,3,150,74,69,16,10,319,0,6,325
25,8,25012,2554,3,133,64,62,11,0,270,0,4,274
25,8,25012,2555,3,97,63,44,15,3,222,0,2,224
25,8,25012,2558,3,74,37,52,13,1,177,0,5,182
25,8,25012,2559,3,82,55,55,14,5,211,1,8,220
25,8,25012,2562,3,128,51,87,14,2,282,0,10,292
25,8,25012,2563,3,132,54,73,21,4,284,1,3,288
25,8,25012,2566,3,54,14,17,10,2,97,0,2,99
25,8,25012,2567,3,125,58,58,11,5,257,2,8,267
25,8,25012,2570,3,80,40,50,8,1,179,0,0,179
25,8,25012,2571,3,148,87,74,9,4,322,0,7,329
25,8,25012,2574,3,66,39,45,13,5,168,0,2,170
25,8,25012,2575,3,58,26,30,6,3,123,0,2,125
25,8,25012,2578,3,72,17,20,12,0,121,1,1,123
25,8,25012,2579,3,67,37,22,8,1,135,1,1,137
25,8,25012,2582,3,107,47,64,12,3,233,0,4,237
25,8,25012,2583,3,116,33,74,15,7,245,1,5,251
25,8,25012,2586,3,111,47,38,18,2,216,2,2,220
25,8,25012,2587,3,102,76,67,11,3,259,0,10,269
25,8,25012,2590,3,100,57,53,11,4,225,0,5,230
25,8,25012,2591,3,101,52,80,14,3,250,0,12,262
25,8,25012,2594,3,144,129,79,14,8,374,3,11,388
25,8,25012,2595,3,185,53,77,9,4,328,0,3,331
25,8,25012,2598,3,79,18,44,7,1,149,0,2,151
25,8,25012,2599,3,64,28,23,11,3,129,0,3,132
25,8,25012,2602,3,66,70,59,13,2,210,0,5,215
25,8,25012,2603,3,81,38,27,8,1,155,2,2,159
25,8,25012,2606,3,72,60,54,2,2,190,2,3,195
25,8,25012,2607,3,229,166,148,21,0,564,5,15,584
25,8,25012,2610,3,154,104,82,9,5,354,0,4,358
25,8,25012,2611,3,154,113,63,12,3,345,1,17,363
25,8,25012,2614,3,129,102,102,14,4,351,1,12,364
25,8,25012,2615,3,49,50,50,2,0,151,0,6,157
25,8,25012,2618,3,323,273,229,33,19,877,6,24,907
25,8,25012,2619,3,106,44,43,7,2,202,0,8,210
25,8,25012,2622,3,58,70,116,16,2,262,3,3,268
25,8,25012,2624,3,35,22,32,9,2,100,0,4,104
25,8,25012,2626,3,85,59,38,4,1,187,0,4,191
25,8,25012,2627,3,147,158,38,5,3,351,0,10,361
25,8,25012,2630,3,51,48,38,6,2,145,1,4,150
25,8,25012,2631,3,76,64,61,11,1,213,0,6,219
25,8,25012,2634,3,44,30,33,4,0,111,1,0,112
25,8,25012,2635,3,34,52,16,1,1,104,0,7,111
25,8,25012,2638,3,96,76,82,2,13,269,0,13,282
25,8,25012,2639,3,65,33,27,6,3,134,1,6,141
25,8,25012,2642,3,40,26,28,8,0,102,0,3,105
25,8,25012,2643,3,56,36,39,12,1,144,0,4,148
25,8,25012,2646,3,68,44,33,6,2,153,0,1,154
25,8,25012,2647,3,202,109,100,21,2,434,2,14,450
25,8,25012,2650,3,21,21,14,2,0,58,0,0,58
25,8,25012,2651,3,69,44,73,10,2,198,0,1,199
25,8,25012,2654,3,57,97,66,25,1,246,0,6,252
25,8,25012,2655,3,162,105,68,20,1,356,0,14,370
25,8,25012,2658,3,18,8,8,6,0,40,0,0,40
25,8,25012,2659,3,25,20,12,4,0,61,0,1,62
25,8,25012,2662,3,206,173,62,15,1,457,2,10,469
25,8,25012,2663,3,75,89,48,9,0,221,1,7,229
25,8,25012,2666,3,105,101,141,16,2,365,1,6,372
25,8,25012,2685,3,698,212,319,122,24,1375,1,16,1392
25,8,25012,2686,3,206,105,158,25,9,503,0,8,511
25,8,25012,2688,3,306,117,127,22,5,577,1,9,587
25,8,25012,2690,3,225,85,99,31,5,445,0,10,455
25,8,25012,2699,3,117,51,60,64,7,299,0,5,304
25,8,25012,2702,3,178,131,108,15,4,436,0,2,438
25,8,25012,2703,3,232,50,70,22,2,376,0,9,385
25,8,25012,2706,3,186,66,66,12,1,331,0,7,338
25,8,25012,2707,3,168,71,69,13,5,326,0,11,337
25,8,25012,2710,3,125,87,80,75,7,374,0,4,378
25,8,25012,2711,3,165,63,65,16,5,314,0,3,317
25,8,25012,2714,3,68,71,77,9,3,228,0,5,233
25,8,25012,2715,3,233,95,128,31,4,491,4,14,509
25,8,25012,2718,3,133,108,91,19,3,354,0,6,360
25,8,25012,2719,3,144,55,68,24,3,294,2,6,302
25,8,25012,2722,3,394,132,170,29,9,734,0,8,742
25,8,25012,2723,3,107,75,59,10,1,252,0,11,263
25,8,25012,2726,3,72,56,32,10,3,173,0,1,174
25,8,25012,2727,3,73,50,47,8,2,180,1,4,185
25,8,25012,2730,3,183,99,92,16,4,394,0,11,405
25,8,25012,2731,3,122,74,83,15,3,297,1,11,309
25,8,25012,2734,3,143,76,45,18,3,285,0,6,291
25,8,25012,2735,3,117,94,84,16,6,317,2,2,321
25,8,25012,2738,3,137,110,110,8,2,367,1,8,376
25,8,25012,2739,3,70,81,79,8,5,243,1,0,244
25,8,25012,2742,3,343,147,207,31,5,733,3,16,752
25,8,25012,2743,3,366,216,338,52,16,988,6,18,1012
25,8,25012,2746,3,252,178,146,31,6,613,0,11,624
25,8,25012,2747,3,31,26,30,8,0,95,0,1,96
25,8,25012,2750,3,56,27,38,10,1,132,0,4,136
25,8,25012,2751,3,165,159,137,54,8,523,0,14,537
25,8,25012,2754,3,116,77,76,15,6,290,3,4,297
25,8,25012,2755,3,155,87,52,17,9,320,2,4,326
25,8,25012,2758,3,110,50,37,15,6,218,1,1,220
25,8,25012,2759,3,120,69,71,28,3,291,0,4,295
25,8,25012,2762,3,253,85,146,25,7,516,1,10,527
25,8,25012,2763,3,193,109,128,40,5,475,0,5,480
25,8,25012,2766,3,101,41,41,10,0,193,0,9,202
25,8,25012,2767,3,90,70,44,12,4,220,0,3,223
25,8,25012,2770,3,201,107,109,17,3,437,0,10,447
25,8,25012,2771,3,115,78,71,8,7,279,3,8,290
25,8,25012,2774,3,269,82,115,29,4,499,0,7,506
25,8,25012,2775,3,238,79,71,18,12,418,2,6,426
25,8,25012,2778,3,124,48,35,18,3,228,1,3,232
25,8,25012,2779,3,148,41,53,9,1,252,1,3,256
25,8,25012,2782,3,121,74,66,23,2,286,0,4,290
25,8,25012,2783,3,236,102,121,36,8,503,1,13,517
25,8,25012,2786,3,156,72,97,27,7,359,0,8,367
25,8,25012,2787,3,101,63,38,8,0,210,0,9,219
25,8,25012,2790,3,112,96,46,4,4,262,6,6,274
25,8,25012,2791,3,198,104,94,16,0,412,0,11,423
25,8,25012,2794,3,82,31,40,9,3,165,0,4,169
25,8,25012,2795,3,81,45,54,6,3,189,0,8,197
25,8,25012,2798,3,114,92,118,22,2,348,1,14,363
25,8,25012,2799,3,115,93,146,17,5,376,2,9,387
25,8,25012,2802,3,77,34,27,7,2,147,1,3,151
25,8,25012,2803,3,45,24,17,8,4,98,2,0,100
25,8,25012,2806,3,69,35,51,8,3,166,0,6,172
25,8,25012,2807,3,142,98,101,9,1,351,2,10,363
25,8,25012,2810,3,116,82,87,20,1,306,3,19,328
25,8,25012,2811,3,47,66,47,8,1,169,3,1,173
25,8,25012,2814,3,111,98,95,17,4,325,0,15,340
25,8,25012,2815,3,138,65,89,11,4,307,0,8,315
25,8,25012,2818,3,137,78,64,15,3,297,0,9,306
25,8,25012,2819,3,51,43,54,7,3,158,0,0,158
25,8,25012,2822,3,136,82,67,15,6,306,0,14,320
25,8,25012,2823,3,135,84,59,20,2,300,0,10,310
25,8,25012,2826,3,98,61,73,3,1,236,0,12,248
25,8,25012,2827,3,179,72,77,14,5,347,2,3,352
25,8,25012,2830,3,230,150,138,23,6,547,1,16,564
25,8,25012,2831,3,152,172,131,31,8,494,4,12,510
25,8,25012,2834,3,139,88,99,9,10,345,2,6,353
25,8,25012,2835,3,252,120,161,28,0,561,1,7,569
25,8,25012,2838,3,73,50,39,8,3,173,1,4,178
25,8,25012,2839,3,96,74,71,0,4,245,4,7,256
25,8,25012,2842,3,127,89,72,9,2,299,0,10,309
25,8,25012,2843,3,113,77,74,12,4,280,1,7,288
25,8,25012,2846,3,123,63,105,23,5,319,0,7,326
25,8,25012,2847,3,127,91,131,21,7,377,1,7,385
25,8,25012,2850,3,112,111,89,15,2,329,2,0,331
25,8,25012,2851,3,201,130,119,10,12,472,2,12,486
25,8,25012,2854,3,138,91,99,14,3,345,0,14,359
25,8,25012,2855,3,112,104,104,15,9,344,4,12,360
25,8,25012,2858,3,69,29,32,7,2,139,1,5,145
25,8,25012,2859,3,169,44,47,10,10,280,2,3,285
25,8,25012,2862,3,85,65,59,15,3,227,0,4,231
25,8,25012,2863,3,184,162,177,29,10,562,0,15,577
25,8,25012,2866,3,127,70,52,20,4,273,0,8,281
25,8,25012,2867,3,74,50,37,14,1,176,1,7,184
25,8,25012,2870,3,108,86,79,12,5,290,5,10,305
25,8,25012,2871,3,176,103,125,13,6,423,2,9,434
25,8,25012,2874,3,67,49,46,5,2,169,0,5,174
25,8,25012,2875,3,93,54,53,11,6,217,2,5,224
25,8,25012,2878,3,86,53,56,16,3,214,2,4,220
25,8,25012,2879,3,349,252,251,43,37,932,3,15,950
25,8,25012,2882,3,61,55,32,4,0,152,0,5,157
25,8,25012,2883,3,57,36,50,3,1,147,2,6,155
25,8,25012,2886,3,81,43,56,6,1,187,0,2,189
25,8,25012,2887,3,96,97,95,12,5,305,2,6,313
25,8,25012,2890,3,63,22,39,6,2,132,0,1,133
25,8,25012,2891,3,82,41,42,4,3,172,0,5,177
25,8,25012,2894,3,189,92,83,12,7,383,0,7,390
25,8,25012,2895,3,196,50,57,7,7,317,0,3,320
25,8,25012,2898,3,121,43,88,6,1,259,0,7,266
25,8,25012,2899,3,77,35,60,5,3,180,0,8,188
25,8,25012,2902,3,114,38,98,8,4,262,1,9,272
25,8,25012,2903,3,135,92,88,16,4,335,3,9,347
25,8,25012,2906,3,133,166,193,25,6,523,3,10,536
25,8,25012,2907,3,89,64,104,9,2,268,0,4,272
25,8,25012,2910,3,85,60,40,9,4,198,1,10,209
25,8,25012,2911,3,96,59,54,8,2,219,0,13,232
25,8,25012,2914,3,69,38,26,6,3,142,0,2,144
25,8,25012,2915,3,151,72,74,12,7,316,0,6,322
25,8,25012,2918,3,80,45,54,10,4,193,1,1,195
25,8,25012,2919,3,147,66,86,10,6,315,0,0,315
25,8,25012,2922,3,226,130,125,43,9,533,0,14,547
25,8,25012,2923,3,95,68,66,10,4,243,0,7,250
25,8,25012,2926,3,48,40,46,6,1,141,2,4,147
25,8,25012,2927,3,117,74,53,11,5,260,7,7,274
25,8,25012,2930,3,108,44,72,5,3,232,2,8,242
25,8,25012,2931,3,73,28,37,6,3,147,2,2,151
25,8,25012,2934,3,73,34,37,4,1,149,0,0,149
25,8,25012,2935,3,66,75,59,7,3,210,0,9,219
25,8,25012,2938,3,156,74,110,9,1,350,0,5,355
25,8,25012,2939,3,143,115,122,18,8,406,0,10,416
25,8,25012,2942,3,104,39,64,9,5,221,0,4,225
25,8,25012,2943,3,39,33,37,3,4,116,0,0,116
25,8,25012,2946,3,52,36,34,6,2,130,2,2,134
25,8,25012,2947,3,98,57,34,9,2,200,0,5,205
25,8,25012,2950,3,68,48,37,6,0,159,1,9,169
25,8,25012,2951,3,105,72,40,3,4,224,4,15,243
25,8,25012,2995,3,157,92,57,14,4,324,0,10,334
26,1,26003,33,3,414,192,347,11,3,967,1,22,990
26,1,26003,34,3,342,173,241,7,4,767,0,12,779
26,1,26003,35,3,562,326,296,11,10,1205,0,15,1220
26,1,26006,46,3,285,258,24,1,1,569,0,5,574
26,1,26014,66,3,364,172,89,8,9,642,1,35,678
26,1,26014,67,3,361,140,48,6,4,559,0,14,573
26,1,26031,232,3,69,210,35,0,3,317,0,0,317
26,1,26036,252,3,278,205,36,4,5,528,1,7,536
26,1,26036,254,3,334,311,53,17,12,727,0,8,735
26,1,26036,255,3,495,520,129,20,10,1174,3,27,1204
26,1,26036,258,3,49,60,4,0,0,113,0,10,123
26,1,26036,259,3,94,133,33,5,1,266,0,13,279
26,1,26036,262,3,218,200,35,11,3,467,0,5,472
26,1,26036,263,3,307,255,48,18,5,633,0,13,646
26,1,26038,266,3,260,257,51,3,4,575,0,8,583
26,1,26042,278,3,292,335,21,2,0,650,0,18,668
26,1,26042,279,3,57,87,3,1,0,148,1,2,151
26,1,26043,282,3,25,28,7,0,0,60,0,1,61
26,1,26043,283,3,29,49,14,0,1,93,0,7,100
26,1,26046,292,3,467,221,85,12,8,793,0,23,816
26,1,26046,294,3,510,250,113,14,18,905,0,14,919
26,1,26046,295,3,794,421,225,23,31,1494,0,31,1525
26,1,26046,298,3,626,360,126,20,19,1151,1,16,1168
26,1,26046,299,3,356,204,72,18,2,652,0,20,672
26,1,26046,302,3,340,207,66,8,8,629,1,16,646
26,1,26046,303,3,278,224,61,6,10,579,0,11,590
26,1,26046,306,3,505,214,77,9,14,819,0,20,839
26,1,26046,307,3,210,107,46,7,2,372,0,6,378
26,1,26046,310,3,471,351,75,6,8,911,0,10,921
26,1,26046,311,3,342,98,92,7,5,544,0,8,552
26,1,26046,314,3,597,360,99,18,12,1086,0,12,1098
26,1,26046,315,3,277,127,38,6,7,455,0,6,461
26,1,26046,318,3,10,10,9,0,0,29,0,0,29
26,1,26046,319,3,532,234,175,10,12,963,0,40,1003
26,1,26046,322,3,247,137,115,7,8,514,0,12,526
26,1,26046,323,3,142,124,117,3,3,389,1,19,409
26,1,26046,326,3,214,65,124,6,4,413,0,18,431
26,1,26046,327,3,71,48,23,0,3,145,1,3,149
26,1,26052,625,3,391,348,132,15,6,892,0,14,906
26,1,26052,626,3,311,318,74,15,1,719,1,15,735
26,1,26052,627,3,362,383,174,7,10,936,1,13,950
26,1,26052,630,3,86,47,64,1,0,198,0,9,207
26,1,26053,631,3,412,587,114,18,14,1145,0,22,1167
26,1,26053,634,3,539,712,149,22,12,1434,0,38,1472
26,1,26053,635,3,207,354,71,5,9,646,0,20,666
26,1,26053,638,3,759,1055,140,37,28,2019,0,36,2055
26,1,26053,639,3,279,407,69,5,2,762,0,7,769
26,1,26053,642,3,374,485,46,13,6,924,0,16,940
26,1,26053,643,3,356,426,53,13,5,853,1,13,867
26,1,26053,646,3,373,493,85,18,10,979,0,15,994
26,1,26053,647,3,94,135,15,2,6,252,0,8,260
26,1,26055,652,3,172,114,79,5,5,375,2,12,389
26,1,26055,654,3,75,58,28,5,6,172,0,7,179
26,1,26055,655,3,154,61,74,1,13,303,1,0,304
26,1,26055,658,3,252,163,101,11,5,532,3,8,543
26,1,26055,659,3,194,127,76,7,1,405,1,9,415
26,1,26055,662,3,190,124,62,6,6,388,0,5,393
26,1,26055,663,3,61,48,41,0,1,151,0,5,156
26,1,26055,666,3,284,245,129,14,8,680,0,3,683
26,1,26055,667,3,340,196,133,11,8,688,0,17,705
26,1,26055,670,3,685,434,593,48,24,1784,3,26,1813
26,1,26055,671,3,95,92,61,10,3,261,0,3,264
26,1,26055,674,3,142,93,49,12,12,308,0,3,311
26,1,26055,675,3,129,61,58,3,0,251,0,5,256
26,1,26055,678,3,308,141,114,16,5,584,0,19,603
26,1,26055,679,3,247,124,97,8,1,477,0,0,477
26,1,26055,682,3,103,78,37,8,3,229,0,0,229
26,1,26055,683,3,154,74,44,5,4,281,2,7,290
26,1,26055,686,3,202,116,45,7,3,373,0,0,373
26,1,26055,687,3,219,132,78,10,5,444,1,10,455
26,1,26055,690,3,344,111,97,10,9,571,0,22,593
26,1,26055,691,3,199,81,52,7,8,347,0,11,358
26,1,26055,694,3,223,91,87,10,9,420,1,6,427
26,1,26055,695,3,198,68,83,46,3,398,0,9,407
26,1,26055,698,3,244,106,93,5,10,458,1,8,467
26,1,26055,699,3,205,119,63,5,3,395,0,7,402
26,1,26055,702,3,204,78,70,8,5,365,1,4,370
26,1,26055,703,3,373,187,127,10,11,708,1,15,724
26,1,26055,706,3,449,189,128,23,8,797,0,12,809
26,1,26055,707,3,354,151,106,8,9,628,2,15,645
26,1,26055,710,3,557,227,289,18,20,1111,0,24,1135
26,1,26055,711,3,441,242,243,14,13,953,0,17,970
26,1,26055,714,3,386,179,132,20,10,727,2,11,740
26,1,26055,715,3,334,141,108,10,12,605,2,11,618
26,1,26055,718,3,267,98,129,11,2,507,0,20,527
26,1,26055,719,3,471,238,163,27,12,911,3,16,930
26,1,26055,722,3,414,173,106,9,3,705,0,17,722
26,1,26055,723,3,535,246,296,29,12,1118,0,17,1135
26,1,26055,726,3,282,107,73,3,8,473,1,5,479
26,1,26055,727,3,335,101,128,10,4,578,2,16,596
26,1,26055,730,3,918,409,523,27,25,1902,3,40,1945
26,1,26055,731,3,370,185,196,22,8,781,0,20,801
26,1,26055,734,3,133,93,34,3,3,266,0,5,271
26,1,26055,735,3,97,42,37,1,1,178,1,3,182
26,1,26055,738,3,358,189,120,12,2,681,2,16,699
26,1,26055,739,3,149,71,45,8,3,276,0,12,288
26,1,26055,742,3,234,471,76,9,3,793,0,20,813
26,1,26070,1323,3,184,337,137,13,7,678,0,11,689
26,1,26070,1326,3,261,336,159,11,6,773,0,6,779
26,1,26070,1327,3,98,221,71,5,1,396,0,8,404
26,1,26070,1330,3,79,160,84,5,2,330,0,0,330
26,2,26002,3,3,322,272,62,16,3,675,3,23,701
26,2,26002,6,3,356,294,81,47,5,783,0,21,804
26,2,26002,7,3,373,297,84,268,7,1029,0,12,1041
26,2,26002,10,3,633,425,187,65,7,1317,1,24,1342
26,2,26002,11,3,327,330,98,35,5,795,0,27,822
26,2,26002,14,3,380,400,109,28,9,926,2,21,949
26,2,26002,15,3,266,281,57,22,1,627,0,31,658
26,2,26002,18,3,318,309,97,53,3,780,0,30,810
26,2,26002,19,3,385,359,139,41,4,928,1,25,954
26,2,26002,22,3,885,855,367,120,13,2240,2,65,2307
26,2,26002,23,3,433,479,151,66,5,1134,2,29,1165
26,2,26002,26,3,436,538,219,45,7,1245,0,45,1290
26,2,26002,27,3,30,58,4,3,0,95,0,1,96
26,2,26002,30,3,100,60,4,0,1,165,1,6,172
26,2,26002,31,3,730,689,240,100,32,1791,0,22,1813
26,2,26005,41,3,278,129,29,16,1,453,0,16,469
26,2,26005,42,3,348,288,17,42,1,696,0,13,709
26,2,26005,43,3,119,128,10,1,0,258,0,9,267
26,2,26010,54,3,330,155,149,22,3,659,0,19,678
26,2,26010,55,3,81,36,75,11,0,203,0,7,210
26,2,26015,70,3,269,208,101,45,0,623,0,12,635
26,2,26015,71,3,333,235,111,40,8,727,1,21,749
26,2,26015,74,3,345,268,127,44,6,790,0,24,814
26,2,26015,75,3,1045,800,335,141,10,2331,6,15,2352
26,2,26015,78,3,241,161,101,24,2,529,0,15,544
26,2,26015,79,3,240,153,78,15,1,487,0,10,497
26,2,26015,82,3,349,301,124,41,6,821,0,9,830
26,2,26015,83,3,452,372,188,77,7,1096,5,17,1118
26,2,26015,86,3,95,73,44,9,0,221,0,6,227
26,2,26015,87,3,49,35,18,2,1,105,0,1,106
26,2,26016,90,3,32,52,2,2,0,88,0,7,95
26,2,26016,91,3,41,7,1,0,0,49,0,9,58
26,2,26019,101,3,308,204,62,23,2,599,0,15,614
26,2,26019,102,3,19,86,33,2,1,141,1,8,150
26,2,26019,103,3,465,600,262,39,9,1375,3,46,1424
26,2,26024,112,3,270,157,68,91,2,588,1,24,613
26,2,26024,114,3,197,170,44,43,2,456,2,13,471
26,2,26024,115,3,284,249,67,68,3,671,0,11,682
26,2,26024,118,3,16,11,2,4,0,33,0,2,35
26,2,26024,121,3,62,76,35,33,1,207,0,1,208
26,2,26024,122,3,127,182,36,40,5,390,0,4,394
26,2,26025,123,3,357,216,182,115,2,872,0,16,888
26,2,26025,126,3,648,416,180,140,10,1394,1,31,1426
26,2,26025,127,3,258,189,138,45,3,633,0,11,644
26,2,26025,130,3,471,286,255,113,12,1137,2,26,1165
26,2,26025,131,3,634,444,123,109,5,1315,0,9,1324
26,2,26025,134,3,67,98,26,25,1,217,0,7,224
26,2,26025,135,3,64,37,15,23,0,139,0,11,150
26,2,26027,142,3,258,155,44,17,0,474,0,5,479
26,2,26027,143,3,266,156,25,19,2,468,0,4,472
26,2,26030,159,3,262,169,57,23,3,514,0,14,528
26,2,26030,162,3,421,222,37,29,3,712,1,15,728
26,2,26030,163,3,446,230,91,30,6,803,0,21,824
26,2,26030,166,3,216,104,54,10,1,385,0,19,404
26,2,26030,167,3,263,137,55,24,4,483,1,16,500
26,2,26030,170,3,337,159,50,15,4,565,0,9,574
26,2,26030,171,3,653,259,90,74,7,1083,1,6,1090
26,2,26030,174,3,374,110,33,25,7,549,0,6,555
26,2,26030,175,3,566,227,64,35,9,901,1,19,921
26,2,26030,178,3,376,178,71,14,4,643,1,20,664
26,2,26030,179,3,348,212,58,18,4,640,0,0,640
26,2,26030,182,3,299,157,50,23,4,533,0,7,540
26,2,26030,183,3,412,155,34,17,5,623,0,7,630
26,2,26030,186,3,283,94,39,23,5,444,3,6,453
26,2,26030,187,3,673,240,78,35,12,1038,0,16,1054
26,2,26030,190,3,266,100,25,13,4,408,1,7,416
26,2,26030,191,3,363,134,50,35,5,587,1,2,590
26,2,26030,194,3,405,199,88,31,5,728,2,18,748
26,2,26030,195,3,300,142,46,24,0,512,2,0,514
26,2,26030,198,3,300,150,45,17,1,513,0,18,531
26,2,26030,199,3,740,408,178,34,21,1381,1,23,1405
26,2,26030,202,3,400,188,33,24,4,649,0,14,663
26,2,26030,203,3,222,73,32,10,10,347,0,8,355
26,2,26030,206,3,416,169,50,23,3,661,1,23,685
26,2,26030,207,3,601,276,80,35,12,1004,4,22,1030
26,2,26030,210,3,556,267,132,31,5,991,0,22,1013
26,2,26030,211,3,547,289,73,45,6,960,2,20,982
26,2,26030,214,3,1018,420,178,112,10,1738,3,45,1786
26,2,26030,215,3,648,320,110,60,12,1150,0,15,1165
26,2,26030,218,3,634,276,58,27,8,1003,1,1,1005
26,2,26030,219,3,362,417,200,31,9,1019,4,28,1051
26,2,26030,222,3,579,308,140,66,14,1107,1,33,1141
26,2,26030,223,3,1538,494,265,114,20,2431,4,16,2451
26,2,26030,226,3,498,133,53,31,5,720,2,2,724
26,2,26030,227,3,2255,922,381,200,45,3803,0,51,3854
26,2,26030,230,3,21,22,4,1,0,48,0,0,48
26,2,26030,231,3,456,267,74,59,9,865,1,13,879
26,2,26037,264,3,288,567,70,28,6,959,0,14,973
26,3,26049,336,3,1101,838,241,69,22,2271,2,54,2327
26,3,26049,338,3,921,523,180,81,18,1723,2,18,1743
26,3,26049,339,3,742,276,128,25,18,1189,0,28,1217
26,3,26049,342,3,943,610,206,78,23,1860,0,43,1903
26,3,26049,343,3,798,506,143,47,19,1513,5,19,1537
26,3,26049,346,3,285,170,50,16,4,525,0,12,537
26,3,26049,347,3,582,329,86,32,11,1040,0,15,1055
26,3,26049,350,3,538,323,92,34,12,999,0,26,1025
26,3,26049,351,3,466,407,91,37,13,1014,0,34,1048
26,3,26049,354,3,365,157,54,15,3,594,0,19,613
26,3,26049,355,3,531,207,154,22,11,925,1,5,931
26,3,26049,358,3,453,272,43,22,11,801,3,6,810
26,3,26049,359,3,1410,663,215,36,33,2357,0,20,2377
26,3,26049,362,3,505,223,60,22,4,814,0,11,825
26,3,26049,363,3,305,139,42,16,5,507,1,11,519
26,3,26049,366,3,496,208,44,20,9,777,1,18,796
26,3,26049,367,3,603,280,99,28,16,1026,1,8,1035
26,3,26049,370,3,484,289,59,36,9,877,0,9,886
26,3,26049,371,3,359,120,50,21,3,553,0,14,567
26,3,26049,374,3,1280,795,176,76,22,2349,4,54,2407
26,3,26049,375,3,601,307,128,34,20,1090,1,18,1109
26,3,26049,378,3,525,238,94,22,11,890,0,11,901
26,3,26049,379,3,463,182,51,21,8,725,1,14,740
26,3,26049,382,3,565,285,75,28,10,963,3,20,986
26,3,26049,383,3,253,136,38,13,2,442,0,14,456
26,3,26049,386,3,579,245,108,26,18,976,0,8,984
26,3,26049,387,3,650,286,116,13,15,1080,0,16,1096
26,3,26049,390,3,771,307,99,29,5,1211,0,22,1233
26,3,26049,391,3,104,148,74,5,4,335,1,7,343
26,3,26049,394,3,709,295,127,30,13,1174,2,22,1198
26,3,26049,395,3,373,146,58,17,7,601,2,12,615
26,3,26049,398,3,459,236,81,24,2,802,0,24,826
26,3,26049,399,3,398,198,97,24,15,732,0,5,737
26,3,26049,402,3,587,337,98,27,4,1053,1,14,1068
26,3,26049,403,3,389,156,106,14,10,675,0,3,678
26,3,26049,406,3,566,219,52,18,8,863,0,18,881
26,3,26049,407,3,394,180,76,13,3,666,0,11,677
26,3,26049,410,3,681,234,129,15,13,1072,1,7,1080
26,3,26049,411,3,582,220,87,26,8,923,2,20,945
26,3,26049,420,3,533,230,89,13,7,872,0,9,881
26,3,26049,422,3,336,135,62,9,3,545,0,13,558
26,3,26049,423,3,434,193,44,16,6,693,0,13,706
26,3,26049,426,3,453,198,57,14,6,728,1,11,740
26,3,26049,427,3,505,302,72,36,5,920,0,26,946
26,3,26049,430,3,586,292,79,41,7,1005,1,25,1031
26,3,26049,431,3,638,286,111,22,8,1065,2,26,1093
26,3,26049,434,3,508,238,80,30,1,857,2,26,885
26,3,26049,435,3,341,183,55,13,10,602,2,21,625
26,3,26049,438,3,532,220,83,19,4,858,1,17,876
26,3,26049,442,3,515,225,101,8,15,864,0,11,875
26,3,26049,443,3,446,217,64,28,5,760,0,17,777
26,3,26049,446,3,297,118,25,11,7,458,1,7,466
26,3,26049,447,3,301,170,63,16,8,558,1,11,570
26,3,26049,450,3,390,222,79,21,7,719,0,14,733
26,3,26049,451,3,791,353,177,50,24,1395,1,24,1420
26,3,26049,454,3,415,182,58,21,10,686,1,15,702
26,3,26049,455,3,256,82,49,10,5,402,0,7,409
26,3,26049,461,3,396,218,57,19,5,695,0,4,699
26,3,26049,462,3,309,147,57,11,3,527,1,23,551
26,3,26049,463,3,574,230,88,21,8,921,8,26,955
26,3,26049,474,3,1019,521,269,25,28,1862,1,22,1885
26,3,26049,585,3,1491,752,253,74,42,2612,1,28,2641
26,3,26049,590,3,971,392,161,40,24,1588,1,23,1612
26,3,26049,591,3,29,32,10,4,1,76,0,0,76
26,3,26049,596,3,14,5,0,1,0,20,0,0,20
26,3,26049,598,3,861,539,189,46,21,1656,0,18,1674
26,3,26049,617,3,11,11,6,0,0,28,0,3,31
26,3,26049,618,3,13,89,74,2,0,178,0,7,185
26,3,26049,1332,3,214,119,58,14,3,408,0,5,413
26,3,26049,1334,3,263,88,35,13,9,408,0,0,408
26,3,26049,1335,3,188,95,19,5,2,309,0,1,310
26,3,26049,1338,3,202,131,39,12,2,386,0,6,392
26,3,26049,1339,3,164,76,33,6,1,280,0,0,280
26,3,26049,1342,3,245,119,24,12,9,409,0,3,412
26,3,26049,1343,3,221,119,31,8,3,382,0,4,386
26,3,26049,1346,3,171,80,21,10,9,291,1,1,293
26,3,26049,1347,3,166,65,36,9,6,282,0,3,285
26,3,26049,1350,3,221,126,32,11,2,392,1,8,401
26,3,26049,1351,3,194,113,30,4,3,344,0,5,349
26,3,26049,1354,3,186,123,21,11,4,345,0,17,362
26,3,26049,1355,3,225,87,40,15,3,370,0,1,371
26,3,26049,1358,3,165,77,48,12,1,303,2,11,316
26,3,26049,1359,3,214,83,42,8,7,354,0,6,360
26,4,26001,1,3,475,497,37,10,2,1021,0,29,1050
26,4,26001,2,3,277,178,13,3,0,471,0,6,477
26,4,26004,38,3,256,274,17,0,0,547,0,10,557
26,4,26004,39,3,97,79,0,0,0,176,0,5,181
26,4,26007,47,3,429,291,23,7,0,750,0,12,762
26,4,26008,50,3,17,33,2,0,0,52,0,4,56
26,4,26008,51,3,148,31,2,2,0,183,0,0,183
26,4,26011,56,3,272,327,9,3,1,612,0,22,634
26,4,26012,58,3,396,267,12,5,0,680,0,14,694
26,4,26012,59,3,246,325,23,3,2,599,0,10,609
26,4,26012,62,3,95,82,11,1,0,189,0,0,189
26,4,26012,63,3,321,201,9,1,0,532,0,11,543
26,4,26017,92,3,137,137,4,4,1,283,0,15,298
26,4,26017,94,3,332,311,18,6,1,668,0,30,698
26,4,26017,95,3,30,47,6,0,0,83,0,0,83
26,4,26017,98,3,119,84,0,3,0,206,0,6,212
26,4,26017,99,3,142,166,8,3,4,323,0,13,336
26,4,26020,106,3,490,472,40,5,5,1012,0,10,1022
26,4,26021,107,3,189,269,7,4,0,469,0,19,488
26,4,26023,110,3,292,332,19,3,2,648,0,20,668
26,4,26023,111,3,144,47,1,3,0,195,0,7,202
26,4,26026,138,3,617,516,33,6,3,1175,0,13,1188
26,4,26026,139,3,211,253,15,2,3,484,0,8,492
26,4,26028,146,3,345,284,7,0,0,636,0,14,650
26,4,26028,147,3,96,190,13,1,1,301,0,1,302
26,4,26029,150,3,200,157,94,4,19,474,0,8,482
26,4,26029,151,3,285,209,185,4,37,720,0,17,737
26,4,26029,154,3,105,104,157,12,17,395,0,12,407
26,4,26029,155,3,145,153,106,7,19,430,0,14,444
26,4,26029,158,3,35,24,221,4,4,288,0,0,288
26,4,26032,233,3,304,377,18,1,4,704,0,15,719
26,4,26032,234,3,211,282,15,4,2,514,0,8,522
26,4,26032,235,3,296,478,28,5,0,807,0,22,829
26,4,26032,238,3,51,39,1,1,0,92,0,2,94
26,4,26032,239,3,49,63,1,1,0,114,0,3,117
26,4,26032,242,3,25,17,0,0,0,42,0,1,43
26,4,26032,243,3,22,62,15,0,0,99,0,6,105
26,4,26032,246,3,52,43,5,0,1,101,2,4,107
26,4,26033,247,3,185,170,4,5,2,366,0,5,371
26,4,26035,250,3,33,43,10,0,0,86,0,1,87
26,4,26035,251,3,140,105,3,0,0,248,0,5,253
26,4,26039,267,3,134,130,29,2,0,295,0,1,296
26,4,26039,270,3,114,85,60,4,1,264,1,12,277
26,4,26039,271,3,25,42,8,1,0,76,0,2,78
26,4,26041,274,3,98,173,132,1,1,405,0,7,412
26,4,26041,275,3,67,168,165,3,0,403,0,11,414
26,4,26044,286,3,147,224,23,0,0,394,0,10,404
26,4,26044,287,3,197,246,31,3,3,480,0,6,486
26,4,26045,290,3,136,133,8,0,2,279,0,5,284
26,4,26045,291,3,77,142,21,2,0,242,0,13,255
26,4,26047,329,3,475,740,81,21,2,1319,0,40,1359
26,4,26047,330,3,283,311,21,7,1,623,0,26,649
26,4,26048,331,3,216,144,9,4,1,374,0,4,378
26,4,26048,334,3,207,173,18,3,0,401,1,0,402
26,4,26048,335,3,144,68,1,2,0,215,3,3,221
26,4,26050,619,3,273,422,296,15,2,1008,0,26,1034
26,4,26051,622,3,172,47,23,1,0,243,0,3,246
26,4,26051,623,3,19,21,50,0,0,90,0,0,90
26,4,26054,649,3,211,229,9,4,0,453,0,9,462
26,4,26054,650,3,480,320,23,1,3,827,0,13,840
26,4,26054,651,3,26,29,1,0,0,56,0,2,58
26,4,26056,743,3,190,80,23,1,3,297,1,0,298
26,4,26056,746,3,583,461,236,18,6,1304,0,55,1359
26,4,26057,747,3,364,428,42,9,5,848,0,19,867
26,4,26057,750,3,342,279,32,3,1,657,0,20,677
26,4,26057,751,3,41,62,8,3,0,114,1,6,121
26,4,26057,754,3,101,142,15,8,1,267,0,14,281
26,4,26057,755,3,95,75,2,1,1,174,0,9,183
26,4,26057,758,3,8,31,3,0,0,42,0,4,46
26,4,26057,759,3,33,46,8,1,0,88,0,3,91
26,4,26058,762,3,157,297,198,14,21,687,1,33,721
26,4,26058,763,3,87,61,83,6,9,246,0,7,253
26,4,26058,766,3,232,305,304,14,30,885,0,21,906
26,4,26058,767,3,98,188,467,18,29,800,7,16,823
26,4,26058,770,3,161,101,144,1,4,411,0,10,421
26,4,26058,771,3,264,208,294,10,23,799,0,14,813
26,4,26060,992,3,88,195,194,15,7,499,0,21,520
26,4,26060,994,3,129,218,239,22,9,617,1,18,636
26,4,26060,995,3,141,222,190,13,14,580,0,7,587
26,4,26060,998,3,357,578,531,42,26,1534,4,41,1579
26,4,26060,999,3,287,382,405,22,17,1113,0,19,1132
26,4,26060,1002,3,125,191,207,7,6,536,1,12,549
26,4,26060,1003,3,126,225,201,8,7,567,1,13,581
26,4,26060,1006,3,121,254,223,6,4,608,1,25,634
26,4,26060,1007,3,160,302,210,16,7,695,0,7,702
26,4,26060,1010,3,176,295,236,10,11,728,1,4,733
26,4,26060,1011,3,155,394,143,9,7,708,0,7,715
26,4,26060,1014,3,174,298,304,17,11,804,2,20,826
26,4,26060,1015,3,231,302,369,15,7,924,5,47,976
26,4,26060,1018,3,50,108,117,4,0,279,0,12,291
26,4,26060,1019,3,49,48,91,8,0,196,0,7,203
26,4,26061,1022,3,389,550,247,15,7,1208,0,13,1221
26,4,26061,1023,3,964,1278,645,42,25,2954,0,26,2980
26,4,26061,1026,3,144,225,129,1,7,506,0,9,515
26,4,26061,1027,3,201,247,141,8,5,602,0,11,613
26,4,26061,1030,3,57,65,42,1,1,166,0,4,170
26,4,26061,1031,3,130,141,117,1,4,393,1,4,398
26,4,26061,1034,3,229,277,236,6,8,756,0,20,776
26,4,26061,1035,3,193,116,177,8,7,501,0,13,514
26,4,26061,1038,3,164,170,136,4,2,476,0,9,485
26,4,26061,1039,3,213,225,169,6,4,617,0,13,630
26,4,26061,1042,3,91,161,84,4,0,340,0,8,348
26,4,26061,1043,3,277,480,219,15,9,1000,4,16,1020
26,4,26061,1046,3,161,181,172,6,5,525,0,11,536
26,4,26061,1047,3,196,184,159,3,3,545,0,29,574
26,4,26061,1050,3,132,210,94,2,1,439,0,2,441
26,4,26061,1051,3,239,260,175,6,13,693,0,17,710
26,4,26061,1054,3,173,273,127,5,8,586,1,15,602
26,4,26061,1055,3,116,162,108,4,1,391,0,2,393
26,4,26061,1058,3,163,262,42,3,2,472,0,5,477
26,4,26061,1059,3,271,361,266,5,7,910,0,7,917
26,4,26061,1062,3,211,265,149,8,5,638,0,5,643
26,4,26061,1063,3,99,154,119,0,1,373,0,13,386
26,4,26061,1066,3,225,232,202,6,4,669,1,27,697
26,4,26061,1067,3,214,258,173,6,3,654,0,14,668
26,4,26061,1070,3,200,259,185,6,4,654,1,8,663
26,4,26061,1071,3,203,219,162,8,5,597,0,17,614
26,4,26061,1074,3,104,126,52,1,1,284,0,8,292
26,4,26061,1075,3,195,289,162,8,3,657,2,11,670
26,4,26061,1078,3,143,194,109,11,0,457,1,4,462
26,4,26061,1079,3,225,281,215,9,4,734,0,7,741
26,4,26061,1082,3,321,269,170,8,5,773,0,13,786
26,4,26061,1083,3,183,267,162,5,3,620,0,17,637
26,4,26061,1086,3,18,13,2,0,0,33,0,0,33
26,4,26061,1087,3,12,63,87,2,1,165,13,3,181
26,4,26061,1090,3,205,250,124,9,1,589,2,24,615
26,4,26061,1091,3,257,87,144,3,3,494,1,9,504
26,4,26061,1094,3,225,178,197,18,3,621,1,24,646
26,4,26061,1095,3,332,137,184,15,10,678,2,26,706
26,4,26061,1098,3,332,307,400,13,11,1063,2,21,1086
26,4,26061,1099,3,194,61,119,2,2,378,0,7,385
26,4,26072,1102,3,127,371,352,27,4,881,3,32,916
26,4,26072,1103,3,70,232,220,6,3,531,1,26,558
26,4,26072,1106,3,110,210,277,17,7,621,0,22,643
26,4,26072,1107,3,340,354,246,20,17,977,0,31,1008
26,4,26066,1306,3,88,207,183,2,2,482,0,4,486
26,4,26069,1316,3,344,254,30,6,2,636,0,16,652
26,4,26069,1318,3,108,79,9,0,0,196,0,5,201
26,4,26069,1319,3,202,226,23,8,0,459,0,29,488
26,4,26069,1322,3,54,47,4,0,0,105,0,0,105
26,5,26049,413,3,613,378,84,61,11,1147,1,5,1153
26,5,26049,414,3,454,328,73,43,4,902,2,33,937
26,5,26049,415,3,640,432,225,49,6,1352,1,35,1388
26,5,26049,418,3,560,429,42,30,9,1070,4,9,1083
26,5,26049,419,3,472,413,70,68,9,1032,0,6,1038
26,5,26049,439,3,660,518,40,26,6,1250,0,9,1259
26,5,26049,456,3,541,328,92,55,10,1026,0,15,1041
26,5,26049,458,3,275,216,51,37,10,589,0,4,593
26,5,26049,459,3,391,227,56,38,3,715,0,12,727
26,5,26049,465,3,473,260,72,38,6,849,0,17,866
26,5,26049,466,3,234,149,34,38,5,460,0,8,468
26,5,26049,467,3,259,170,39,18,2,488,0,12,500
26,5,26049,470,3,249,120,57,34,6,466,1,18,485
26,5,26049,471,3,556,376,98,54,13,1097,0,7,1104
26,5,26049,475,3,502,337,47,53,5,944,0,10,954
26,5,26049,478,3,275,157,37,26,8,503,0,12,515
26,5,26049,479,3,211,160,36,20,1,428,0,12,440
26,5,26049,482,3,290,174,48,32,6,550,0,11,561
26,5,26049,483,3,207,162,31,34,3,437,0,15,452
26,5,26049,486,3,377,296,59,29,9,770,0,23,793
26,5,26049,487,3,339,270,46,29,3,687,0,0,687
26,5,26049,490,3,285,245,70,64,1,665,0,7,672
26,5,26049,491,3,231,172,74,47,4,528,0,4,532
26,5,26049,494,3,190,150,49,84,4,477,1,0,478
26,5,26049,495,3,268,244,52,149,5,718,1,16,735
26,5,26049,498,3,396,348,105,74,5,928,0,17,945
26,5,26049,499,3,428,346,77,43,12,906,0,6,912
26,5,26049,502,3,288,279,59,30,8,664,0,6,670
26,5,26049,503,3,338,267,66,44,13,728,0,6,734
26,5,26049,506,3,464,411,32,30,5,942,1,2,945
26,5,26049,507,3,186,125,43,26,4,384,0,8,392
26,5,26049,510,3,272,236,47,36,3,594,0,22,616
26,5,26049,511,3,296,165,43,44,0,548,4,17,569
26,5,26049,514,3,387,259,107,52,10,815,2,25,842
26,5,26049,515,3,93,80,22,24,2,221,0,8,229
26,5,26049,518,3,293,239,28,29,2,591,0,5,596
26,5,26049,519,3,276,208,34,39,6,563,3,7,573
26,5,26049,522,3,384,299,60,33,10,786,0,9,795
26,5,26049,523,3,238,146,31,17,1,433,1,2,436
26,5,26049,526,3,227,185,54,25,7,498,0,3,501
26,5,26049,527,3,339,264,47,32,7,689,0,9,698
26,5,26049,530,3,182,208,32,24,0,446,0,13,459
26,5,26049,531,3,304,233,64,49,3,653,0,12,665
26,5,26049,534,3,325,158,37,21,0,541,2,10,553
26,5,26049,535,3,258,191,34,18,2,503,2,14,519
26,5,26049,538,3,392,373,112,74,16,967,0,15,982
26,5,26049,539,3,334,370,62,50,6,822,1,11,834
26,5,26049,542,3,232,221,55,22,3,533,0,7,540
26,5,26049,543,3,249,181,32,25,3,490,0,7,497
26,5,26049,546,3,241,159,30,43,2,475,0,9,484
26,5,26049,547,3,221,185,29,49,5,489,1,12,502
26,5,26049,550,3,272,187,55,27,4,545,0,4,549
26,5,26049,551,3,239,270,41,36,1,587,1,12,600
26,5,26049,554,3,353,220,55,51,8,687,1,15,703
26,5,26049,555,3,432,264,53,49,13,811,0,15,826
26,5,26049,558,3,396,297,87,54,8,842,0,15,857
26,5,26049,559,3,410,332,60,61,5,868,0,10,878
26,5,26049,562,3,354,246,38,19,1,658,0,15,673
26,5,26049,563,3,250,212,54,21,6,543,0,16,559
26,5,26049,566,3,307,204,29,27,8,575,1,15,591
26,5,26049,567,3,584,256,51,42,2,935,1,23,959
26,5,26049,570,3,339,220,142,34,5,740,1,11,752
26,5,26049,571,3,872,617,141,91,9,1730,1,26,1757
26,5,26049,574,3,252,218,52,54,10,586,0,12,598
26,5,26049,575,3,418,261,107,36,11,833,0,18,851
26,5,26049,578,3,213,204,79,25,7,528,1,5,534
26,5,26049,579,3,342,319,91,61,9,822,2,8,832
26,5,26049,582,3,408,239,62,46,4,759,3,9,771
26,5,26049,583,3,2253,1603,412,360,40,4668,4,46,4718
26,5,26049,586,3,207,288,37,18,0,550,2,24,576
26,5,26049,587,3,357,218,22,10,1,608,1,8,617
26,5,26049,592,3,750,679,71,62,10,1572,2,29,1603
26,5,26049,594,3,10,5,1,2,0,18,0,1,19
26,5,26049,595,3,525,495,113,100,10,1243,0,13,1256
26,5,26049,599,3,44,28,4,1,0,77,0,3,80
26,5,26049,602,3,255,340,94,41,2,732,0,30,762
26,5,26049,603,3,407,498,98,20,7,1030,3,49,1082
26,5,26049,606,3,88,139,14,3,3,247,0,11,258
26,5,26049,608,3,55,21,6,1,0,83,0,5,88
26,5,26049,610,3,53,41,10,2,2,108,0,4,112
26,5,26049,611,3,57,47,8,2,1,115,0,3,118
26,5,26049,614,3,55,38,14,18,0,125,0,4,129
26,5,26049,615,3,70,40,29,47,1,187,0,16,203
26,6,26059,773,3,599,242,104,10,9,964,0,9,973
26,6,26059,774,3,236,118,56,7,0,417,0,1,418
26,6,26059,775,3,226,122,17,2,2,369,0,1,370
26,6,26059,778,3,281,93,66,1,3,444,0,18,462
26,6,26059,779,3,301,130,75,8,4,518,3,18,539
26,6,26059,782,3,238,117,83,5,1,444,0,13,457
26,6,26059,783,3,342,215,94,6,8,665,1,26,692
26,6,26059,786,3,651,392,151,13,6,1213,1,18,1232
26,6,26059,787,3,299,189,113,1,7,609,0,3,612
26,6,26059,790,3,349,145,180,2,5,681,0,9,690
26,6,26059,791,3,223,94,67,2,3,389,0,14,403
26,6,26059,794,3,544,257,46,3,6,856,0,9,865
26,6,26059,795,3,685,323,120,11,9,1148,1,7,1156
26,6,26059,798,3,214,140,62,1,4,421,1,11,433
26,6,26059,799,3,232,112,74,2,4,424,0,10,434
26,6,26059,802,3,400,201,35,2,4,642,0,5,647
26,6,26059,803,3,401,195,63,4,6,669,0,9,678
26,6,26059,806,3,340,162,64,3,5,574,0,9,583
26,6,26059,807,3,1865,817,426,41,28,3177,0,8,3185
26,6,26059,810,3,583,249,46,1,7,886,1,5,892
26,6,26059,811,3,356,170,122,6,6,660,1,3,664
26,6,26059,814,3,427,214,155,2,4,802,0,21,823
26,6,26059,815,3,325,123,74,1,2,525,0,6,531
26,6,26059,818,3,181,80,27,0,7,295,0,4,299
26,6,26059,819,3,95,55,28,2,2,182,0,1,183
26,6,26059,822,3,688,318,194,9,12,1221,1,18,1240
26,6,26059,823,3,356,160,61,2,6,585,0,2,587
26,6,26059,826,3,297,105,68,4,1,475,1,7,483
26,6,26059,827,3,233,130,46,4,3,416,0,7,423
26,6,26059,830,3,486,378,159,6,8,1037,0,20,1057
26,6,26059,831,3,267,123,155,6,7,558,0,8,566
26,6,26059,834,3,143,91,61,2,3,300,0,12,312
26,6,26059,835,3,193,92,46,2,4,337,0,0,337
26,6,26059,838,3,219,135,103,5,6,468,2,16,486
26,6,26059,839,3,212,110,47,7,2,378,0,5,383
26,6,26059,842,3,493,308,161,21,6,989,1,6,996
26,6,26059,843,3,334,179,100,5,12,630,0,15,645
26,6,26059,846,3,289,174,132,6,7,608,1,9,618
26,6,26059,847,3,215,146,66,2,0,429,0,8,437
26,6,26059,850,3,209,91,52,1,2,355,0,8,363
26,6,26059,851,3,277,89,57,6,3,432,0,13,445
26,6,26059,854,3,283,125,78,5,2,493,0,5,498
26,6,26059,855,3,365,159,81,6,9,620,0,12,632
26,6,26059,858,3,310,153,100,14,3,580,0,9,589
26,6,26059,859,3,285,145,68,4,8,510,0,7,517
26,6,26059,862,3,396,197,78,2,3,676,1,6,683
26,6,26059,863,3,359,134,127,0,8,628,7,17,652
26,6,26059,866,3,310,185,120,35,3,653,3,12,668
26,6,26059,867,3,368,153,134,8,5,668,1,11,680
26,6,26059,870,3,307,167,69,1,4,548,0,4,552
26,6,26059,871,3,406,165,88,5,3,667,0,21,688
26,6,26059,874,3,232,117,70,4,0,423,1,4,428
26,6,26059,875,3,397,191,112,8,3,711,2,14,727
26,6,26059,878,3,270,124,66,3,1,464,1,8,473
26,6,26059,879,3,287,113,72,2,5,479,0,16,495
26,6,26059,882,3,440,222,70,4,6,742,2,13,757
26,6,26059,883,3,458,231,86,7,4,786,2,14,802
26,6,26059,886,3,378,131,68,5,4,586,0,10,596
26,6,26059,887,3,885,450,208,12,12,1567,3,22,1592
26,6,26059,890,3,360,182,123,3,3,671,1,5,677
26,6,26059,891,3,217,121,99,3,4,444,0,7,451
26,6,26059,894,3,337,159,66,1,3,566,0,7,573
26,6,26059,895,3,257,137,55,4,4,457,1,5,463
26,6,26059,898,3,350,182,79,5,4,620,1,7,628
26,6,26059,899,3,357,197,87,6,6,653,0,2,655
26,6,26059,902,3,285,138,54,4,5,486,1,20,507
26,6,26059,903,3,215,135,82,3,6,441,0,9,450
26,6,26059,906,3,417,189,142,13,6,767,1,25,793
26,6,26059,907,3,666,229,169,12,6,1082,1,17,1100
26,6,26059,910,3,677,269,166,11,5,1128,1,7,1136
26,6,26059,911,3,428,155,123,7,5,718,1,24,743
26,6,26059,914,3,271,124,69,0,0,464,0,16,480
26,6,26059,915,3,479,201,114,12,6,812,1,16,829
26,6,26059,918,3,177,125,89,2,3,396,0,17,413
26,6,26059,919,3,613,154,155,8,5,935,1,25,961
26,6,26059,922,3,389,188,145,11,6,739,0,11,750
26,6,26059,923,3,308,115,91,9,4,527,0,4,531
26,6,26059,926,3,300,120,83,11,8,522,0,3,525
26,6,26059,927,3,315,108,69,6,2,500,3,7,510
26,6,26059,930,3,352,215,78,6,8,659,1,17,677
26,6,26059,931,3,291,164,72,8,11,546,0,7,553
26,6,26059,934,3,132,67,28,0,1,228,0,1,229
26,6,26059,935,3,163,132,36,2,3,336,0,20,356
26,6,26059,938,3,210,111,31,6,2,360,0,9,369
26,6,26059,939,3,303,126,146,9,2,586,0,27,613
26,6,26059,942,3,266,233,122,8,3,632,0,12,644
26,6,26059,943,3,403,225,146,8,4,786,0,16,802
26,6,26059,946,3,261,170,70,3,3,507,1,15,523
26,6,26059,947,3,405,232,136,9,6,788,1,13,802
26,6,26059,950,3,269,197,91,5,1,563,0,8,571
26,6,26059,951,3,2135,991,468,37,48,3679,5,48,3732
26,6,26059,954,3,229,164,140,8,9,550,1,14,565
26,6,26059,955,3,103,112,28,0,3,246,1,2,249
26,6,26059,958,3,335,272,114,3,1,725,1,16,742
26,6,26059,959,3,318,211,74,5,9,617,0,9,626
26,6,26059,962,3,232,128,74,2,3,439,0,13,452
26,6,26059,963,3,65,49,73,0,1,188,0,1,189
26,6,26059,966,3,488,241,373,6,5,1113,1,27,1141
26,6,26059,967,3,208,127,88,2,1,426,1,6,433
26,6,26059,970,3,230,121,132,10,4,497,0,14,511
26,6,26059,971,3,359,156,206,10,2,733,1,25,759
26,6,26059,974,3,328,223,118,7,2,678,1,24,703
26,6,26059,975,3,341,222,90,5,3,661,0,22,683
26,6,26059,978,3,335,137,175,9,20,676,2,19,697
26,6,26059,979,3,271,116,88,0,6,481,0,13,494
26,6,26059,982,3,110,144,85,5,3,347,0,14,361
26,6,26059,983,3,176,163,121,11,1,472,0,24,496
26,6,26059,986,3,138,118,167,1,10,434,1,14,449
26,6,26059,987,3,144,153,180,7,2,486,0,12,498
26,6,26059,990,3,106,44,19,2,0,171,0,3,174
26,6,26059,991,3,510,215,232,9,2,968,0,34,1002
26,7,26062,1109,3,716,546,148,17,7,1434,2,29,1465
26,7,26062,1110,3,468,254,104,5,2,833,0,20,853
26,7,26062,1111,3,397,241,48,4,0,690,0,13,703
26,7,26062,1114,3,58,30,11,1,0,100,0,4,104
26,7,26062,1115,3,144,179,26,6,1,356,0,21,377
26,7,26062,1118,3,53,68,39,2,1,163,0,15,178
26,7,26062,1119,3,14,18,21,1,0,54,0,2,56
26,7,26062,1122,3,136,107,18,5,1,267,0,8,275
26,7,26062,1123,3,68,159,42,4,2,275,1,13,289
26,7,26062,1126,3,38,15,2,0,0,55,0,0,55
26,7,26062,1127,3,22,30,6,0,0,58,0,1,59
26,7,26062,1130,3,124,169,129,2,1,425,0,18,443
26,7,26062,1131,3,97,127,78,6,0,308,0,10,318
26,7,26062,1134,3,69,81,48,1,0,199,0,4,203
26,7,26062,1135,3,66,96,123,1,0,286,0,8,294
26,7,26063,1138,3,457,348,109,12,0,926,0,22,948
26,7,26063,1139,3,160,274,77,3,0,514,0,14,528
26,7,26071,1142,3,281,175,103,2,6,567,0,7,574
26,7,26063,1143,3,24,65,89,1,0,179,0,5,184
26,7,26071,1146,3,169,180,138,8,6,501,0,16,517
26,7,26071,1147,3,209,257,321,4,8,799,0,17,816
26,7,26071,1150,3,483,338,109,6,4,940,0,7,947
26,7,26071,1151,3,337,266,164,11,4,782,0,18,800
26,7,26063,1154,3,53,19,25,2,2,101,0,3,104
26,7,26071,1155,3,601,568,103,0,0,1272,1,21,1294
26,7,26063,1158,3,362,160,96,0,1,619,0,29,648
26,7,26063,1159,3,235,257,208,2,2,704,0,32,736
26,7,26063,1162,3,170,162,222,5,1,560,0,25,585
26,7,26063,1163,3,226,187,149,4,11,577,0,11,588
26,7,26063,1166,3,248,181,217,1,0,647,0,24,671
26,7,26063,1167,3,197,188,82,3,3,473,0,9,482
26,7,26063,1170,3,365,239,66,7,0,677,0,4,681
26,7,26063,1171,3,308,253,92,3,3,659,1,23,683
26,7,26063,1174,3,417,392,162,10,0,981,0,20,1001
26,7,26063,1175,3,134,108,95,2,0,339,0,10,349
26,7,26063,1178,3,148,254,173,12,3,590,0,10,600
26,7,26063,1179,3,178,108,30,3,1,320,1,10,331
26,7,26063,1182,3,330,167,87,2,1,587,0,50,637
26,7,26063,1183,3,453,261,160,11,5,890,0,28,918
26,7,26063,1186,3,218,269,112,6,1,606,0,10,616
26,7,26063,1187,3,216,260,171,8,2,657,0,18,675
26,7,26064,1190,3,451,551,273,13,5,1293,0,19,1312
26,7,26064,1191,3,181,256,159,4,2,602,0,3,605
26,7,26064,1194,3,207,328,104,7,4,650,0,12,662
26,7,26064,1195,3,565,384,354,14,6,1323,0,25,1348
26,7,26064,1198,3,262,278,107,1,3,651,0,3,654
26,7,26064,1199,3,363,463,242,7,6,1081,0,17,1098
26,7,26064,1202,3,203,249,202,7,2,663,0,7,670
26,7,26064,1203,3,490,419,319,15,8,1251,0,27,1278
26,7,26064,1206,3,289,140,153,2,2,586,2,17,605
26,7,26064,1207,3,177,263,121,1,1,563,0,21,584
26,7,26064,1210,3,195,162,225,6,2,590,0,10,600
26,7,26064,1211,3,343,323,362,5,4,1037,0,28,1065
26,7,26064,1214,3,172,156,127,0,0,455,0,16,471
26,7,26064,1215,3,304,248,421,3,3,979,0,19,998
26,7,26064,1218,3,423,383,533,22,4,1365,0,31,1396
26,7,26064,1219,3,171,164,204,8,4,551,0,3,554
26,7,26064,1222,3,268,136,129,6,5,544,0,23,567
26,7,26064,1223,3,81,184,78,2,4,349,0,7,356
26,7,26064,1226,3,176,129,323,6,3,637,0,17,654
26,7,26064,1227,3,50,74,95,2,0,221,0,1,222
26,7,26065,1230,3,271,381,149,10,5,816,1,26,843
26,7,26065,1231,3,168,259,76,10,4,517,1,9,527
26,7,26065,1234,3,333,348,151,6,3,841,0,4,845
26,7,26065,1235,3,157,328,107,2,3,597,0,9,606
26,7,26065,1238,3,143,169,141,11,8,472,0,11,483
26,7,26065,1239,3,162,410,323,10,7,912,1,31,944
26,7,26065,1242,3,82,159,91,5,1,338,0,5,343
26,7,26065,1243,3,262,357,189,12,4,824,0,25,849
26,7,26065,1246,3,250,391,130,10,7,788,1,10,799
26,7,26065,1247,3,312,416,151,7,14,900,3,8,911
26,7,26065,1250,3,141,242,117,11,4,515,0,9,524
26,7,26065,1251,3,318,701,296,24,16,1355,0,21,1376
26,7,26065,1254,3,242,450,191,11,6,900,0,15,915
26,7,26065,1255,3,186,320,121,0,1,628,1,9,638
26,7,26065,1258,3,153,360,184,9,6,712,1,17,730
26,7,26065,1259,3,245,373,231,16,6,871,2,11,884
26,7,26065,1262,3,143,312,140,10,7,612,0,6,618
26,7,26065,1263,3,307,547,325,16,3,1198,1,27,1226
26,7,26065,1266,3,139,278,158,15,7,597,0,19,616
26,7,26065,1267,3,352,481,297,16,7,1153,1,32,1186
26,7,26065,1270,3,203,201,164,6,7,581,1,20,602
26,7,26065,1271,3,369,426,315,1,2,1113,0,28,1141
26,7,26065,1274,3,27,99,54,5,0,185,0,6,191
26,7,26065,1275,3,159,145,95,2,2,403,1,16,420
26,7,26065,1278,3,174,259,296,8,3,740,0,39,779
26,7,26065,1279,3,147,264,149,5,3,568,0,24,592
26,7,26065,1282,3,106,152,181,8,5,452,0,15,467
26,7,26065,1283,3,106,211,148,2,5,472,0,19,491
26,7,26065,1286,3,287,295,196,12,1,791,0,48,839
26,7,26065,1287,3,190,202,191,5,1,589,0,14,603
26,7,26065,1290,3,143,397,201,11,4,756,1,22,779
26,7,26065,1291,3,357,598,295,22,15,1287,0,32,1319
26,7,26065,1294,3,116,282,183,4,5,590,0,19,609
26,7,26065,1295,3,55,244,209,2,2,512,0,12,524
26,7,26065,1298,3,144,199,189,0,0,532,1,13,546
26,7,26065,1299,3,69,106,67,3,0,245,0,6,251
26,7,26065,1302,3,86,201,124,4,0,415,1,14,430
26,7,26065,1303,3,460,505,376,21,19,1381,2,29,1412
26,7,26067,1307,3,496,376,36,5,2,915,1,15,931
26,7,26068,1310,3,209,401,65,7,1,683,0,17,700
26,7,26068,1311,3,252,571,64,2,1,890,0,51,941
26,7,26068,1314,3,149,249,53,6,2,459,0,23,482
26,7,26068,1315,3,34,129,21,3,0,187,0,8,195
26,7,26071,1331,3,113,118,117,3,2,353,0,0,353
27,1,27001,1,3,56,638,416,26,4,1140,1,22,1163
27,1,27001,2,3,65,458,295,31,5,854,3,31,888
27,1,27001,3,3,59,382,321,24,3,789,0,9,798
27,1,27001,6,3,84,234,205,11,5,539,0,11,550
27,1,27001,7,3,62,392,295,19,9,777,0,12,789
27,1,27001,10,3,6,58,33,0,1,98,0,6,104
27,1,27001,11,3,18,134,104,2,0,258,0,5,263
27,1,27001,14,3,36,193,156,13,2,400,0,10,410
27,1,27001,15,3,27,241,194,20,3,485,1,4,490
27,1,27001,18,3,25,285,194,5,3,512,3,16,531
27,1,27001,19,3,13,75,31,1,1,121,0,2,123
27,1,27001,22,3,14,294,150,7,2,467,0,19,486
27,1,27001,23,3,30,232,241,4,1,508,0,17,525
27,1,27001,26,3,3,21,9,1,0,34,0,2,36
27,1,27001,27,3,9,196,151,13,1,370,0,0,370
27,1,27001,30,3,29,316,192,0,1,538,0,19,557
27,1,27001,31,3,7,73,31,2,0,113,0,5,118
27,1,27001,34,3,10,137,62,3,0,212,0,4,216
27,1,27001,35,3,19,435,386,5,0,845,0,2,847
27,1,27001,38,3,10,195,240,3,4,452,0,8,460
27,1,27001,39,3,16,196,204,6,0,422,0,7,429
27,1,27001,42,3,41,311,407,5,6,770,1,28,799
27,1,27001,43,3,25,284,218,9,3,539,2,13,554
27,1,27007,668,3,46,513,479,13,0,1051,0,16,1067
27,1,27007,670,3,51,283,323,0,1,658,0,2,660
27,1,27007,671,3,45,325,380,11,4,765,0,4,769
27,1,27007,674,3,68,574,552,15,6,1215,0,31,1246
27,1,27007,675,3,39,223,323,11,2,598,2,7,607
27,1,27007,678,3,90,820,610,11,5,1536,3,34,1573
27,1,27007,679,3,8,271,216,3,2,500,0,8,508
27,1,27007,682,3,15,136,319,2,1,473,0,11,484
27,1,27007,683,3,30,356,243,7,5,641,0,17,658
27,1,27011,846,3,17,511,393,7,2,930,0,16,946
27,1,27011,847,3,21,408,473,10,9,921,0,18,939
27,1,27011,850,3,14,135,128,0,1,278,0,5,283
27,1,27011,851,3,5,231,282,0,2,520,0,4,524
27,1,27011,854,3,3,53,57,0,0,113,0,0,113
27,1,27011,855,3,0,92,133,1,0,226,0,0,226
27,1,27011,858,3,9,275,347,2,1,634,0,26,660
27,1,27011,859,3,2,253,407,0,1,663,0,26,689
27,1,27011,862,3,1,187,261,0,0,449,0,8,457
27,1,27011,863,3,6,469,379,0,3,857,0,9,866
27,1,27011,866,3,0,126,230,0,0,356,0,15,371
27,1,27011,867,3,5,148,168,2,0,323,0,0,323
27,1,27011,870,3,9,361,356,1,3,730,0,2,732
27,1,27011,871,3,7,309,249,2,1,568,0,5,573
27,1,27012,874,3,85,500,727,36,16,1364,0,26,1390
27,1,27012,875,3,33,344,503,25,14,919,0,18,937
27,1,27012,878,3,52,516,589,43,26,1226,0,15,1241
27,1,27012,879,3,54,526,721,32,15,1348,1,34,1383
27,1,27012,882,3,38,445,487,18,12,1000,0,11,1011
27,1,27012,883,3,31,347,444,25,12,859,0,17,876
27,1,27012,886,3,18,257,375,1,2,653,0,21,674
27,1,27012,887,3,3,65,184,1,0,253,0,5,258
27,1,27012,890,3,44,475,602,10,5,1136,0,43,1179
27,1,27012,891,3,3,162,159,3,0,327,1,10,338
27,1,27012,894,3,5,80,129,2,0,216,0,5,221
27,1,27012,895,3,46,267,557,48,13,931,0,18,949
27,1,27012,898,3,50,225,418,65,5,763,2,3,768
27,1,27012,899,3,39,145,186,26,8,404,0,3,407
27,1,27012,902,3,22,139,524,21,1,707,1,15,723
27,1,27012,903,3,30,234,840,21,6,1131,1,16,1148
27,1,27012,906,3,10,144,323,6,1,484,0,4,488
27,1,27012,907,3,16,107,394,10,5,532,0,20,552
27,1,27012,910,3,13,183,669,15,2,882,0,5,887
27,1,27012,911,3,24,187,907,13,2,1133,0,5,1138
27,1,27012,914,3,21,183,773,21,5,1003,0,12,1015
27,1,27012,915,3,12,323,728,21,13,1097,1,37,1135
27,1,27012,918,3,14,174,803,10,4,1005,0,4,1009
27,1,27012,919,3,9,182,632,2,1,826,0,17,843
27,1,27012,922,3,16,486,596,9,3,1110,1,22,1133
27,1,27012,923,3,26,344,642,11,9,1032,0,36,1068
27,1,27012,926,3,1,67,90,1,1,160,0,1,161
27,1,27012,927,3,20,194,229,2,2,447,1,14,462
27,1,27012,930,3,18,247,568,9,3,845,0,10,855
27,1,27012,931,3,16,273,650,16,5,960,0,5,965
27,1,27012,934,3,53,573,892,27,2,1547,2,33,1582
27,1,27012,935,3,25,416,389,22,6,858,0,26,884
27,1,27012,938,3,37,339,697,9,4,1086,0,28,1114
27,1,27012,939,3,37,506,467,21,4,1035,0,16,1051
27,1,27012,942,3,18,324,351,8,6,707,1,23,731
27,1,27012,943,3,16,341,560,4,7,928,1,28,957
27,1,27012,946,3,12,472,219,3,1,707,2,37,746
27,1,27012,947,3,34,411,378,10,2,835,1,28,864
27,1,27012,950,3,11,259,318,2,0,590,1,12,603
27,1,27012,951,3,21,247,189,2,3,462,0,7,469
27,1,27017,1089,3,17,235,131,4,0,387,0,8,395
27,1,27017,1090,3,63,342,394,12,5,816,2,11,829
27,1,27017,1091,3,19,222,203,12,3,459,1,7,467
27,1,27017,1094,3,36,291,251,7,3,588,0,5,593
27,1,27017,1095,3,24,182,168,0,3,377,0,7,384
27,1,27017,1098,3,23,302,258,6,4,593,0,23,616
27,1,27017,1099,3,71,386,427,16,0,900,0,8,908
27,1,27017,1102,3,40,291,336,8,6,681,0,6,687
27,1,27017,1103,3,20,239,241,8,2,510,0,13,523
27,1,27017,1106,3,23,172,194,9,3,401,0,8,409
27,1,27017,1107,3,26,172,229,7,2,436,0,5,441
27,1,27017,1110,3,9,84,62,2,1,158,0,3,161
27,1,27017,1111,3,22,173,141,3,3,342,0,19,361
27,1,27017,1114,3,28,304,267,1,3,603,0,13,616
27,1,27017,1115,3,12,258,176,8,4,458,3,13,474
27,1,27017,1118,3,26,287,223,8,2,546,0,21,567
27,1,27017,1119,3,4,342,196,5,1,548,1,20,569
27,1,27017,1122,3,14,172,236,6,5,433,2,5,440
27,1,27017,1123,3,20,236,130,4,0,390,4,7,401
27,1,27017,1126,3,5,143,183,3,1,335,0,16,351
27,1,27017,1127,3,30,214,200,7,1,452,0,11,463
27,1,27017,1130,3,34,313,272,2,1,622,0,11,633
27,1,27017,1131,3,35,186,140,0,0,361,0,13,374
27,2,27002,46,3,42,227,470,14,10,763,1,18,782
27,2,27002,47,3,106,509,1385,36,17,2053,3,24,2080
27,2,27002,50,3,63,202,582,20,5,872,0,15,887
27,2,27002,51,3,30,220,477,21,12,760,3,15,778
27,2,27002,54,3,39,190,454,22,8,713,2,6,721
27,2,27002,57,3,25,112,267,10,2,416,0,14,430
27,2,27002,58,3,31,210,338,16,5,600,0,1,601
27,2,27002,59,3,27,196,363,15,7,608,1,11,620
27,2,27002,66,3,51,212,245,11,6,525,0,6,531
27,2,27002,67,3,64,181,213,7,4,469,0,9,478
27,2,27002,70,3,49,260,510,24,10,853,1,11,865
27,2,27002,71,3,162,399,892,29,5,1487,0,15,1502
27,2,27002,90,3,16,268,448,3,1,736,3,9,748
27,2,27002,91,3,23,199,410,13,0,645,0,11,656
27,2,27002,94,3,21,297,291,19,3,631,0,13,644
27,2,27002,95,3,51,324,429,4,6,814,1,15,830
27,2,27002,98,3,38,236,455,8,3,740,0,16,756
27,2,27002,99,3,34,197,445,5,0,681,0,18,699
27,2,27002,102,3,8,113,359,8,0,488,0,11,499
27,2,27002,103,3,27,268,342,4,2,643,3,23,669
27,2,27002,106,3,19,224,301,2,1,547,0,9,556
27,2,27002,107,3,23,190,460,15,1,689,0,21,710
27,2,27002,110,3,76,363,631,7,3,1080,8,22,1110
27,2,27002,111,3,7,134,237,2,0,380,0,4,384
27,2,27002,114,3,19,212,391,14,3,639,1,8,648
27,2,27002,115,3,12,142,312,9,2,477,1,7,485
27,2,27002,118,3,5,213,270,6,1,495,0,14,509
27,2,27002,119,3,9,292,318,0,1,620,0,18,638
27,2,27002,122,3,14,370,666,0,3,1053,2,10,1065
27,2,27002,123,3,10,141,466,1,0,618,0,13,631
27,2,27002,126,3,19,218,234,1,0,472,0,8,480
27,2,27002,127,3,23,207,350,6,4,590,4,9,603
27,2,27002,130,3,21,350,531,9,2,913,1,23,937
27,2,27002,131,3,22,231,454,3,0,710,0,6,716
27,2,27002,134,3,58,522,273,7,3,863,2,18,883
27,2,27002,135,3,5,81,154,2,0,242,1,2,245
27,2,27002,138,3,17,234,532,19,4,806,4,14,824
27,2,27002,139,3,22,262,488,10,1,783,1,19,803
27,2,27002,142,3,10,122,374,7,2,515,0,13,528
27,2,27002,143,3,39,297,509,12,5,862,0,12,874
27,2,27002,146,3,17,326,644,10,8,1005,3,15,1023
27,2,27002,147,3,38,288,466,10,2,804,1,19,824
27,2,27002,151,3,26,144,531,8,6,715,4,23,742
27,2,27002,154,3,24,297,594,8,7,930,0,22,952
27,2,27002,155,3,70,469,628,42,5,1214,5,24,1243
27,2,27002,158,3,24,142,429,13,6,614,0,5,619
27,2,27002,159,3,14,95,442,1,1,553,1,46,600
27,2,27002,163,3,18,352,642,17,2,1031,0,6,1037
27,2,27002,167,3,17,124,215,9,1,366,0,10,376
27,2,27008,684,3,24,333,449,20,2,828,0,14,842
27,2,27008,686,3,33,422,348,11,3,817,2,12,831
27,2,27008,687,3,40,434,423,14,7,918,3,7,928
27,2,27008,690,3,20,223,223,15,1,482,0,6,488
27,2,27008,691,3,18,206,232,10,2,468,1,4,473
27,2,27008,694,3,43,726,820,28,14,1631,4,17,1652
27,2,27008,695,3,30,319,456,13,5,823,0,5,828
27,2,27008,698,3,14,223,330,4,6,577,2,9,588
27,2,27008,699,3,43,403,588,15,8,1057,3,34,1094
27,2,27008,702,3,25,225,267,11,3,531,0,6,537
27,2,27008,703,3,29,343,578,15,7,972,1,23,996
27,2,27008,706,3,27,514,515,11,2,1069,2,13,1084
27,2,27008,707,3,45,413,621,10,20,1109,0,18,1127
27,2,27008,710,3,26,249,392,4,3,674,0,8,682
27,2,27008,711,3,21,268,381,1,2,673,0,21,694
27,2,27008,714,3,20,381,550,12,3,966,1,23,990
27,2,27008,715,3,0,75,27,0,0,102,1,1,104
27,2,27008,718,3,36,334,401,6,2,779,3,11,793
27,2,27008,719,3,31,343,386,7,3,770,3,8,781
27,2,27008,722,3,30,451,532,38,3,1054,0,18,1072
27,2,27008,723,3,33,448,504,2,4,991,2,20,1013
27,2,27008,726,3,31,210,378,16,7,642,4,13,659
27,2,27008,727,3,71,627,532,16,2,1248,6,9,1263
27,2,27008,730,3,11,271,407,3,3,695,1,13,709
27,2,27008,731,3,15,304,541,9,2,871,0,7,878
27,2,27008,734,3,10,84,62,5,0,161,0,0,161
27,2,27008,735,3,7,337,282,2,3,631,1,11,643
27,2,27008,738,3,52,537,424,8,4,1025,1,31,1057
27,2,27008,739,3,17,178,86,2,0,283,0,6,289
27,2,27008,742,3,14,368,357,6,1,746,0,23,769
27,2,27008,743,3,33,436,477,7,6,959,3,37,999
27,2,27008,746,3,19,429,230,5,1,684,2,23,709
27,2,27008,747,3,30,382,483,10,2,907,1,26,934
27,2,27008,750,3,3,173,136,4,0,316,0,9,325
27,2,27008,751,3,9,75,110,3,2,199,1,7,207
27,2,27008,754,3,15,189,141,2,1,348,0,7,355
27,2,27008,755,3,13,56,111,1,1,182,1,0,183
27,2,27008,758,3,20,190,15,2,3,230,1,11,242
27,2,27008,759,3,14,268,279,2,3,566,0,29,595
27,2,27008,762,3,12,95,74,0,0,181,0,0,181
27,2,27008,763,3,20,162,256,7,3,448,3,7,458
27,2,27008,766,3,40,190,261,7,11,509,1,10,520
27,2,27008,767,3,28,239,259,10,5,541,2,8,551
27,2,27008,770,3,16,222,332,5,4,579,0,13,592
27,2,27008,771,3,13,186,206,0,0,405,0,18,423
27,2,27008,774,3,12,243,161,0,0,416,2,10,428
27,2,27008,775,3,8,120,72,1,0,201,1,9,211
27,2,27008,778,3,13,262,68,0,0,343,0,14,357
27,2,27008,779,3,10,281,111,1,2,405,0,15,420
27,3,27002,49,3,15,139,329,19,5,507,1,12,520
27,3,27002,55,3,59,248,733,29,13,1082,1,20,1103
27,3,27002,62,3,26,177,359,19,6,587,0,11,598
27,3,27002,63,3,54,250,756,46,14,1120,2,8,1130
27,3,27002,74,3,32,261,290,23,4,610,0,8,618
27,3,27002,75,3,43,261,558,13,17,892,0,10,902
27,3,27002,78,3,32,259,441,18,11,761,0,12,773
27,3,27002,79,3,35,230,441,18,12,736,1,6,743
27,3,27002,82,3,36,196,460,17,5,714,1,5,720
27,3,27002,83,3,31,270,508,31,8,848,0,14,862
27,3,27002,86,3,95,565,1108,38,17,1823,2,14,1839
27,3,27002,87,3,31,241,705,28,6,1011,0,20,1031
27,3,27002,150,3,15,131,345,6,1,498,0,21,519
27,3,27002,160,3,22,215,572,7,3,819,0,24,843
27,3,27002,162,3,33,244,644,13,11,945,3,11,959
27,3,27002,164,3,11,234,432,10,2,689,1,21,711
27,3,27002,166,3,14,190,510,12,9,735,0,22,757
27,3,27005,512,3,108,331,401,18,8,866,0,9,875
27,3,27005,514,3,42,180,197,4,2,425,0,7,432
27,3,27005,515,3,56,388,479,16,10,949,2,5,956
27,3,27005,518,3,33,166,185,7,4,395,0,10,405
27,3,27005,519,3,45,272,299,15,2,633,0,6,639
27,3,27005,522,3,67,182,247,15,7,518,0,5,523
27,3,27005,523,3,84,356,462,14,5,921,1,7,929
27,3,27005,526,3,50,219,294,11,5,579,0,2,581
27,3,27005,527,3,44,238,301,12,1,596,0,7,603
27,3,27005,530,3,60,273,275,12,8,628,0,6,634
27,3,27005,531,3,58,255,332,6,8,659,4,4,667
27,3,27005,534,3,37,252,406,12,3,710,1,3,714
27,3,27005,535,3,46,314,366,12,2,740,0,16,756
27,3,27005,538,3,20,468,794,4,1,1287,0,18,1305
27,3,27005,539,3,8,256,210,3,1,478,0,10,488
27,3,27005,542,3,26,403,358,5,4,796,2,35,833
27,3,27005,543,3,11,239,448,3,3,704,0,12,716
27,3,27005,546,3,31,219,417,5,3,675,0,18,693
27,3,27005,547,3,13,184,331,5,4,537,0,9,546
27,3,27005,550,3,23,422,480,9,4,938,1,19,958
27,3,27005,551,3,22,275,539,1,3,840,6,24,870
27,3,27005,554,3,26,333,529,6,1,895,0,20,915
27,3,27005,555,3,63,781,1125,19,6,1994,2,39,2035
27,3,27005,558,3,19,346,495,5,0,865,1,15,881
27,3,27005,559,3,31,325,538,7,2,903,0,19,922
27,3,27005,562,3,36,205,585,15,1,842,0,7,849
27,3,27005,563,3,35,266,546,12,1,860,0,13,873
27,3,27005,566,3,9,224,390,7,1,631,1,10,642
27,3,27005,567,3,12,218,446,14,4,694,0,8,702
27,3,27005,570,3,18,594,623,5,3,1243,0,46,1289
27,3,27005,571,3,18,299,562,7,4,890,9,19,918
27,3,27005,574,3,51,306,614,15,4,990,2,17,1009
27,3,27005,575,3,36,381,710,5,2,1134,0,24,1158
27,3,27005,578,3,33,333,412,9,2,789,1,16,806
27,3,27005,579,3,43,194,300,3,0,540,1,3,544
27,3,27005,582,3,29,319,380,11,2,741,2,28,771
27,3,27005,583,3,38,382,454,3,3,880,0,26,906
27,3,27005,586,3,21,348,477,12,3,861,0,20,881
27,3,27005,587,3,32,508,720,47,4,1311,3,36,1350
27,3,27005,590,3,47,496,786,9,7,1345,2,34,1381
27,3,27005,591,3,31,339,644,3,1,1018,0,15,1033
27,3,27005,594,3,20,264,560,5,1,850,0,14,864
27,3,27005,595,3,20,293,399,4,2,718,0,5,723
27,3,27005,598,3,30,399,568,7,0,1004,1,12,1017
27,3,27005,599,3,12,201,239,1,1,454,2,9,465
27,3,27005,602,3,8,370,535,5,1,919,2,8,929
27,3,27005,603,3,18,315,437,0,1,771,1,21,793
27,3,27005,606,3,47,418,621,9,0,1095,3,24,1122
27,3,27005,607,3,15,382,583,4,1,985,2,8,995
27,3,27006,610,3,33,383,445,66,14,941,0,13,954
27,3,27006,611,3,30,431,466,49,4,980,0,20,1000
27,3,27006,614,3,41,386,553,30,18,1028,2,26,1056
27,3,27006,615,3,40,365,373,77,8,863,0,14,877
27,3,27006,618,3,9,346,501,4,4,864,1,24,889
27,3,27006,619,3,6,297,310,6,0,619,2,11,632
27,3,27006,622,3,12,140,285,4,0,441,0,16,457
27,3,27006,623,3,296,140,164,5,8,613,0,42,655
27,3,27006,626,3,14,180,398,9,1,602,2,8,612
27,3,27006,627,3,5,321,163,2,1,492,2,3,497
27,3,27006,630,3,79,194,396,24,1,694,1,28,723
27,3,27006,631,3,60,199,526,19,5,809,1,21,831
27,3,27006,634,3,37,306,475,9,5,832,0,11,843
27,3,27006,635,3,30,394,498,10,3,935,1,26,962
27,3,27006,638,3,22,315,510,18,1,866,2,22,890
27,3,27006,639,3,100,239,473,7,4,823,4,4,831
27,3,27006,642,3,17,514,658,18,1,1208,3,45,1256
27,3,27006,643,3,46,192,357,40,4,639,1,14,654
27,3,27006,646,3,19,220,262,73,3,577,1,31,609
27,3,27006,647,3,46,259,453,52,10,820,0,26,846
27,3,27006,650,3,11,313,347,4,3,678,1,8,687
27,3,27006,651,3,13,263,533,15,2,826,2,4,832
27,3,27006,654,3,64,384,590,44,4,1086,2,26,1114
27,3,27006,655,3,6,161,384,17,4,572,4,12,588
27,3,27006,658,3,28,276,460,23,0,787,1,13,801
27,3,27006,659,3,19,429,472,18,7,945,1,25,971
27,3,27006,662,3,12,226,399,5,3,645,0,17,662
27,3,27006,663,3,43,871,762,16,8,1700,4,23,1727
27,3,27006,666,3,9,251,390,7,1,658,0,20,678
27,3,27006,667,3,9,256,286,3,1,555,0,13,568
27,4,27004,232,3,356,1632,2565,124,43,4720,6,70,4796
27,4,27004,234,3,100,876,1157,36,10,2179,2,45,2226
27,4,27004,235,3,41,293,304,26,8,672,1,8,681
27,4,27004,238,3,49,468,574,21,7,1119,0,15,1134
27,4,27004,239,3,35,252,258,9,3,557,1,7,565
27,4,27004,242,3,100,729,863,30,13,1735,1,28,1764
27,4,27004,243,3,44,344,463,20,9,880,0,9,889
27,4,27004,246,3,46,352,356,19,3,776,0,20,796
27,4,27004,247,3,27,291,286,13,2,619,0,3,622
27,4,27004,250,3,129,442,467,25,7,1070,0,7,1077
27,4,27004,251,3,178,621,821,18,11,1649,1,25,1675
27,4,27004,254,3,55,548,600,25,9,1237,0,17,1254
27,4,27004,255,3,106,363,441,16,12,938,0,9,947
27,4,27004,258,3,58,250,265,13,12,598,1,7,606
27,4,27004,259,3,139,342,325,16,10,832,0,7,839
27,4,27004,262,3,61,417,375,18,13,884,3,7,894
27,4,27004,263,3,71,176,145,6,1,399,0,3,402
27,4,27004,266,3,44,173,215,8,2,442,1,0,443
27,4,27004,267,3,185,651,595,39,18,1488,1,11,1500
27,4,27004,270,3,42,367,437,15,4,865,3,10,878
27,4,27004,271,3,18,204,280,5,2,509,0,3,512
27,4,27004,274,3,58,368,444,28,12,910,3,16,929
27,4,27004,275,3,176,443,462,26,9,1116,0,7,1123
27,4,27004,278,3,112,275,316,7,6,716,1,5,722
27,4,27004,279,3,74,180,201,17,3,475,1,5,481
27,4,27004,282,3,27,316,356,24,6,729,2,15,746
27,4,27004,283,3,26,320,447,14,6,813,3,3,819
27,4,27004,286,3,57,279,364,20,10,730,0,11,741
27,4,27004,287,3,40,277,287,14,2,620,0,7,627
27,4,27004,290,3,42,370,491,29,6,938,0,21,959
27,4,27004,291,3,44,451,458,31,3,987,1,9,997
27,4,27004,294,3,36,295,313,13,5,662,1,9,672
27,4,27004,295,3,31,222,242,19,5,519,0,9,528
27,4,27004,298,3,18,120,135,7,0,280,0,4,284
27,4,27004,299,3,43,389,373,14,5,824,0,13,837
27,4,27004,302,3,43,248,358,15,7,671,2,16,689
27,4,27004,303,3,24,330,403,29,4,790,0,13,803
27,4,27004,306,3,50,302,326,20,8,706,0,8,714
27,4,27004,307,3,51,391,359,22,7,830,2,6,838
27,4,27004,310,3,45,274,340,27,5,691,0,4,695
27,4,27004,311,3,30,270,285,10,4,599,0,15,614
27,4,27004,315,3,64,358,499,14,7,942,9,19,970
27,4,27004,318,3,27,143,192,3,4,369,0,1,370
27,4,27004,319,3,39,278,314,25,5,661,1,6,668
27,4,27004,322,3,36,220,211,8,4,479,0,9,488
27,4,27004,323,3,39,378,340,15,3,775,2,11,788
27,4,27004,326,3,72,259,267,11,6,615,0,1,616
27,4,27004,327,3,27,322,368,19,6,742,1,8,751
27,4,27004,330,3,29,338,333,17,4,721,0,14,735
27,4,27004,331,3,35,237,239,13,4,528,1,10,539
27,4,27004,334,3,22,394,441,18,2,877,1,9,887
27,4,27004,335,3,50,302,292,16,7,667,0,5,672
27,4,27004,338,3,48,310,329,22,5,714,0,4,718
27,4,27004,339,3,28,183,163,8,6,388,0,5,393
27,4,27004,353,3,29,326,370,17,10,752,1,9,762
27,4,27004,354,3,73,372,337,15,5,802,0,3,805
27,4,27004,355,3,19,330,334,15,4,702,1,4,707
27,4,27004,358,3,35,423,499,22,7,986,1,16,1003
27,4,27004,359,3,40,435,503,11,8,997,2,13,1012
27,4,27004,362,3,34,364,421,23,4,846,1,12,859
27,4,27004,363,3,90,325,400,10,12,837,0,7,844
27,4,27004,379,3,31,340,403,16,5,795,0,11,806
27,4,27004,382,3,47,476,561,42,15,1141,1,21,1163
27,4,27004,383,3,66,524,638,34,9,1271,3,21,1295
27,4,27004,386,3,31,273,381,12,4,701,1,7,709
27,4,27004,387,3,26,417,317,16,8,784,0,11,795
27,4,27004,403,3,46,417,354,26,7,850,0,5,855
27,4,27004,419,3,4,98,216,0,1,319,0,5,324
27,4,27004,422,3,21,238,1444,19,2,1724,0,47,1771
27,4,27004,423,3,28,256,1428,27,5,1744,1,21,1766
27,4,27004,426,3,10,146,1020,18,1,1195,0,18,1213
27,4,27004,427,3,28,451,564,18,0,1061,0,5,1066
27,4,27004,430,3,10,298,689,10,4,1011,0,5,1016
27,4,27004,431,3,21,372,639,12,1,1045,0,19,1064
27,4,27004,434,3,42,341,434,16,7,840,1,9,850
27,4,27004,435,3,125,1012,1517,40,11,2705,1,34,2740
27,4,27004,438,3,12,321,726,24,4,1087,0,27,1114
27,4,27004,439,3,13,209,279,3,1,505,1,12,518
27,4,27004,442,3,6,105,221,0,2,334,0,8,342
27,4,27004,443,3,49,584,747,31,7,1418,5,22,1445
27,4,27004,446,3,69,645,926,29,9,1678,2,40,1720
27,4,27004,447,3,8,216,327,4,4,559,1,6,566
27,4,27004,450,3,53,569,568,13,13,1216,1,85,1302
27,4,27004,451,3,12,217,273,3,1,506,2,51,559
27,4,27004,454,3,10,203,302,3,0,518,3,15,536
27,4,27004,455,3,13,271,178,1,2,465,1,10,476
27,4,27004,466,3,23,405,300,5,2,735,1,15,751
27,4,27004,471,3,20,175,231,7,3,436,0,8,444
27,4,27004,474,3,46,805,899,50,11,1811,4,34,1849
27,4,27004,478,3,17,296,252,6,0,571,1,55,627
27,4,27004,489,3,28,426,268,3,0,725,1,0,726
27,4,27004,493,3,11,328,180,7,1,527,3,18,548
27,4,27004,511,3,10,56,53,4,2,125,0,3,128
27,5,27003,168,3,80,275,214,18,4,591,1,15,607
27,5,27003,170,3,67,282,214,22,4,589,1,14,604
27,5,27003,171,3,91,337,268,26,8,730,1,14,745
27,5,27003,174,3,127,212,119,20,4,482,0,12,494
27,5,27003,175,3,87,295,162,15,10,569,1,7,577
27,5,27003,178,3,84,246,168,17,8,523,6,8,537
27,5,27003,179,3,61,516,289,26,7,899,1,29,929
27,5,27003,182,3,6,176,119,5,0,306,0,6,312
27,5,27003,183,3,12,240,169,6,1,428,3,7,438
27,5,27003,186,3,9,171,171,18,1,370,0,21,391
27,5,27003,187,3,8,92,60,4,1,165,0,5,170
27,5,27003,190,3,15,270,179,11,5,480,0,17,497
27,5,27003,191,3,7,168,100,2,2,279,0,2,281
27,5,27003,194,3,11,143,141,1,1,297,0,15,312
27,5,27003,195,3,5,182,144,3,0,334,0,14,348
27,5,27003,198,3,10,310,319,16,2,657,1,18,676
27,5,27003,199,3,7,203,120,65,4,399,1,12,412
27,5,27003,202,3,15,292,571,15,4,897,0,11,908
27,5,27003,203,3,23,439,486,60,0,1008,0,26,1034
27,5,27003,206,3,29,385,366,103,0,883,1,28,912
27,5,27003,207,3,8,451,334,241,0,1034,1,33,1068
27,5,27003,210,3,17,411,573,49,6,1056,1,38,1095
27,5,27003,211,3,29,474,387,61,7,958,0,22,980
27,5,27003,214,3,14,429,365,24,1,833,0,28,861
27,5,27003,215,3,1,41,64,2,0,108,0,2,110
27,5,27003,218,3,5,99,57,0,0,161,0,0,161
27,5,27003,219,3,3,85,81,0,0,169,0,0,169
27,5,27003,222,3,6,497,360,16,3,882,0,21,903
27,5,27003,223,3,29,442,663,33,6,1173,1,23,1197
27,5,27003,226,3,2,97,108,7,1,215,0,3,218
27,5,27003,227,3,6,293,362,22,2,685,1,16,702
27,5,27003,230,3,1,29,67,13,0,110,0,3,113
27,5,27003,231,3,0,96,121,6,0,223,0,2,225
27,5,27010,809,3,21,283,495,17,3,819,0,11,830
27,5,27010,810,3,34,615,912,26,8,1595,3,37,1635
27,5,27010,811,3,11,454,528,50,6,1049,2,22,1073
27,5,27010,814,3,30,298,424,16,2,770,0,15,785
27,5,27010,815,3,34,325,590,27,11,987,1,17,1005
27,5,27010,818,3,2,194,301,1,2,500,0,6,506
27,5,27010,819,3,5,219,344,3,3,574,4,6,584
27,5,27010,822,3,14,470,548,9,4,1045,1,8,1054
27,5,27010,823,3,84,522,829,18,4,1457,2,16,1475
27,5,27010,826,3,27,462,656,10,2,1157,1,16,1174
27,5,27010,827,3,24,492,938,14,7,1475,3,18,1496
27,5,27010,830,3,8,89,212,2,3,314,0,10,324
27,5,27010,831,3,21,306,388,16,3,734,0,3,737
27,5,27010,834,3,195,279,488,4,7,973,1,25,999
27,5,27010,835,3,14,256,274,3,1,548,0,9,557
27,5,27010,838,3,40,458,769,13,1,1281,0,17,1298
27,5,27010,839,3,17,514,629,15,3,1178,1,10,1189
27,5,27010,842,3,44,477,728,9,6,1264,3,8,1275
27,5,27010,843,3,9,327,333,2,2,673,0,27,700
27,5,27013,954,3,24,367,258,23,6,678,2,10,690
27,5,27013,955,3,28,471,453,25,4,981,0,23,1004
27,5,27013,958,3,31,664,423,27,6,1151,2,28,1181
27,5,27013,959,3,28,421,498,20,9,976,2,20,998
27,5,27013,962,3,27,482,941,18,8,1476,1,11,1488
27,5,27013,963,3,11,390,845,3,3,1252,1,28,1281
27,5,27013,966,3,8,81,351,5,3,448,0,17,465
27,5,27013,967,3,16,356,794,29,12,1207,1,40,1248
27,5,27013,970,3,11,340,640,3,3,997,3,31,1031
27,5,27013,971,3,30,595,1034,16,14,1689,0,39,1728
27,5,27013,974,3,28,898,960,21,13,1920,4,51,1975
27,5,27013,975,3,5,215,382,8,2,612,0,13,625
27,5,27013,978,3,6,305,360,10,3,684,1,11,696
27,5,27013,979,3,38,336,584,15,7,980,2,19,1001
27,5,27013,982,3,45,909,926,14,11,1905,1,44,1950
27,5,27013,983,3,48,425,547,16,7,1043,5,23,1071
27,5,27013,986,3,179,1763,2314,70,25,4351,10,158,4519
27,5,27013,987,3,51,493,610,33,14,1201,3,29,1233
27,5,27013,990,3,43,478,503,30,14,1068,3,24,1095
27,5,27014,991,3,44,393,648,30,9,1124,0,15,1139
27,5,27014,994,3,25,389,415,27,6,862,0,18,880
27,5,27014,995,3,24,304,422,20,9,779,0,17,796
27,5,27014,998,3,20,335,415,7,11,788,0,14,802
27,5,27014,999,3,21,333,353,26,1,734,1,6,741
27,5,27014,1002,3,20,282,250,18,4,574,2,8,584
27,5,27014,1003,3,26,347,359,20,18,770,0,14,784
27,5,27014,1006,3,6,298,261,1,1,567,2,11,580
27,5,27014,1007,3,16,350,421,5,3,795,2,11,808
27,5,27014,1010,3,6,266,274,5,2,553,0,4,557
27,5,27014,1011,3,12,368,353,19,8,760,0,15,775
27,5,27014,1014,3,25,403,615,10,3,1056,2,18,1076
27,5,27014,1015,3,13,251,240,5,1,510,0,4,514
27,5,27014,1018,3,19,378,334,12,3,746,0,8,754
27,5,27014,1019,3,17,341,512,8,1,879,2,9,890
27,5,27014,1022,3,23,608,934,33,10,1608,1,29,1638
27,5,27014,1023,3,10,442,667,6,3,1128,0,7,1135
27,5,27014,1026,3,11,403,312,2,2,730,2,15,747
27,5,27014,1027,3,18,782,509,15,3,1327,0,17,1344
27,5,27014,1030,3,12,384,254,8,1,659,0,0,659
27,5,27014,1031,3,2,316,137,4,1,460,1,12,473
27,5,27014,1034,3,10,262,487,6,3,768,0,9,777
27,5,27014,1035,3,5,303,529,10,2,849,0,14,863
27,6,27004,314,3,87,820,862,46,14,1829,1,28,1858
27,6,27004,341,3,26,266,255,18,5,570,0,6,576
27,6,27004,342,3,29,319,311,11,13,683,1,9,693
27,6,27004,343,3,28,363,355,9,6,761,0,6,767
27,6,27004,346,3,30,359,361,13,4,767,0,18,785
27,6,27004,347,3,16,257,302,11,4,590,0,15,605
27,6,27004,350,3,59,454,416,14,14,957,0,10,967
27,6,27004,351,3,47,216,288,8,10,569,1,5,575
27,6,27004,365,3,37,315,285,14,3,654,1,9,664
27,6,27004,366,3,23,363,312,16,8,722,0,18,740
27,6,27004,367,3,33,374,353,16,10,786,0,11,797
27,6,27004,370,3,51,314,299,10,6,680,2,7,689
27,6,27004,371,3,48,344,405,20,7,824,1,21,846
27,6,27004,374,3,28,296,336,21,10,691,3,9,703
27,6,27004,375,3,27,366,351,14,8,766,2,8,776
27,6,27004,378,3,36,263,199,13,3,514,0,7,521
27,6,27004,388,3,179,554,672,28,16,1449,0,15,1464
27,6,27004,390,3,33,326,240,11,11,621,0,6,627
27,6,27004,391,3,68,458,409,15,7,957,1,12,970
27,6,27004,394,3,41,376,338,14,11,780,1,7,788
27,6,27004,395,3,23,311,354,14,7,709,2,9,720
27,6,27004,398,3,165,713,861,30,21,1790,1,12,1803
27,6,27004,399,3,24,511,380,27,13,955,0,15,970
27,6,27004,402,3,59,365,375,17,7,823,1,10,834
27,6,27004,406,3,37,308,389,17,8,759,0,10,769
27,6,27004,407,3,34,369,351,15,12,781,2,9,792
27,6,27004,410,3,61,407,482,21,16,987,0,18,1005
27,6,27004,411,3,42,482,406,25,9,964,0,11,975
27,6,27004,414,3,20,369,451,21,15,876,0,11,887
27,6,27004,415,3,222,1016,913,44,34,2229,3,15,2247
27,6,27004,418,3,95,554,489,22,16,1176,0,16,1192
27,6,27004,452,3,52,624,650,19,5,1350,14,56,1420
27,6,27004,458,3,44,429,594,15,4,1086,0,17,1103
27,6,27004,459,3,0,71,16,1,0,88,0,0,88
27,6,27004,462,3,14,412,588,6,3,1023,3,17,1043
27,6,27004,463,3,47,570,860,23,6,1506,1,40,1547
27,6,27004,467,3,146,1016,1288,32,17,2499,4,39,2542
27,6,27004,470,3,86,736,1073,39,9,1943,4,40,1987
27,6,27004,475,3,7,278,568,7,3,863,0,38,901
27,6,27004,479,3,47,439,611,19,4,1120,0,26,1146
27,6,27004,482,3,33,392,351,17,6,799,1,27,827
27,6,27004,483,3,49,446,369,21,15,900,0,21,921
27,6,27004,486,3,119,723,852,22,19,1735,0,35,1770
27,6,27004,487,3,22,337,282,10,10,661,2,13,676
27,6,27004,490,3,15,306,458,4,6,789,0,14,803
27,6,27004,491,3,35,384,576,8,7,1010,0,21,1031
27,6,27004,494,3,58,511,790,12,15,1386,2,29,1417
27,6,27004,495,3,25,443,709,8,5,1190,2,27,1219
27,6,27004,498,3,51,440,586,18,9,1104,1,35,1140
27,6,27004,499,3,6,174,110,2,2,294,0,5,299
27,6,27004,502,3,84,1012,1114,39,17,2266,4,51,2321
27,6,27004,503,3,35,585,623,15,11,1269,2,38,1309
27,6,27004,506,3,19,289,184,3,2,497,0,44,541
27,6,27004,507,3,16,419,124,2,1,562,0,22,584
27,6,27004,510,3,4,71,129,0,1,205,0,8,213
27,6,27009,781,3,32,603,523,4,0,1162,0,22,1184
27,6,27009,782,3,24,365,319,6,2,716,0,8,724
27,6,27009,783,3,21,443,324,7,4,799,0,3,802
27,6,27009,786,3,14,442,331,8,2,797,0,12,809
27,6,27009,787,3,9,230,154,1,2,396,1,13,410
27,6,27009,790,3,2,79,34,0,0,115,0,4,119
27,6,27009,791,3,6,136,104,1,0,247,1,3,251
27,6,27009,794,3,23,344,276,3,2,648,0,14,662
27,6,27009,795,3,12,303,310,1,1,627,2,40,669
27,6,27009,798,3,18,447,422,9,9,905,0,21,926
27,6,27009,799,3,24,233,223,3,1,484,0,14,498
27,6,27009,802,3,33,329,272,4,3,641,0,15,656
27,6,27009,803,3,12,386,233,1,1,633,0,16,649
27,6,27009,806,3,20,335,184,2,4,545,0,9,554
27,6,27009,807,3,31,199,130,2,2,364,0,12,376
27,6,27015,1036,3,29,445,471,6,9,960,1,10,971
27,6,27015,1038,3,32,437,647,7,3,1126,0,18,1144
27,6,27015,1039,3,18,349,401,10,4,782,0,14,796
27,6,27015,1042,3,31,268,172,1,1,473,0,17,490
27,6,27015,1043,3,7,69,35,1,0,112,0,1,113
27,6,27015,1046,3,18,277,249,5,1,550,0,7,557
27,6,27015,1047,3,12,84,108,0,1,205,0,3,208
27,6,27015,1050,3,19,394,435,5,2,855,1,33,889
27,6,27015,1051,3,41,323,746,7,2,1119,3,26,1148
27,6,27015,1054,3,17,363,204,3,0,587,0,21,608
27,6,27015,1055,3,81,423,269,5,3,781,3,17,801
27,6,27015,1058,3,22,285,202,2,1,512,0,10,522
27,6,27015,1059,3,1,284,75,0,0,360,0,8,368
27,6,27015,1062,3,1,172,253,2,1,429,1,9,439
27,6,27016,1063,3,76,404,571,21,59,1131,2,32,1165
27,6,27016,1066,3,65,321,419,11,44,860,0,27,887
27,6,27016,1067,3,63,346,451,8,29,897,1,26,924
27,6,27016,1070,3,79,422,466,15,39,1021,0,16,1037
27,6,27016,1071,3,84,358,359,6,51,858,0,18,876
27,6,27016,1074,3,94,367,328,11,28,828,1,14,843
27,6,27016,1075,3,17,162,95,5,5,284,1,15,300
27,6,27016,1078,3,39,305,269,16,1,630,0,12,642
27,6,27016,1079,3,37,211,290,3,3,544,4,34,582
27,6,27016,1082,3,57,740,844,21,22,1684,0,42,1726
27,6,27016,1083,3,140,425,379,17,10,971,3,22,996
27,6,27016,1086,3,6,181,127,3,5,322,3,10,335
27,6,27016,1087,3,11,145,110,1,3,270,3,7,280
28,1,28007,125,3,272,280,278,29,10,869,0,19,888
28,1,28007,126,3,125,187,146,8,5,471,1,22,494
28,1,28007,127,3,165,202,165,16,14,562,0,13,575
28,1,28007,130,3,93,99,117,14,4,327,0,4,331
28,1,28007,131,3,167,207,124,18,2,518,0,19,537
28,1,28007,134,3,100,136,72,10,0,318,3,10,331
28,1,28007,135,3,50,68,38,1,2,159,0,5,164
28,1,28007,138,3,56,81,60,4,1,202,0,6,208
28,1,28007,139,3,119,96,82,10,4,311,0,10,321
28,1,28007,142,3,61,74,57,3,0,195,0,8,203
28,1,28014,327,3,208,207,163,10,5,593,1,15,609
28,1,28014,330,3,6,23,11,0,0,40,0,1,41
28,1,28024,716,3,169,147,157,16,7,496,0,15,511
28,1,28024,718,3,122,103,81,10,2,318,0,4,322
28,1,28024,719,3,142,165,85,11,4,407,0,13,420
28,1,28025,722,3,111,163,176,4,4,458,0,7,465
28,1,28025,723,3,197,295,186,36,11,725,1,12,738
28,1,28025,726,3,110,165,82,12,2,371,1,10,382
28,1,28025,727,3,153,210,159,10,4,536,1,14,551
28,1,28025,730,3,153,205,123,14,8,503,0,8,511
28,1,28025,731,3,84,172,65,8,2,331,0,5,336
28,1,28025,734,3,176,213,110,10,4,513,1,17,531
28,1,28025,735,3,173,256,160,17,10,616,0,6,622
28,1,28025,738,3,132,182,192,12,8,526,3,7,536
28,1,28025,739,3,258,283,293,26,13,873,1,17,891
28,1,28025,742,3,36,22,18,2,0,78,0,2,80
28,1,28025,743,3,70,40,13,4,2,129,0,3,132
28,1,28027,749,3,471,763,247,29,18,1528,5,32,1565
28,1,28027,750,3,553,755,357,52,27,1744,7,32,1783
28,1,28027,751,3,79,165,40,8,3,295,0,8,303
28,1,28027,754,3,462,719,265,28,13,1487,2,46,1535
28,1,28027,755,3,175,318,113,13,11,630,1,18,649
28,1,28027,758,3,369,546,181,45,17,1158,1,30,1189
28,1,28027,759,3,398,858,265,56,15,1592,3,14,1609
28,1,28027,762,3,206,369,79,32,9,695,0,20,715
28,1,28027,763,3,290,251,123,4,3,671,1,4,676
28,1,28027,766,3,190,303,116,22,11,642,1,19,662
28,1,28027,767,3,181,287,94,18,0,580,1,11,592
28,1,28027,770,3,190,169,100,13,6,478,0,9,487
28,1,28027,771,3,82,108,49,6,4,249,0,5,254
28,1,28027,774,3,139,244,86,15,5,489,1,15,505
28,1,28027,775,3,156,249,77,15,4,501,1,4,506
28,1,28027,778,3,213,271,92,17,14,607,0,12,619
28,1,28027,779,3,245,310,112,14,10,691,5,20,716
28,1,28027,782,3,220,249,88,22,8,587,0,22,609
28,1,28027,783,3,144,191,78,17,9,439,1,13,453
28,1,28027,786,3,104,111,56,5,2,278,2,8,288
28,1,28027,787,3,172,136,83,7,5,403,0,1,404
28,1,28027,790,3,122,128,39,10,5,304,0,6,310
28,1,28027,791,3,189,252,78,23,4,546,1,15,562
28,1,28027,794,3,119,185,42,10,2,358,0,9,367
28,1,28027,795,3,83,135,25,9,2,254,0,12,266
28,1,28027,798,3,218,205,109,21,6,559,0,12,571
28,1,28027,799,3,168,176,89,13,9,455,0,10,465
28,1,28027,802,3,143,170,68,10,1,392,0,5,397
28,1,28027,803,3,131,167,60,9,6,373,0,6,379
28,1,28027,806,3,178,174,79,9,0,440,0,12,452
28,1,28027,807,3,184,255,129,16,5,589,0,6,595
28,1,28027,810,3,312,463,130,24,15,944,0,23,967
28,1,28027,811,3,313,386,130,24,9,862,0,26,888
28,1,28027,814,3,442,545,345,44,17,1393,6,45,1444
28,1,28027,815,3,1506,2027,1123,137,70,4863,18,109,4990
28,1,28027,818,3,327,370,181,23,12,913,0,24,937
28,1,28027,819,3,187,269,96,12,8,572,0,6,578
28,1,28027,822,3,97,179,74,13,4,367,0,10,377
28,1,28027,823,3,247,272,122,13,10,664,1,13,678
28,1,28027,826,3,259,246,104,20,2,631,0,12,643
28,1,28027,827,3,293,338,127,29,5,792,0,11,803
28,1,28027,830,3,191,231,74,20,5,521,1,11,533
28,1,28027,831,3,66,107,29,8,0,210,1,9,220
28,1,28027,834,3,146,147,85,5,1,384,1,17,402
28,1,28027,835,3,216,214,105,16,5,556,1,8,565
28,1,28027,838,3,148,222,77,9,7,463,3,19,485
28,1,28027,839,3,355,454,198,37,12,1056,1,23,1080
28,1,28027,842,3,186,237,120,17,7,567,4,14,585
28,1,28027,843,3,127,213,61,13,6,420,5,23,448
28,1,28027,846,3,214,159,78,15,5,471,0,4,475
28,1,28027,847,3,210,242,103,14,5,574,2,9,585
28,1,28027,850,3,153,185,75,16,5,434,1,9,444
28,1,28027,851,3,67,77,40,5,5,194,0,2,196
28,1,28027,854,3,316,423,137,21,13,910,0,9,919
28,1,28027,855,3,181,217,94,21,5,518,0,11,529
28,1,28027,858,3,154,126,72,12,2,366,0,2,368
28,1,28027,859,3,350,360,159,26,11,906,0,20,926
28,1,28027,862,3,161,217,92,5,0,475,2,13,490
28,1,28027,863,3,168,303,75,15,12,573,1,15,589
28,1,28027,866,3,1266,1733,891,84,42,4016,13,101,4130
28,1,28027,867,3,294,379,133,24,10,840,0,20,860
28,1,28027,870,3,250,246,106,21,4,627,0,11,638
28,1,28027,871,3,391,267,158,16,9,841,1,1,843
28,1,28027,874,3,361,240,158,14,4,777,0,6,783
28,1,28027,875,3,399,363,133,25,9,929,7,22,958
28,1,28027,878,3,144,265,90,7,8,514,0,10,524
28,1,28027,879,3,594,775,258,64,24,1715,3,25,1743
28,1,28027,882,3,109,201,68,11,4,393,1,4,398
28,1,28027,883,3,186,269,105,19,3,582,0,12,594
28,1,28027,886,3,268,372,87,23,9,759,1,10,770
28,1,28027,887,3,202,354,110,12,8,686,0,19,705
28,1,28027,890,3,427,708,157,38,20,1350,2,20,1372
28,1,28027,891,3,751,911,262,57,28,2009,1,34,2044
28,1,28027,894,3,1322,1618,540,132,52,3664,7,32,3703
28,1,28027,895,3,247,306,133,30,10,726,0,12,738
28,1,28027,898,3,1346,1180,496,100,41,3163,5,39,3207
28,1,28027,899,3,212,251,82,9,5,559,3,19,581
28,1,28027,902,3,103,143,55,16,6,323,0,14,337
28,1,28027,903,3,990,1558,660,65,30,3303,7,53,3363
28,2,28032,936,3,205,287,76,4,4,576,3,27,606
28,2,28032,938,3,136,115,62,4,4,321,0,8,329
28,2,28032,939,3,127,122,95,11,4,359,0,15,374
28,2,28032,942,3,146,197,83,6,3,435,1,15,451
28,2,28032,944,3,420,332,171,17,9,949,2,19,970
28,2,28032,946,3,396,266,231,21,7,921,4,18,943
28,2,28032,947,3,320,251,233,15,6,825,2,14,841
28,2,28032,950,3,241,183,108,9,3,544,1,16,561
28,2,28032,951,3,241,219,118,9,3,590,1,10,601
28,2,28032,954,3,112,88,66,12,2,280,0,5,285
28,2,28032,955,3,155,149,140,11,2,457,4,5,466
28,2,28032,958,3,146,149,120,7,5,427,0,7,434
28,2,28032,959,3,192,174,134,18,3,521,3,5,529
28,2,28032,962,3,182,113,110,10,0,415,1,7,423
28,2,28032,963,3,256,196,132,22,13,619,7,16,642
28,2,28032,966,3,1901,1380,820,82,31,4214,16,79,4309
28,2,28032,967,3,338,276,177,9,4,804,4,21,829
28,2,28032,970,3,272,243,135,16,4,670,2,11,683
28,2,28032,971,3,242,165,147,3,4,561,0,13,574
28,2,28032,974,3,173,155,128,7,4,467,1,11,479
28,2,28032,975,3,203,229,116,15,1,564,0,11,575
28,2,28032,978,3,325,349,193,45,2,914,0,9,923
28,2,28032,979,3,221,192,138,8,4,563,0,6,569
28,2,28032,982,3,216,152,117,6,6,497,1,13,511
28,2,28032,983,3,196,166,118,18,1,499,3,19,521
28,2,28032,986,3,90,110,46,2,3,251,2,8,261
28,2,28032,987,3,183,181,153,14,7,538,0,13,551
28,2,28032,996,3,321,209,211,16,8,765,2,30,797
28,2,28032,998,3,274,287,142,29,3,735,6,16,757
28,2,28032,999,3,319,202,173,20,7,721,4,19,744
28,2,28032,1002,3,201,141,124,18,7,491,2,8,501
28,2,28032,1003,3,227,204,131,13,5,580,2,12,594
28,2,28032,1006,3,149,111,106,5,0,371,1,5,377
28,2,28032,1007,3,332,229,219,31,5,816,0,12,828
28,2,28032,1010,3,205,149,122,21,4,501,2,8,511
28,2,28032,1011,3,242,242,272,19,4,779,3,14,796
28,2,28032,1014,3,307,185,176,28,5,701,4,15,720
28,2,28032,1015,3,366,278,235,39,7,925,2,7,934
28,2,28032,1021,3,290,227,179,14,8,718,1,23,742
28,2,28032,1023,3,2959,1518,1161,145,54,5837,7,67,5911
28,2,28032,1026,3,448,349,263,23,10,1093,3,23,1119
28,2,28032,1027,3,294,278,208,52,7,839,0,11,850
28,2,28032,1030,3,265,239,126,13,6,649,0,14,663
28,2,28032,1031,3,227,237,158,12,8,642,0,10,652
28,2,28032,1034,3,158,185,131,6,6,486,1,8,495
28,2,28032,1035,3,247,233,137,19,4,640,0,4,644
28,2,28032,1038,3,263,224,257,19,7,770,5,10,785
28,2,28032,1039,3,472,334,205,25,7,1043,1,18,1062
28,2,28032,1042,3,338,295,330,25,9,997,3,11,1011
28,2,28032,1043,3,342,209,182,19,6,758,1,6,765
28,2,28032,1046,3,301,214,142,15,9,681,0,13,694
28,2,28032,1047,3,270,231,144,20,6,671,4,9,684
28,2,28032,1050,3,323,245,207,29,3,807,2,12,821
28,2,28032,1051,3,212,227,141,13,2,595,0,29,624
28,2,28032,1054,3,174,208,114,30,2,528,2,3,533
28,2,28032,1055,3,254,182,264,18,14,732,0,9,741
28,2,28032,1058,3,309,279,208,26,10,832,1,21,854
28,2,28032,1059,3,151,158,145,12,4,470,0,20,490
28,2,28032,1062,3,359,238,248,23,8,876,4,21,901
28,2,28032,1063,3,293,220,160,17,7,697,2,21,720
28,2,28032,1066,3,2138,1167,857,117,42,4321,33,117,4471
28,2,28032,1067,3,204,181,88,14,3,490,2,6,498
28,2,28032,1070,3,368,308,162,17,15,870,2,15,887
28,2,28032,1071,3,247,224,125,10,8,614,6,18,638
28,2,28032,1074,3,441,236,202,20,9,908,3,26,937
28,2,28032,1075,3,994,607,503,49,20,2173,5,42,2220
28,2,28032,1078,3,429,461,225,22,6,1143,12,18,1173
28,2,28032,1079,3,284,230,118,17,5,654,11,31,696
28,2,28032,1082,3,261,271,166,14,5,717,3,23,743
28,2,28032,1083,3,564,320,190,16,8,1098,5,20,1123
28,2,28032,1086,3,370,169,193,16,13,761,5,24,790
28,2,28032,1087,3,1301,766,474,70,30,2641,6,49,2696
28,2,28032,1090,3,465,278,194,15,10,962,3,14,979
28,2,28032,1091,3,316,203,130,8,6,663,1,13,677
28,2,28032,1094,3,1105,729,462,38,24,2358,20,78,2456
28,2,28032,1095,3,1250,716,464,32,27,2489,11,23,2523
28,2,28032,1098,3,370,348,180,9,5,912,2,35,949
28,2,28032,1099,3,279,284,144,12,6,725,0,18,743
28,2,28032,1102,3,251,226,153,13,5,648,5,22,675
28,2,28032,1103,3,304,263,156,9,7,739,4,16,759
28,2,28032,1106,3,260,270,95,17,2,644,0,22,666
28,2,28032,1107,3,197,181,88,4,2,472,0,7,479
28,2,28032,1110,3,614,380,208,14,5,1221,3,31,1255
28,2,28032,1112,3,287,219,125,12,7,650,6,34,690
28,2,28032,1114,3,225,187,124,17,9,562,1,18,581
28,2,28032,1115,3,199,219,98,68,5,589,0,23,612
28,2,28032,1118,3,279,242,159,13,7,700,5,17,722
28,2,28032,1119,3,389,302,164,18,14,887,1,30,916
28,2,28032,1122,3,720,540,339,26,14,1639,3,45,1687
28,2,28032,1123,3,402,431,178,22,6,1039,3,23,1065
28,3,28005,108,3,131,249,47,5,1,433,0,11,444
28,3,28005,110,3,128,241,85,5,2,461,0,8,469
28,3,28005,111,3,78,69,13,0,0,160,0,2,162
28,3,28005,114,3,108,296,187,6,1,598,1,5,604
28,3,28005,115,3,33,86,3,0,0,122,0,1,123
28,3,28010,259,3,76,235,28,2,2,343,0,5,348
28,3,28010,262,3,36,90,26,0,0,152,0,4,156
28,3,28010,263,3,5,27,4,0,0,36,0,1,37
28,3,28015,332,3,111,178,170,36,2,497,0,8,505
28,3,28015,334,3,110,142,173,14,6,445,3,5,453
28,3,28015,335,3,153,178,156,14,0,501,0,18,519
28,3,28015,338,3,154,198,136,12,2,502,0,9,511
28,3,28015,339,3,185,230,209,17,3,644,3,20,667
28,3,28015,342,3,81,112,82,3,2,280,0,8,288
28,3,28015,343,3,44,114,32,1,0,191,0,7,198
28,3,28022,547,3,682,581,463,31,26,1783,23,26,1832
28,3,28022,562,3,644,414,395,42,40,1535,3,46,1584
28,3,28022,673,3,279,247,187,12,15,740,6,28,774
28,3,28022,674,3,175,138,139,11,61,524,8,10,542
28,3,28022,675,3,486,377,241,12,14,1130,5,33,1168
28,3,28022,678,3,170,158,76,13,3,420,4,13,437
28,3,28022,679,3,163,151,38,6,4,362,2,20,384
28,3,28022,682,3,304,127,89,10,6,536,0,33,569
28,3,28022,683,3,292,245,104,7,7,655,0,24,679
28,3,28022,686,3,308,259,140,12,0,719,0,14,733
28,3,28022,687,3,265,284,148,18,11,726,3,34,763
28,3,28022,690,3,212,184,47,19,3,465,1,5,471
28,3,28022,691,3,129,188,56,5,4,382,2,9,393
28,3,28022,694,3,187,167,145,9,11,519,0,24,543
28,3,28022,695,3,171,225,83,5,9,493,2,11,506
28,3,28022,698,3,301,339,112,8,5,765,1,20,786
28,3,28022,699,3,276,356,140,18,7,797,2,29,828
28,3,28022,702,3,178,89,57,4,4,332,0,6,338
28,3,28022,703,3,117,155,77,4,4,357,2,18,377
28,3,28022,706,3,219,107,45,0,0,371,0,49,420
28,3,28022,707,3,59,35,9,0,1,104,0,6,110
28,3,28023,710,3,118,269,100,7,0,494,0,11,505
28,3,28023,711,3,98,230,37,2,0,367,1,9,377
28,3,28023,714,3,69,133,100,2,1,305,1,6,312
28,3,28023,715,3,75,86,21,2,0,184,0,11,195
28,3,28032,935,3,548,313,211,9,9,1090,1,21,1112
28,3,28032,943,3,292,257,186,9,6,750,14,36,800
28,3,28032,948,3,272,241,157,7,8,685,4,20,709
28,3,28032,990,3,208,191,135,7,8,549,0,47,596
28,3,28032,991,3,400,294,211,16,9,930,8,29,967
28,3,28032,994,3,18,20,7,0,0,45,0,3,48
28,3,28032,995,3,1641,534,632,52,44,2903,3,48,2954
28,3,28032,1018,3,1052,387,450,43,34,1966,4,31,2001
28,3,28032,1019,3,827,471,352,26,29,1705,10,39,1754
28,3,28032,1022,3,4435,1398,1703,149,120,7805,13,103,7921
28,3,28032,1076,3,553,251,248,21,12,1085,1,39,1125
28,3,28032,1111,3,921,523,384,18,27,1873,10,34,1917
28,3,28032,1124,3,139,159,175,5,7,485,2,22,509
28,3,28032,1126,3,20,71,17,1,2,111,2,4,117
28,3,28032,1127,3,73,113,62,6,4,258,0,8,266
28,3,28032,1130,3,75,142,56,2,1,276,0,0,276
28,3,28032,1131,3,26,115,13,0,0,154,1,0,155
28,3,28032,1134,3,97,92,55,1,0,245,2,9,256
28,3,28032,1135,3,124,120,54,0,1,299,1,18,318
28,3,28032,1138,3,2,41,4,0,0,47,0,0,47
28,3,28033,1139,3,133,158,281,13,12,597,1,16,614
28,3,28033,1142,3,101,111,208,10,9,439,0,27,466
28,3,28033,1143,3,79,81,191,7,3,361,0,11,372
28,3,28033,1146,3,204,168,447,42,16,877,3,34,914
28,3,28033,1147,3,163,179,423,27,15,807,1,27,835
28,3,28033,1150,3,147,99,324,31,10,611,0,7,618
28,3,28033,1151,3,128,174,279,14,9,604,0,28,632
28,3,28033,1154,3,120,142,227,22,13,524,4,12,540
28,3,28033,1155,3,148,124,301,20,24,617,0,8,625
28,3,28033,1158,3,176,253,479,36,19,963,6,52,1021
28,3,28033,1159,3,266,287,492,42,25,1112,3,48,1163
28,3,28033,1162,3,141,169,197,24,16,547,2,17,566
28,3,28033,1163,3,219,176,253,23,20,691,1,20,712
28,3,28033,1166,3,158,138,238,19,16,569,0,27,596
28,3,28033,1167,3,106,94,162,7,14,383,3,16,402
28,3,28033,1170,3,198,176,315,48,10,747,0,19,766
28,3,28033,1171,3,220,257,367,57,13,914,4,6,924
28,3,28033,1174,3,442,532,854,146,36,2010,1,29,2040
28,3,28033,1175,3,169,246,388,67,28,898,2,18,918
28,3,28033,1178,3,277,315,354,110,29,1085,0,6,1091
28,3,28033,1179,3,76,91,82,12,8,269,0,3,272
28,3,28033,1182,3,90,83,156,20,6,355,1,8,364
28,3,28033,1183,3,101,109,150,32,11,403,2,6,411
28,3,28033,1186,3,100,85,133,21,7,346,1,12,359
28,3,28033,1187,3,47,56,95,6,6,210,1,7,218
28,3,28033,1190,3,35,155,122,6,19,337,0,25,362
28,3,28033,1191,3,127,287,172,25,16,627,1,16,644
28,3,28033,1194,3,310,517,331,19,11,1188,2,47,1237
28,3,28033,1195,3,87,222,142,9,7,467,1,24,492
28,3,28033,1198,3,25,30,55,3,1,114,0,4,118
28,3,28033,1199,3,27,38,60,17,2,144,0,9,153
28,3,28033,1202,3,45,82,57,3,2,189,0,2,191
28,3,28033,1203,3,90,68,156,6,6,326,4,16,346
28,3,28033,1206,3,183,159,137,20,7,506,2,28,536
28,3,28033,1207,3,167,45,44,2,4,262,0,13,275
28,3,28033,1210,3,92,58,55,4,2,211,2,18,231
28,3,28035,1223,3,92,169,168,12,2,443,1,15,459
28,3,28035,1226,3,216,224,194,29,6,669,1,23,693
28,3,28035,1227,3,154,121,160,20,6,461,2,13,476
28,3,28035,1230,3,139,207,146,29,2,523,1,6,530
28,3,28035,1231,3,110,125,146,23,2,406,0,11,417
28,3,28035,1234,3,112,155,115,14,1,397,0,10,407
28,3,28035,1235,3,162,218,147,23,3,553,1,9,563
28,3,28035,1238,3,252,295,224,36,5,812,1,30,843
28,3,28035,1239,3,194,175,254,13,5,641,3,22,666
28,3,28035,1242,3,131,159,141,9,5,445,1,10,456
28,3,28035,1243,3,151,116,138,17,4,426,1,7,434
28,3,28035,1246,3,166,168,156,16,8,514,0,6,520
28,3,28035,1247,3,149,155,129,13,0,446,0,13,459
28,3,28035,1250,3,60,106,78,7,3,254,0,11,265
28,3,28035,1251,3,62,72,81,5,1,221,0,9,230
28,3,28035,1254,3,109,260,316,11,5,701,1,21,723
28,3,28035,1255,3,64,115,107,5,2,293,0,27,320
28,3,28035,1258,3,104,195,121,13,4,437,0,11,448
28,3,28035,1259,3,136,225,291,14,3,669,0,14,683
28,3,28035,1262,3,141,132,140,6,2,421,2,14,437
28,3,28035,1263,3,197,216,253,21,3,690,0,19,709
28,3,28035,1266,3,16,20,7,1,0,44,0,1,45
28,3,28035,1267,3,30,16,19,1,1,67,0,5,72
28,3,28035,1270,3,24,30,55,3,1,113,0,2,115
28,3,28035,1271,3,107,155,155,14,1,432,1,19,452
28,3,28035,1274,3,15,71,71,2,0,159,0,0,159
28,3,28035,1275,3,13,65,37,0,0,115,0,2,117
28,3,28040,1516,3,334,124,137,41,9,645,2,9,656
28,3,28040,1518,3,300,210,132,32,9,683,3,8,694
28,3,28040,1519,3,302,100,89,17,6,514,0,11,525
28,3,28040,1522,3,343,193,121,20,7,684,4,18,706
28,3,28040,1523,3,286,189,116,21,4,616,1,6,623
28,3,28040,1526,3,181,133,110,20,3,447,0,11,458
28,3,28040,1527,3,286,226,153,15,5,685,0,8,693
28,3,28040,1530,3,355,262,219,28,11,875,1,17,893
28,3,28040,1531,3,330,175,135,35,7,682,1,4,687
28,3,28040,1534,3,278,142,107,19,5,551,2,11,564
28,3,28040,1535,3,124,54,46,16,2,242,0,4,246
28,3,28040,1538,3,291,105,129,27,4,556,1,11,568
28,3,28040,1539,3,119,107,61,8,4,299,0,7,306
28,3,28040,1542,3,220,153,123,13,7,516,2,8,526
28,3,28040,1543,3,535,349,218,61,11,1174,2,19,1195
28,3,28040,1546,3,154,202,46,6,2,410,0,14,424
28,3,28040,1547,3,58,51,47,3,1,160,0,0,160
28,3,28040,1550,3,376,200,100,16,7,699,1,17,717
28,3,28040,1551,3,474,254,168,19,8,923,1,9,933
28,3,28040,1554,3,123,83,44,6,3,259,1,10,270
28,3,28040,1555,3,278,267,134,21,6,706,2,22,730
28,3,28040,1558,3,69,47,33,2,3,154,0,6,160
28,3,28040,1559,3,67,50,43,2,0,162,0,9,171
28,4,28022,498,3,216,248,101,17,3,585,6,26,617
28,4,28022,499,3,286,256,96,8,6,652,6,17,675
28,4,28022,502,3,286,254,190,14,6,750,4,39,793
28,4,28022,503,3,331,254,145,11,5,746,4,20,770
28,4,28022,506,3,235,211,122,13,5,586,2,12,600
28,4,28022,507,3,322,326,190,11,15,864,5,18,887
28,4,28022,510,3,204,149,88,9,5,455,3,9,467
28,4,28022,511,3,260,216,95,9,8,588,0,7,595
28,4,28022,514,3,757,559,257,43,27,1643,12,23,1678
28,4,28022,515,3,541,481,260,23,12,1317,5,26,1348
28,4,28022,518,3,368,200,78,19,6,671,1,5,677
28,4,28022,519,3,311,227,65,9,5,617,0,5,622
28,4,28022,522,3,194,131,85,14,4,428,0,9,437
28,4,28022,523,3,170,120,87,7,10,394,2,10,406
28,4,28022,526,3,163,230,108,38,8,547,2,6,555
28,4,28022,527,3,408,279,94,8,5,794,0,7,801
28,4,28022,530,3,125,116,64,7,3,315,0,5,320
28,4,28022,531,3,165,128,63,8,6,370,0,9,379
28,4,28022,534,3,254,205,120,20,9,608,3,15,626
28,4,28022,535,3,746,610,343,40,30,1769,5,37,1811
28,4,28022,538,3,251,185,86,14,8,544,0,11,555
28,4,28022,539,3,299,225,150,6,8,688,1,5,694
28,4,28022,542,3,175,233,118,13,11,550,2,10,562
28,4,28022,543,3,698,766,342,42,27,1875,11,28,1914
28,4,28022,546,3,1305,1261,722,82,59,3429,14,64,3507
28,4,28022,548,3,456,260,92,28,5,841,0,5,846
28,4,28022,550,3,261,197,85,37,9,589,0,5,594
28,4,28022,551,3,233,126,64,12,3,438,1,3,442
28,4,28022,554,3,272,198,100,36,12,618,0,11,629
28,4,28022,555,3,255,240,79,26,7,607,1,9,617
28,4,28022,558,3,344,200,126,12,4,686,0,3,689
28,4,28022,559,3,224,178,73,28,1,504,2,9,515
28,4,28022,563,3,132,157,63,9,9,370,0,0,370
28,4,28022,566,3,202,119,68,12,7,408,0,13,421
28,4,28022,567,3,236,156,93,26,6,517,1,7,525
28,4,28022,570,3,208,152,83,17,9,469,0,11,480
28,4,28022,571,3,143,135,83,10,6,377,1,10,388
28,4,28022,574,3,76,69,44,2,2,193,1,10,204
28,4,28022,575,3,161,174,126,11,5,477,0,4,481
28,4,28022,578,3,247,180,121,18,4,570,1,11,582
28,4,28022,579,3,239,163,91,18,7,518,0,5,523
28,4,28022,582,3,180,125,69,19,6,399,0,8,407
28,4,28022,583,3,207,194,67,8,6,482,1,5,488
28,4,28022,586,3,157,110,57,6,8,338,1,5,344
28,4,28022,587,3,158,93,121,11,3,386,4,8,398
28,4,28022,590,3,450,415,212,40,17,1134,9,26,1169
28,4,28022,591,3,209,199,122,12,6,548,0,6,554
28,4,28022,594,3,235,224,149,11,13,632,6,8,646
28,4,28022,595,3,88,82,34,10,2,216,1,11,228
28,4,28022,598,3,170,160,78,16,13,437,0,8,445
28,4,28022,599,3,199,119,65,7,3,393,0,8,401
28,4,28022,602,3,299,185,124,21,7,636,2,7,645
28,4,28022,603,3,208,190,85,17,5,505,3,12,520
28,4,28022,606,3,239,165,113,10,15,542,5,22,569
28,4,28022,607,3,227,164,115,11,5,522,7,15,544
28,4,28022,610,3,587,487,263,65,25,1427,5,30,1462
28,4,28022,611,3,192,176,105,10,9,492,2,11,505
28,4,28022,614,3,196,190,119,11,7,523,2,14,539
28,4,28022,615,3,206,171,57,8,6,448,1,19,468
28,4,28022,618,3,473,435,282,28,24,1242,3,32,1277
28,4,28022,619,3,394,309,167,30,8,908,1,9,918
28,4,28022,622,3,139,165,88,16,4,412,3,5,420
28,4,28022,623,3,322,229,140,23,7,721,0,16,737
28,4,28022,626,3,471,490,253,26,21,1261,0,20,1281
28,4,28022,627,3,1290,1208,673,92,48,3311,19,35,3365
28,4,28022,630,3,306,364,167,15,10,862,5,10,877
28,4,28022,631,3,219,164,125,12,8,528,7,16,551
28,4,28022,634,3,659,538,373,27,29,1626,11,29,1666
28,4,28022,635,3,303,339,166,26,9,843,9,28,880
28,4,28022,638,3,208,229,155,7,17,616,18,16,650
28,4,28022,639,3,1082,811,549,29,40,2511,22,74,2607
28,4,28022,642,3,214,266,148,17,13,658,8,12,678
28,4,28022,643,3,229,257,131,7,7,631,1,27,659
28,4,28022,646,3,195,195,123,11,4,528,3,15,546
28,4,28022,647,3,1001,942,596,56,32,2627,39,62,2728
28,4,28022,650,3,297,178,141,22,14,652,2,20,674
28,4,28022,651,3,1202,1002,617,78,42,2941,18,52,3011
28,4,28022,654,3,683,675,433,42,21,1854,21,35,1910
28,4,28022,655,3,239,195,100,12,12,558,4,9,571
28,4,28022,658,3,175,295,107,18,10,605,8,16,629
28,4,28022,659,3,232,366,142,12,7,759,4,23,786
28,4,28022,662,3,415,310,222,23,14,984,1,17,1002
28,4,28022,663,3,307,371,144,13,13,848,2,27,877
28,4,28022,666,3,365,261,171,32,15,844,6,18,868
28,4,28022,667,3,214,281,120,19,11,645,5,19,669
28,4,28022,670,3,543,606,342,30,19,1540,19,10,1569
28,4,28022,671,3,379,343,225,20,10,977,1,37,1015
28,5,28013,311,3,117,310,70,16,6,519,1,12,532
28,5,28013,314,3,210,219,47,10,2,488,0,0,488
28,5,28013,315,3,120,172,73,17,0,382,0,5,387
28,5,28013,318,3,95,297,48,11,2,453,0,10,463
28,5,28013,319,3,89,197,55,7,2,350,0,3,353
28,5,28013,322,3,127,199,70,5,1,402,0,6,408
28,5,28013,323,3,7,44,1,0,0,52,0,0,52
28,5,28013,326,3,65,71,6,4,0,146,2,4,152
28,5,28016,346,3,227,314,171,30,8,750,0,22,772
28,5,28016,347,3,190,302,127,22,8,649,0,14,663
28,5,28016,350,3,76,174,89,8,3,350,0,17,367
28,5,28016,351,3,96,86,6,0,0,188,0,8,196
28,5,28016,354,3,207,335,86,11,4,643,0,18,661
28,5,28016,355,3,104,252,83,3,3,445,0,21,466
28,5,28016,358,3,175,198,51,7,1,432,0,10,442
28,5,28016,359,3,228,284,64,21,0,597,1,29,627
28,5,28016,362,3,59,59,23,2,6,149,0,3,152
28,5,28016,363,3,147,183,128,20,6,484,0,26,510
28,5,28016,366,3,120,170,121,20,6,437,0,8,445
28,5,28016,367,3,147,261,87,21,10,526,1,14,541
28,5,28020,408,3,49,252,2,1,0,304,0,12,316
28,5,28020,410,3,105,327,23,9,1,465,1,15,481
28,5,28020,411,3,82,210,14,9,4,319,0,7,326
28,5,28030,922,3,148,290,78,81,96,693,0,25,718
28,5,28030,923,3,118,200,66,69,76,529,0,28,557
28,5,28030,926,3,319,394,186,62,16,977,0,44,1021
28,5,28030,927,3,160,273,73,27,11,544,0,18,562
28,5,28030,930,3,240,323,93,27,15,698,0,26,724
28,5,28034,1211,3,67,107,22,32,0,228,0,6,234
28,5,28034,1214,3,73,106,1,3,0,183,0,19,202
28,5,28034,1215,3,87,117,24,11,0,239,0,5,244
28,5,28034,1218,3,52,163,38,43,2,298,0,17,315
28,5,28034,1219,3,71,179,41,17,3,311,0,9,320
28,5,28034,1222,3,288,285,57,25,23,678,0,41,719
28,5,28036,1278,3,100,237,1,4,0,342,0,9,351
28,5,28036,1279,3,14,189,3,1,0,207,0,4,211
28,5,28041,1562,3,382,487,225,51,28,1173,0,21,1194
28,5,28041,1563,3,219,256,98,32,4,609,0,18,627
28,5,28041,1566,3,516,609,267,103,19,1514,4,22,1540
28,5,28041,1567,3,271,260,102,28,7,668,2,5,675
28,5,28041,1570,3,405,510,146,64,15,1140,1,2,1143
28,5,28041,1571,3,370,408,164,81,13,1036,0,13,1049
28,5,28041,1574,3,235,213,132,47,5,632,0,12,644
28,5,28041,1575,3,299,287,150,40,9,785,0,11,796
28,5,28041,1578,3,13,30,17,1,0,61,0,0,61
28,5,28041,1579,3,280,336,167,48,5,836,4,14,854
28,5,28041,1582,3,295,307,147,75,9,833,1,9,843
28,5,28041,1583,3,245,332,174,81,5,837,2,11,850
28,5,28041,1586,3,221,283,143,50,12,709,1,15,725
28,5,28041,1587,3,362,494,147,44,11,1058,0,11,1069
28,5,28041,1590,3,220,337,165,39,6,767,0,18,785
28,5,28041,1591,3,298,318,136,76,14,842,2,16,860
28,5,28041,1594,3,296,474,89,37,10,906,1,4,911
28,5,28041,1595,3,198,278,102,37,8,623,0,10,633
28,5,28041,1598,3,148,259,85,57,6,555,0,10,565
28,5,28041,1599,3,132,193,95,26,9,455,0,11,466
28,5,28041,1602,3,291,373,151,61,30,906,1,3,910
28,5,28041,1603,3,276,340,187,65,7,875,3,16,894
28,5,28041,1606,3,349,373,147,90,8,967,1,22,990
28,5,28041,1607,3,806,909,527,130,33,2405,3,61,2469
28,5,28041,1610,3,235,259,130,47,7,678,2,24,704
28,5,28041,1611,3,192,325,137,39,6,699,3,12,714
28,5,28041,1614,3,285,276,127,63,9,760,1,11,772
28,5,28041,1615,3,239,266,131,75,8,719,0,15,734
28,5,28041,1618,3,246,256,159,65,11,737,0,12,749
28,5,28041,1619,3,352,365,215,90,12,1034,0,14,1048
28,5,28041,1622,3,206,233,180,57,9,685,0,8,693
28,5,28041,1623,3,181,232,106,56,8,583,1,6,590
28,5,28041,1626,3,216,204,114,42,8,584,0,6,590
28,5,28041,1627,3,213,267,91,45,2,618,0,7,625
28,5,28041,1630,3,117,93,63,36,0,309,1,3,313
28,5,28041,1631,3,205,262,116,35,2,620,0,16,636
28,5,28041,1634,3,210,319,167,75,9,780,2,19,801
28,5,28041,1635,3,171,272,123,41,8,615,2,7,624
28,5,28041,1638,3,172,239,127,44,11,593,1,8,602
28,5,28041,1639,3,203,315,137,43,6,704,1,14,719
28,5,28041,1642,3,153,157,95,34,3,442,0,8,450
28,5,28041,1643,3,156,175,81,27,9,448,0,8,456
28,5,28041,1646,3,271,327,193,86,5,882,1,21,904
28,5,28041,1647,3,265,348,166,75,12,866,0,6,872
28,5,28041,1650,3,474,579,292,126,15,1486,2,15,1503
28,5,28041,1651,3,383,388,257,109,16,1153,4,25,1182
28,5,28041,1654,3,60,32,57,18,0,167,0,2,169
28,5,28041,1655,3,213,220,128,56,17,634,0,12,646
28,5,28041,1658,3,170,211,128,32,4,545,1,15,561
28,5,28041,1659,3,159,193,92,24,13,481,1,13,495
28,5,28041,1662,3,250,292,145,61,14,762,0,16,778
28,5,28041,1663,3,232,240,125,45,7,649,0,12,661
28,5,28041,1666,3,339,413,288,79,9,1128,1,21,1150
28,5,28041,1667,3,456,518,232,59,8,1273,1,35,1309
28,5,28041,1670,3,163,230,140,44,8,585,0,15,600
28,5,28041,1671,3,204,309,176,45,8,742,3,28,773
28,5,28041,1674,3,196,237,115,38,6,592,3,10,605
28,5,28041,1675,3,262,350,138,47,6,803,1,11,815
28,5,28041,1678,3,127,188,87,18,5,425,0,20,445
28,5,28041,1679,3,200,173,122,48,5,548,3,16,567
28,5,28041,1682,3,478,614,377,71,36,1576,1,43,1620
28,5,28041,1683,3,569,593,339,106,12,1619,7,33,1659
28,5,28041,1686,3,365,398,222,65,16,1066,3,18,1087
28,5,28041,1687,3,248,288,138,52,5,731,2,21,754
28,5,28041,1690,3,242,277,133,44,3,699,0,18,717
28,5,28041,1691,3,151,258,114,36,2,561,3,14,578
28,5,28041,1694,3,407,601,251,67,8,1334,3,26,1363
28,5,28041,1695,3,113,149,76,21,2,361,1,9,371
28,5,28041,1698,3,295,494,220,59,15,1083,0,32,1115
28,5,28041,1699,3,200,254,84,39,0,577,3,9,589
28,5,28041,1702,3,131,220,53,6,1,411,0,13,424
28,5,28041,1703,3,143,262,73,13,6,497,4,28,529
28,5,28041,1706,3,234,297,82,39,3,655,0,23,678
28,5,28041,1707,3,184,233,106,19,4,546,0,13,559
28,5,28041,1710,3,187,211,76,14,1,489,1,20,510
28,5,28041,1711,3,50,13,20,2,0,85,0,2,87
28,5,28042,1714,3,46,280,22,5,1,354,0,8,362
28,5,28042,1715,3,60,335,18,6,0,419,0,10,429
28,5,28042,1718,3,96,231,37,3,0,367,0,17,384
28,6,28001,1,3,125,150,55,28,1,359,0,0,359
28,6,28001,2,3,285,239,100,34,1,659,0,12,671
28,6,28001,3,3,142,162,74,18,1,397,0,6,403
28,6,28001,6,3,157,142,37,13,4,353,0,17,370
28,6,28001,8,3,212,150,83,14,1,460,1,19,480
28,6,28001,10,3,278,212,233,21,6,750,6,13,769
28,6,28001,11,3,181,120,92,3,1,397,0,13,410
28,6,28004,101,3,334,293,117,33,3,780,0,13,793
28,6,28004,102,3,283,305,132,20,5,745,0,27,772
28,6,28004,103,3,227,205,117,6,5,560,3,19,582
28,6,28004,106,3,300,344,79,10,0,733,0,11,744
28,6,28004,107,3,102,65,35,2,0,204,0,4,208
28,6,28006,116,3,92,332,23,7,0,454,0,9,463
28,6,28006,118,3,136,306,63,20,2,527,2,23,552
28,6,28006,119,3,34,118,3,1,0,156,0,2,158
28,6,28006,122,3,30,261,4,0,0,295,1,2,298
28,6,28006,123,3,40,140,3,5,0,188,0,3,191
28,6,28008,143,3,271,223,58,14,3,569,1,20,590
28,6,28008,146,3,26,73,21,0,0,120,0,5,125
28,6,28008,147,3,86,249,51,7,3,396,0,5,401
28,6,28008,150,3,37,52,0,0,0,89,0,2,91
28,6,28011,266,3,349,331,164,15,4,863,2,25,890
28,6,28011,267,3,38,55,36,2,0,131,0,6,137
28,6,28011,270,3,279,197,68,13,2,559,0,20,579
28,6,28011,271,3,341,255,68,38,3,705,0,39,744
28,6,28012,274,3,93,72,16,2,0,183,0,7,190
28,6,28012,275,3,292,194,87,22,3,598,3,14,615
28,6,28012,278,3,196,199,76,9,4,484,3,9,496
28,6,28012,279,3,202,217,117,20,5,561,1,11,573
28,6,28012,282,3,176,171,17,5,2,371,0,8,379
28,6,28012,283,3,82,115,20,3,0,220,1,3,224
28,6,28012,286,3,158,117,100,5,5,385,3,6,394
28,6,28012,287,3,244,145,121,9,4,523,0,20,543
28,6,28012,290,3,259,122,41,10,1,433,4,11,448
28,6,28012,291,3,201,169,63,14,2,449,1,33,483
28,6,28012,294,3,293,253,70,17,2,635,2,22,659
28,6,28012,295,3,228,173,62,5,2,470,8,10,488
28,6,28012,298,3,246,208,42,6,2,504,6,17,527
28,6,28012,299,3,114,148,19,5,0,286,0,10,296
28,6,28012,302,3,225,262,45,8,1,541,2,10,553
28,6,28012,303,3,97,124,110,6,2,339,0,16,355
28,6,28012,306,3,193,318,80,11,1,603,4,8,615
28,6,28012,307,3,9,27,2,1,0,39,0,0,39
28,6,28012,310,3,265,271,45,15,4,600,17,30,647
28,6,28017,368,3,226,249,91,39,5,610,0,14,624
28,6,28017,370,3,159,261,177,97,0,694,1,16,711
28,6,28017,371,3,85,194,7,2,1,289,0,5,294
28,6,28017,374,3,81,98,7,2,0,188,0,2,190
28,6,28017,375,3,218,432,50,7,0,707,0,21,728
28,6,28017,378,3,151,170,32,8,2,363,2,16,381
28,6,28017,379,3,10,26,4,0,0,40,0,0,40
28,6,28018,382,3,132,270,103,37,0,542,0,14,556
28,6,28018,383,3,84,134,43,31,2,294,0,11,305
28,6,28018,386,3,150,103,19,3,2,277,0,10,287
28,6,28018,387,3,43,140,12,3,0,198,0,4,202
28,6,28019,390,3,142,235,109,72,3,561,0,14,575
28,6,28019,391,3,214,344,146,81,2,787,1,37,825
28,6,28019,394,3,168,244,74,17,2,505,0,18,523
28,6,28019,395,3,111,186,22,11,2,332,0,12,344
28,6,28019,398,3,134,131,31,6,2,304,0,10,314
28,6,28019,399,3,129,110,33,4,3,279,1,19,299
28,6,28019,402,3,132,200,59,4,2,397,0,8,405
28,6,28019,403,3,71,105,15,0,0,191,0,10,201
28,6,28019,406,3,64,115,27,8,0,214,0,13,227
28,6,28019,407,3,158,213,36,13,0,420,0,6,426
28,6,28021,412,3,84,140,298,11,5,538,1,10,549
28,6,28021,414,3,89,124,106,20,3,342,2,9,353
28,6,28021,415,3,179,147,194,25,2,547,2,15,564
28,6,28021,418,3,175,188,162,115,5,645,2,6,653
28,6,28021,419,3,125,128,151,30,6,440,2,8,450
28,6,28021,422,3,255,259,232,63,9,818,1,18,837
28,6,28021,423,3,178,189,197,40,10,614,2,9,625
28,6,28021,426,3,296,251,248,47,12,854,2,25,881
28,6,28021,427,3,137,204,155,23,3,522,2,24,548
28,6,28021,430,3,244,165,160,34,6,609,2,13,624
28,6,28021,431,3,198,171,132,43,8,552,0,4,556
28,6,28021,434,3,117,79,90,4,16,306,0,4,310
28,6,28021,435,3,172,214,140,35,13,574,2,14,590
28,6,28021,438,3,146,106,82,26,2,362,3,8,373
28,6,28021,439,3,210,217,176,64,8,675,1,14,690
28,6,28021,442,3,179,139,108,29,4,459,0,1,460
28,6,28021,443,3,197,170,163,52,16,598,1,2,601
28,6,28021,446,3,118,135,143,43,1,440,0,12,452
28,6,28021,447,3,135,165,174,61,4,539,1,12,552
28,6,28021,450,3,225,205,211,62,3,706,0,4,710
28,6,28021,451,3,283,202,176,63,6,730,0,11,741
28,6,28021,454,3,83,81,97,19,6,286,1,8,295
28,6,28021,455,3,315,323,258,90,11,997,1,21,1019
28,6,28021,458,3,279,258,259,111,10,917,1,24,942
28,6,28021,459,3,147,149,165,35,13,509,0,10,519
28,6,28021,462,3,306,174,265,84,8,837,2,13,852
28,6,28021,463,3,182,166,215,34,12,609,5,11,625
28,6,28021,466,3,309,206,164,41,5,725,0,21,746
28,6,28021,467,3,127,101,68,7,0,303,0,12,315
28,6,28021,470,3,89,171,94,8,5,367,0,13,380
28,6,28021,471,3,254,263,175,14,2,708,1,10,719
28,6,28021,474,3,88,84,91,10,1,274,0,6,280
28,6,28021,475,3,117,100,112,6,3,338,0,9,347
28,6,28021,478,3,319,174,110,6,2,611,4,20,635
28,6,28021,479,3,263,120,97,12,4,496,2,19,517
28,6,28021,482,3,210,130,94,9,2,445,0,13,458
28,6,28021,483,3,232,245,118,8,3,606,2,26,634
28,6,28021,486,3,41,29,13,5,1,89,2,4,95
28,6,28021,487,3,146,138,59,20,3,366,1,16,383
28,6,28021,490,3,169,111,90,14,6,390,1,11,402
28,6,28021,491,3,165,148,28,7,0,348,4,4,356
28,6,28021,494,3,129,69,67,10,1,276,1,8,285
28,6,28021,495,3,107,103,73,3,2,288,0,9,297
28,6,28026,745,3,119,373,62,6,0,560,1,12,573
28,6,28026,746,3,64,157,40,15,0,276,0,7,283
28,6,28026,747,3,96,278,70,12,1,457,0,13,470
28,6,28028,905,3,133,281,200,1,2,617,1,18,636
28,6,28028,906,3,141,243,104,15,1,504,2,16,522
28,6,28028,907,3,66,156,45,3,3,273,1,5,279
28,6,28029,910,3,312,344,109,71,2,838,0,18,856
28,6,28029,911,3,103,117,30,23,0,273,0,8,281
28,6,28029,914,3,187,289,73,27,0,576,0,19,595
28,6,28029,915,3,81,155,33,2,2,273,0,6,279
28,6,28029,918,3,160,178,50,17,3,408,0,11,419
28,6,28029,919,3,99,96,11,0,1,207,0,4,211
28,6,28031,931,3,71,63,22,4,0,160,0,2,162
28,6,28031,934,3,35,231,33,3,0,302,0,11,313
28,6,28037,1280,3,328,260,143,30,5,766,1,25,792
28,6,28037,1282,3,324,272,102,48,6,752,4,21,777
28,6,28037,1283,3,239,268,91,35,1,634,0,14,648
28,6,28037,1286,3,98,148,86,8,0,340,0,10,350
28,6,28037,1287,3,88,187,38,2,5,320,1,7,328
28,6,28037,1290,3,178,154,64,15,1,412,0,4,416
28,6,28037,1291,3,90,142,51,9,3,295,1,14,310
28,6,28037,1294,3,184,457,224,29,4,898,3,20,921
28,6,28037,1295,3,61,83,78,10,0,232,0,1,233
28,6,28037,1298,3,140,152,54,4,0,350,4,9,363
28,6,28037,1299,3,129,210,157,10,0,506,1,5,512
28,6,28037,1302,3,109,217,74,8,1,409,1,16,426
28,6,28037,1303,3,81,136,33,4,0,254,0,4,258
28,6,28039,1497,3,144,207,51,61,4,467,1,11,479
28,6,28039,1498,3,200,466,134,72,7,879,0,27,906
28,6,28039,1499,3,321,390,117,154,11,993,0,18,1011
28,6,28039,1502,3,60,350,25,7,1,443,0,15,458
28,6,28039,1503,3,59,214,15,2,0,290,0,19,309
28,6,28039,1506,3,87,331,15,10,2,445,2,24,471
28,6,28039,1507,3,38,245,16,3,2,304,0,20,324
28,6,28039,1510,3,134,243,3,6,0,386,1,15,402
28,6,28039,1511,3,121,486,43,16,3,669,0,23,692
28,6,28039,1514,3,222,440,41,21,1,725,0,18,743
28,6,28039,1515,3,115,247,33,7,1,403,1,27,431
28,6,28043,1719,3,467,338,72,12,2,891,1,26,918
28,6,28043,1722,3,332,311,74,6,3,726,3,33,762
28,6,28043,1723,3,297,198,55,12,3,565,1,13,579
28,6,28043,1726,3,183,76,4,1,0,264,2,3,269
28,6,28043,1727,3,70,34,2,1,0,107,0,1,108
28,6,28043,1730,3,285,355,57,6,1,704,3,28,735
28,6,28043,1731,3,213,103,6,0,1,323,1,10,334
28,6,28043,1734,3,174,94,16,0,1,285,0,16,301
28,6,28043,1735,3,277,151,41,8,2,479,1,16,496
28,6,28043,1738,3,365,147,78,23,3,616,0,18,634
28,6,28043,1739,3,144,82,15,4,0,245,0,5,250
28,7,28002,13,3,548,231,109,54,7,949,4,24,977
28,7,28002,14,3,466,303,143,78,6,996,8,31,1035
28,7,28002,15,3,328,234,92,54,4,712,0,18,730
28,7,28002,18,3,350,293,93,79,4,819,2,17,838
28,7,28002,19,3,589,422,200,96,3,1310,4,46,1360
28,7,28002,22,3,151,84,94,4,0,333,0,10,343
28,7,28002,23,3,307,193,97,19,2,618,5,21,644
28,7,28002,26,3,73,31,132,9,2,247,0,4,251
28,7,28002,27,3,346,137,80,16,4,583,1,18,602
28,7,28002,30,3,370,232,91,7,2,702,9,15,726
28,7,28002,31,3,176,84,41,4,2,307,2,7,316
28,7,28003,34,3,400,419,201,35,10,1065,15,28,1108
28,7,28003,35,3,158,137,79,18,10,402,7,20,429
28,7,28003,38,3,406,356,155,25,12,954,10,24,988
28,7,28003,39,3,337,247,104,25,7,720,13,19,752
28,7,28003,42,3,249,203,103,17,4,576,2,18,596
28,7,28003,43,3,276,333,132,32,17,790,10,24,824
28,7,28003,46,3,250,344,121,40,11,766,3,9,778
28,7,28003,47,3,68,85,26,12,2,193,0,5,198
28,7,28003,50,3,253,268,127,55,10,713,4,16,733
28,7,28003,51,3,336,420,184,45,12,997,10,25,1032
28,7,28003,54,3,502,547,249,53,16,1367,11,19,1397
28,7,28003,55,3,163,216,42,3,1,425,10,33,468
28,7,28003,58,3,206,161,76,14,5,462,11,16,489
28,7,28003,59,3,210,163,58,14,5,450,4,7,461
28,7,28003,62,3,406,284,146,18,15,869,21,39,929
28,7,28003,63,3,335,251,122,19,9,736,19,51,806
28,7,28003,66,3,66,128,74,2,0,270,5,8,283
28,7,28003,67,3,313,254,111,25,9,712,17,36,765
28,7,28003,70,3,381,394,185,14,12,986,19,25,1030
28,7,28003,71,3,637,583,230,43,23,1516,9,45,1570
28,7,28003,74,3,362,327,115,27,14,845,2,26,873
28,7,28003,75,3,365,264,90,21,9,749,13,16,778
28,7,28003,78,3,255,278,92,19,7,651,0,32,683
28,7,28003,79,3,235,185,99,24,9,552,10,8,570
28,7,28003,82,3,293,220,74,20,10,617,14,14,645
28,7,28003,83,3,342,335,79,18,8,782,4,47,833
28,7,28003,86,3,348,243,81,35,13,720,2,10,732
28,7,28003,87,3,236,173,69,13,3,494,4,6,504
28,7,28003,90,3,362,233,90,32,8,725,6,26,757
28,7,28003,91,3,325,220,137,20,12,714,7,11,732
28,7,28003,94,3,276,212,79,27,6,600,6,23,629
28,7,28003,95,3,462,283,126,44,16,931,3,24,958
28,7,28003,98,3,327,208,137,26,14,712,4,16,732
28,7,28003,99,3,302,198,104,23,10,637,5,18,660
28,7,28009,151,3,364,267,161,22,12,826,7,15,848
28,7,28009,154,3,419,352,177,32,11,991,13,29,1033
28,7,28009,155,3,347,272,197,30,15,861,15,16,892
28,7,28009,158,3,263,396,162,42,12,875,5,27,907
28,7,28009,159,3,1125,650,537,274,46,2632,5,34,2671
28,7,28009,162,3,246,276,259,35,9,825,7,10,842
28,7,28009,163,3,111,111,77,14,2,315,14,11,340
28,7,28009,166,3,311,296,215,44,12,878,18,28,924
28,7,28009,167,3,256,241,210,34,15,756,4,12,772
28,7,28009,170,3,437,199,168,38,12,854,1,6,861
28,7,28009,172,3,455,302,233,52,13,1055,1,13,1069
28,7,28009,174,3,93,114,79,16,8,310,2,4,316
28,7,28009,175,3,165,216,104,33,17,535,0,21,556
28,7,28009,178,3,249,233,179,36,10,707,8,23,738
28,7,28009,179,3,435,278,261,60,23,1057,3,14,1074
28,7,28009,187,3,370,323,377,63,19,1152,1,15,1168
28,7,28009,190,3,249,347,237,36,13,882,3,37,922
28,7,28009,191,3,293,242,209,33,16,793,8,24,825
28,7,28009,194,3,240,327,291,36,12,906,7,25,938
28,7,28009,195,3,205,191,167,24,9,596,3,10,609
28,7,28009,201,3,257,183,116,54,5,615,3,7,625
28,7,28009,202,3,268,212,219,39,12,750,2,7,759
28,7,28009,203,3,212,226,174,49,14,675,3,5,683
28,7,28009,206,3,325,257,285,50,21,938,2,12,952
28,7,28009,207,3,240,285,211,38,9,783,10,14,807
28,7,28009,210,3,253,261,205,43,9,771,8,8,787
28,7,28009,211,3,345,277,273,53,20,968,1,18,987
28,7,28009,215,3,324,248,185,36,15,808,0,24,832
28,7,28009,218,3,223,290,216,39,14,782,5,15,802
28,7,28009,219,3,233,249,198,70,10,760,6,15,781
28,7,28009,222,3,184,221,302,47,10,764,0,18,782
28,7,28009,223,3,191,232,227,40,18,708,0,16,724
28,7,28009,226,3,248,214,137,39,9,647,1,11,659
28,7,28009,227,3,319,234,237,42,20,852,2,16,870
28,7,28009,230,3,350,238,201,42,8,839,3,22,864
28,7,28009,231,3,273,228,215,60,19,795,5,15,815
28,7,28009,234,3,188,183,199,43,11,624,2,14,640
28,7,28009,235,3,134,136,208,31,7,516,2,4,522
28,7,28009,238,3,289,257,224,54,12,836,3,9,848
28,7,28009,239,3,209,206,236,49,18,718,2,8,728
28,7,28009,242,3,384,299,235,70,24,1012,4,14,1030
28,7,28009,243,3,179,183,161,40,11,574,0,3,577
28,7,28009,246,3,183,192,242,43,11,671,2,4,677
28,7,28009,247,3,168,197,200,53,8,626,0,16,642
28,7,28009,250,3,251,288,187,99,7,832,0,7,839
28,7,28009,251,3,191,209,158,38,10,606,0,15,621
28,7,28009,254,3,197,195,153,95,6,646,1,13,660
28,7,28009,255,3,165,178,184,29,8,564,3,9,576
28,7,28009,258,3,193,182,165,30,11,581,2,4,587
28,8,28009,171,3,559,329,256,60,18,1222,1,9,1232
28,8,28009,180,3,366,244,178,46,17,851,1,7,859
28,8,28009,182,3,237,266,181,24,11,719,3,5,727
28,8,28009,183,3,342,196,103,30,6,677,0,10,687
28,8,28009,186,3,423,247,139,28,14,851,0,4,855
28,8,28009,197,3,434,297,192,38,18,979,2,3,984
28,8,28009,198,3,475,263,220,35,18,1011,0,14,1025
28,8,28009,199,3,352,230,209,40,13,844,2,12,858
28,8,28009,214,3,363,243,163,59,21,849,2,16,867
28,8,28038,1304,3,586,525,192,37,13,1353,3,38,1394
28,8,28038,1306,3,276,188,108,22,6,600,4,4,608
28,8,28038,1307,3,334,205,128,29,12,708,13,12,733
28,8,28038,1310,3,326,377,156,18,8,885,0,30,915
28,8,28038,1311,3,164,243,86,11,5,509,9,13,531
28,8,28038,1314,3,700,541,260,48,18,1567,20,20,1607
28,8,28038,1315,3,317,223,135,18,7,700,0,21,721
28,8,28038,1318,3,456,357,212,48,14,1087,3,32,1122
28,8,28038,1319,3,389,271,126,21,5,812,2,18,832
28,8,28038,1322,3,232,259,127,30,10,658,5,12,675
28,8,28038,1323,3,321,348,166,24,9,868,2,25,895
28,8,28038,1326,3,472,338,152,43,17,1022,6,17,1045
28,8,28038,1327,3,423,327,157,33,11,951,8,17,976
28,8,28038,1330,3,566,345,207,38,13,1169,4,26,1199
28,8,28038,1331,3,533,249,127,38,14,961,1,6,968
28,8,28038,1334,3,456,352,219,33,11,1071,18,20,1109
28,8,28038,1335,3,310,295,92,32,7,736,3,11,750
28,8,28038,1338,3,281,166,132,22,12,613,3,17,633
28,8,28038,1339,3,276,254,111,23,7,671,9,17,697
28,8,28038,1342,3,309,223,121,20,7,680,0,14,694
28,8,28038,1343,3,210,174,58,11,4,457,1,4,462
28,8,28038,1346,3,279,317,99,26,9,730,3,9,742
28,8,28038,1347,3,767,687,327,63,25,1869,3,23,1895
28,8,28038,1350,3,629,459,312,65,33,1498,8,20,1526
28,8,28038,1351,3,492,403,203,61,15,1174,1,13,1188
28,8,28038,1354,3,356,295,152,32,9,844,4,26,874
28,8,28038,1355,3,242,194,93,24,8,561,1,21,583
28,8,28038,1358,3,449,467,157,34,15,1122,4,15,1141
28,8,28038,1359,3,910,880,314,91,29,2224,18,36,2278
28,8,28038,1362,3,506,371,255,35,24,1191,6,22,1219
28,8,28038,1363,3,252,268,146,25,8,699,1,16,716
28,8,28038,1366,3,325,181,98,27,5,636,2,16,654
28,8,28038,1367,3,325,308,190,42,11,876,1,10,887
28,8,28038,1370,3,275,220,153,23,6,677,9,11,697
28,8,28038,1371,3,325,244,144,24,13,750,4,13,767
28,8,28038,1374,3,153,159,117,14,6,449,1,4,454
28,8,28038,1375,3,141,167,90,16,3,417,0,3,420
28,8,28038,1378,3,416,314,195,38,14,977,5,13,995
28,8,28038,1379,3,249,270,128,24,9,680,0,15,695
28,8,28038,1382,3,165,297,91,15,5,573,2,2,577
28,8,28038,1383,3,198,264,108,20,9,599,2,6,607
28,8,28038,1386,3,274,281,134,43,9,741,3,6,750
28,8,28038,1387,3,815,482,198,38,14,1547,0,15,1562
28,8,28038,1390,3,423,170,60,13,4,670,1,2,673
28,8,28038,1391,3,484,311,80,19,3,897,1,5,903
28,8,28038,1394,3,352,250,115,27,10,754,4,3,761
28,8,28038,1395,3,337,163,75,24,7,606,0,4,610
28,8,28038,1398,3,386,173,34,12,2,607,1,3,611
28,8,28038,1399,3,255,198,47,6,5,511,2,5,518
28,8,28038,1402,3,380,241,156,46,15,838,0,17,855
28,8,28038,1403,3,368,237,70,13,10,698,1,6,705
28,8,28038,1406,3,254,151,92,25,5,527,2,15,544
28,8,28038,1407,3,182,151,88,16,6,443,0,8,451
28,8,28038,1410,3,392,247,145,33,7,824,2,6,832
28,8,28038,1411,3,202,172,107,18,8,507,3,12,522
28,8,28038,1414,3,346,231,120,31,9,737,3,14,754
28,8,28038,1415,3,324,181,120,30,3,658,3,14,675
28,8,28038,1418,3,216,244,191,23,6,680,5,8,693
28,8,28038,1419,3,305,296,168,39,15,823,6,5,834
28,8,28038,1422,3,247,191,97,27,10,572,0,7,579
28,8,28038,1423,3,232,167,144,28,7,578,1,12,591
28,8,28038,1426,3,306,236,138,30,9,719,1,18,738
28,8,28038,1427,3,435,428,161,18,10,1052,9,28,1089
28,8,28038,1430,3,154,135,82,20,6,397,0,2,399
28,8,28038,1431,3,215,120,74,24,9,442,2,7,451
28,8,28038,1434,3,190,157,99,26,3,475,0,12,487
28,8,28038,1435,3,133,148,110,17,5,413,1,20,434
28,8,28038,1438,3,114,106,83,17,1,321,2,6,329
28,8,28038,1439,3,219,216,129,19,15,598,2,7,607
28,8,28038,1442,3,402,380,256,22,9,1069,8,15,1092
28,8,28038,1443,3,213,239,119,30,4,605,3,18,626
28,8,28038,1446,3,215,124,115,15,9,478,0,10,488
28,8,28038,1447,3,280,174,126,29,17,626,0,15,641
28,8,28038,1450,3,312,227,135,12,10,696,3,9,708
28,8,28038,1451,3,296,282,151,32,9,770,4,18,792
28,8,28038,1454,3,181,195,95,14,8,493,2,5,500
28,8,28038,1455,3,199,180,101,20,7,507,2,5,514
28,8,28038,1458,3,234,177,126,35,8,580,4,5,589
28,8,28038,1459,3,223,189,120,31,5,568,1,5,574
28,8,28038,1462,3,298,194,130,22,6,650,3,12,665
28,8,28038,1463,3,270,235,205,36,8,754,1,8,763
28,8,28038,1466,3,293,207,173,36,8,717,0,18,735
28,8,28038,1467,3,178,130,104,19,5,436,0,10,446
28,8,28038,1470,3,123,106,71,21,5,326,2,0,328
28,8,28038,1471,3,287,286,139,35,6,753,1,13,767
28,8,28038,1474,3,171,172,83,10,5,441,2,10,453
28,8,28038,1475,3,199,142,112,28,9,490,2,4,496
28,8,28038,1478,3,123,149,105,19,8,404,0,12,416
28,8,28038,1479,3,238,301,143,30,10,722,0,19,741
28,8,28038,1482,3,165,168,93,21,3,450,1,8,459
28,8,28038,1483,3,178,178,94,28,2,480,1,3,484
28,8,28038,1486,3,151,147,109,12,6,425,2,5,432
28,8,28038,1487,3,244,148,133,26,11,562,0,6,568
28,8,28038,1490,3,92,62,58,18,0,230,2,2,234
28,8,28038,1491,3,85,73,46,5,2,211,0,1,212
28,8,28038,1494,3,122,119,85,16,6,348,2,8,358
28,8,28038,1495,3,124,119,91,10,5,349,4,7,360
29,1,29003,12,3,286,102,272,59,33,752,1,28,781
29,1,29003,14,3,577,227,549,77,70,1500,15,36,1551
29,1,29003,15,3,273,118,385,58,36,870,1,27,898
29,1,29003,18,3,386,133,274,47,35,875,3,25,903
29,1,29003,19,3,287,110,296,49,29,771,3,24,798
29,1,29003,22,3,359,148,371,35,25,938,2,47,987
29,1,29003,23,3,220,94,178,30,20,542,1,24,567
29,1,29003,26,3,341,109,280,48,36,814,0,29,843
29,1,29003,27,3,433,166,384,49,34,1066,4,38,1108
29,1,29003,30,3,689,303,797,136,61,1986,5,53,2044
29,1,29003,31,3,428,227,532,55,32,1274,6,44,1324
29,1,29003,34,3,418,145,296,50,35,944,6,14,964
29,1,29003,35,3,318,106,258,38,22,742,0,20,762
29,1,29003,38,3,163,95,94,6,2,360,0,26,386
29,1,29003,39,3,102,99,214,14,6,435,2,15,452
29,1,29003,42,3,50,27,86,6,6,175,3,7,185
29,1,29003,43,3,362,167,413,52,30,1024,2,33,1059
29,1,29003,46,3,190,101,296,22,21,630,0,24,654
29,1,29003,47,3,291,123,350,31,21,816,16,36,868
29,1,29004,50,3,47,46,72,5,3,173,0,5,178
29,1,29004,51,3,41,31,72,4,0,148,0,5,153
29,1,29004,54,3,62,47,57,6,6,178,0,6,184
29,1,29004,55,3,53,48,49,7,0,157,0,5,162
29,1,29034,58,3,22,34,20,3,1,80,0,2,82
29,1,29005,59,3,274,136,113,34,10,567,0,29,596
29,1,29005,62,3,45,66,42,3,2,158,0,5,163
29,1,29005,63,3,76,53,36,3,8,176,5,2,183
29,1,29005,66,3,94,59,41,16,3,213,3,15,231
29,1,29005,67,3,61,7,41,3,1,113,0,8,121
29,1,29005,70,3,187,47,70,5,3,312,0,9,321
29,1,29005,71,3,291,47,112,9,4,463,0,27,490
29,1,29005,74,3,234,61,168,12,3,478,0,14,492
29,1,29005,75,3,111,36,71,16,2,236,0,15,251
29,1,29007,100,3,424,147,292,41,24,928,2,49,979
29,1,29007,102,3,315,201,282,22,16,836,5,39,880
29,1,29007,103,3,118,65,196,6,8,393,3,44,440
29,1,29007,106,3,35,19,47,0,2,103,0,6,109
29,1,29008,107,3,562,142,314,41,16,1075,5,31,1111
29,1,29008,110,3,227,79,289,15,7,617,3,34,654
29,1,29008,111,3,48,45,39,3,3,138,0,4,142
29,1,29008,114,3,87,66,179,7,1,340,0,21,361
29,1,29008,115,3,61,10,109,5,3,188,0,7,195
29,1,29009,118,3,139,140,188,14,6,487,0,16,503
29,1,29009,119,3,54,45,176,7,2,284,0,14,298
29,1,29011,161,3,303,163,316,29,11,822,9,42,873
29,1,29011,162,3,170,44,232,10,13,469,0,22,491
29,1,29011,163,3,88,25,60,8,2,183,0,3,186
29,1,29013,178,3,741,200,369,65,47,1422,10,52,1484
29,1,29013,179,3,703,185,355,57,25,1325,6,47,1378
29,1,29013,182,3,345,71,200,30,16,662,8,26,696
29,1,29013,183,3,425,119,235,48,22,849,2,22,873
29,1,29013,186,3,444,131,234,40,22,871,1,24,896
29,1,29013,187,3,581,148,247,37,32,1045,2,56,1103
29,1,29013,190,3,330,69,143,21,22,585,0,24,609
29,1,29013,191,3,338,84,170,25,11,628,3,19,650
29,1,29013,194,3,498,124,262,47,27,958,3,55,1016
29,1,29013,195,3,307,74,186,22,15,604,0,26,630
29,1,29013,198,3,99,19,87,5,3,213,0,9,222
29,1,29013,199,3,152,58,101,5,4,320,0,19,339
29,1,29013,202,3,107,47,58,3,5,220,0,18,238
29,1,29013,203,3,356,245,249,28,7,885,8,32,925
29,1,29013,206,3,98,101,177,5,5,386,0,22,408
29,1,29013,207,3,79,112,149,2,8,350,0,13,363
29,1,29013,210,3,47,32,29,1,1,110,1,2,113
29,1,29013,211,3,98,91,192,13,6,400,2,21,423
29,1,29013,214,3,366,128,249,18,22,783,3,46,832
29,1,29013,215,3,40,19,20,4,3,86,1,6,93
29,1,29013,218,3,127,31,78,18,4,258,2,20,280
29,1,29013,219,3,124,34,120,7,4,289,3,18,310
29,1,29016,259,3,285,104,262,43,25,719,3,36,758
29,1,29016,262,3,191,49,174,23,15,452,3,16,471
29,1,29030,398,3,319,183,484,41,12,1039,0,39,1078
29,1,29030,399,3,271,120,277,14,9,691,2,25,718
29,1,29055,402,3,92,11,36,1,1,141,0,2,143
29,1,29030,403,3,150,96,160,11,8,425,0,37,462
29,1,29030,406,3,94,39,83,8,3,227,0,10,237
29,1,29030,407,3,127,27,182,10,6,352,0,11,363
29,1,29031,410,3,227,116,186,14,7,550,3,21,574
29,1,29031,411,3,357,145,376,59,32,969,0,72,1041
29,1,29031,414,3,170,68,190,23,22,473,0,16,489
29,1,29031,415,3,221,89,240,33,28,611,1,9,621
29,1,29031,418,3,52,21,85,4,4,166,0,7,173
29,1,29031,419,3,86,37,92,20,7,242,0,12,254
29,1,29031,422,3,569,145,405,30,23,1172,0,41,1213
29,1,29031,423,3,59,23,26,2,0,110,0,2,112
29,1,29034,470,3,97,73,143,7,8,328,0,14,342
29,1,29034,471,3,190,122,184,8,7,511,0,32,543
29,1,29034,474,3,161,142,312,7,10,632,0,17,649
29,1,29034,475,3,347,157,251,29,22,806,0,12,818
29,1,29034,478,3,33,43,91,9,7,183,3,7,193
29,1,29034,479,3,29,68,47,8,1,153,0,3,156
29,1,29034,482,3,293,80,229,21,15,638,0,20,658
29,1,29034,483,3,26,10,26,0,0,62,0,4,66
29,1,29034,486,3,127,14,112,17,1,271,1,7,279
29,1,29034,487,3,102,144,61,4,7,318,0,6,324
29,1,29034,490,3,52,15,18,5,0,90,0,3,93
29,1,29034,491,3,291,165,447,18,20,941,5,45,991
29,1,29034,494,3,127,45,157,10,1,340,3,22,365
29,1,29034,495,3,133,38,178,6,2,357,0,4,361
29,1,29034,498,3,36,24,69,1,1,131,3,7,141
29,1,29034,499,3,75,86,170,24,3,358,0,13,371
29,1,29034,502,3,30,57,68,1,2,158,0,10,168
29,1,29034,503,3,18,16,45,5,2,86,1,1,88
29,1,29035,506,3,151,102,158,17,8,436,2,28,466
29,1,29035,507,3,101,49,111,10,6,277,3,6,286
29,1,29037,520,3,170,138,290,13,14,625,8,48,681
29,1,29037,522,3,129,130,271,14,13,557,0,38,595
29,1,29037,523,3,149,119,257,36,9,570,1,32,603
29,1,29037,526,3,21,4,50,4,4,83,1,4,88
29,1,29038,527,3,268,153,619,36,27,1103,1,40,1144
29,1,29038,530,3,145,114,132,16,9,416,1,24,441
29,1,29050,531,3,106,135,251,13,11,516,3,6,525
29,1,29050,534,3,155,153,214,17,10,549,9,13,571
29,1,29050,535,3,56,114,95,8,6,279,0,4,283
29,1,29039,538,3,276,157,374,29,17,853,0,47,900
29,1,29039,539,3,276,194,350,36,53,909,3,35,947
29,1,29039,542,3,263,165,387,35,21,871,5,34,910
29,1,29039,543,3,242,234,428,41,29,974,2,36,1012
29,1,29039,546,3,47,67,155,10,5,284,0,12,296
29,1,29043,575,3,315,110,340,22,26,813,3,40,856
29,1,29043,578,3,189,75,144,20,8,436,2,13,451
29,1,29043,579,3,201,93,247,24,5,570,0,24,594
29,1,29043,582,3,468,151,592,44,42,1297,5,40,1342
29,1,29043,583,3,305,99,382,36,25,847,0,30,877
29,1,29055,606,3,325,130,267,19,11,752,2,45,799
29,1,29054,607,3,421,169,407,11,3,1011,4,35,1050
29,2,29001,1,3,150,97,238,11,4,500,3,8,511
29,2,29001,2,3,480,338,615,64,40,1537,4,21,1562
29,2,29001,3,3,508,305,526,52,19,1410,0,49,1459
29,2,29002,6,3,243,139,154,19,9,564,2,11,577
29,2,29002,7,3,62,47,75,5,8,197,0,4,201
29,2,29002,10,3,443,234,424,67,19,1187,0,28,1215
29,2,29002,11,3,138,123,133,17,6,417,1,5,423
29,2,29010,122,3,368,139,310,31,19,867,3,15,885
29,2,29010,123,3,378,159,325,40,20,922,0,27,949
29,2,29010,126,3,274,187,257,19,23,760,0,26,786
29,2,29010,127,3,450,252,494,55,30,1281,7,35,1323
29,2,29010,130,3,269,138,188,38,18,651,0,15,666
29,2,29010,131,3,381,195,269,42,18,905,0,24,929
29,2,29010,134,3,172,140,183,43,14,552,0,9,561
29,2,29010,135,3,225,156,182,32,15,610,3,6,619
29,2,29010,138,3,388,172,256,36,15,867,3,25,895
29,2,29010,139,3,697,308,552,86,40,1683,2,40,1725
29,2,29010,142,3,279,119,343,34,9,784,1,20,805
29,2,29010,143,3,356,175,292,51,12,886,1,20,907
29,2,29010,146,3,220,171,274,34,11,710,0,16,726
29,2,29010,147,3,260,117,237,19,15,648,0,19,667
29,2,29052,150,3,150,20,113,7,3,293,0,4,297
29,2,29052,151,3,844,325,647,66,20,1902,3,32,1937
29,2,29052,154,3,393,97,219,32,13,754,1,10,765
29,2,29052,155,3,301,130,257,21,10,719,0,12,731
29,2,29051,158,3,528,361,497,51,14,1451,3,59,1513
29,2,29051,159,3,507,133,331,37,19,1027,3,38,1068
29,2,29018,267,3,302,198,358,34,25,917,0,21,938
29,2,29018,270,3,152,83,236,21,21,513,6,6,525
29,2,29018,271,3,266,196,372,36,19,889,1,21,911
29,2,29018,274,3,159,96,274,20,10,559,2,14,575
29,2,29018,275,3,325,172,202,27,6,732,0,10,742
29,2,29018,278,3,66,53,107,6,7,239,0,11,250
29,2,29018,279,3,266,209,305,31,24,835,3,20,858
29,2,29018,282,3,68,24,53,2,8,155,0,0,155
29,2,29018,283,3,216,181,231,28,12,668,1,11,680
29,2,29022,309,3,295,102,251,9,7,664,1,13,678
29,2,29022,310,3,244,103,290,14,7,658,0,9,667
29,2,29022,311,3,168,98,272,5,5,548,0,10,558
29,2,29025,348,3,576,427,518,51,40,1612,8,29,1649
29,2,29025,350,3,543,323,653,50,40,1609,11,35,1655
29,2,29025,351,3,450,181,434,24,40,1129,0,28,1157
29,2,29025,354,3,544,398,499,160,29,1630,7,31,1668
29,2,29025,355,3,399,283,500,44,24,1250,2,24,1276
29,2,29025,358,3,618,193,517,49,36,1413,3,18,1434
29,2,29025,359,3,303,189,230,23,17,762,5,26,793
29,2,29025,362,3,521,248,287,37,39,1132,3,34,1169
29,2,29025,363,3,293,304,387,62,18,1064,2,49,1115
29,2,29026,366,3,422,218,306,32,15,993,1,25,1019
29,2,29026,367,3,511,150,447,37,18,1163,0,37,1200
29,2,29026,370,3,154,113,143,8,5,423,0,3,426
29,2,29026,371,3,401,229,314,22,10,976,5,23,1004
29,2,29028,378,3,239,179,352,41,23,834,4,30,868
29,2,29028,379,3,309,204,324,27,24,888,0,17,905
29,2,29028,382,3,207,140,210,17,11,585,1,17,603
29,2,29028,383,3,248,192,244,19,12,715,3,7,725
29,2,29028,386,3,396,136,414,48,24,1018,0,18,1036
29,2,29029,387,3,307,173,248,9,11,748,2,11,761
29,2,29029,390,3,151,38,146,15,5,355,4,14,373
29,2,29049,391,3,263,124,172,13,3,575,3,20,598
29,2,29029,394,3,380,259,239,36,13,927,1,32,960
29,2,29029,397,3,178,166,411,16,20,791,0,25,816
29,2,29033,435,3,320,210,252,21,18,821,0,33,854
29,2,29033,438,3,522,113,167,31,12,845,0,23,868
29,2,29033,439,3,546,236,236,26,11,1055,6,24,1085
29,2,29033,442,3,303,160,199,55,12,729,3,17,749
29,2,29033,443,3,205,110,143,25,24,507,0,13,520
29,2,29033,446,3,236,164,170,26,15,611,0,6,617
29,2,29033,447,3,252,155,138,23,12,580,3,10,593
29,2,29033,450,3,230,162,155,43,8,598,3,16,617
29,2,29033,451,3,393,232,367,49,25,1066,1,35,1102
29,2,29033,454,3,219,126,189,28,14,576,2,11,589
29,2,29033,455,3,175,116,148,42,20,501,2,10,513
29,2,29033,458,3,689,287,542,58,27,1603,11,40,1654
29,2,29033,459,3,399,236,353,66,34,1088,0,27,1115
29,2,29033,462,3,206,157,255,46,23,687,0,22,709
29,2,29033,463,3,405,173,365,52,21,1016,2,17,1035
29,2,29033,466,3,514,206,497,61,21,1299,9,35,1343
29,2,29033,467,3,241,127,181,51,13,613,4,22,639
29,2,29036,508,3,105,128,145,27,7,412,6,10,428
29,2,29036,510,3,172,123,200,15,7,517,5,13,535
29,2,29036,511,3,135,104,164,18,6,427,0,0,427
29,2,29036,514,3,272,185,214,20,8,699,1,19,719
29,2,29036,515,3,268,293,356,31,20,968,7,16,991
29,2,29036,518,3,221,143,216,27,12,619,1,14,634
29,2,29036,519,3,137,102,145,26,0,410,0,21,431
29,3,29006,78,3,443,391,444,47,32,1357,10,41,1408
29,3,29006,79,3,312,337,464,52,36,1201,1,35,1237
29,3,29006,82,3,232,183,224,29,30,698,0,10,708
29,3,29006,83,3,368,291,460,36,51,1206,23,32,1261
29,3,29006,86,3,212,198,330,19,28,787,5,13,805
29,3,29006,87,3,182,166,173,14,15,550,5,9,564
29,3,29006,90,3,289,211,266,34,28,828,5,23,856
29,3,29006,91,3,163,56,141,8,2,370,1,7,378
29,3,29006,94,3,144,145,178,33,14,514,1,14,529
29,3,29006,95,3,67,82,62,8,3,222,0,6,228
29,3,29006,98,3,410,138,164,9,7,728,17,19,764
29,3,29006,99,3,7,37,4,1,1,50,0,0,50
29,3,29012,165,3,235,178,347,27,14,801,4,39,844
29,3,29012,166,3,16,6,16,1,0,39,0,2,41
29,3,29012,167,3,65,48,52,3,1,169,0,5,174
29,3,29012,170,3,86,29,142,6,3,266,0,20,286
29,3,29012,171,3,36,6,74,2,1,119,4,5,128
29,3,29012,174,3,41,18,17,11,2,89,0,8,97
29,3,29012,175,3,95,47,123,11,1,277,1,10,288
29,3,29014,220,3,389,125,261,54,10,839,7,44,890
29,3,29014,222,3,167,29,168,7,3,374,0,26,400
29,3,29014,223,3,93,20,57,15,3,188,2,15,205
29,3,29014,226,3,177,23,44,9,5,258,0,8,266
29,3,29014,227,3,140,41,34,22,9,246,0,4,250
29,3,29014,230,3,57,36,130,1,2,226,0,23,249
29,3,29014,231,3,56,13,32,5,1,107,1,1,109
29,3,29015,234,3,217,169,181,27,12,606,0,0,606
29,3,29015,235,3,32,23,33,1,1,90,0,8,98
29,3,29015,238,3,31,22,47,1,1,102,0,7,109
29,3,29015,239,3,61,71,48,4,9,193,0,7,200
29,3,29015,242,3,178,102,135,15,6,436,5,18,459
29,3,29015,243,3,64,29,37,3,0,133,0,3,136
29,3,29015,246,3,99,93,117,29,8,346,0,12,358
29,3,29015,247,3,241,90,286,46,17,680,7,36,723
29,3,29015,250,3,199,64,138,33,8,442,7,11,460
29,3,29015,251,3,380,191,395,215,20,1201,13,45,1259
29,3,29058,254,3,463,169,432,76,15,1155,2,43,1200
29,3,29058,255,3,529,159,384,46,6,1124,6,27,1157
29,3,29015,258,3,99,41,72,20,11,243,0,3,246
29,3,29017,263,3,246,127,392,19,11,795,10,10,815
29,3,29017,266,3,198,123,382,28,8,739,1,4,744
29,3,29019,284,3,239,59,205,54,11,568,4,19,591
29,3,29019,286,3,473,130,336,109,15,1063,6,32,1101
29,3,29019,287,3,299,78,241,66,16,700,14,28,742
29,3,29019,290,3,336,121,382,69,21,929,0,32,961
29,3,29019,291,3,85,49,70,8,0,212,0,2,214
29,3,29020,294,3,326,80,175,10,3,594,0,26,620
29,3,29060,295,3,483,229,339,27,18,1096,10,20,1126
29,3,29020,298,3,200,100,101,14,8,423,0,12,435
29,3,29021,299,3,380,135,383,22,15,935,3,23,961
29,3,29021,302,3,434,178,381,33,36,1062,3,39,1104
29,3,29021,303,3,242,105,141,9,13,510,0,9,519
29,3,29021,306,3,18,25,22,5,0,70,1,3,74
29,3,29021,307,3,81,71,60,8,2,222,0,5,227
29,3,29046,313,3,208,97,206,33,16,560,8,19,587
29,3,29046,314,3,142,97,191,18,7,455,1,13,469
29,3,29046,315,3,89,97,256,9,7,458,2,20,480
29,3,29023,318,3,233,48,133,42,8,464,1,7,472
29,3,29023,319,3,469,180,228,83,17,977,6,32,1015
29,3,29023,322,3,233,43,119,38,6,439,2,8,449
29,3,29023,323,3,179,75,281,45,12,592,0,21,613
29,3,29023,326,3,372,127,368,52,17,936,5,28,969
29,3,29023,327,3,345,128,228,28,13,742,5,34,781
29,3,29023,330,3,222,86,96,23,5,432,2,17,451
29,3,29023,331,3,232,156,73,24,10,495,2,37,534
29,3,29024,334,3,133,158,278,62,21,652,3,13,668
29,3,29024,335,3,107,102,191,48,10,458,0,18,476
29,3,29024,338,3,215,105,344,39,14,717,15,56,788
29,3,29024,339,3,57,51,204,14,4,330,3,9,342
29,3,29024,342,3,237,74,270,58,10,649,0,30,679
29,3,29024,343,3,88,60,147,12,3,310,4,10,324
29,3,29024,346,3,226,131,227,273,16,873,2,18,893
29,3,29024,347,3,215,131,207,264,24,841,0,41,882
29,3,29027,372,3,136,179,203,30,10,558,1,17,576
29,3,29027,374,3,89,103,147,15,5,359,1,9,369
29,3,29027,375,3,163,142,404,30,6,745,1,14,760
29,3,29047,395,3,280,116,299,64,14,773,1,16,790
29,3,29032,424,3,184,101,155,13,4,457,0,7,464
29,3,29032,426,3,225,136,111,42,9,523,2,11,536
29,3,29032,427,3,317,94,293,58,9,771,4,19,794
29,3,29053,430,3,285,179,264,136,17,881,0,32,913
29,3,29032,431,3,241,157,141,29,10,578,1,23,602
29,3,29032,434,3,116,39,120,14,4,293,1,11,305
29,3,29040,547,3,157,68,173,14,5,417,5,28,450
29,3,29040,550,3,138,46,198,16,8,406,8,16,430
29,3,29057,551,3,246,94,257,50,22,669,2,26,697
29,3,29040,554,3,35,12,32,3,4,86,0,3,89
29,3,29040,555,3,107,105,108,8,1,329,2,14,345
29,3,29041,558,3,347,174,523,54,22,1120,2,39,1161
29,3,29041,559,3,216,266,370,48,28,928,0,46,974
29,3,29041,562,3,313,152,366,59,31,921,3,23,947
29,3,29041,563,3,206,244,350,60,29,889,3,37,929
29,3,29041,566,3,91,194,194,24,5,508,2,9,519
29,3,29041,567,3,115,61,241,15,12,444,1,27,472
29,3,29042,570,3,457,159,410,69,24,1119,12,25,1156
29,3,29042,571,3,316,131,357,72,18,894,9,19,922
29,3,29042,574,3,347,155,402,54,34,992,9,24,1025
29,3,29059,586,3,218,128,325,55,16,742,1,14,757
29,3,29059,587,3,261,137,347,64,13,822,0,21,843
29,3,29044,590,3,494,162,519,97,34,1306,3,24,1333
29,3,29044,591,3,457,244,550,71,32,1354,3,37,1394
29,3,29044,594,3,280,85,282,42,17,706,0,15,721
29,3,29044,595,3,396,110,392,60,25,983,5,32,1020
29,3,29044,598,3,213,119,365,22,19,738,2,27,767
29,3,29044,599,3,300,156,341,31,16,844,3,24,871
29,3,29048,602,3,117,113,370,18,13,631,3,31,665
29,3,29048,603,3,105,92,190,18,8,413,2,20,435
30,1,30015,320,3,130,153,133,3,2,421,0,9,430
30,1,30015,322,3,197,220,183,8,0,608,0,8,616
30,1,30015,323,3,171,220,173,11,6,581,1,9,591
30,1,30015,326,3,102,136,110,4,3,355,0,5,360
30,1,30015,327,3,114,147,110,5,3,379,0,8,387
30,1,30015,330,3,363,337,327,10,5,1042,0,17,1059
30,1,30015,331,3,125,182,234,8,4,553,1,8,562
30,1,30015,334,3,124,245,64,9,2,444,2,17,463
30,1,30015,335,3,163,230,112,8,10,523,0,13,536
30,1,30015,338,3,215,247,88,1,3,554,0,13,567
30,1,30062,1403,3,249,81,65,0,0,395,0,3,398
30,1,30062,1406,3,269,217,37,1,0,524,0,6,530
30,1,30062,1407,3,54,163,38,0,0,255,0,1,256
30,1,30062,1410,3,65,204,75,0,2,346,2,7,355
30,1,30062,1411,3,136,224,105,0,1,466,0,4,470
30,1,30122,2776,3,570,241,89,11,1,912,4,16,932
30,1,30122,2778,3,122,56,12,1,1,192,1,0,193
30,1,30122,2779,3,91,58,19,0,1,169,0,5,174
30,1,30122,2782,3,42,76,15,2,1,136,0,5,141
30,1,30122,2783,3,28,116,11,0,2,157,0,11,168
30,1,30122,2786,3,190,116,34,2,2,344,2,10,356
30,1,30122,2787,3,138,142,19,0,2,301,13,7,321
30,1,30122,2790,3,197,318,65,11,3,594,4,13,611
30,1,30122,2791,3,91,65,9,16,1,182,0,3,185
30,1,30122,2794,3,163,60,23,3,0,249,0,8,257
30,1,30122,2795,3,178,39,6,1,0,224,1,3,228
30,1,30122,2798,3,122,82,30,7,1,242,0,17,259
30,1,30122,2799,3,131,33,11,2,3,180,0,4,184
30,1,30122,2802,3,240,155,42,0,0,437,3,9,449
30,1,30122,2803,3,42,63,17,0,0,122,0,7,129
30,1,30124,2814,3,179,104,84,5,0,372,1,22,395
30,1,30124,2815,3,265,204,107,10,8,594,4,4,602
30,1,30124,2818,3,170,255,86,11,4,526,0,5,531
30,1,30124,2819,3,572,394,228,29,14,1237,4,18,1259
30,1,30124,2822,3,182,264,63,8,5,522,0,10,532
30,1,30124,2823,3,251,198,128,17,4,598,1,15,614
30,1,30124,2826,3,178,79,96,3,3,359,6,11,376
30,1,30124,2827,3,232,127,153,7,7,526,8,9,543
30,1,30124,2830,3,220,298,108,7,11,644,2,16,662
30,1,30124,2831,3,275,224,79,9,5,592,1,13,606
30,1,30124,2834,3,194,97,139,12,4,446,1,18,465
30,1,30124,2835,3,339,260,184,16,8,807,6,23,836
30,1,30124,2838,3,162,157,173,13,0,505,3,16,524
30,1,30124,2839,3,151,153,179,10,6,499,3,17,519
30,1,30124,2842,3,58,15,17,1,0,91,0,9,100
30,1,30124,2843,3,106,34,5,1,0,146,0,6,152
30,1,30124,2846,3,22,39,9,0,0,70,1,1,72
30,1,30124,2847,3,20,51,12,0,0,83,0,1,84
30,1,30124,2850,3,96,103,45,2,0,246,0,10,256
30,1,30124,2851,3,74,36,32,1,0,143,5,9,157
30,1,30124,2854,3,109,95,29,0,1,234,0,9,243
30,1,30124,2855,3,128,66,92,0,6,292,0,0,292
30,1,30124,2858,3,112,69,68,1,0,250,0,11,261
30,1,30124,2859,3,446,165,145,77,9,842,4,36,882
30,1,30124,2862,3,268,139,183,18,4,612,16,19,647
30,1,30124,2863,3,269,142,87,14,7,519,2,25,546
30,1,30124,2866,3,72,51,22,4,2,151,2,4,157
30,1,30124,2867,3,137,38,43,2,3,223,1,0,224
30,1,30124,2870,3,96,131,154,9,1,391,3,5,399
30,1,30124,2871,3,164,167,209,13,8,561,4,12,577
30,1,30124,2874,3,37,70,32,0,0,139,2,5,146
30,1,30124,2875,3,190,124,111,1,2,428,1,23,452
30,1,30124,2878,3,78,88,33,2,1,202,0,7,209
30,1,30124,2879,3,169,117,28,1,1,316,1,16,333
30,1,30124,2882,3,205,95,77,16,2,395,0,10,405
30,1,30124,2883,3,153,208,53,3,5,422,0,14,436
30,1,30124,2886,3,55,74,36,1,2,168,0,7,175
30,1,30124,2887,3,50,107,13,1,1,172,0,3,175
30,1,30124,2890,3,20,10,6,0,0,36,0,3,39
30,1,30124,2891,3,75,46,80,1,1,203,1,9,213
30,1,30124,2894,3,86,63,14,1,0,164,0,1,165
30,1,30124,2895,3,190,145,212,0,1,548,5,19,572
30,1,30133,3219,3,175,90,94,9,1,369,0,23,392
30,1,30133,3222,3,191,74,91,20,6,382,1,8,391
30,1,30133,3223,3,256,101,131,16,6,510,2,21,533
30,1,30133,3226,3,154,127,70,6,11,368,3,14,385
30,1,30133,3227,3,407,167,218,18,8,818,9,20,847
30,1,30133,3230,3,312,193,121,18,5,649,2,15,666
30,1,30133,3231,3,179,118,86,8,3,394,3,9,406
30,1,30133,3234,3,298,75,67,3,2,445,0,9,454
30,1,30133,3235,3,214,99,110,8,8,439,4,13,456
30,1,30133,3238,3,308,54,86,5,2,455,5,15,475
30,1,30133,3239,3,362,91,141,13,4,611,4,4,619
30,1,30133,3242,3,209,100,63,12,4,388,6,8,402
30,1,30133,3243,3,253,111,114,20,1,499,6,17,522
30,1,30133,3246,3,186,76,123,13,9,407,7,9,423
30,1,30133,3247,3,185,85,127,8,4,409,2,3,414
30,1,30133,3250,3,67,25,61,5,3,161,3,3,167
30,1,30133,3251,3,134,49,103,10,2,298,10,4,312
30,1,30133,3254,3,73,39,49,3,1,165,1,9,175
30,1,30133,3255,3,206,43,38,2,1,290,1,1,292
30,1,30133,3258,3,53,26,11,0,0,90,0,0,90
30,1,30151,3543,3,329,365,94,1,3,792,2,4,798
30,1,30151,3546,3,263,354,31,2,2,652,1,7,660
30,1,30151,3547,3,29,111,9,0,0,149,0,0,149
30,1,30151,3550,3,150,493,17,10,2,672,0,17,689
30,1,30153,3572,3,296,113,78,4,7,498,0,13,511
30,1,30153,3574,3,61,69,15,0,0,145,0,4,149
30,1,30153,3575,3,54,21,26,1,0,102,0,3,105
30,1,30153,3578,3,141,165,5,1,1,313,1,7,321
30,1,30153,3579,3,113,19,5,0,0,137,0,0,137
30,1,30153,3582,3,77,16,7,0,0,100,0,3,103
30,1,30153,3583,3,51,61,6,2,1,121,0,2,123
30,1,30153,3586,3,221,116,44,4,0,385,0,16,401
30,1,30153,3587,3,58,41,29,0,0,128,0,7,135
30,1,30153,3590,3,116,50,56,1,1,224,0,0,224
30,1,30154,3591,3,13,75,179,1,0,268,0,4,272
30,1,30154,3594,3,16,104,40,1,2,163,0,2,165
30,1,30154,3595,3,145,209,185,6,2,547,3,20,570
30,1,30155,3598,3,464,363,43,1,3,874,0,6,880
30,1,30155,3599,3,312,329,53,3,1,698,2,20,720
30,1,30155,3602,3,193,38,13,1,1,246,0,11,257
30,1,30155,3603,3,224,301,98,5,3,631,1,19,651
30,1,30155,3606,3,236,140,35,1,3,415,0,1,416
30,1,30155,3607,3,178,111,83,1,1,374,0,8,382
30,1,30160,3706,3,119,126,175,4,0,424,0,18,442
30,1,30160,3707,3,182,193,200,2,6,583,0,22,605
30,1,30160,3710,3,200,168,355,3,5,731,0,23,754
30,1,30160,3711,3,272,297,376,10,5,960,0,13,973
30,1,30160,3714,3,242,210,283,4,5,744,0,15,759
30,1,30160,3715,3,95,83,181,0,14,373,0,16,389
30,1,30160,3718,3,115,99,161,2,28,405,2,22,429
30,1,30160,3719,3,78,202,228,1,1,510,3,21,534
30,1,30160,3722,3,107,33,89,1,2,232,0,11,243
30,1,30160,3723,3,150,153,137,3,4,447,3,40,490
30,1,30160,3726,3,95,197,74,0,1,367,0,22,389
30,1,30160,3727,3,135,152,164,0,0,451,0,24,475
30,1,30160,3730,3,76,78,206,0,60,420,0,22,442
30,1,30160,3731,3,61,50,142,1,64,318,0,14,332
30,1,30160,3734,3,74,64,158,1,9,306,3,30,339
30,1,30160,3735,3,76,95,104,0,46,321,0,7,328
30,1,30207,4696,3,74,209,135,12,4,434,2,6,442
30,1,30207,4698,3,179,255,228,32,5,699,6,4,709
30,1,30207,4699,3,194,248,261,28,3,734,1,14,749
30,1,30207,4702,3,142,254,77,3,4,480,1,18,499
30,1,30207,4703,3,136,230,80,22,4,472,3,40,515
30,1,30207,4706,3,53,91,88,3,0,235,4,9,248
30,1,30207,4707,3,128,237,110,17,1,493,6,21,520
30,1,30207,4710,3,104,215,239,17,3,578,3,26,607
30,1,30207,4711,3,119,212,75,6,4,416,1,15,432
30,2,30028,482,3,134,315,295,9,9,762,1,47,810
30,2,30028,483,3,127,64,181,5,10,387,1,29,417
30,2,30028,486,3,54,176,199,0,1,430,0,45,475
30,2,30028,487,3,183,110,120,0,4,417,2,43,462
30,2,30028,490,3,170,440,212,1,3,826,0,45,871
30,2,30028,491,3,99,383,106,1,5,594,0,10,604
30,2,30037,695,3,243,241,97,5,5,591,1,16,608
30,2,30037,698,3,250,91,36,2,2,381,1,4,386
30,2,30037,699,3,123,164,32,2,1,322,0,1,323
30,2,30037,702,3,85,192,14,1,2,294,1,6,301
30,2,30037,703,3,211,360,23,0,0,594,0,11,605
30,2,30057,1320,3,168,99,490,5,0,762,0,50,812
30,2,30057,1322,3,236,97,210,0,2,545,0,23,568
30,2,30057,1323,3,184,118,148,2,1,453,0,28,481
30,2,30057,1326,3,161,115,124,3,2,405,3,31,439
30,2,30057,1327,3,140,118,204,6,6,474,0,29,503
30,2,30058,1330,3,76,48,74,1,1,200,0,9,209
30,2,30058,1331,3,153,112,135,1,0,401,0,22,423
30,2,30058,1334,3,67,137,266,8,4,482,2,18,502
30,2,30060,1343,3,124,235,190,65,11,625,3,32,660
30,2,30060,1346,3,76,171,136,38,11,432,0,8,440
30,2,30060,1347,3,212,179,291,15,14,711,2,29,742
30,2,30060,1350,3,52,104,209,6,7,378,1,16,395
30,2,30060,1351,3,166,173,334,8,13,694,0,42,736
30,2,30060,1354,3,65,75,95,0,4,239,2,6,247
30,2,30060,1355,3,76,103,99,3,3,284,0,4,288
30,2,30060,1358,3,103,264,186,5,8,566,3,23,592
30,2,30060,1359,3,150,203,290,4,4,651,0,33,684
30,2,30060,1362,3,142,154,166,9,10,481,0,24,505
30,2,30060,1363,3,41,177,113,2,15,348,1,44,393
30,2,30060,1366,3,63,207,178,5,8,461,2,24,487
30,2,30060,1367,3,37,80,114,7,1,239,0,13,252
30,2,30060,1370,3,94,109,80,12,4,299,0,9,308
30,2,30060,1371,3,51,152,312,3,8,526,0,28,554
30,2,30060,1374,3,222,75,56,1,6,360,0,8,368
30,2,30060,1375,3,64,66,204,4,0,338,0,30,368
30,2,30060,1378,3,129,173,109,4,5,420,1,38,459
30,2,30060,1379,3,10,103,35,5,0,153,0,4,157
30,2,30060,1382,3,71,98,61,1,0,231,0,19,250
30,2,30060,1383,3,36,72,154,4,24,290,0,19,309
30,2,30060,1386,3,59,104,45,4,13,225,1,15,241
30,2,30060,1387,3,23,54,42,0,4,123,0,15,138
30,2,30065,1463,3,233,257,78,6,2,576,1,10,587
30,2,30065,1466,3,146,113,2,1,0,262,0,1,263
30,2,30065,1467,3,351,438,14,2,2,807,1,31,839
30,2,30065,1470,3,345,316,26,1,2,690,0,7,697
30,2,30065,1471,3,291,366,20,1,1,679,1,21,701
30,2,30074,1623,3,143,266,346,35,11,801,6,36,843
30,2,30074,1626,3,60,75,61,1,0,197,0,35,232
30,2,30074,1627,3,51,74,94,2,4,225,0,7,232
30,2,30074,1630,3,46,277,111,1,0,435,0,0,435
30,2,30074,1631,3,12,50,47,1,1,111,3,7,121
30,2,30074,1634,3,41,65,175,5,2,288,1,1,290
30,2,30074,1635,3,29,71,96,2,1,199,0,11,210
30,2,30074,1638,3,58,240,81,1,5,385,0,29,414
30,2,30074,1639,3,25,112,102,3,3,245,0,8,253
30,2,30078,1688,3,112,100,69,4,0,285,0,10,295
30,2,30078,1690,3,44,46,32,0,1,123,0,21,144
30,2,30078,1691,3,222,116,47,3,3,391,0,44,435
30,2,30078,1694,3,340,66,98,11,4,519,0,20,539
30,2,30078,1695,3,157,244,113,4,5,523,0,28,551
30,2,30078,1698,3,50,12,2,0,0,64,0,56,120
30,2,30078,1699,3,100,16,15,0,0,131,0,24,155
30,2,30080,1718,3,219,477,151,5,11,863,1,6,870
30,2,30080,1719,3,264,428,114,7,6,819,3,15,837
30,2,30080,1722,3,153,211,12,2,1,379,0,5,384
30,2,30080,1723,3,235,331,22,0,0,588,0,17,605
30,2,30082,1731,3,88,253,307,9,16,673,0,33,706
30,2,30082,1734,3,88,70,312,8,6,484,0,17,501
30,2,30082,1735,3,81,108,147,2,7,345,0,10,355
30,2,30082,1738,3,126,158,351,7,11,653,2,25,680
30,2,30082,1739,3,100,205,211,16,2,534,0,30,564
30,2,30082,1742,3,243,381,153,20,2,799,1,37,837
30,2,30082,1743,3,56,154,200,4,3,417,0,25,442
30,2,30082,1746,3,84,331,308,6,6,735,0,23,758
30,2,30082,1747,3,77,119,186,10,4,396,0,22,418
30,2,30082,1750,3,127,63,349,4,3,546,1,11,558
30,2,30082,1751,3,42,51,201,2,2,298,0,20,318
30,2,30082,1754,3,49,253,391,1,4,698,5,11,714
30,2,30082,1755,3,49,135,135,3,0,322,0,9,331
30,2,30082,1758,3,44,144,206,5,1,400,0,11,411
30,2,30082,1759,3,29,147,115,0,2,293,0,10,303
30,2,30082,1762,3,6,120,201,0,0,327,0,18,345
30,2,30082,1763,3,46,301,274,4,2,627,0,67,694
30,2,30130,3067,3,279,269,324,28,3,903,0,23,926
30,2,30130,3070,3,298,295,283,17,3,896,0,26,922
30,2,30130,3071,3,199,222,255,11,2,689,0,13,702
30,2,30130,3074,3,261,196,176,2,5,640,0,31,671
30,2,30130,3075,3,51,33,53,0,1,138,0,5,143
30,2,30130,3078,3,60,27,36,2,2,127,0,10,137
30,2,30130,3079,3,160,73,177,4,0,414,0,18,432
30,2,30156,3609,3,313,168,96,11,4,592,0,15,607
30,2,30156,3610,3,156,174,51,9,2,392,2,9,403
30,2,30156,3611,3,504,392,133,11,4,1044,0,9,1053
30,2,30156,3614,3,569,323,117,19,1,1029,0,27,1056
30,2,30156,3615,3,333,434,119,21,6,913,0,13,926
30,2,30156,3618,3,344,460,155,43,10,1012,0,12,1024
30,2,30156,3619,3,338,472,138,28,7,983,1,23,1007
30,2,30156,3622,3,246,212,73,14,0,545,0,15,560
30,2,30156,3623,3,276,180,89,7,3,555,0,6,561
30,2,30156,3626,3,159,29,4,0,0,192,0,5,197
30,2,30156,3627,3,61,46,6,0,0,113,0,5,118
30,2,30156,3630,3,286,130,24,0,0,440,0,12,452
30,2,30156,3631,3,451,154,37,3,0,645,0,13,658
30,2,30156,3634,3,461,105,76,3,2,647,1,10,658
30,2,30156,3635,3,450,174,83,0,1,708,0,31,739
30,2,30156,3638,3,299,91,81,2,1,474,0,21,495
30,2,30156,3639,3,367,200,63,1,0,631,1,14,646
30,2,30156,3642,3,179,109,82,1,1,372,0,8,380
30,2,30156,3643,3,376,317,100,4,17,814,1,6,821
30,2,30156,3646,3,210,138,22,1,1,372,1,5,378
30,2,30156,3647,3,375,186,40,0,1,602,0,2,604
30,2,30156,3650,3,305,142,119,1,0,567,0,20,587
30,2,30156,3651,3,242,246,64,1,0,553,0,18,571
30,2,30156,3654,3,371,200,35,0,0,606,0,12,618
30,2,30156,3655,3,276,157,55,1,5,494,1,12,507
30,2,30156,3658,3,190,73,54,0,0,317,0,6,323
30,2,30156,3659,3,279,129,41,0,2,451,0,5,456
30,2,30156,3662,3,93,32,20,2,0,147,0,2,149
30,2,30156,3663,3,517,345,78,7,7,954,1,21,976
30,2,30156,3666,3,205,79,81,1,2,368,1,15,384
30,2,30156,3667,3,368,325,61,9,7,770,0,20,790
30,2,30169,3799,3,126,402,500,47,5,1080,1,27,1108
30,2,30169,3802,3,6,24,83,0,1,114,1,3,118
30,2,30169,3803,3,55,289,536,4,1,885,0,15,900
30,2,30179,4001,3,142,331,516,38,6,1033,3,44,1080
30,2,30179,4002,3,36,21,76,0,1,134,0,5,139
30,2,30179,4003,3,159,258,345,2,0,764,0,33,797
30,2,30179,4006,3,38,113,78,1,0,230,0,5,235
30,2,30179,4007,3,17,53,54,3,2,129,0,14,143
30,2,30198,4551,3,178,120,295,7,2,602,0,35,637
30,2,30198,4554,3,91,13,123,2,1,230,0,16,246
30,2,30198,4555,3,104,24,147,0,3,278,0,13,291
30,2,30202,4598,3,239,109,67,7,3,425,0,35,460
30,2,30202,4599,3,108,105,179,3,2,397,0,19,416
30,2,30202,4602,3,24,58,199,3,1,285,2,39,326
30,2,30202,4603,3,85,119,492,0,8,704,1,39,744
30,3,30008,109,3,198,131,244,40,8,621,2,12,635
30,3,30008,110,3,246,186,319,35,9,795,2,34,831
30,3,30008,111,3,206,126,214,36,3,585,4,14,603
30,3,30008,114,3,237,147,321,26,5,736,0,18,754
30,3,30008,115,3,201,138,193,29,11,572,2,7,581
30,3,30008,118,3,118,110,176,21,4,429,3,9,441
30,3,30008,119,3,110,64,144,27,2,347,0,11,358
30,3,30008,122,3,79,50,78,5,1,213,2,0,215
30,3,30008,123,3,115,208,130,5,5,463,4,18,485
30,3,30008,126,3,56,71,91,30,2,250,2,7,259
30,3,30008,127,3,12,7,90,0,0,109,0,2,111
30,3,30008,130,3,396,164,190,43,10,803,1,25,829
30,3,30008,131,3,214,113,112,15,6,460,1,14,475
30,3,30008,134,3,83,43,89,4,5,224,0,0,224
30,3,30008,135,3,181,147,223,9,6,566,1,37,604
30,3,30008,138,3,57,54,152,4,3,270,0,20,290
30,3,30008,139,3,85,37,328,6,5,461,1,27,489
30,3,30008,142,3,182,102,233,6,6,529,1,31,561
30,3,30008,143,3,115,102,130,8,1,356,4,8,368
30,3,30008,146,3,103,173,410,12,9,707,3,22,732
30,3,30008,147,3,189,148,186,18,5,546,0,24,570
30,3,30008,150,3,158,84,248,42,1,533,2,12,547
30,3,30008,151,3,74,108,191,18,8,399,2,10,411
30,3,30008,154,3,109,69,142,4,3,327,1,14,342
30,3,30008,155,3,136,135,376,18,5,670,2,21,693
30,3,30008,158,3,41,71,283,73,3,471,0,19,490
30,3,30008,159,3,53,54,277,8,4,396,2,16,414
30,3,30008,162,3,270,109,372,48,12,811,2,28,841
30,3,30008,163,3,178,84,297,41,8,608,0,16,624
30,3,30008,166,3,112,36,98,9,3,258,2,9,269
30,3,30008,167,3,138,111,188,18,2,457,8,23,488
30,3,30008,170,3,93,130,114,6,8,351,3,24,378
30,3,30008,171,3,152,66,421,49,7,695,0,41,736
30,3,30008,174,3,77,132,103,2,3,317,3,9,329
30,3,30008,175,3,207,127,184,13,6,537,3,26,566
30,3,30035,656,3,284,282,143,26,7,742,7,17,766
30,3,30035,658,3,181,182,123,24,2,512,0,4,516
30,3,30035,659,3,265,392,141,3,7,808,2,42,852
30,3,30035,662,3,155,126,34,0,1,316,0,8,324
30,3,30035,663,3,244,261,108,3,3,619,1,13,633
30,3,30035,666,3,245,314,207,5,4,775,3,29,807
30,3,30035,667,3,476,516,133,10,6,1141,5,25,1171
30,3,30035,670,3,98,182,49,3,2,334,2,4,340
30,3,30036,671,3,116,99,256,7,7,485,0,15,500
30,3,30036,674,3,87,109,223,17,11,447,0,7,454
30,3,30036,675,3,87,97,197,23,14,418,0,12,430
30,3,30036,678,3,166,39,181,11,11,408,2,4,414
30,3,30036,679,3,107,115,165,8,4,399,1,11,411
30,3,30036,682,3,89,166,224,25,11,515,0,5,520
30,3,30036,683,3,48,33,69,9,5,164,0,4,168
30,3,30036,686,3,78,93,95,7,5,278,3,11,292
30,3,30036,687,3,96,98,170,13,10,387,0,8,395
30,3,30036,690,3,204,117,191,11,11,534,3,22,559
30,3,30036,691,3,59,52,85,6,0,202,0,5,207
30,3,30036,694,3,239,224,171,40,15,689,3,22,714
30,3,30152,3551,3,141,258,245,20,2,666,0,18,684
30,3,30152,3554,3,91,146,161,21,8,427,0,10,437
30,3,30152,3555,3,123,102,47,0,0,272,1,5,278
30,3,30152,3558,3,252,226,164,7,2,651,0,22,673
30,3,30152,3559,3,122,172,15,0,2,311,1,15,327
30,3,30152,3562,3,61,76,23,2,0,162,0,4,166
30,3,30152,3563,3,124,266,142,5,2,539,0,10,549
30,3,30152,3566,3,178,211,42,54,1,486,1,40,527
30,3,30152,3567,3,87,191,63,3,1,345,0,16,361
30,3,30152,3570,3,103,118,57,6,0,284,1,10,295
30,3,30152,3571,3,94,25,10,0,1,130,0,5,135
30,3,30166,3763,3,272,289,442,35,16,1054,1,23,1078
30,3,30166,3766,3,247,186,167,24,10,634,0,26,660
30,3,30166,3767,3,133,125,73,10,3,344,1,17,362
30,3,30166,3770,3,171,315,166,11,10,673,1,20,694
30,3,30166,3771,3,113,125,76,2,0,316,3,9,328
30,3,30188,4096,3,77,30,14,1,1,123,3,4,130
30,3,30188,4098,3,132,78,99,16,3,328,0,9,337
30,3,30188,4099,3,304,200,170,43,25,742,0,13,755
30,3,30188,4102,3,283,167,174,28,11,663,1,5,669
30,3,30188,4103,3,297,200,186,25,16,724,8,22,754
30,3,30188,4106,3,216,179,145,48,3,591,0,15,606
30,3,30188,4107,3,318,233,217,34,16,818,7,19,844
30,3,30188,4110,3,202,127,126,22,7,484,1,14,499
30,3,30188,4111,3,190,109,104,28,8,439,3,7,449
30,3,30188,4114,3,267,156,145,44,11,623,2,8,633
30,3,30188,4115,3,358,261,205,33,11,868,2,28,898
30,3,30188,4118,3,426,234,244,39,17,960,4,33,997
30,3,30188,4119,3,233,165,147,27,12,584,7,11,602
30,3,30188,4122,3,254,150,141,41,19,605,1,9,615
30,3,30188,4123,3,167,131,99,39,7,443,1,3,447
30,3,30188,4126,3,243,147,171,37,17,615,2,15,632
30,3,30188,4127,3,191,126,98,19,5,439,1,8,448
30,3,30188,4130,3,596,313,257,72,21,1259,1,16,1276
30,3,30188,4131,3,107,101,106,23,9,346,4,9,359
30,3,30188,4134,3,130,95,70,12,4,311,0,4,315
30,3,30188,4135,3,388,266,220,50,22,946,2,14,962
30,3,30188,4138,3,303,227,223,58,20,831,1,5,837
30,3,30188,4139,3,252,110,137,38,10,547,5,9,561
30,3,30188,4142,3,382,270,272,59,27,1010,11,15,1036
30,3,30188,4143,3,495,300,374,66,27,1262,4,38,1304
30,3,30188,4146,3,317,132,158,39,9,655,4,10,669
30,3,30188,4147,3,175,63,86,27,2,353,0,8,361
30,3,30188,4150,3,265,116,52,8,3,444,1,15,460
30,3,30188,4151,3,25,39,10,2,0,76,0,6,82
30,3,30188,4154,3,498,214,146,19,4,881,8,25,914
30,3,30188,4155,3,523,333,374,41,19,1290,2,24,1316
30,3,30188,4158,3,227,84,109,32,16,468,5,23,496
30,3,30188,4159,3,557,220,294,25,21,1117,11,32,1160
30,3,30188,4162,3,116,63,54,3,3,239,1,9,249
30,3,30188,4163,3,112,76,141,6,2,337,2,13,352
30,3,30188,4166,3,230,42,45,18,2,337,4,16,357
30,3,30188,4167,3,240,150,136,21,10,557,8,28,593
30,3,30188,4170,3,160,167,142,11,2,482,0,24,506
30,4,30029,492,3,335,158,157,31,14,695,2,6,703
30,4,30029,494,3,378,187,142,32,15,754,0,10,764
30,4,30029,495,3,329,175,102,43,20,669,0,10,679
30,4,30029,498,3,211,150,63,23,14,461,1,4,466
30,4,30029,499,3,281,167,123,21,5,597,1,3,601
30,4,30029,502,3,355,161,118,24,15,673,1,5,679
30,4,30029,503,3,200,110,116,16,8,450,6,5,461
30,4,30029,506,3,433,259,246,30,21,989,5,16,1010
30,4,30029,507,3,380,248,184,40,11,863,2,11,876
30,4,30029,510,3,578,296,192,51,22,1139,3,11,1153
30,4,30029,511,3,815,308,164,43,20,1350,2,15,1367
30,4,30029,514,3,515,257,172,20,27,991,0,18,1009
30,4,30029,515,3,399,199,146,33,9,786,0,7,793
30,4,30029,518,3,325,151,123,27,10,636,0,19,655
30,4,30029,519,3,296,200,167,17,18,698,2,9,709
30,4,30029,522,3,553,210,205,34,15,1017,5,16,1038
30,4,30029,523,3,432,230,232,34,15,943,0,14,957
30,4,30029,526,3,326,210,128,16,6,686,0,4,690
30,4,30029,527,3,392,163,161,24,10,750,4,10,764
30,4,30029,530,3,381,242,187,28,8,846,1,8,855
30,4,30029,531,3,180,179,85,21,6,471,1,3,475
30,4,30029,534,3,284,157,140,24,9,614,4,10,628
30,4,30029,535,3,251,118,102,27,7,505,0,4,509
30,4,30029,538,3,201,93,97,15,11,417,0,10,427
30,4,30029,539,3,223,104,69,11,7,414,1,0,415
30,4,30029,542,3,106,54,97,0,2,259,1,2,262
30,4,30029,543,3,396,140,133,4,4,677,1,13,691
30,4,30029,546,3,130,139,114,3,6,392,2,2,396
30,4,30029,547,3,133,107,79,1,4,324,1,2,327
30,4,30029,550,3,279,229,120,16,9,653,0,12,665
30,4,30029,551,3,265,160,100,23,8,556,0,13,569
30,4,30029,554,3,235,146,130,17,6,534,1,19,554
30,4,30029,555,3,203,81,102,6,1,393,0,6,399
30,4,30029,558,3,225,114,153,9,9,510,1,16,527
30,4,30029,559,3,264,169,187,16,6,642,1,8,651
30,4,30029,562,3,441,357,246,12,5,1061,0,26,1087
30,4,30029,563,3,269,156,133,11,8,577,4,7,588
30,4,30029,566,3,265,100,86,10,6,467,1,10,478
30,4,30029,567,3,328,176,181,23,12,720,3,14,737
30,4,30029,570,3,707,606,361,33,14,1721,11,31,1763
30,4,30029,571,3,426,309,248,25,11,1019,0,22,1041
30,4,30029,574,3,285,121,120,19,15,560,0,18,578
30,4,30029,575,3,180,110,133,17,9,449,0,14,463
30,4,30029,578,3,231,145,62,14,5,457,0,6,463
30,4,30029,579,3,227,137,90,10,6,470,0,5,475
30,4,30029,582,3,320,154,104,25,17,620,3,8,631
30,4,30029,583,3,169,158,113,14,4,458,0,5,463
30,4,30029,586,3,275,467,215,18,10,985,1,25,1011
30,4,30029,587,3,220,381,148,17,17,783,6,0,789
30,4,30192,4366,3,443,319,198,31,16,1007,5,28,1040
30,4,30192,4367,3,376,252,192,28,9,857,4,19,880
30,4,30192,4382,3,2803,1728,1288,166,93,6078,15,133,6226
30,4,30192,4383,3,217,228,130,11,18,604,4,16,624
30,4,30192,4386,3,293,115,177,55,12,652,0,8,660
30,4,30192,4390,3,585,257,248,71,25,1186,0,16,1202
30,4,30192,4408,3,222,149,92,25,15,503,0,12,515
30,4,30192,4410,3,250,101,103,25,13,492,0,14,506
30,4,30192,4411,3,280,171,133,19,9,612,0,16,628
30,4,30192,4414,3,309,171,173,25,4,682,0,6,688
30,4,30192,4415,3,209,101,65,8,5,388,4,197,589
30,4,30192,4418,3,140,82,70,8,8,308,0,10,318
30,4,30192,4419,3,205,138,92,10,10,455,2,10,467
30,4,30192,4422,3,180,98,67,11,9,365,2,6,373
30,4,30192,4423,3,273,163,129,13,13,591,0,10,601
30,4,30192,4426,3,182,119,112,18,3,434,0,5,439
30,4,30192,4427,3,248,167,95,32,13,555,0,8,563
30,4,30192,4430,3,277,119,85,17,4,502,0,9,511
30,4,30192,4431,3,333,149,100,15,9,606,2,11,619
30,4,30192,4434,3,368,175,98,33,10,684,1,9,694
30,4,30192,4435,3,282,154,73,21,8,538,0,9,547
30,4,30192,4438,3,189,119,98,17,8,431,0,10,441
30,4,30192,4439,3,221,132,96,22,6,477,0,6,483
30,4,30192,4442,3,298,152,131,33,9,623,3,9,635
30,4,30192,4443,3,204,117,84,16,7,428,5,1,434
30,4,30192,4446,3,285,97,98,10,7,497,3,18,518
30,4,30192,4447,3,433,166,164,21,15,799,6,13,818
30,4,30192,4450,3,266,103,77,10,4,460,1,13,474
30,4,30192,4451,3,226,114,69,10,5,424,0,7,431
30,4,30192,4454,3,320,151,151,16,13,651,5,9,665
30,4,30192,4455,3,203,99,84,25,10,421,1,3,425
30,4,30192,4458,3,364,223,104,27,15,733,0,7,740
30,4,30192,4459,3,216,116,114,17,11,474,2,5,481
30,4,30192,4462,3,306,231,124,18,12,691,2,10,703
30,4,30192,4463,3,454,227,104,27,9,821,1,5,827
30,4,30192,4466,3,332,162,112,21,20,647,1,7,655
30,4,30192,4467,3,323,142,120,21,17,623,0,7,630
30,4,30192,4470,3,306,171,106,11,9,603,0,7,610
30,4,30192,4471,3,777,366,308,60,39,1550,10,13,1573
30,4,30192,4494,3,577,423,259,35,19,1313,6,15,1334
30,4,30192,4495,3,1513,1063,592,75,33,3276,10,85,3371
30,4,30192,4498,3,325,88,30,0,2,445,3,6,454
30,4,30192,4500,3,421,163,93,18,6,701,4,17,722
30,5,30033,617,3,173,281,359,21,3,837,2,24,863
30,5,30033,618,3,110,211,262,12,1,596,0,20,616
30,5,30033,619,3,114,107,221,15,1,458,0,17,475
30,5,30033,622,3,83,127,70,7,1,288,0,15,303
30,5,30033,623,3,93,115,169,10,2,389,0,12,401
30,5,30033,626,3,43,100,133,1,1,278,0,10,288
30,5,30033,627,3,55,70,105,3,1,234,0,17,251
30,5,30033,630,3,190,264,138,27,1,620,1,31,652
30,5,30033,631,3,74,140,173,6,2,395,0,15,410
30,5,30042,932,3,244,126,311,10,5,696,3,2,701
30,5,30042,934,3,482,169,294,18,11,974,1,17,992
30,5,30042,935,3,318,118,266,23,2,727,0,11,738
30,5,30042,938,3,350,157,353,19,7,886,3,16,905
30,5,30042,939,3,218,145,274,21,3,661,1,10,672
30,5,30042,942,3,163,68,132,6,3,372,0,13,385
30,5,30042,943,3,400,122,315,22,8,867,6,22,895
30,5,30042,946,3,297,283,314,4,3,901,0,35,936
30,5,30042,947,3,105,39,124,2,0,270,3,12,285
30,5,30042,950,3,63,56,46,2,2,169,0,4,173
30,5,30042,951,3,34,25,39,0,0,98,0,6,104
30,5,30042,954,3,85,29,75,1,0,190,1,1,192
30,5,30042,955,3,336,210,169,1,1,717,3,18,738
30,5,30042,958,3,134,24,106,1,4,269,1,12,282
30,5,30042,959,3,51,33,134,1,4,223,0,5,228
30,5,30132,3109,3,509,246,394,31,5,1185,0,13,1198
30,5,30132,3110,3,263,147,238,31,11,690,1,11,702
30,5,30132,3111,3,567,213,553,43,9,1385,5,21,1411
30,5,30132,3114,3,323,163,328,20,4,838,1,19,858
30,5,30132,3115,3,347,264,290,28,9,938,5,13,956
30,5,30132,3118,3,416,136,264,29,4,849,0,42,891
30,5,30132,3119,3,395,189,322,20,4,930,4,51,985
30,5,30132,3122,3,190,118,104,18,2,432,5,9,446
30,5,30132,3123,3,187,137,219,13,3,559,0,10,569
30,5,30132,3126,3,136,77,166,8,5,392,2,10,404
30,5,30132,3127,3,189,105,202,10,4,510,3,7,520
30,5,30132,3130,3,307,115,386,26,9,843,0,11,854
30,5,30132,3131,3,352,185,349,32,5,923,4,24,951
30,5,30132,3134,3,192,117,148,12,4,473,0,5,478
30,5,30132,3135,3,245,125,253,19,3,645,3,14,662
30,5,30132,3138,3,201,110,195,9,8,523,0,3,526
30,5,30132,3139,3,270,134,281,12,3,700,3,31,734
30,5,30132,3142,3,243,137,184,16,6,586,0,11,597
30,5,30132,3143,3,188,110,173,9,4,484,1,8,493
30,5,30132,3146,3,302,118,326,23,6,775,1,8,784
30,5,30132,3147,3,253,131,237,13,4,638,0,12,650
30,5,30132,3150,3,757,500,632,27,10,1926,15,48,1989
30,5,30132,3151,3,421,176,380,19,14,1010,4,10,1024
30,5,30132,3154,3,149,153,167,11,1,481,0,9,490
30,5,30132,3155,3,208,145,269,7,3,632,2,11,645
30,5,30132,3158,3,177,73,159,16,7,432,1,8,441
30,5,30132,3159,3,369,245,401,22,9,1046,1,22,1069
30,5,30132,3162,3,150,81,150,13,2,396,0,6,402
30,5,30132,3163,3,112,90,181,18,7,408,0,11,419
30,5,30132,3166,3,311,179,366,28,7,891,0,13,904
30,5,30132,3167,3,253,113,118,14,1,499,0,14,513
30,5,30132,3170,3,292,170,364,16,7,849,5,16,870
30,5,30132,3171,3,281,214,290,27,9,821,2,16,839
30,5,30132,3174,3,175,79,190,14,3,461,1,6,468
30,5,30132,3175,3,306,151,282,25,3,767,0,25,792
30,5,30132,3178,3,109,62,102,4,3,280,0,6,286
30,5,30132,3179,3,165,93,214,1,18,491,0,1,492
30,5,30132,3182,3,148,112,190,11,4,465,0,10,475
30,5,30132,3183,3,203,104,238,15,4,564,3,18,585
30,5,30132,3186,3,255,135,179,7,11,587,2,26,615
30,5,30132,3187,3,361,161,257,21,5,805,7,40,852
30,5,30132,3190,3,240,138,308,16,4,706,5,17,728
30,5,30132,3191,3,266,161,331,21,7,786,0,21,807
30,5,30132,3194,3,159,107,224,11,5,506,1,11,518
30,5,30132,3195,3,117,71,151,10,3,352,0,5,357
30,5,30132,3198,3,294,211,313,34,4,856,8,24,888
30,5,30132,3199,3,218,131,241,14,6,610,12,12,634
30,5,30132,3202,3,227,139,213,17,1,597,5,14,616
30,5,30132,3203,3,285,190,315,20,4,814,0,8,822
30,5,30132,3206,3,86,88,87,5,1,267,0,4,271
30,5,30132,3207,3,303,196,380,17,11,907,5,27,939
30,5,30132,3210,3,304,146,320,28,3,801,5,14,820
30,5,30132,3211,3,187,85,174,15,3,464,1,10,475
30,5,30132,3214,3,416,174,361,31,8,990,1,18,1009
30,5,30132,3215,3,396,157,377,24,11,965,3,14,982
30,5,30132,3218,3,154,90,102,3,5,354,1,0,355
30,5,30174,3926,3,322,181,205,17,5,730,2,20,752
30,5,30174,3927,3,207,101,133,16,5,462,0,15,477
30,5,30174,3930,3,425,213,237,35,9,919,0,17,936
30,5,30174,3931,3,427,167,236,33,4,867,2,17,886
30,5,30174,3934,3,148,85,71,6,3,313,1,19,333
30,5,30174,3935,3,317,99,82,6,6,510,8,18,536
30,5,30174,3938,3,221,231,127,6,2,587,2,18,607
30,5,30174,3939,3,146,208,170,5,3,532,3,12,547
30,5,30174,3942,3,176,136,253,12,8,585,1,19,605
30,5,30174,3943,3,157,176,145,8,2,488,0,18,506
30,5,30174,3946,3,143,210,206,11,7,577,2,34,613
30,5,30174,3947,3,59,78,100,3,4,244,2,13,259
30,5,30174,3950,3,274,125,163,13,3,578,2,12,592
30,5,30174,3951,3,291,338,109,5,5,748,12,30,790
30,5,30174,3954,3,523,127,340,22,8,1020,2,47,1069
30,5,30174,3955,3,76,70,34,1,1,182,0,7,189
30,5,30174,3958,3,224,129,156,7,3,519,2,22,543
30,5,30174,3959,3,275,178,116,10,0,579,2,26,607
30,5,30174,3962,3,299,141,192,41,9,682,3,18,703
30,5,30174,3963,3,255,105,160,43,5,568,1,20,589
30,5,30174,3966,3,247,104,186,60,2,599,1,26,626
30,5,30174,3967,3,294,95,176,21,6,592,5,9,606
30,5,30174,3970,3,180,66,134,26,1,407,0,14,421
30,5,30174,3971,3,364,114,225,20,5,728,0,29,757
30,5,30174,3974,3,226,123,215,14,3,581,3,30,614
30,6,30039,709,3,100,458,397,3,18,976,1,20,997
30,6,30039,710,3,547,239,65,0,0,851,0,24,875
30,6,30039,711,3,132,198,369,10,5,714,0,34,748
30,6,30052,1266,3,247,155,377,9,11,799,1,38,838
30,6,30052,1267,3,297,261,382,10,8,958,0,30,988
30,6,30052,1270,3,122,82,140,3,1,348,0,18,366
30,6,30052,1271,3,234,77,96,1,5,413,0,17,430
30,6,30052,1274,3,234,112,159,1,0,506,0,15,521
30,6,30053,1275,3,92,455,328,16,4,895,4,22,921
30,6,30053,1278,3,87,248,252,8,7,602,0,20,622
30,6,30053,1279,3,33,106,127,0,0,266,0,0,266
30,6,30053,1282,3,42,353,390,2,0,787,0,12,799
30,6,30053,1283,3,93,253,455,1,1,803,4,26,833
30,6,30066,1473,3,213,250,370,15,7,855,0,29,884
30,6,30066,1474,3,99,126,189,8,2,424,0,18,442
30,6,30068,1510,3,66,284,335,26,8,719,2,5,726
30,6,30068,1511,3,68,147,236,8,3,462,0,23,485
30,6,30068,1514,3,172,334,306,6,1,819,0,40,859
30,6,30068,1515,3,71,190,194,1,3,459,1,12,472
30,6,30068,1518,3,197,348,325,24,8,902,1,25,928
30,6,30068,1519,3,83,250,372,3,3,711,0,12,723
30,6,30068,1522,3,213,164,350,0,6,733,2,27,762
30,6,30068,1523,3,209,174,437,4,8,832,0,29,861
30,6,30069,1526,3,435,364,134,6,1,940,0,15,955
30,6,30069,1527,3,452,445,102,2,6,1007,3,12,1022
30,6,30071,1556,3,66,155,331,9,4,565,0,11,576
30,6,30071,1558,3,36,72,216,6,5,335,1,7,343
30,6,30071,1559,3,77,91,211,4,1,384,1,6,391
30,6,30071,1562,3,60,114,353,7,3,537,0,11,548
30,6,30071,1563,3,87,97,251,5,3,443,0,15,458
30,6,30071,1566,3,52,31,283,1,7,374,0,16,390
30,6,30071,1567,3,21,39,213,1,0,274,0,8,282
30,6,30071,1570,3,54,49,209,1,0,313,0,0,313
30,6,30071,1571,3,17,56,120,1,0,194,0,6,200
30,6,30071,1574,3,60,63,151,0,1,275,0,8,283
30,6,30071,1575,3,133,103,199,6,5,446,0,19,465
30,6,30071,1578,3,74,41,182,3,0,300,1,4,305
30,6,30104,2374,3,236,205,274,10,3,728,0,29,757
30,6,30104,2375,3,234,235,281,6,6,762,1,37,800
30,6,30104,2378,3,152,85,169,2,0,408,0,17,425
30,6,30125,2898,3,310,165,406,14,10,905,1,31,937
30,6,30125,2899,3,328,228,494,40,10,1100,0,28,1128
30,6,30125,2902,3,131,103,211,13,3,461,1,10,472
30,6,30125,2903,3,110,109,240,8,4,471,0,10,481
30,6,30125,2906,3,232,248,394,19,9,902,1,14,917
30,6,30125,2907,3,202,250,310,28,9,799,0,9,808
30,6,30125,2910,3,225,256,386,18,10,895,0,20,915
30,6,30125,2911,3,240,247,410,25,17,939,1,15,955
30,6,30125,2914,3,222,278,401,37,9,947,0,19,966
30,6,30125,2915,3,210,249,382,21,9,871,3,18,892
30,6,30125,2918,3,145,136,237,10,6,534,4,6,544
30,6,30125,2919,3,159,139,208,33,10,549,0,15,564
30,6,30125,2922,3,163,96,224,11,2,496,1,16,513
30,6,30125,2923,3,177,248,355,19,11,810,0,11,821
30,6,30125,2926,3,285,64,344,7,3,703,0,22,725
30,6,30125,2927,3,165,240,323,7,6,741,2,20,763
30,6,30125,2930,3,263,238,460,2,5,968,0,36,1004
30,6,30125,2931,3,46,73,213,1,2,335,0,20,355
30,6,30125,2934,3,80,176,224,9,5,494,0,12,506
30,6,30125,2935,3,145,197,250,6,7,605,2,23,630
30,6,30125,2938,3,507,153,262,28,10,960,6,19,985
30,6,30125,2939,3,141,124,154,4,1,424,1,11,436
30,6,30125,2942,3,69,107,304,1,1,482,1,18,501
30,6,30125,2943,3,167,123,283,6,6,585,2,31,618
30,6,30125,2946,3,154,285,327,0,2,768,2,33,803
30,6,30125,2947,3,135,79,370,2,1,587,2,7,596
30,6,30125,2950,3,159,90,384,3,10,646,0,18,664
30,6,30125,2951,3,68,56,175,3,4,306,0,9,315
30,6,30125,2954,3,147,63,218,9,4,441,1,8,450
30,6,30125,2955,3,206,64,206,6,2,484,1,9,494
30,6,30125,2958,3,118,106,212,1,2,439,2,10,451
30,6,30125,2959,3,183,126,415,9,7,740,2,20,762
30,6,30125,2962,3,94,82,90,3,3,272,0,10,282
30,6,30125,2963,3,95,38,151,3,6,293,3,9,305
30,6,30125,2966,3,122,142,201,8,2,475,0,19,494
30,6,30125,2967,3,133,202,221,5,3,564,1,8,573
30,6,30125,2970,3,186,76,158,12,5,437,4,15,456
30,6,30125,2971,3,288,143,379,13,5,828,4,20,852
30,6,30125,2974,3,117,93,212,2,1,425,1,15,441
30,6,30125,2975,3,169,91,150,4,5,419,0,11,430
30,6,30125,2978,3,88,53,158,2,2,303,5,11,319
30,6,30125,2979,3,141,157,261,6,17,582,2,20,604
30,6,30125,2982,3,89,177,530,9,10,815,1,15,831
30,6,30125,2983,3,90,146,284,0,4,524,4,18,546
30,6,30125,2986,3,247,102,265,1,4,619,2,17,638
30,6,30125,2987,3,121,109,345,6,10,591,2,38,631
30,6,30158,3673,3,23,39,188,0,0,250,0,9,259
30,6,30158,3674,3,45,97,410,5,3,560,0,15,575
30,6,30158,3675,3,91,259,815,8,7,1180,0,30,1210
30,6,30158,3678,3,3,5,37,0,0,45,0,4,49
30,6,30158,3680,3,28,121,167,5,1,322,1,6,329
30,6,30158,3682,3,42,67,104,1,0,214,0,13,227
30,6,30158,3683,3,75,259,303,6,2,645,1,16,662
30,6,30158,3686,3,81,130,181,8,4,404,1,13,418
30,6,30158,3687,3,99,129,160,3,2,393,1,7,401
30,6,30158,3690,3,66,174,372,4,5,621,1,25,647
30,6,30158,3691,3,64,80,134,0,1,279,3,13,295
30,6,30158,3694,3,56,172,178,6,3,415,0,20,435
30,6,30158,3695,3,123,94,169,5,2,393,0,13,406
30,6,30158,3698,3,271,273,214,16,1,775,2,20,797
30,6,30203,4606,3,230,226,183,4,3,646,0,14,660
30,6,30203,4607,3,255,143,162,3,0,563,2,12,577
30,6,30203,4610,3,74,56,82,2,3,217,0,6,223
30,6,30203,4611,3,312,263,97,1,1,674,0,11,685
30,7,30024,425,3,138,156,156,7,2,459,0,8,467
30,7,30024,426,3,170,88,152,12,4,426,2,11,439
30,7,30024,427,3,325,155,200,23,4,707,4,21,732
30,7,30024,430,3,177,108,46,0,0,331,0,10,341
30,7,30024,431,3,207,119,35,1,0,362,0,9,371
30,7,30024,434,3,338,255,110,6,3,712,3,29,744
30,7,30024,435,3,244,234,100,2,1,581,1,13,595
30,7,30024,438,3,293,181,46,2,5,527,0,7,534
30,7,30024,439,3,87,178,29,1,0,295,1,28,324
30,7,30024,442,3,174,192,33,3,0,402,0,12,414
30,7,30024,443,3,151,147,10,2,0,310,0,15,325
30,7,30024,446,3,320,131,135,9,3,598,0,11,609
30,7,30024,447,3,160,159,164,5,4,492,3,18,513
30,7,30024,450,3,590,268,160,5,4,1027,6,38,1071
30,7,30024,451,3,174,296,68,1,3,542,0,20,562
30,7,30024,454,3,138,80,75,0,1,294,1,6,301
30,7,30024,455,3,492,192,27,3,2,716,5,22,743
30,7,30024,458,3,126,87,27,1,1,242,0,12,254
30,7,30088,1830,3,496,386,254,59,29,1224,18,27,1269
30,7,30088,1831,3,464,253,161,42,12,932,19,28,979
30,7,30088,1834,3,86,47,81,4,3,221,3,8,232
30,7,30088,1835,3,196,29,36,4,2,267,0,0,267
30,7,30088,1838,3,141,197,203,8,6,555,8,32,595
30,7,30088,1839,3,88,156,198,6,8,456,1,32,489
30,7,30088,1842,3,143,74,65,4,0,286,0,19,305
30,7,30088,1843,3,251,124,147,5,5,532,5,35,572
30,7,30088,1846,3,200,218,336,25,16,795,16,35,846
30,7,30088,1847,3,47,51,31,0,4,133,2,4,139
30,7,30097,2219,3,200,139,17,1,0,357,0,4,361
30,7,30103,2281,3,312,169,217,40,9,747,2,25,774
30,7,30103,2282,3,140,129,137,19,7,432,4,12,448
30,7,30103,2283,3,251,276,245,36,2,810,0,13,823
30,7,30103,2286,3,1084,842,851,136,23,2936,19,105,3060
30,7,30103,2287,3,157,106,194,27,6,490,0,13,503
30,7,30103,2290,3,198,170,248,38,9,663,0,21,684
30,7,30103,2291,3,139,92,148,7,8,394,1,6,401
30,7,30103,2294,3,134,86,121,27,5,373,1,0,374
30,7,30103,2295,3,154,123,161,20,2,460,3,9,472
30,7,30103,2298,3,283,175,228,40,1,727,0,24,751
30,7,30103,2299,3,140,114,97,21,1,373,0,8,381
30,7,30103,2302,3,161,127,157,15,5,465,0,20,485
30,7,30103,2303,3,150,145,152,26,2,475,4,1,480
30,7,30103,2306,3,151,159,125,22,0,457,1,3,461
30,7,30103,2307,3,213,253,166,25,5,662,2,16,680
30,7,30103,2310,3,169,135,189,32,3,528,1,17,546
30,7,30103,2311,3,182,210,170,29,3,594,0,13,607
30,7,30103,2314,3,201,172,170,39,2,584,1,15,600
30,7,30103,2315,3,146,166,113,20,3,448,1,10,459
30,7,30103,2318,3,34,23,39,0,1,97,0,4,101
30,7,30211,2319,3,146,119,87,6,5,363,0,9,372
30,7,30211,2322,3,51,30,21,2,0,104,0,0,104
30,7,30211,2323,3,99,85,38,4,2,228,0,1,229
30,7,30211,2326,3,279,207,124,4,1,615,1,17,633
30,7,30103,2327,3,128,108,108,4,1,349,0,15,364
30,7,30103,2331,3,213,83,204,12,4,516,1,16,533
30,7,30211,2334,3,139,106,64,3,1,313,2,8,323
30,7,30211,2335,3,96,93,30,4,1,224,1,2,227
30,7,30211,2338,3,230,97,85,8,6,426,0,15,441
30,7,30211,2339,3,369,329,262,37,7,1004,1,32,1037
30,7,30211,2342,3,336,68,148,9,1,562,1,18,581
30,7,30211,2343,3,318,106,190,11,2,627,2,7,636
30,7,30211,2346,3,24,28,35,1,0,88,0,1,89
30,7,30103,2347,3,291,288,193,17,4,793,2,24,819
30,7,30103,2350,3,14,11,8,2,0,35,0,0,35
30,7,30211,2351,3,201,118,95,10,3,427,0,17,444
30,7,30211,2354,3,213,115,129,15,2,474,0,13,487
30,7,30211,2355,3,157,113,89,11,1,371,0,21,392
30,7,30103,2358,3,352,145,139,10,4,650,8,18,676
30,7,30103,2359,3,275,162,213,20,0,670,1,25,696
30,7,30103,2362,3,34,35,33,1,0,103,0,2,105
30,7,30103,2363,3,339,129,117,11,2,598,2,4,604
30,7,30103,2366,3,131,117,57,12,1,318,0,6,324
30,7,30103,2367,3,242,120,124,6,2,494,1,14,509
30,7,30103,2370,3,72,56,18,2,1,149,0,1,150
30,7,30103,2371,3,65,121,65,3,3,257,1,1,259
30,7,30110,2526,3,334,208,280,73,9,904,3,42,949
30,7,30110,2527,3,237,160,194,38,5,634,4,14,652
30,7,30110,2530,3,169,129,239,66,3,606,2,18,626
30,7,30110,2531,3,214,159,150,49,6,578,2,16,596
30,7,30110,2534,3,150,109,103,78,1,441,0,33,474
30,7,30110,2535,3,291,189,286,42,5,813,0,27,840
30,7,30110,2538,3,289,191,203,94,7,784,3,25,812
30,7,30110,2539,3,213,106,93,51,6,469,0,33,502
30,7,30110,2542,3,214,139,91,44,1,489,0,9,498
30,7,30110,2543,3,143,108,143,34,4,432,3,21,456
30,7,30110,2546,3,144,67,137,35,3,386,0,28,414
30,7,30110,2547,3,175,160,129,83,3,550,3,31,584
30,7,30110,2550,3,117,92,68,13,0,290,5,7,302
30,7,30110,2551,3,107,91,79,15,2,294,2,6,302
30,7,30110,2554,3,44,118,60,8,1,231,0,13,244
30,7,30110,2555,3,109,160,193,67,3,532,3,50,585
30,7,30110,2558,3,180,87,129,17,1,414,0,15,429
30,7,30110,2559,3,100,108,112,17,0,337,1,20,358
30,7,30110,2562,3,70,39,64,2,2,177,0,6,183
30,7,30110,2563,3,156,121,128,13,2,420,0,2,422
30,7,30110,2566,3,132,108,113,13,2,368,0,14,382
30,7,30110,2567,3,112,90,80,34,0,316,0,27,343
30,7,30110,2570,3,99,144,101,24,0,368,0,32,400
30,7,30110,2571,3,116,88,226,22,4,456,0,17,473
30,7,30110,2574,3,43,96,52,7,0,198,0,5,203
30,7,30110,2575,3,148,171,78,4,0,401,0,6,407
30,7,30115,2610,3,98,154,236,14,0,502,0,14,516
30,7,30115,2611,3,79,175,277,11,8,550,4,16,570
30,7,30115,2614,3,135,111,209,15,0,470,5,11,486
30,7,30115,2615,3,34,52,48,2,0,136,0,2,138
30,7,30115,2618,3,62,90,83,4,0,239,2,10,251
30,7,30115,2619,3,36,79,104,12,3,234,2,7,243
30,7,30162,3739,3,297,161,136,4,3,601,0,4,605
30,7,30162,3742,3,141,325,123,0,2,591,4,15,610
30,7,30162,3743,3,47,75,6,0,0,128,0,1,129
30,7,30182,4042,3,173,142,194,19,5,533,0,9,542
30,7,30182,4043,3,323,261,269,36,13,902,1,28,931
30,7,30182,4046,3,202,138,214,35,8,597,1,11,609
30,7,30182,4047,3,160,139,201,22,9,531,2,14,547
30,7,30182,4050,3,177,87,150,25,3,442,1,10,453
30,7,30182,4051,3,196,180,215,29,11,631,0,9,640
30,7,30182,4054,3,213,163,175,24,10,585,5,16,606
30,7,30182,4055,3,243,156,253,25,12,689,4,11,704
30,7,30182,4058,3,19,12,34,2,1,68,0,2,70
30,7,30182,4059,3,54,42,46,4,2,148,0,5,153
30,7,30182,4062,3,314,247,208,29,11,809,1,24,834
30,7,30182,4063,3,397,119,310,29,4,859,6,30,895
30,7,30182,4066,3,198,194,204,19,7,622,4,16,642
30,7,30182,4067,3,138,96,99,14,6,353,10,9,372
30,7,30182,4070,3,58,25,50,7,0,140,0,0,140
30,7,30182,4071,3,192,154,202,11,5,564,2,17,583
30,8,30002,5,3,239,181,98,18,4,540,0,19,559
30,8,30002,6,3,263,193,106,15,3,580,1,15,596
30,8,30004,47,3,191,239,271,30,4,735,3,21,759
30,8,30004,50,3,137,176,164,6,11,494,0,5,499
30,8,30004,51,3,536,271,143,24,15,989,0,13,1002
30,8,30004,54,3,64,40,46,1,5,156,0,6,162
30,8,30004,55,3,72,129,103,3,5,312,1,26,339
30,8,30004,58,3,71,19,36,2,2,130,0,4,134
30,8,30004,59,3,122,28,29,4,4,187,0,5,192
30,8,30004,62,3,128,113,49,5,4,299,1,10,310
30,8,30004,63,3,100,153,203,8,2,466,3,14,483
30,8,30004,66,3,159,104,58,3,7,331,0,11,342
30,8,30004,67,3,214,82,118,20,9,443,0,14,457
30,8,30004,70,3,188,108,224,18,11,549,0,18,567
30,8,30004,71,3,114,203,113,14,11,455,3,12,470
30,8,30004,74,3,257,87,100,14,2,460,0,9,469
30,8,30004,75,3,210,113,93,5,0,421,0,12,433
30,8,30004,78,3,115,64,21,2,1,203,0,7,210
30,8,30004,79,3,64,101,31,7,0,203,0,5,208
30,8,30004,82,3,23,23,26,2,1,75,0,6,81
30,8,30004,83,3,168,112,144,3,2,429,0,10,439
30,8,30010,183,3,127,186,208,10,1,532,0,8,540
30,8,30010,186,3,178,186,226,15,2,607,1,14,622
30,8,30010,187,3,74,96,125,2,4,301,1,15,317
30,8,30010,190,3,39,46,40,0,0,125,0,7,132
30,8,30010,191,3,17,125,63,0,1,206,0,11,217
30,8,30010,194,3,51,104,28,2,2,187,0,13,200
30,8,30010,197,3,326,248,220,19,10,823,1,8,832
30,8,30010,198,3,117,98,87,5,4,311,2,23,336
30,8,30010,199,3,48,42,36,2,2,130,0,0,130
30,8,30010,202,3,131,253,162,5,6,557,1,32,590
30,8,30010,203,3,90,50,10,0,1,151,0,1,152
30,8,30010,206,3,138,202,92,6,7,445,1,17,463
30,8,30010,207,3,68,138,103,2,0,311,0,9,320
30,8,30010,210,3,62,161,115,2,2,342,0,12,354
30,8,30010,211,3,64,119,306,22,2,513,1,33,547
30,8,30010,214,3,36,114,88,2,1,241,0,3,244
30,8,30010,215,3,104,190,378,8,1,681,1,0,682
30,8,30018,384,3,156,200,87,1,2,446,4,9,459
30,8,30018,386,3,77,118,138,4,0,337,1,0,338
30,8,30018,387,3,33,206,50,1,2,292,0,0,292
30,8,30027,473,3,250,271,264,48,24,857,5,18,880
30,8,30027,474,3,189,238,256,38,19,740,0,31,771
30,8,30027,475,3,192,169,229,35,12,637,0,30,667
30,8,30027,478,3,253,291,286,44,19,893,0,38,931
30,8,30027,479,3,283,195,306,44,12,840,1,34,875
30,8,30044,963,3,169,145,288,13,6,621,1,29,651
30,8,30044,967,3,92,98,51,0,1,242,0,4,246
30,8,30059,1335,3,261,226,163,14,6,670,1,35,706
30,8,30059,1338,3,97,118,65,2,2,284,3,12,299
30,8,30059,1339,3,173,58,92,3,3,329,0,21,350
30,8,30059,1342,3,271,65,88,4,4,432,0,24,456
30,8,30067,1475,3,119,150,77,16,11,373,0,13,386
30,8,30067,1478,3,210,103,76,9,9,407,1,8,416
30,8,30067,1479,3,298,269,132,21,17,737,10,10,757
30,8,30067,1482,3,243,151,233,20,10,657,6,29,692
30,8,30067,1483,3,202,152,194,42,12,602,0,14,616
30,8,30067,1486,3,57,96,11,2,2,168,2,7,177
30,8,30067,1487,3,461,264,395,61,34,1215,6,34,1255
30,8,30067,1490,3,99,127,71,1,1,299,0,2,301
30,8,30067,1491,3,233,208,228,18,10,697,9,9,715
30,8,30067,1494,3,118,77,80,9,3,287,0,11,298
30,8,30067,1495,3,253,135,547,29,8,972,0,10,982
30,8,30067,1498,3,123,148,145,19,14,449,2,6,457
30,8,30067,1499,3,326,57,70,8,1,462,1,9,472
30,8,30067,1502,3,172,90,98,20,5,385,2,8,395
30,8,30067,1503,3,201,144,101,34,6,486,1,8,495
30,8,30067,1506,3,272,202,212,24,12,722,0,20,742
30,8,30067,1507,3,159,118,176,11,6,470,1,9,480
30,8,30089,1970,3,436,425,568,97,47,1573,9,35,1617
30,8,30089,1971,3,503,297,338,71,30,1239,5,164,1408
30,8,30089,2005,3,819,614,760,135,78,2406,4,57,2467
30,8,30089,2006,3,334,169,280,34,27,844,1,22,867
30,8,30089,2027,3,473,304,282,48,37,1144,0,22,1166
30,8,30089,2051,3,147,143,189,15,25,519,0,17,536
30,8,30089,2054,3,219,349,299,40,26,933,0,43,976
30,8,30089,2055,3,351,233,335,45,22,986,1,20,1007
30,8,30089,2069,3,138,133,133,25,20,449,1,11,461
30,8,30089,2070,3,907,931,868,185,110,3001,10,64,3075
30,8,30089,2071,3,95,103,127,31,7,363,2,4,369
30,8,30089,2074,3,38,28,48,6,6,126,1,2,129
30,8,30089,2085,3,228,204,289,54,27,802,6,19,827
30,8,30089,2086,3,560,576,815,142,81,2174,9,46,2229
30,8,30089,2087,3,178,195,285,35,23,716,0,28,744
30,8,30089,2090,3,135,98,147,26,16,422,0,15,437
30,8,30089,2091,3,140,84,125,21,11,381,0,9,390
30,8,30089,2094,3,119,215,87,12,11,444,10,10,464
30,8,30089,2095,3,220,326,187,21,13,767,2,37,806
30,8,30089,2099,3,431,689,664,105,45,1934,4,86,2024
30,8,30090,2102,3,100,167,346,11,1,625,1,8,634
30,8,30090,2103,3,3,55,27,0,0,85,0,3,88
30,8,30094,2170,3,294,202,234,44,12,786,2,17,805
30,8,30094,2171,3,215,154,199,28,12,608,0,9,617
30,8,30094,2174,3,89,461,96,23,12,681,0,14,695
30,8,30094,2175,3,125,548,154,28,7,862,0,27,889
30,8,30094,2178,3,123,73,121,7,6,330,3,5,338
30,8,30096,2201,3,201,205,176,15,8,605,1,19,625
30,8,30096,2202,3,215,236,90,16,5,562,0,21,583
30,8,30096,2203,3,56,114,128,1,2,301,0,5,306
30,8,30096,2206,3,124,111,69,3,7,314,0,8,322
30,8,30096,2207,3,43,45,93,1,2,184,1,3,188
30,8,30096,2210,3,51,147,25,1,2,226,0,10,236
30,8,30096,2211,3,48,115,53,0,0,216,1,13,230
30,8,30096,2214,3,78,79,35,2,0,194,0,18,212
30,8,30096,2215,3,88,130,177,2,5,402,0,35,437
30,8,30096,2218,3,38,84,54,1,3,180,1,5,186
30,8,30107,2415,3,123,167,153,2,4,449,2,11,462
30,8,30113,2594,3,341,193,201,50,10,795,5,17,817
30,8,30113,2595,3,305,226,206,48,16,801,1,19,821
30,8,30113,2598,3,275,154,155,29,6,619,0,13,632
30,8,30113,2599,3,230,85,95,2,2,414,3,6,423
30,8,30113,2602,3,255,91,42,8,1,397,0,228,625
30,8,30113,2603,3,262,197,281,40,16,796,1,32,829
30,8,30113,2606,3,158,175,68,10,2,413,0,4,417
30,8,30165,3757,3,453,248,331,32,11,1075,3,56,1134
30,8,30165,3758,3,88,98,17,1,1,205,1,2,208
30,8,30165,3759,3,81,309,134,5,5,534,0,28,562
30,8,30165,3762,3,148,127,86,15,8,384,5,11,400
30,8,30186,4083,3,134,202,169,9,5,519,0,18,537
30,8,30190,4173,3,281,294,268,43,7,893,0,13,906
30,8,30190,4174,3,257,203,224,43,14,741,1,21,763
30,8,30190,4175,3,208,124,195,22,10,559,0,8,567
30,8,30190,4178,3,187,142,147,16,8,500,1,2,503
30,8,30190,4179,3,200,104,202,38,11,555,1,16,572
30,8,30190,4182,3,136,117,105,22,5,385,0,8,393
30,8,30190,4183,3,191,158,146,27,6,528,0,11,539
30,8,30190,4186,3,210,155,148,34,9,556,3,8,567
30,8,30190,4187,3,48,151,117,6,4,326,0,5,331
30,8,30190,4190,3,295,129,165,29,10,628,9,17,654
30,8,30190,4191,3,200,279,178,27,10,694,5,21,720
30,8,30190,4194,3,83,147,68,10,5,313,0,9,322
30,8,30190,4195,3,349,92,82,23,5,551,3,19,573
30,8,30191,4198,3,152,169,166,3,1,491,0,16,507
30,8,30191,4199,3,183,280,147,19,4,633,4,11,648
30,8,30191,4202,3,115,179,46,3,4,347,1,29,377
30,8,30191,4203,3,17,56,22,0,0,95,1,4,100
30,8,30191,4206,3,9,85,38,0,1,133,0,5,138
30,8,30191,4207,3,64,63,71,5,1,204,0,8,212
30,8,30191,4210,3,100,88,111,7,2,308,0,4,312
30,8,30191,4211,3,142,187,153,9,3,494,0,10,504
30,8,30191,4214,3,39,82,44,0,2,167,0,5,172
30,8,30191,4215,3,58,44,28,1,0,131,1,3,135
30,8,30197,4541,3,133,188,366,27,5,719,0,25,744
30,8,30197,4542,3,87,92,110,9,4,302,1,2,305
30,8,30197,4543,3,216,99,153,11,1,480,1,29,510
30,8,30197,4546,3,111,216,311,20,1,659,0,30,689
30,8,30197,4547,3,193,156,207,7,2,565,2,12,579
30,8,30197,4550,3,111,163,185,21,0,480,1,17,498
30,9,30001,1,3,223,360,262,64,9,918,1,21,940
30,9,30001,2,3,273,297,108,40,13,731,0,34,765
30,9,30001,3,3,216,366,163,31,11,787,8,38,833
30,9,30011,218,3,329,329,341,50,33,1082,4,50,1136
30,9,30011,219,3,351,427,441,70,31,1320,8,45,1373
30,9,30011,222,3,241,233,353,68,26,921,2,35,958
30,9,30011,223,3,243,244,266,51,18,822,8,28,858
30,9,30011,226,3,68,93,57,1,3,222,0,15,237
30,9,30011,227,3,71,164,44,0,2,281,0,15,296
30,9,30011,230,3,13,83,179,1,3,279,2,21,302
30,9,30011,231,3,21,164,115,5,0,305,4,17,326
30,9,30011,234,3,68,92,138,5,3,306,0,35,341
30,9,30011,235,3,128,116,114,13,3,374,11,24,409
30,9,30011,238,3,237,407,160,21,11,836,9,40,885
30,9,30011,239,3,151,254,161,12,5,583,3,24,610
30,9,30011,242,3,114,501,109,11,8,743,2,53,798
30,9,30011,243,3,149,175,97,3,2,426,7,25,458
30,9,30011,246,3,57,125,52,5,5,244,1,14,259
30,9,30026,465,3,290,252,150,68,4,764,4,55,823
30,9,30026,466,3,139,659,146,10,10,964,8,51,1023
30,9,30026,467,3,167,441,235,26,11,880,0,67,947
30,9,30026,470,3,454,377,62,7,0,900,3,44,947
30,9,30026,471,3,379,330,43,40,7,799,9,49,857
30,9,30038,704,3,262,376,197,36,8,879,6,30,915
30,9,30038,706,3,76,155,21,5,1,258,2,8,268
30,9,30038,707,3,269,232,426,26,0,953,8,21,982
30,9,30040,712,3,231,299,146,55,19,750,6,30,786
30,9,30040,714,3,208,391,193,45,15,852,5,22,879
30,9,30040,715,3,283,429,175,40,24,951,2,19,972
30,9,30040,718,3,138,196,108,30,4,476,1,18,495
30,9,30040,719,3,255,310,212,64,18,859,8,39,906
30,9,30040,722,3,124,240,91,13,5,473,0,10,483
30,9,30040,723,3,218,386,154,18,19,795,1,29,825
30,9,30040,726,3,121,258,130,32,13,554,1,14,569
30,9,30040,727,3,154,232,131,26,9,552,0,14,566
30,9,30040,730,3,154,222,153,23,9,561,0,18,579
30,9,30040,731,3,222,329,145,41,13,750,3,15,768
30,9,30040,734,3,184,341,100,28,23,676,3,23,702
30,9,30040,735,3,147,311,129,30,12,629,0,20,649
30,9,30040,738,3,69,173,97,32,10,381,0,20,401
30,9,30040,739,3,179,306,176,24,18,703,2,20,725
30,9,30040,742,3,298,591,249,54,26,1218,8,48,1274
30,9,30040,743,3,26,90,17,2,1,136,0,12,148
30,9,30040,746,3,351,355,180,51,19,956,0,28,984
30,9,30040,747,3,179,206,122,28,9,544,7,13,564
30,9,30040,750,3,290,373,80,10,5,758,1,14,773
30,9,30040,751,3,131,357,273,27,10,798,4,24,826
30,9,30040,754,3,166,369,143,8,7,693,5,13,711
30,9,30040,755,3,103,368,115,16,7,609,1,21,631
30,9,30040,758,3,126,175,279,30,9,619,2,16,637
30,9,30040,759,3,205,158,269,20,5,657,1,12,670
30,9,30040,762,3,74,158,74,10,2,318,1,4,323
30,9,30048,1153,3,156,310,65,26,7,564,3,17,584
30,9,30048,1154,3,116,240,77,9,8,450,0,16,466
30,9,30048,1155,3,151,256,109,41,10,567,0,36,603
30,9,30048,1158,3,392,255,204,21,6,878,4,48,930
30,9,30048,1159,3,176,177,111,12,7,483,0,40,523
30,9,30081,1726,3,300,224,66,4,7,601,1,24,626
30,9,30081,1727,3,245,340,67,12,5,669,1,8,678
30,9,30081,1730,3,399,212,64,4,3,682,8,28,718
30,9,30108,2418,3,76,254,113,7,1,451,0,17,468
30,9,30108,2419,3,118,144,156,1,3,422,0,14,436
30,9,30129,3036,3,194,376,97,25,7,699,1,20,720
30,9,30129,3038,3,197,368,110,34,10,719,3,28,750
30,9,30129,3039,3,428,720,117,46,18,1329,0,56,1385
30,9,30129,3042,3,185,207,95,28,8,523,4,15,542
30,9,30129,3043,3,479,956,224,60,26,1745,1,60,1806
30,9,30129,3046,3,349,598,114,33,14,1108,0,29,1137
30,9,30129,3047,3,234,371,97,19,12,733,2,48,783
30,9,30129,3050,3,76,127,12,6,0,221,0,3,224
30,9,30129,3051,3,250,713,116,49,15,1143,3,51,1197
30,9,30129,3054,3,58,212,21,1,1,293,0,19,312
30,9,30129,3055,3,37,73,13,1,0,124,1,8,133
30,9,30129,3058,3,191,473,162,32,10,868,4,62,934
30,9,30129,3059,3,108,154,71,14,5,352,1,10,363
30,9,30129,3062,3,126,350,83,10,6,575,0,33,608
30,9,30129,3063,3,115,156,79,19,4,373,2,0,375
30,9,30129,3066,3,54,164,75,9,2,304,0,0,304
30,9,30136,3283,3,218,354,240,28,7,847,0,19,866
30,9,30137,3286,3,303,414,287,39,40,1083,0,36,1119
30,9,30137,3287,3,359,367,301,61,38,1126,0,31,1157
30,9,30137,3290,3,84,124,34,4,4,250,2,19,271
30,9,30137,3291,3,90,259,69,10,9,437,0,36,473
30,9,30157,3669,3,197,179,75,7,0,458,2,13,473
30,9,30157,3670,3,291,211,66,2,1,571,0,28,599
30,9,30157,3671,3,129,230,50,10,2,421,4,23,448
30,9,30163,3745,3,223,424,324,24,10,1005,0,36,1041
30,9,30163,3746,3,77,203,210,15,9,514,3,14,531
30,9,30163,3747,3,124,286,248,19,18,695,8,19,722
30,9,30163,3750,3,142,156,172,7,4,481,2,19,502
30,9,30163,3751,3,189,139,180,7,3,518,0,15,533
30,9,30176,3979,3,142,251,257,21,10,681,0,15,696
30,9,30176,3982,3,185,258,263,5,5,716,1,17,734
30,9,30176,3983,3,72,109,65,7,2,255,0,11,266
30,9,30181,4037,3,174,281,179,23,20,677,0,24,701
30,9,30181,4038,3,147,329,164,24,16,680,1,29,710
30,9,30181,4039,3,591,567,439,110,42,1749,7,68,1824
30,9,30193,4501,3,125,292,75,30,10,532,0,24,556
30,9,30193,4502,3,129,331,118,49,5,632,3,18,653
30,9,30193,4503,3,38,131,40,1,2,212,0,6,218
30,9,30194,4506,3,81,125,223,14,4,447,2,25,474
30,9,30194,4507,3,112,426,364,26,14,942,5,21,968
30,9,30194,4510,3,118,317,265,23,13,736,1,20,757
30,9,30194,4511,3,124,317,208,15,10,674,1,18,693
30,9,30194,4514,3,132,324,423,34,4,917,2,23,942
30,9,30194,4515,3,31,196,36,4,5,272,1,18,291
30,9,30194,4518,3,21,155,195,5,4,380,6,11,397
30,9,30194,4519,3,104,351,171,22,3,651,0,23,674
30,9,30194,4522,3,150,150,137,22,6,465,0,17,482
30,9,30194,4523,3,121,211,216,28,9,585,1,20,606
30,10,30089,1848,3,243,521,304,24,20,1112,2,34,1148
30,10,30089,1850,3,253,742,412,36,22,1465,10,47,1522
30,10,30089,1851,3,251,612,449,23,15,1350,4,34,1388
30,10,30089,1854,3,146,304,192,14,5,661,0,16,677
30,10,30089,1855,3,101,303,193,19,17,633,0,13,646
30,10,30089,1858,3,146,340,231,20,13,750,6,21,777
30,10,30089,1859,3,107,271,224,14,7,623,5,16,644
30,10,30089,1862,3,143,358,231,17,5,754,2,23,779
30,10,30089,1863,3,80,284,181,18,2,565,0,24,589
30,10,30089,1866,3,117,331,154,14,13,629,1,23,653
30,10,30089,1867,3,137,249,197,23,9,615,2,12,629
30,10,30089,1870,3,110,312,189,14,14,639,4,13,656
30,10,30089,1871,3,79,282,146,8,10,525,1,17,543
30,10,30089,1874,3,210,491,320,12,14,1047,8,60,1115
30,10,30089,1875,3,167,694,382,35,13,1291,2,46,1339
30,10,30089,1878,3,94,346,190,17,9,656,2,16,674
30,10,30089,1879,3,219,516,379,30,25,1169,1,34,1204
30,10,30089,1882,3,231,370,338,23,17,979,0,33,1012
30,10,30089,1883,3,121,285,180,11,4,601,3,17,621
30,10,30089,1886,3,105,291,199,15,3,613,1,27,641
30,10,30089,1887,3,124,333,235,12,11,715,1,22,738
30,10,30089,1890,3,174,281,194,15,14,678,1,8,687
30,10,30089,1891,3,122,299,230,24,13,688,1,13,702
30,10,30089,1894,3,84,272,196,11,3,566,0,18,584
30,10,30089,1895,3,230,669,402,38,19,1358,5,33,1396
30,10,30089,1898,3,118,297,259,17,9,700,0,19,719
30,10,30089,1899,3,256,307,310,25,24,922,1,23,946
30,10,30089,1902,3,113,313,218,18,7,669,0,8,677
30,10,30089,1903,3,267,398,326,27,23,1041,5,20,1066
30,10,30089,1906,3,286,630,417,29,24,1386,0,24,1410
30,10,30089,1907,3,229,704,433,38,16,1420,2,37,1459
30,10,30089,1910,3,144,447,334,12,20,957,5,15,977
30,10,30089,1911,3,159,398,239,22,13,831,2,13,846
30,10,30089,1914,3,124,363,215,23,13,738,1,19,758
30,10,30089,1915,3,141,265,190,15,5,616,0,14,630
30,10,30089,1918,3,115,264,218,23,9,629,0,12,641
30,10,30089,1919,3,66,223,136,7,4,436,2,7,445
30,10,30089,1922,3,124,324,231,11,6,696,1,15,712
30,10,30089,1923,3,150,418,295,18,13,894,2,20,916
30,10,30089,1926,3,143,338,263,31,15,790,0,9,799
30,10,30089,1927,3,104,267,201,13,7,592,1,15,608
30,10,30089,1930,3,73,206,146,14,8,447,0,11,458
30,10,30089,1931,3,97,182,139,12,10,440,0,9,449
30,10,30089,1934,3,127,229,184,35,10,585,0,13,598
30,10,30089,1935,3,70,217,143,11,5,446,1,12,459
30,10,30089,1938,3,199,353,257,29,18,856,1,14,871
30,10,30089,1939,3,125,340,257,24,14,760,0,14,774
30,10,30089,1942,3,114,261,190,19,10,594,1,11,606
30,10,30089,1943,3,118,199,172,8,18,515,1,14,530
30,10,30089,1946,3,155,179,208,16,19,577,1,10,588
30,10,30089,1947,3,158,250,230,19,16,673,0,11,684
30,10,30089,1950,3,104,181,213,26,5,529,0,5,534
30,10,30089,1951,3,398,1024,665,54,44,2185,4,44,2233
30,10,30089,1954,3,103,167,154,11,10,445,1,7,453
30,10,30089,1955,3,160,327,216,26,13,742,0,18,760
30,10,30089,1958,3,155,332,223,18,10,738,1,20,759
30,10,30089,1959,3,153,406,246,14,8,827,3,25,855
30,10,30089,1962,3,121,291,233,28,17,690,0,20,710
30,10,30089,1963,3,153,145,144,13,9,464,1,5,470
30,10,30089,1966,3,127,294,273,13,18,725,2,10,737
30,10,30089,1967,3,103,171,176,16,7,473,0,8,481
30,10,30089,1972,3,229,507,341,36,20,1133,0,16,1149
30,10,30089,1974,3,104,214,217,7,8,550,0,15,565
30,10,30089,1975,3,128,202,178,9,3,520,0,13,533
30,10,30089,1978,3,117,257,171,16,8,569,0,11,580
30,10,30089,1979,3,101,202,150,15,10,478,1,10,489
30,10,30089,1982,3,108,180,141,19,18,466,0,9,475
30,10,30089,1983,3,125,263,219,13,13,633,0,9,642
30,10,30089,1986,3,79,280,161,13,9,542,0,19,561
30,10,30089,1987,3,104,307,193,11,6,621,1,16,638
30,10,30089,1990,3,102,186,140,13,7,448,0,9,457
30,10,30089,1991,3,120,236,127,11,10,504,1,11,516
30,10,30089,1994,3,212,273,263,12,14,774,0,6,780
30,10,30089,1995,3,169,229,155,12,13,578,0,8,586
30,10,30089,1998,3,94,216,222,30,9,571,0,18,589
30,10,30089,1999,3,146,255,247,23,8,679,0,19,698
30,10,30089,2002,3,121,276,178,19,10,604,1,10,615
30,10,30089,2003,3,187,453,295,26,10,971,1,13,985
30,10,30089,2007,3,140,235,215,19,9,618,0,5,623
30,10,30089,2010,3,106,214,180,13,17,530,2,6,538
30,10,30089,2011,3,112,205,154,20,13,504,1,8,513
30,10,30089,2014,3,156,306,306,18,12,798,0,25,823
30,10,30089,2015,3,174,408,281,19,12,894,2,26,922
30,10,30089,2018,3,129,144,172,8,15,468,3,4,475
30,10,30089,2019,3,193,264,335,24,16,832,0,14,846
30,10,30089,2022,3,79,130,102,12,9,332,0,4,336
30,10,30089,2023,3,150,241,185,14,12,602,0,19,621
30,10,30089,2026,3,169,399,229,22,16,835,1,13,849
30,10,30089,2030,3,178,223,195,17,16,629,3,8,640
30,10,30089,2031,3,168,261,264,13,17,723,0,8,731
30,10,30089,2034,3,193,204,194,19,17,627,0,7,634
30,10,30089,2035,3,224,270,219,26,12,751,4,8,763
30,10,30089,2038,3,157,341,240,31,17,786,0,15,801
30,10,30089,2039,3,179,216,133,11,15,554,3,4,561
30,10,30089,2042,3,89,261,196,13,8,567,0,16,583
30,10,30089,2043,3,101,178,150,5,19,453,1,11,465
30,10,30089,2046,3,146,158,160,8,20,492,0,8,500
30,10,30089,2047,3,79,141,168,14,15,417,1,3,421
30,10,30089,2050,3,232,229,206,16,12,695,1,9,705
30,10,30089,2056,3,168,234,189,12,21,624,1,9,634
30,10,30089,2058,3,101,172,123,7,25,428,0,9,437
30,10,30089,2059,3,179,289,245,22,23,758,0,9,767
30,10,30089,2062,3,97,215,183,19,11,525,1,4,530
30,10,30089,2063,3,67,235,173,18,9,502,1,5,508
30,10,30089,2066,3,166,221,210,12,17,626,0,11,637
30,10,30089,2067,3,107,277,228,26,12,650,1,11,662
30,10,30089,2075,3,122,255,236,18,15,646,2,17,665
30,10,30089,2078,3,75,140,142,9,8,374,2,5,381
30,10,30089,2079,3,65,156,117,6,7,351,0,12,363
30,10,30089,2082,3,210,474,410,30,32,1156,0,15,1171
30,10,30089,2083,3,110,374,289,23,16,812,0,23,835
30,10,30089,2098,3,18,82,25,1,3,129,0,8,137
30,10,30089,4719,3,32,88,43,2,1,166,0,0,166
30,11,30041,763,3,138,213,196,14,6,567,1,5,573
30,11,30041,766,3,361,524,227,73,18,1203,0,6,1209
30,11,30041,767,3,95,123,100,3,1,322,0,11,333
30,11,30041,770,3,80,154,127,11,4,376,1,5,382
30,11,30041,771,3,174,203,147,15,8,547,2,4,553
30,11,30041,774,3,199,308,279,31,14,831,0,15,846
30,11,30041,775,3,181,326,341,19,12,879,5,22,906
30,11,30041,778,3,185,237,197,14,9,642,2,11,655
30,11,30041,779,3,176,155,132,16,5,484,1,8,493
30,11,30041,782,3,189,178,141,14,6,528,0,13,541
30,11,30041,783,3,92,137,101,5,7,342,1,0,343
30,11,30041,786,3,262,321,222,18,8,831,1,9,841
30,11,30041,787,3,277,305,225,15,9,831,0,7,838
30,11,30041,790,3,171,298,209,14,4,696,1,11,708
30,11,30041,791,3,193,287,262,20,13,775,0,14,789
30,11,30041,794,3,304,341,186,25,17,873,2,14,889
30,11,30041,795,3,312,419,173,14,12,930,0,9,939
30,11,30041,798,3,143,237,195,14,10,599,1,18,618
30,11,30041,799,3,174,228,223,21,8,654,1,13,668
30,11,30041,802,3,95,122,90,13,2,322,0,6,328
30,11,30041,803,3,125,216,165,12,8,526,1,5,532
30,11,30041,806,3,138,240,188,19,7,592,3,11,606
30,11,30041,807,3,122,161,141,11,3,438,1,6,445
30,11,30041,810,3,94,162,207,10,6,479,0,12,491
30,11,30041,811,3,49,68,72,11,1,201,4,0,205
30,11,30041,814,3,133,213,179,17,7,549,2,11,562
30,11,30041,815,3,287,365,383,27,13,1075,4,15,1094
30,11,30041,818,3,505,781,762,59,26,2133,3,37,2173
30,11,30041,819,3,440,660,598,61,24,1783,5,33,1821
30,11,30041,822,3,114,198,164,0,8,484,0,7,491
30,11,30041,823,3,261,384,327,32,17,1021,1,12,1034
30,11,30041,826,3,72,158,217,8,10,465,1,15,481
30,11,30041,827,3,67,110,120,7,4,308,2,4,314
30,11,30041,830,3,153,209,247,18,3,630,2,13,645
30,11,30041,831,3,135,216,248,23,8,630,1,10,641
30,11,30041,834,3,90,171,177,9,7,454,2,7,463
30,11,30041,835,3,109,171,161,10,3,454,0,6,460
30,11,30041,838,3,123,229,207,14,3,576,2,17,595
30,11,30041,839,3,143,226,193,9,5,576,1,6,583
30,11,30041,842,3,92,257,205,14,8,576,1,10,587
30,11,30041,843,3,110,248,237,15,7,617,0,13,630
30,11,30041,846,3,100,168,231,3,8,510,0,8,518
30,11,30041,847,3,114,192,201,8,5,520,0,17,537
30,11,30041,850,3,190,375,511,18,8,1102,1,35,1138
30,11,30041,851,3,191,330,195,16,5,737,1,12,750
30,11,30041,854,3,153,310,353,8,7,831,5,19,855
30,11,30041,855,3,168,360,424,19,9,980,4,30,1014
30,11,30041,858,3,101,170,227,20,6,524,2,13,539
30,11,30041,859,3,68,224,175,8,4,479,0,13,492
30,11,30041,862,3,149,250,239,12,5,655,3,4,662
30,11,30041,863,3,69,114,156,12,9,360,0,6,366
30,11,30041,866,3,51,120,72,4,2,249,0,0,249
30,11,30041,867,3,75,168,201,8,6,458,0,14,472
30,11,30041,870,3,74,125,124,12,2,337,0,8,345
30,11,30041,871,3,95,172,136,5,2,410,0,16,426
30,11,30041,874,3,95,231,199,16,5,546,2,22,570
30,11,30041,875,3,88,222,243,14,5,572,0,16,588
30,11,30041,878,3,111,208,240,13,6,578,4,18,600
30,11,30041,879,3,61,209,257,6,7,540,0,10,550
30,11,30041,882,3,121,248,295,12,13,689,0,19,708
30,11,30041,883,3,73,191,205,10,1,480,1,14,495
30,11,30041,886,3,118,308,258,12,8,704,1,16,721
30,11,30041,887,3,187,436,431,20,9,1083,1,21,1105
30,11,30041,890,3,157,289,351,20,8,825,2,22,849
30,11,30041,891,3,161,321,484,18,13,997,1,40,1038
30,11,30041,894,3,171,439,529,13,8,1160,1,40,1201
30,11,30041,895,3,132,268,362,15,13,790,1,18,809
30,11,30041,898,3,131,282,298,13,10,734,2,17,753
30,11,30041,899,3,90,270,322,15,6,703,0,19,722
30,11,30041,902,3,138,204,242,8,7,599,1,18,618
30,11,30041,903,3,104,240,339,7,10,700,2,21,723
30,11,30041,906,3,163,387,582,18,13,1163,6,25,1194
30,11,30041,907,3,284,481,614,20,11,1410,0,42,1452
30,11,30041,910,3,83,225,314,9,7,638,0,13,651
30,11,30041,911,3,63,216,239,8,1,527,0,8,535
30,11,30041,914,3,190,604,548,16,18,1376,2,18,1396
30,11,30041,915,3,176,532,706,20,13,1447,8,28,1483
30,11,30041,918,3,112,351,277,8,6,754,2,24,780
30,11,30041,919,3,209,568,736,21,12,1546,0,31,1577
30,11,30041,922,3,22,93,100,0,2,217,0,9,226
30,11,30041,923,3,40,108,105,4,7,264,0,2,266
30,11,30041,926,3,26,141,215,13,3,398,1,8,407
30,11,30041,927,3,14,141,178,5,3,341,0,10,351
30,11,30041,930,3,20,122,211,10,1,364,2,24,390
30,11,30041,931,3,37,105,190,4,1,337,2,0,339
30,11,30205,4647,3,59,387,351,22,7,826,2,12,840
30,11,30205,4650,3,61,280,254,27,1,623,0,5,628
30,11,30205,4651,3,42,283,237,39,8,609,1,18,628
30,11,30205,4654,3,22,175,168,13,1,379,0,7,386
30,11,30205,4655,3,54,196,287,17,4,558,0,16,574
30,11,30205,4658,3,42,191,195,8,4,440,0,6,446
30,11,30205,4659,3,67,282,350,40,5,744,0,16,760
30,11,30205,4662,3,69,387,318,28,5,807,0,12,819
30,11,30205,4663,3,50,301,259,16,2,628,1,4,633
30,11,30205,4666,3,35,158,132,9,2,336,0,9,345
30,11,30206,4667,3,41,156,272,7,1,477,1,13,491
30,11,30206,4670,3,67,266,515,20,9,877,1,8,886
30,11,30206,4671,3,61,181,518,5,9,774,2,4,780
30,11,30206,4674,3,62,140,339,15,4,560,1,2,563
30,11,30206,4675,3,50,189,391,19,10,659,2,6,667
30,11,30206,4678,3,65,195,336,21,6,623,0,2,625
30,11,30206,4679,3,72,182,403,12,6,675,1,6,682
30,11,30206,4682,3,72,194,238,14,6,524,1,4,529
30,11,30206,4683,3,69,240,268,8,6,591,0,12,603
30,11,30206,4686,3,106,349,448,16,8,927,0,15,942
30,11,30206,4687,3,124,230,590,25,12,981,0,16,997
30,11,30206,4690,3,79,179,585,13,8,864,3,13,880
30,11,30206,4691,3,51,82,121,3,1,258,0,4,262
30,11,30206,4694,3,74,92,170,6,3,345,2,10,357
30,11,30206,4695,3,115,120,150,4,3,392,0,15,407
30,12,30192,4217,3,712,484,445,63,16,1720,2,20,1742
30,12,30192,4218,3,495,414,313,43,9,1274,2,21,1297
30,12,30192,4219,3,216,138,106,19,3,482,1,19,502
30,12,30192,4222,3,196,134,98,10,4,442,2,6,450
30,12,30192,4223,3,155,93,102,16,6,372,0,10,382
30,12,30192,4226,3,283,157,163,28,4,635,4,9,648
30,12,30192,4227,3,420,234,254,29,6,943,4,11,958
30,12,30192,4230,3,1844,1171,1017,117,45,4194,5,47,4246
30,12,30192,4231,3,1182,687,666,51,31,2617,7,21,2645
30,12,30192,4234,3,210,152,106,12,5,485,2,4,491
30,12,30192,4235,3,231,134,109,12,6,492,0,6,498
30,12,30192,4238,3,324,179,165,16,8,692,2,8,702
30,12,30192,4239,3,221,115,151,15,7,509,2,7,518
30,12,30192,4242,3,242,203,137,56,5,643,0,6,649
30,12,30192,4243,3,279,166,105,20,7,577,1,12,590
30,12,30192,4246,3,144,126,122,6,8,406,0,2,408
30,12,30192,4247,3,150,83,74,12,0,319,0,6,325
30,12,30192,4250,3,136,106,88,5,4,339,0,4,343
30,12,30192,4251,3,157,106,90,10,2,365,4,0,369
30,12,30192,4254,3,393,228,285,36,13,955,0,52,1007
30,12,30192,4255,3,332,187,159,17,3,698,1,0,699
30,12,30192,4258,3,312,161,143,17,3,636,1,9,646
30,12,30192,4259,3,250,211,172,28,7,668,2,8,678
30,12,30192,4262,3,828,801,434,43,18,2124,10,29,2163
30,12,30192,4263,3,302,175,156,17,4,654,2,7,663
30,12,30192,4266,3,406,227,228,9,9,879,0,7,886
30,12,30192,4267,3,481,267,254,21,13,1036,0,14,1050
30,12,30192,4270,3,326,193,190,23,6,738,0,12,750
30,12,30192,4271,3,115,136,117,8,5,381,0,6,387
30,12,30192,4274,3,194,173,167,13,3,550,0,7,557
30,12,30192,4275,3,214,156,142,17,9,538,0,12,550
30,12,30192,4278,3,247,173,203,15,8,646,0,13,659
30,12,30192,4279,3,365,287,207,12,7,878,1,8,887
30,12,30192,4282,3,249,176,149,19,4,597,1,7,605
30,12,30192,4283,3,331,272,213,18,10,844,0,7,851
30,12,30192,4286,3,250,139,168,9,5,571,0,7,578
30,12,30192,4287,3,172,172,117,11,4,476,3,8,487
30,12,30192,4290,3,222,125,158,8,8,521,1,11,533
30,12,30192,4291,3,110,107,95,11,4,327,0,5,332
30,12,30192,4294,3,109,93,85,8,2,297,0,0,297
30,12,30192,4295,3,154,122,119,16,4,415,4,3,422
30,12,30192,4298,3,146,119,122,14,10,411,0,5,416
30,12,30192,4299,3,95,92,57,6,5,255,0,3,258
30,12,30192,4302,3,176,115,111,12,9,423,0,6,429
30,12,30192,4303,3,144,92,122,7,6,371,1,7,379
30,12,30192,4306,3,244,258,123,9,5,639,0,11,650
30,12,30192,4307,3,990,830,534,62,24,2440,17,52,2509
30,12,30192,4310,3,318,237,111,16,6,688,3,18,709
30,12,30192,4311,3,311,280,150,23,3,767,1,33,801
30,12,30192,4314,3,165,91,97,13,3,369,3,10,382
30,12,30192,4315,3,147,111,148,9,6,421,1,8,430
30,12,30192,4318,3,126,123,156,21,8,434,0,2,436
30,12,30192,4319,3,110,116,41,14,4,285,0,6,291
30,12,30192,4322,3,258,171,167,14,15,625,3,17,645
30,12,30192,4323,3,212,206,153,16,6,593,1,7,601
30,12,30192,4326,3,178,114,119,15,10,436,1,5,442
30,12,30192,4327,3,159,140,112,10,10,431,1,5,437
30,12,30192,4330,3,132,108,122,7,1,370,2,7,379
30,12,30192,4331,3,181,80,139,13,8,421,0,0,421
30,12,30192,4334,3,201,121,139,17,7,485,2,6,493
30,12,30192,4335,3,201,123,105,10,2,441,1,9,451
30,12,30192,4338,3,351,181,121,17,7,677,0,13,690
30,12,30192,4339,3,316,269,185,17,8,795,3,24,822
30,12,30192,4342,3,263,148,146,13,2,572,1,5,578
30,12,30192,4343,3,333,296,106,9,7,751,0,24,775
30,12,30192,4346,3,275,196,172,16,13,672,0,20,692
30,12,30192,4347,3,251,150,158,8,2,569,0,10,579
30,12,30192,4350,3,212,168,144,8,7,539,1,13,553
30,12,30192,4351,3,217,173,156,20,13,579,2,7,588
30,12,30192,4354,3,301,267,189,16,11,784,1,18,803
30,12,30192,4355,3,218,180,153,14,13,578,3,13,594
30,12,30192,4358,3,158,117,96,8,4,383,1,5,389
30,12,30192,4359,3,170,187,101,11,10,479,0,11,490
30,12,30192,4362,3,426,380,211,25,15,1057,3,17,1077
30,12,30192,4363,3,274,208,155,23,7,667,0,11,678
30,12,30192,4368,3,207,241,125,19,3,595,4,14,613
30,12,30192,4370,3,194,163,117,15,4,493,0,8,501
30,12,30192,4371,3,249,164,140,8,2,563,5,8,576
30,12,30192,4374,3,276,153,220,14,5,668,0,7,675
30,12,30192,4375,3,125,110,96,16,3,350,2,3,355
30,12,30192,4378,3,173,100,98,11,4,386,0,10,396
30,12,30192,4379,3,283,147,155,13,3,601,0,15,616
30,12,30192,4385,3,273,118,118,7,5,521,2,8,531
30,12,30192,4387,3,269,125,149,11,7,561,1,6,568
30,12,30192,4391,3,195,142,105,11,9,462,0,9,471
30,12,30192,4394,3,218,170,126,15,6,535,0,10,545
30,12,30192,4395,3,123,118,108,7,3,359,1,1,361
30,12,30192,4398,3,182,151,114,10,5,462,1,0,463
30,12,30192,4399,3,169,113,83,4,4,373,1,3,377
30,12,30192,4402,3,245,209,158,18,16,646,0,7,653
30,12,30192,4403,3,227,93,143,7,8,478,0,9,487
30,12,30192,4406,3,173,97,104,9,8,391,2,2,395
30,12,30192,4407,3,153,140,96,17,4,410,0,24,434
30,12,30192,4473,3,271,187,56,8,1,523,0,12,535
30,12,30192,4474,3,1166,696,316,73,19,2270,13,56,2339
30,12,30192,4475,3,1443,1034,718,63,25,3283,17,141,3441
30,12,30192,4478,3,177,128,85,2,4,396,2,0,398
30,12,30192,4479,3,233,162,98,4,2,499,2,10,511
30,12,30192,4482,3,358,262,19,3,0,642,0,18,660
30,12,30192,4483,3,231,118,26,3,0,378,0,7,385
30,12,30192,4486,3,248,139,126,10,5,528,1,5,534
30,12,30192,4487,3,179,178,81,4,6,448,0,8,456
30,12,30192,4490,3,719,405,380,38,16,1558,1,18,1577
30,12,30192,4491,3,469,314,216,14,8,1021,0,14,1035
30,12,30192,4499,3,270,208,37,5,1,521,2,14,537
30,13,30007,106,3,436,304,187,103,6,1036,2,26,1064
30,13,30007,107,3,334,730,135,40,6,1245,1,47,1293
30,13,30017,363,3,161,195,124,29,5,514,0,7,521
30,13,30017,366,3,151,112,87,21,9,380,2,7,389
30,13,30017,367,3,314,223,179,33,4,753,1,21,775
30,13,30017,370,3,84,122,107,16,1,330,7,8,345
30,13,30017,371,3,110,175,104,23,5,417,1,8,426
30,13,30017,374,3,218,224,141,25,13,621,3,16,640
30,13,30017,375,3,414,301,338,64,19,1136,3,39,1178
30,13,30017,378,3,162,170,100,17,9,458,0,14,472
30,13,30017,379,3,163,187,152,19,3,524,2,5,531
30,13,30017,382,3,207,113,38,6,3,367,0,3,370
30,13,30017,383,3,193,109,35,10,3,350,1,5,356
30,13,30022,398,3,265,116,112,6,3,502,2,6,510
30,13,30022,399,3,432,258,99,15,3,807,2,20,829
30,13,30022,402,3,89,94,24,18,0,225,0,10,235
30,13,30022,403,3,113,127,109,7,1,357,0,12,369
30,13,30022,406,3,247,135,217,17,2,618,2,4,624
30,13,30022,407,3,265,109,229,10,8,621,3,12,636
30,13,30022,410,3,283,192,291,45,7,818,1,28,847
30,13,30022,411,3,262,185,290,38,7,782,3,24,809
30,13,30025,459,3,280,192,208,49,10,739,6,26,771
30,13,30025,462,3,186,242,88,12,7,535,5,13,553
30,13,30025,463,3,324,163,241,42,7,777,5,16,798
30,13,30032,609,3,265,238,271,32,4,810,2,29,841
30,13,30032,610,3,242,399,434,16,11,1102,6,30,1138
30,13,30032,611,3,172,100,95,8,6,381,0,5,386
30,13,30032,614,3,228,428,400,17,8,1081,13,33,1127
30,13,30032,615,3,341,245,242,28,19,875,19,11,905
30,13,30045,970,3,234,337,65,47,1,684,1,16,701
30,13,30045,971,3,190,212,61,12,1,476,0,14,490
30,13,30045,974,3,311,127,75,24,4,541,5,9,555
30,13,30045,975,3,132,66,20,21,0,239,2,8,249
30,13,30045,978,3,282,91,27,25,4,429,1,4,434
30,13,30045,979,3,498,414,32,11,2,957,2,27,986
30,13,30073,1597,3,178,234,72,96,14,594,0,32,626
30,13,30073,1598,3,176,206,115,95,10,602,2,21,625
30,13,30073,1599,3,227,346,147,147,7,874,1,32,907
30,13,30073,1602,3,103,147,56,88,7,401,1,14,416
30,13,30073,1603,3,173,257,67,132,14,643,0,24,667
30,13,30073,1606,3,287,299,188,204,14,992,6,31,1029
30,13,30073,1607,3,457,416,206,260,25,1364,9,52,1425
30,13,30073,1610,3,223,294,157,107,15,796,6,25,827
30,13,30073,1611,3,253,363,32,9,1,658,7,14,679
30,13,30073,1614,3,324,225,46,63,5,663,8,44,715
30,13,30073,1615,3,299,198,97,38,8,640,6,34,680
30,13,30073,1618,3,137,57,35,10,4,243,2,7,252
30,13,30073,1619,3,433,417,65,36,5,956,3,26,985
30,13,30073,1622,3,261,329,99,34,2,725,10,26,761
30,13,30083,1764,3,349,289,278,85,9,1010,0,50,1060
30,13,30083,1766,3,177,89,70,26,2,364,1,14,379
30,13,30083,1767,3,255,220,185,47,8,715,5,24,744
30,13,30083,1770,3,126,144,238,14,6,528,3,27,558
30,13,30083,1771,3,157,171,268,39,4,639,3,52,694
30,13,30083,1774,3,182,148,215,26,7,578,1,24,603
30,13,30101,2249,3,182,207,201,50,5,645,1,10,656
30,13,30101,2250,3,162,182,166,49,5,564,0,6,570
30,13,30101,2251,3,101,179,111,57,4,452,2,13,467
30,13,30101,2254,3,254,96,183,14,11,558,5,6,569
30,13,30101,2255,3,234,115,112,22,2,485,4,19,508
30,13,30101,2258,3,180,167,302,9,1,659,0,19,678
30,13,30101,2259,3,245,144,108,17,2,516,2,9,527
30,13,30101,2262,3,217,318,77,23,2,637,9,11,657
30,13,30101,2263,3,154,325,135,26,1,641,0,17,658
30,13,30126,2990,3,189,243,361,40,4,837,4,14,855
30,13,30126,2991,3,213,272,273,52,4,814,5,27,846
30,13,30126,2994,3,318,343,558,111,13,1343,5,52,1400
30,13,30126,2995,3,154,301,599,35,12,1101,8,20,1129
30,13,30126,2998,3,58,247,262,12,2,581,6,8,595
30,13,30126,2999,3,142,269,437,15,8,871,2,42,915
30,13,30126,3002,3,111,282,212,3,3,611,0,18,629
30,13,30126,3003,3,165,319,362,9,6,861,1,35,897
30,13,30127,3006,3,163,142,209,22,6,542,2,9,553
30,13,30127,3007,3,192,139,108,14,3,456,0,5,461
30,13,30127,3010,3,176,155,36,6,0,373,0,4,377
30,13,30127,3011,3,412,226,244,22,6,910,7,16,933
30,13,30127,3014,3,245,171,116,14,1,547,5,7,559
30,13,30127,3015,3,499,233,275,35,4,1046,5,14,1065
30,13,30127,3018,3,167,106,248,32,3,556,5,19,580
30,13,30127,3019,3,191,99,122,40,0,452,6,6,464
30,13,30127,3022,3,147,168,366,13,2,696,1,14,711
30,13,30127,3023,3,148,133,158,1,2,442,0,6,448
30,13,30127,3026,3,214,48,123,6,3,394,1,6,401
30,13,30127,3027,3,155,83,162,9,2,411,3,7,421
30,13,30134,3259,3,184,147,231,17,4,583,1,7,591
30,13,30134,3262,3,154,140,120,20,4,438,4,13,455
30,13,30134,3263,3,199,137,216,26,14,592,6,10,608
30,13,30134,3266,3,177,97,144,2,2,422,0,10,432
30,13,30134,3267,3,213,175,290,36,12,726,6,17,749
30,13,30134,3270,3,101,215,104,19,4,443,3,11,457
30,13,30134,3271,3,103,104,46,10,0,263,0,4,267
30,13,30147,3502,3,308,266,100,33,4,711,0,14,725
30,13,30147,3503,3,357,232,56,44,6,695,5,13,713
30,13,30149,3513,3,309,231,190,24,4,758,2,16,776
30,13,30149,3514,3,347,131,216,24,5,723,4,7,734
30,13,30149,3515,3,304,160,186,42,4,696,3,15,714
30,13,30149,3518,3,275,123,208,30,1,637,1,12,650
30,13,30149,3519,3,258,118,175,49,4,604,6,10,620
30,13,30149,3522,3,264,152,102,5,8,531,0,2,533
30,13,30149,3523,3,177,103,148,3,3,434,3,9,446
30,13,30149,3526,3,262,224,102,5,3,596,0,11,607
30,13,30149,3527,3,236,222,99,29,4,590,2,8,600
30,13,30161,3736,3,402,547,64,34,3,1050,2,34,1086
30,13,30161,3738,3,311,357,119,45,7,839,2,17,858
30,13,30164,3754,3,512,289,190,52,6,1049,3,31,1083
30,13,30164,3755,3,474,340,138,45,9,1006,5,34,1045
30,13,30178,3999,3,278,324,138,29,1,770,0,12,782
30,13,30187,4086,3,472,377,124,54,4,1031,6,24,1061
30,13,30187,4087,3,391,399,76,54,3,923,3,21,947
30,13,30187,4090,3,206,138,28,4,3,379,0,14,393
30,13,30187,4091,3,204,193,93,39,2,531,1,17,549
30,13,30187,4094,3,109,132,23,22,3,289,5,13,307
30,13,30187,4095,3,291,251,90,43,8,683,2,11,696
30,13,30200,4561,3,214,295,82,49,6,646,3,20,669
30,13,30200,4562,3,80,120,33,12,1,246,0,10,256
30,13,30200,4563,3,285,226,46,18,0,575,4,11,590
30,13,30200,4566,3,205,342,158,43,7,755,6,21,782
30,13,30200,4567,3,542,218,43,17,2,822,3,18,843
30,14,30063,1413,3,133,173,250,16,9,581,1,4,586
30,14,30063,1414,3,283,314,420,19,12,1048,5,17,1070
30,14,30063,1415,3,105,199,216,7,3,530,0,10,540
30,14,30063,1418,3,123,210,186,11,5,535,3,13,551
30,14,30063,1419,3,122,261,265,9,6,663,2,15,680
30,14,30063,1422,3,89,331,304,11,11,746,0,20,766
30,14,30063,1423,3,92,162,157,11,2,424,1,6,431
30,14,30063,1426,3,149,130,166,11,7,463,3,7,473
30,14,30063,1427,3,94,187,153,9,12,455,1,15,471
30,14,30063,1430,3,104,133,132,4,6,379,1,14,394
30,14,30063,1431,3,101,224,199,19,5,548,7,8,563
30,14,30063,1434,3,168,205,176,9,3,561,1,19,581
30,14,30063,1435,3,196,130,196,6,3,531,0,19,550
30,14,30063,1438,3,103,209,133,2,3,450,0,26,476
30,14,30063,1439,3,55,59,70,2,4,190,0,12,202
30,14,30063,1442,3,127,83,33,1,0,244,0,0,244
30,14,30063,1443,3,173,198,71,2,4,448,2,19,469
30,14,30063,1446,3,527,272,82,28,4,913,3,37,953
30,14,30063,1447,3,23,141,29,1,1,195,1,11,207
30,14,30063,1450,3,51,84,28,6,1,170,1,8,179
30,14,30063,1451,3,259,70,15,2,2,348,0,11,359
30,14,30063,1454,3,496,123,85,4,4,712,0,27,739
30,14,30063,1455,3,714,84,39,1,1,839,1,25,865
30,14,30072,1579,3,184,262,159,0,0,605,1,7,613
30,14,30072,1582,3,193,205,82,0,1,481,6,10,497
30,14,30072,1583,3,94,224,101,5,0,424,3,13,440
30,14,30072,1586,3,229,142,93,3,0,467,2,8,477
30,14,30072,1587,3,247,25,60,3,3,338,0,7,345
30,14,30072,1590,3,205,76,137,3,4,425,7,15,447
30,14,30209,1591,3,67,91,74,4,1,237,1,1,239
30,14,30209,1594,3,84,122,24,1,1,232,0,10,242
30,14,30209,1595,3,352,276,223,8,9,868,4,36,908
30,14,30084,1775,3,197,335,781,17,6,1336,2,23,1361
30,14,30084,1778,3,137,335,550,7,8,1037,0,20,1057
30,14,30084,1779,3,4,4,31,0,1,40,0,2,42
30,14,30084,1782,3,75,90,108,3,1,277,5,13,295
30,14,30084,1783,3,79,240,181,0,0,500,1,32,533
30,14,30093,2146,3,114,250,135,7,1,507,0,12,519
30,14,30093,2147,3,60,191,72,7,2,332,0,8,340
30,14,30093,2150,3,36,67,56,0,2,161,0,10,171
30,14,30093,2151,3,34,14,44,3,1,96,0,3,99
30,14,30093,2154,3,59,67,133,9,0,268,1,8,277
30,14,30093,2155,3,300,291,247,20,11,869,3,19,891
30,14,30093,2158,3,41,172,40,1,0,254,0,4,258
30,14,30093,2159,3,142,189,137,5,3,476,0,16,492
30,14,30093,2162,3,119,197,271,2,4,593,0,23,616
30,14,30093,2163,3,71,168,213,2,1,455,0,16,471
30,14,30093,2166,3,154,115,108,3,2,382,2,23,407
30,14,30093,2167,3,257,193,168,11,17,646,1,23,670
30,14,30109,2420,3,149,213,402,7,3,774,10,19,803
30,14,30109,2422,3,161,236,529,14,12,952,1,17,970
30,14,30109,2423,3,100,163,290,4,4,561,0,33,594
30,14,30109,2426,3,109,176,341,5,6,637,1,14,652
30,14,30109,2427,3,161,186,516,11,6,880,0,25,905
30,14,30109,2430,3,181,242,273,8,8,712,1,13,726
30,14,30109,2431,3,283,864,888,20,9,2064,0,31,2095
30,14,30109,2434,3,155,370,329,7,7,868,0,17,885
30,14,30109,2435,3,210,351,510,23,18,1112,0,21,1133
30,14,30109,2438,3,90,124,292,11,2,519,1,15,535
30,14,30109,2439,3,88,109,283,17,6,503,1,3,507
30,14,30109,2442,3,150,159,255,6,4,574,0,17,591
30,14,30109,2443,3,78,151,253,3,2,487,0,11,498
30,14,30109,2446,3,161,324,435,20,7,947,0,11,958
30,14,30109,2447,3,98,313,325,8,3,747,1,11,759
30,14,30109,2450,3,103,180,333,8,4,628,1,11,640
30,14,30109,2451,3,76,154,232,5,5,472,0,6,478
30,14,30109,2454,3,62,109,165,2,1,339,0,7,346
30,14,30109,2455,3,78,107,130,0,5,320,0,6,326
30,14,30109,2458,3,124,308,413,7,5,857,1,8,866
30,14,30109,2459,3,89,287,350,6,9,741,0,4,745
30,14,30109,2462,3,174,340,384,8,13,919,0,11,930
30,14,30109,2463,3,61,158,181,3,3,406,0,4,410
30,14,30109,2466,3,107,125,222,14,3,471,1,6,478
30,14,30109,2467,3,91,190,224,4,0,509,1,13,523
30,14,30109,2470,3,166,279,455,12,10,922,1,7,930
30,14,30109,2471,3,102,266,273,5,1,647,0,8,655
30,14,30109,2474,3,62,205,233,5,6,511,1,3,515
30,14,30109,2475,3,106,330,271,5,3,715,0,10,725
30,14,30109,2478,3,143,221,296,10,6,676,1,9,686
30,14,30109,2479,3,133,310,344,8,6,801,1,6,808
30,14,30109,2482,3,98,222,423,5,4,752,1,26,779
30,14,30109,2483,3,173,261,434,8,7,883,3,18,904
30,14,30109,2486,3,153,207,335,14,2,711,0,10,721
30,14,30109,2487,3,105,166,202,4,3,480,0,4,484
30,14,30109,2490,3,129,139,169,8,4,449,0,11,460
30,14,30109,2491,3,110,76,232,5,4,427,1,9,437
30,14,30109,2494,3,67,212,259,1,2,541,0,16,557
30,14,30109,2495,3,74,194,184,1,3,456,1,10,467
30,14,30109,2498,3,109,172,270,0,3,554,0,6,560
30,14,30109,2499,3,207,232,254,3,0,696,3,21,720
30,14,30109,2502,3,265,189,191,4,3,652,1,39,692
30,14,30109,2503,3,68,201,155,0,2,426,1,26,453
30,14,30109,2506,3,61,101,181,1,0,344,1,11,356
30,14,30109,2507,3,131,152,114,0,0,397,1,11,409
30,14,30109,2510,3,93,184,95,0,1,373,0,9,382
30,14,30109,2511,3,81,122,34,3,3,243,0,11,254
30,14,30109,2514,3,151,127,222,2,1,503,4,29,536
30,14,30109,2515,3,295,134,153,2,4,588,2,19,609
30,14,30109,2518,3,329,220,26,3,3,581,3,2,586
30,14,30109,2519,3,177,155,108,1,4,445,6,30,481
30,14,30209,2522,3,333,262,195,6,5,801,1,15,817
30,14,30209,2523,3,73,68,26,0,1,168,0,5,173
30,14,30112,2583,3,141,318,328,5,3,795,4,16,815
30,14,30112,2586,3,134,254,373,6,4,771,4,23,798
30,14,30112,2587,3,42,69,96,1,0,208,0,12,220
30,14,30112,2590,3,94,315,335,8,14,766,3,8,777
30,14,30112,2591,3,36,189,216,2,3,446,0,8,454
30,14,30209,4714,3,104,82,52,0,1,239,0,6,245
30,14,30209,4715,3,140,92,52,0,2,286,1,15,302
30,15,30009,178,3,332,409,94,10,11,856,4,27,887
30,15,30009,179,3,260,181,44,3,6,494,3,23,520
30,15,30009,182,3,194,222,40,3,4,463,0,35,498
30,15,30019,389,3,321,235,172,0,0,728,2,29,759
30,15,30030,588,3,281,204,241,11,5,742,2,31,775
30,15,30030,590,3,319,265,109,4,10,707,8,37,752
30,15,30030,591,3,262,292,106,3,12,675,3,30,708
30,15,30049,1162,3,283,277,84,19,8,671,7,16,694
30,15,30049,1163,3,282,179,136,27,14,638,7,23,668
30,15,30049,1166,3,209,174,107,12,10,512,0,15,527
30,15,30049,1167,3,278,214,89,20,8,609,11,14,634
30,15,30049,1170,3,141,164,102,4,4,415,1,42,458
30,15,30049,1171,3,154,175,68,6,4,407,16,4,427
30,15,30049,1174,3,135,285,111,1,7,539,0,43,582
30,15,30049,1175,3,274,174,45,5,5,503,2,45,550
30,15,30049,1178,3,55,300,38,3,3,399,13,25,437
30,15,30049,1179,3,153,368,63,2,5,591,1,42,634
30,15,30049,1182,3,112,520,101,3,4,740,1,56,797
30,15,30049,1183,3,139,169,22,0,2,332,4,14,350
30,15,30064,1456,3,299,314,162,9,1,785,6,22,813
30,15,30064,1458,3,476,457,312,10,11,1266,2,40,1308
30,15,30064,1459,3,324,397,381,11,6,1119,1,41,1161
30,15,30064,1462,3,229,501,245,7,4,986,1,29,1016
30,15,30085,1784,3,139,273,160,9,5,586,4,41,631
30,15,30085,1786,3,79,141,68,9,5,302,0,16,318
30,15,30085,1787,3,82,152,63,5,5,307,2,7,316
30,15,30085,1790,3,94,66,62,10,5,237,0,3,240
30,15,30100,2240,3,265,224,168,13,8,678,12,16,706
30,15,30100,2242,3,269,182,227,13,10,701,9,28,738
30,15,30100,2243,3,226,170,209,21,10,636,12,16,664
30,15,30100,2246,3,63,229,100,2,2,396,3,22,421
30,15,30100,2247,3,20,63,16,1,0,100,1,15,116
30,15,30102,2265,3,297,512,237,28,4,1078,3,54,1135
30,15,30102,2266,3,49,260,169,4,5,487,0,21,508
30,15,30102,2267,3,28,132,203,3,4,370,0,15,385
30,15,30102,2270,3,66,113,535,7,9,730,0,10,740
30,15,30102,2271,3,55,152,145,6,1,359,4,15,378
30,15,30102,2274,3,150,113,90,12,9,374,1,3,378
30,15,30102,2275,3,107,131,126,9,7,380,0,12,392
30,15,30102,2278,3,215,126,176,26,7,550,1,12,563
30,15,30102,2279,3,211,196,155,24,4,590,1,8,599
30,15,30116,2621,3,272,245,257,20,12,806,0,16,822
30,15,30116,2622,3,184,279,274,10,13,760,1,9,770
30,15,30116,2623,3,177,284,200,10,5,676,1,14,691
30,15,30116,2626,3,287,363,268,27,12,957,3,20,980
30,15,30116,2627,3,245,320,206,27,15,813,2,15,830
30,15,30116,2630,3,315,271,232,20,7,845,2,19,866
30,15,30116,2631,3,217,289,210,17,8,741,0,21,762
30,15,30116,2634,3,251,528,551,42,7,1379,4,32,1415
30,15,30116,2635,3,243,498,327,29,12,1109,6,23,1138
30,15,30116,2638,3,112,377,168,5,7,669,1,39,709
30,15,30116,2639,3,65,264,210,6,4,549,0,27,576
30,15,30119,2666,3,488,395,320,47,20,1270,9,19,1298
30,15,30119,2667,3,227,176,126,12,9,550,1,8,559
30,15,30119,2670,3,328,244,211,56,14,853,5,6,864
30,15,30119,2671,3,211,218,140,26,8,603,0,11,614
30,15,30119,2674,3,209,172,126,15,12,534,0,9,543
30,15,30119,2675,3,236,213,145,30,16,640,3,12,655
30,15,30119,2678,3,279,225,203,28,13,748,0,14,762
30,15,30119,2679,3,309,263,198,29,10,809,1,16,826
30,15,30119,2682,3,99,77,82,5,3,266,1,4,271
30,15,30119,2683,3,176,165,168,15,10,534,4,12,550
30,15,30119,2686,3,402,263,299,40,8,1012,4,15,1031
30,15,30119,2687,3,211,169,103,11,11,505,3,13,521
30,15,30119,2690,3,158,131,149,23,9,470,1,7,478
30,15,30119,2691,3,168,122,148,21,8,467,0,8,475
30,15,30119,2694,3,145,106,113,21,4,389,1,10,400
30,15,30119,2695,3,197,131,175,26,7,536,0,10,546
30,15,30119,2698,3,234,181,197,17,9,638,0,12,650
30,15,30119,2699,3,226,169,151,20,10,576,1,8,585
30,15,30119,2702,3,298,214,163,20,12,707,1,7,715
30,15,30119,2703,3,94,96,105,9,3,307,1,4,312
30,15,30119,2706,3,103,89,87,16,1,296,0,4,300
30,15,30119,2707,3,136,105,113,6,4,364,0,8,372
30,15,30119,2710,3,157,97,94,16,17,381,0,11,392
30,15,30119,2711,3,205,166,134,27,9,541,1,7,549
30,15,30119,2714,3,170,113,70,11,4,368,1,3,372
30,15,30119,2715,3,180,126,99,17,9,431,0,10,441
30,15,30119,2718,3,438,295,280,21,20,1054,2,28,1084
30,15,30119,2719,3,418,269,222,28,15,952,0,21,973
30,15,30119,2722,3,285,188,164,16,12,665,0,10,675
30,15,30119,2723,3,213,152,124,18,12,519,1,11,531
30,15,30119,2726,3,295,281,186,31,9,802,2,10,814
30,15,30119,2727,3,123,116,68,13,5,325,0,3,328
30,15,30119,2730,3,156,177,104,17,5,459,0,10,469
30,15,30119,2731,3,137,129,77,21,5,369,0,19,388
30,15,30119,2734,3,87,55,38,7,3,190,0,5,195
30,15,30119,2735,3,173,150,132,15,6,476,1,7,484
30,15,30119,2738,3,181,128,143,18,9,479,1,12,492
30,15,30119,2739,3,202,210,127,22,8,569,3,8,580
30,15,30119,2742,3,393,274,233,27,15,942,0,19,961
30,15,30119,2743,3,378,274,229,28,9,918,1,17,936
30,15,30119,2746,3,186,162,149,22,8,527,4,7,538
30,15,30119,2747,3,370,313,295,34,14,1026,5,10,1041
30,15,30119,2750,3,121,118,107,17,3,366,0,7,373
30,15,30119,2751,3,225,173,173,26,3,600,0,14,614
30,15,30119,2754,3,199,160,145,9,10,523,1,17,541
30,15,30119,2755,3,164,170,98,22,6,460,2,9,471
30,15,30119,2758,3,346,267,234,31,16,894,4,32,930
30,15,30119,2759,3,227,177,122,19,8,553,8,10,571
30,15,30119,2762,3,244,184,172,27,6,633,2,17,652
30,15,30119,2763,3,568,391,325,39,26,1349,2,20,1371
30,15,30128,3028,3,396,423,165,17,14,1015,7,32,1054
30,15,30128,3030,3,25,320,9,2,2,358,2,13,373
30,15,30128,3031,3,120,260,17,1,2,400,0,20,420
30,15,30128,3034,3,159,267,161,2,5,594,17,39,650
30,15,30128,3035,3,235,229,88,7,1,560,11,23,594
30,15,30139,3297,3,288,393,262,24,21,988,6,15,1009
30,15,30139,3298,3,300,336,277,22,14,949,2,6,957
30,15,30139,3299,3,455,447,398,33,15,1348,2,27,1377
30,15,30139,3302,3,285,293,292,31,10,911,2,21,934
30,15,30139,3303,3,269,286,279,32,19,885,5,16,906
30,15,30139,3306,3,161,173,170,19,7,530,1,6,537
30,15,30139,3307,3,187,164,172,18,10,551,0,13,564
30,15,30139,3310,3,209,216,288,22,3,738,4,10,752
30,15,30139,3311,3,229,200,219,12,11,671,2,13,686
30,15,30139,3314,3,257,300,245,35,14,851,6,15,872
30,15,30139,3315,3,63,132,84,10,7,296,1,4,301
30,15,30139,3318,3,224,311,181,27,8,751,0,9,760
30,15,30139,3319,3,168,272,136,17,5,598,2,5,605
30,15,30185,4079,3,317,180,111,14,12,634,0,15,649
30,15,30185,4082,3,345,269,79,11,12,716,9,27,752
30,16,30014,294,3,177,289,127,12,5,610,1,10,621
30,16,30014,295,3,382,395,290,35,7,1109,8,16,1133
30,16,30014,298,3,136,138,107,9,1,391,0,18,409
30,16,30014,299,3,69,105,158,12,2,346,1,18,365
30,16,30014,302,3,16,27,74,2,0,119,0,3,122
30,16,30014,303,3,144,154,146,9,5,458,2,8,468
30,16,30014,306,3,346,196,250,16,6,814,7,17,838
30,16,30014,307,3,402,313,220,19,12,966,1,9,976
30,16,30014,310,3,422,469,269,19,9,1188,7,26,1221
30,16,30014,311,3,175,39,69,4,2,289,1,8,298
30,16,30014,314,3,107,217,37,4,1,366,5,6,377
30,16,30014,315,3,299,221,175,9,6,710,0,9,719
30,16,30014,318,3,351,486,82,2,2,923,0,23,946
30,16,30014,319,3,109,86,34,5,1,235,0,2,237
30,16,30023,414,3,143,129,142,8,6,428,2,14,444
30,16,30023,415,3,217,324,206,18,13,778,5,19,802
30,16,30023,418,3,249,258,205,12,11,735,1,17,753
30,16,30023,419,3,223,274,40,0,1,538,1,12,551
30,16,30023,422,3,167,164,54,3,4,392,3,19,414
30,16,30023,423,3,404,369,156,7,16,952,2,37,991
30,16,30046,980,3,582,512,400,40,21,1555,7,34,1596
30,16,30046,982,3,396,334,252,32,21,1035,3,31,1069
30,16,30046,983,3,433,255,183,27,5,903,4,25,932
30,16,30046,986,3,375,273,145,24,10,827,1,12,840
30,16,30046,987,3,176,188,165,16,4,549,7,15,571
30,16,30046,990,3,307,308,201,19,9,844,2,17,863
30,16,30046,991,3,224,181,149,18,7,579,5,13,597
30,16,30046,994,3,181,158,148,17,2,506,2,9,517
30,16,30046,995,3,183,207,120,7,5,522,1,14,537
30,16,30046,998,3,246,197,155,16,6,620,3,10,633
30,16,30046,999,3,154,148,115,7,6,430,0,13,443
30,16,30046,1002,3,466,326,130,9,7,938,1,15,954
30,16,30046,1003,3,241,173,93,18,1,526,4,5,535
30,16,30046,1006,3,149,98,125,9,3,384,0,8,392
30,16,30046,1007,3,188,144,116,7,5,460,1,9,470
30,16,30046,1010,3,314,176,191,18,3,702,9,12,723
30,16,30046,1011,3,320,225,173,21,10,749,2,8,759
30,16,30046,1014,3,282,306,182,14,8,792,0,1,793
30,16,30046,1015,3,194,78,82,7,4,365,0,7,372
30,16,30046,1018,3,144,112,124,5,9,394,1,5,400
30,16,30046,1019,3,405,210,141,37,9,802,2,11,815
30,16,30046,1022,3,275,194,176,13,6,664,0,13,677
30,16,30046,1023,3,167,142,104,11,4,428,2,16,446
30,16,30046,1026,3,206,142,113,22,5,488,1,5,494
30,16,30046,1027,3,227,120,159,13,4,523,2,11,536
30,16,30046,1030,3,362,530,287,25,6,1210,3,21,1234
30,16,30046,1031,3,270,282,200,11,9,772,6,13,791
30,16,30046,1034,3,355,210,209,27,13,814,0,9,823
30,16,30046,1035,3,247,156,149,26,13,591,0,15,606
30,16,30046,1038,3,245,166,198,20,6,635,3,12,650
30,16,30046,1039,3,264,154,132,20,8,578,3,6,587
30,16,30046,1042,3,226,118,102,10,4,460,0,0,460
30,16,30046,1043,3,337,211,159,19,8,734,3,7,744
30,16,30046,1046,3,210,113,72,15,3,413,1,4,418
30,16,30046,1047,3,295,186,125,19,11,636,3,12,651
30,16,30046,1050,3,361,188,250,36,12,847,5,5,857
30,16,30046,1051,3,419,263,210,44,8,944,4,21,969
30,16,30046,1054,3,292,174,166,26,9,667,0,11,678
30,16,30046,1055,3,398,190,210,30,12,840,0,17,857
30,16,30046,1058,3,188,136,123,15,9,471,2,13,486
30,16,30046,1059,3,517,252,264,26,11,1070,6,23,1099
30,16,30046,1062,3,760,419,395,49,23,1646,9,31,1686
30,16,30046,1063,3,333,152,176,17,6,684,4,10,698
30,16,30046,1066,3,498,261,252,40,16,1067,2,23,1092
30,16,30046,1067,3,251,193,120,27,6,597,1,13,611
30,16,30046,1070,3,217,137,88,13,4,459,5,9,473
30,16,30046,1071,3,307,138,127,22,14,608,3,6,617
30,16,30046,1074,3,270,235,114,13,8,640,0,18,658
30,16,30046,1075,3,342,245,36,5,4,632,1,22,655
30,16,30046,1078,3,190,174,28,3,6,401,2,11,414
30,16,30046,1079,3,541,246,131,15,11,944,8,22,974
30,16,30046,1082,3,332,182,135,18,4,671,5,23,699
30,16,30046,1083,3,489,302,206,36,15,1048,1,34,1083
30,16,30046,1086,3,281,177,122,8,6,594,4,15,613
30,16,30046,1087,3,448,284,110,8,4,854,0,24,878
30,16,30046,1090,3,320,144,143,31,9,647,3,20,670
30,16,30046,1091,3,1304,608,455,63,36,2466,9,28,2503
30,16,30070,1529,3,208,163,204,12,7,594,6,16,616
30,16,30070,1530,3,454,528,281,41,11,1315,7,33,1355
30,16,30070,1531,3,280,213,170,17,13,693,4,5,702
30,16,30070,1534,3,286,262,150,24,6,728,9,20,757
30,16,30070,1535,3,253,212,155,12,5,637,2,4,643
30,16,30070,1538,3,284,188,111,13,8,604,1,9,614
30,16,30070,1539,3,404,303,271,26,6,1010,2,30,1042
30,16,30070,1542,3,450,396,289,25,22,1182,19,19,1220
30,16,30070,1543,3,338,290,207,34,9,878,4,20,902
30,16,30070,1546,3,1129,549,420,61,18,2177,9,55,2241
30,16,30070,1547,3,425,183,150,26,7,791,2,17,810
30,16,30070,1550,3,296,156,179,21,2,654,0,8,662
30,16,30070,1551,3,279,171,98,14,4,566,0,10,576
30,16,30070,1554,3,122,179,88,7,7,403,2,17,422
30,16,30070,1555,3,192,174,79,2,4,451,0,4,455
30,16,30087,1798,3,376,191,269,18,6,860,3,13,876
30,16,30087,1799,3,482,257,374,32,18,1163,0,15,1178
30,16,30087,1802,3,237,285,143,23,7,695,2,15,712
30,16,30087,1803,3,196,479,176,17,7,875,2,17,894
30,16,30087,1806,3,325,278,160,28,9,800,0,19,819
30,16,30087,1807,3,347,213,249,28,15,852,2,18,872
30,16,30087,1810,3,943,431,647,66,36,2123,6,21,2150
30,16,30087,1811,3,195,95,116,16,8,430,0,12,442
30,16,30087,1814,3,326,182,254,25,15,802,2,23,827
30,16,30087,1815,3,229,159,246,25,9,668,1,10,679
30,16,30087,1818,3,179,273,147,6,4,609,11,23,643
30,16,30087,1819,3,105,36,44,8,3,196,0,2,198
30,16,30087,1822,3,354,419,250,16,13,1052,1,12,1065
30,16,30087,1823,3,359,213,273,13,11,869,1,5,875
30,16,30087,1826,3,33,32,22,1,0,88,0,2,90
30,16,30087,1827,3,164,122,39,4,2,331,6,5,342
30,16,30114,2607,3,324,468,207,17,4,1020,2,28,1050
30,17,30012,247,3,294,218,44,11,4,571,7,20,598
30,17,30012,250,3,168,193,55,29,6,451,1,10,462
30,17,30012,251,3,159,83,28,9,4,283,1,14,298
30,17,30012,254,3,209,171,87,40,10,517,2,11,530
30,17,30012,255,3,312,337,77,51,5,782,7,16,805
30,17,30012,258,3,188,147,63,29,6,433,4,14,451
30,17,30012,259,3,222,193,94,35,9,553,5,15,573
30,17,30012,262,3,172,127,85,26,5,415,1,1,417
30,17,30012,263,3,155,183,86,29,5,458,1,19,478
30,17,30012,266,3,155,69,37,9,5,275,2,8,285
30,17,30012,267,3,197,146,74,20,9,446,8,10,464
30,17,30012,270,3,121,210,52,14,2,399,0,18,417
30,17,30012,271,3,248,460,104,30,16,858,2,12,872
30,17,30012,274,3,146,114,105,2,5,372,0,24,396
30,17,30012,275,3,128,98,37,1,1,265,0,6,271
30,17,30012,278,3,185,93,26,4,3,311,1,11,323
30,17,30012,279,3,180,131,32,9,2,354,0,13,367
30,17,30012,282,3,304,291,119,15,5,734,0,21,755
30,17,30012,283,3,220,275,92,10,4,601,1,11,613
30,17,30012,286,3,62,52,20,1,1,136,0,0,136
30,17,30047,1094,3,217,130,166,3,6,522,6,14,542
30,17,30047,1095,3,390,358,258,29,10,1045,2,15,1062
30,17,30047,1098,3,116,115,106,7,5,349,0,12,361
30,17,30047,1099,3,165,132,156,12,7,472,0,10,482
30,17,30047,1102,3,213,145,131,11,3,503,2,6,511
30,17,30047,1103,3,178,230,113,11,5,537,1,4,542
30,17,30047,1106,3,244,108,180,10,8,550,1,11,562
30,17,30047,1107,3,338,279,231,23,8,879,3,19,901
30,17,30047,1110,3,196,133,96,18,7,450,1,9,460
30,17,30047,1111,3,353,165,187,24,5,734,5,25,764
30,17,30047,1114,3,217,215,145,11,5,593,2,38,633
30,17,30047,1115,3,337,241,194,21,4,797,2,36,835
30,17,30047,1133,3,319,289,159,11,8,786,5,18,809
30,17,30047,1134,3,417,179,248,6,6,856,1,39,896
30,17,30047,1135,3,49,67,51,2,1,170,1,6,177
30,17,30047,1138,3,75,251,67,7,1,401,0,9,410
30,17,30047,1139,3,78,230,131,6,4,449,2,22,473
30,17,30047,1142,3,188,194,147,19,2,550,2,22,574
30,17,30047,1146,3,163,288,105,4,3,563,1,21,585
30,17,30047,1147,3,184,208,195,4,5,596,5,3,604
30,17,30047,1150,3,161,194,153,18,6,532,5,17,554
30,17,30047,1151,3,184,223,121,11,1,540,1,19,560
30,17,30051,1252,3,420,331,218,17,13,999,1,32,1032
30,17,30051,1254,3,136,128,126,1,2,393,2,10,405
30,17,30051,1255,3,186,135,136,6,0,463,6,7,476
30,17,30051,1258,3,251,109,151,116,11,638,4,14,656
30,17,30051,1259,3,342,283,511,20,6,1162,5,38,1205
30,17,30051,1262,3,226,118,87,9,7,447,2,17,466
30,17,30051,1263,3,158,108,129,9,6,410,2,9,421
30,17,30077,1672,3,170,187,88,7,4,456,3,17,476
30,17,30077,1674,3,252,300,99,21,1,673,0,13,686
30,17,30077,1675,3,158,203,55,10,2,428,2,5,435
30,17,30077,1678,3,168,196,11,0,0,375,1,9,385
30,17,30077,1679,3,108,167,71,2,3,351,0,17,368
30,17,30077,1682,3,190,161,45,0,6,402,3,11,416
30,17,30077,1683,3,90,26,19,0,0,135,0,9,144
30,17,30077,1686,3,110,171,123,8,1,413,5,24,442
30,17,30077,1687,3,28,52,8,0,0,88,0,1,89
30,17,30086,1791,3,292,368,193,21,7,881,14,37,932
30,17,30086,1794,3,150,175,70,6,5,406,0,8,414
30,17,30086,1795,3,135,110,35,0,4,284,2,11,297
30,17,30092,2138,3,398,202,121,23,4,748,2,9,759
30,17,30092,2139,3,209,151,60,18,5,443,0,10,453
30,17,30092,2142,3,286,229,80,28,7,630,0,15,645
30,17,30092,2143,3,31,127,19,4,0,181,3,2,186
30,17,30106,2390,3,490,301,229,46,10,1076,7,31,1114
30,17,30106,2391,3,304,143,82,8,0,537,2,10,549
30,17,30106,2394,3,357,170,137,18,6,688,3,15,706
30,17,30106,2395,3,130,84,61,7,0,282,0,4,286
30,17,30106,2398,3,254,109,177,23,2,565,0,20,585
30,17,30106,2399,3,184,158,124,23,3,492,3,10,505
30,17,30106,2402,3,228,207,71,8,1,515,3,11,529
30,17,30106,2403,3,272,141,129,22,3,567,7,16,590
30,17,30106,2406,3,206,156,129,78,17,586,3,12,601
30,17,30106,2407,3,176,138,85,14,7,420,2,16,438
30,17,30106,2410,3,161,156,87,9,5,418,1,9,428
30,17,30106,2411,3,440,397,126,60,9,1032,1,29,1062
30,17,30106,2414,3,120,77,33,6,0,236,0,2,238
30,17,30120,2764,3,132,189,114,9,0,444,4,9,457
30,17,30120,2766,3,135,229,195,11,2,572,0,23,595
30,17,30120,2767,3,158,216,210,8,6,598,1,29,628
30,17,30173,3859,3,244,155,342,75,4,820,1,7,828
30,17,30173,3862,3,241,98,379,28,7,753,1,18,772
30,17,30173,3863,3,252,127,345,22,5,751,1,11,763
30,17,30173,3866,3,132,57,185,13,5,392,3,7,402
30,17,30173,3867,3,292,141,360,29,10,832,3,19,854
30,17,30173,3870,3,93,92,141,10,0,336,0,8,344
30,17,30173,3871,3,263,127,394,35,4,823,0,6,829
30,17,30173,3874,3,138,73,149,10,3,373,2,4,379
30,17,30173,3875,3,219,171,385,14,5,794,0,11,805
30,17,30173,3878,3,185,128,447,23,4,787,10,17,814
30,17,30173,3879,3,209,120,267,19,3,618,5,11,634
30,17,30173,3882,3,257,161,342,21,9,790,3,11,804
30,17,30173,3883,3,265,119,405,29,3,821,1,20,842
30,17,30173,3886,3,302,145,419,20,7,893,6,28,927
30,17,30173,3887,3,267,133,232,15,7,654,2,12,668
30,17,30173,3890,3,420,184,170,11,7,792,3,25,820
30,17,30173,3891,3,143,322,179,10,3,657,3,13,673
30,17,30173,3894,3,170,203,133,5,3,514,5,20,539
30,17,30173,3895,3,83,117,64,5,2,271,0,2,273
30,17,30173,3898,3,190,120,87,19,4,420,2,12,434
30,17,30173,3899,3,338,189,180,18,2,727,5,22,754
30,17,30173,3902,3,152,34,50,2,1,239,0,10,249
30,17,30173,3903,3,113,109,70,5,1,298,1,16,315
30,17,30173,3906,3,190,145,140,12,2,489,2,17,508
30,17,30173,3907,3,193,104,76,5,3,381,1,15,397
30,17,30173,3910,3,114,238,73,6,3,434,2,16,452
30,17,30173,3911,3,164,133,190,16,5,508,4,24,536
30,17,30173,3914,3,146,179,107,8,12,452,1,27,480
30,17,30173,3915,3,51,74,43,3,1,172,0,13,185
30,17,30173,3918,3,176,116,50,4,5,351,3,6,360
30,17,30173,3919,3,221,202,136,6,10,575,4,30,609
30,17,30173,3922,3,247,134,202,6,3,592,2,18,612
30,17,30173,3923,3,303,99,261,11,7,681,2,21,704
30,17,30175,3975,3,170,198,164,4,2,538,0,14,552
30,17,30175,3978,3,42,69,48,1,0,160,1,8,169
30,17,30180,4010,3,166,458,179,20,6,829,0,23,852
30,17,30180,4011,3,97,299,199,24,5,624,9,14,647
30,17,30180,4014,3,252,265,104,11,1,633,3,35,671
30,17,30180,4015,3,81,146,121,4,3,355,0,8,363
30,17,30180,4018,3,191,120,202,15,3,531,1,17,549
30,17,30180,4019,3,175,84,206,16,0,481,0,12,493
30,17,30180,4022,3,177,121,226,19,4,547,4,13,564
30,17,30180,4023,3,198,81,211,11,3,504,4,16,524
30,17,30180,4026,3,355,161,241,9,6,772,5,24,801
30,17,30180,4027,3,211,49,211,4,3,478,1,11,490
30,17,30180,4030,3,131,214,92,3,5,445,1,10,456
30,17,30180,4031,3,100,129,76,4,3,312,0,12,324
30,17,30180,4034,3,204,215,192,13,1,625,1,33,659
30,17,30180,4035,3,223,142,187,11,4,567,3,23,593
30,17,30204,4614,3,144,449,201,9,6,809,13,4,826
30,17,30204,4615,3,291,282,277,33,7,890,1,10,901
30,17,30204,4618,3,299,276,236,50,10,871,4,21,896
30,17,30204,4619,3,262,287,237,15,4,805,1,28,834
30,17,30204,4622,3,239,205,269,21,9,743,1,20,764
30,17,30204,4623,3,117,137,165,11,1,431,3,3,437
30,17,30204,4626,3,202,106,159,16,2,485,4,16,505
30,17,30204,4627,3,152,50,155,6,5,368,5,14,387
30,17,30204,4630,3,177,58,89,7,2,333,3,14,350
30,17,30204,4631,3,144,126,107,7,3,387,4,19,410
30,17,30204,4634,3,229,183,273,14,8,707,2,27,736
30,17,30204,4635,3,122,98,125,8,7,360,7,13,380
30,17,30204,4638,3,138,211,117,8,2,476,2,6,484
30,17,30204,4639,3,330,458,427,8,9,1232,0,14,1246
30,17,30204,4642,3,105,154,182,19,8,468,8,15,491
30,17,30204,4643,3,173,110,142,13,7,445,5,13,463
30,17,30204,4646,3,170,184,195,4,5,558,6,31,595
30,18,30006,92,3,396,256,386,25,8,1071,3,15,1089
30,18,30006,94,3,168,198,180,6,6,558,1,23,582
30,18,30006,95,3,193,179,180,11,8,571,0,9,580
30,18,30006,98,3,140,112,178,19,9,458,0,17,475
30,18,30006,99,3,177,112,146,40,9,484,5,10,499
30,18,30006,102,3,15,33,57,4,1,110,2,1,113
30,18,30006,103,3,35,40,89,1,0,165,0,0,165
30,18,30020,390,3,317,384,61,3,1,766,3,56,825
30,18,30020,391,3,336,159,114,2,4,615,0,34,649
30,18,30021,394,3,46,318,192,1,1,558,0,20,578
30,18,30021,395,3,24,103,567,1,2,697,0,34,731
30,18,30031,593,3,297,210,465,50,18,1040,0,39,1079
30,18,30031,594,3,240,178,388,34,11,851,0,19,870
30,18,30031,595,3,193,217,347,30,15,802,0,36,838
30,18,30031,598,3,163,163,275,20,11,632,0,20,652
30,18,30031,599,3,264,228,294,47,18,851,0,21,872
30,18,30031,602,3,344,254,526,66,20,1210,0,33,1243
30,18,30031,603,3,251,183,292,64,22,812,0,21,833
30,18,30031,606,3,171,149,287,27,7,641,1,14,656
30,18,30031,607,3,122,215,288,13,11,649,0,97,746
30,18,30043,961,3,129,235,192,3,2,561,0,48,609
30,18,30043,962,3,89,149,58,1,3,300,2,13,315
30,18,30054,1286,3,245,298,169,15,11,738,2,21,761
30,18,30054,1287,3,262,314,117,2,2,697,4,23,724
30,18,30054,1290,3,125,398,177,9,3,712,4,14,730
30,18,30054,1291,3,137,426,276,8,2,849,2,29,880
30,18,30055,1294,3,299,253,294,18,11,875,2,19,896
30,18,30055,1295,3,279,229,235,22,13,778,3,20,801
30,18,30055,1298,3,248,157,93,6,6,510,1,16,527
30,18,30055,1299,3,303,131,207,13,4,658,0,9,667
30,18,30055,1302,3,330,322,232,17,10,911,2,30,943
30,18,30055,1303,3,249,109,90,6,3,457,1,7,465
30,18,30055,1306,3,131,381,152,16,10,690,3,28,721
30,18,30055,1307,3,204,203,92,7,7,513,1,17,531
30,18,30076,1668,3,183,178,121,10,5,497,0,12,509
30,18,30076,1670,3,313,183,182,18,13,709,0,18,727
30,18,30076,1671,3,225,281,309,26,5,846,1,31,878
30,18,30099,2237,3,206,388,191,2,0,787,0,14,801
30,18,30099,2238,3,14,68,39,0,0,121,0,3,124
30,18,30099,2239,3,29,108,52,0,0,189,0,1,190
30,18,30111,2578,3,166,278,46,4,4,498,2,0,500
30,18,30111,2579,3,247,415,56,11,4,733,5,38,776
30,18,30111,2582,3,167,303,69,0,4,543,2,59,604
30,18,30118,2650,3,256,189,121,9,5,580,5,15,600
30,18,30118,2651,3,296,340,109,13,10,768,4,19,791
30,18,30118,2654,3,136,99,20,2,1,258,0,8,266
30,18,30118,2655,3,105,286,122,4,7,524,1,25,550
30,18,30118,2658,3,170,296,75,6,4,551,0,28,579
30,18,30118,2659,3,50,142,34,7,4,237,0,17,254
30,18,30118,2662,3,257,332,74,5,8,676,2,40,718
30,18,30118,2663,3,168,352,57,2,4,583,3,24,610
30,18,30135,3274,3,433,406,176,20,9,1044,1,18,1063
30,18,30135,3275,3,531,269,111,11,4,926,2,22,950
30,18,30135,3278,3,38,65,37,4,0,144,0,4,148
30,18,30135,3279,3,249,268,190,41,8,756,2,20,778
30,18,30135,3282,3,126,114,96,0,1,337,0,7,344
30,18,30138,3294,3,376,371,126,29,3,905,1,58,964
30,18,30138,3295,3,90,229,8,2,0,329,0,24,353
30,18,30141,3326,3,288,348,119,2,1,758,0,23,781
30,18,30141,3327,3,71,89,14,0,0,174,1,5,180
30,18,30148,3504,3,147,409,384,8,3,951,1,52,1004
30,18,30148,3506,3,93,353,196,2,2,646,0,22,668
30,18,30148,3507,3,47,369,277,6,0,699,3,44,746
30,18,30148,3510,3,169,315,394,4,6,888,0,24,912
30,18,30148,3511,3,87,106,499,5,7,704,6,58,768
30,18,30159,3699,3,296,302,204,8,3,813,7,129,949
30,18,30159,3702,3,46,136,185,3,5,375,1,66,442
30,18,30159,3703,3,73,171,269,3,7,523,2,69,594
30,18,30167,3772,3,200,327,310,28,3,868,1,55,924
30,18,30167,3774,3,52,93,0,1,1,147,0,1,148
30,18,30167,3775,3,45,68,55,1,4,173,0,13,186
30,18,30167,3778,3,77,243,57,2,1,380,0,14,394
30,18,30167,3779,3,66,154,53,0,0,273,0,15,288
30,18,30170,3804,3,408,212,64,33,5,722,3,48,773
30,18,30170,3806,3,83,48,25,3,2,161,0,9,170
30,18,30170,3807,3,64,110,20,3,0,197,0,10,207
30,18,30172,3824,3,179,173,266,15,5,638,2,23,663
30,18,30172,3826,3,192,281,295,22,14,804,2,15,821
30,18,30172,3827,3,226,170,23,1,3,423,1,21,445
30,18,30172,3830,3,201,97,73,2,4,377,3,15,395
30,18,30172,3831,3,240,233,138,2,6,619,6,19,644
30,18,30172,3834,3,234,208,111,4,0,557,0,33,590
30,18,30172,3835,3,39,40,26,0,0,105,2,9,116
30,18,30172,3838,3,58,46,46,2,0,152,2,11,165
30,18,30172,3839,3,213,298,216,3,7,737,1,54,792
30,18,30172,3842,3,45,3,58,4,16,126,0,4,130
30,18,30172,3843,3,281,309,213,11,11,825,3,31,859
30,18,30172,3846,3,52,144,132,3,3,334,0,0,334
30,18,30172,3847,3,106,246,91,5,4,452,0,12,464
30,18,30172,3850,3,139,239,47,0,1,426,0,16,442
30,18,30172,3851,3,140,130,117,1,0,388,3,21,412
30,18,30172,3854,3,115,146,35,5,0,301,3,12,316
30,18,30172,3855,3,260,345,236,4,3,848,2,51,901
30,18,30172,3858,3,116,90,25,1,1,233,0,11,244
30,18,30183,4074,3,363,471,375,13,7,1229,1,96,1326
30,18,30183,4075,3,113,226,165,2,1,507,0,22,529
30,18,30184,4078,3,150,142,100,1,4,397,0,12,409
30,18,30195,4525,3,318,778,399,6,7,1508,4,76,1588
30,18,30195,4526,3,38,225,40,2,0,305,1,16,322
30,18,30196,4527,3,127,122,144,13,5,411,0,19,430
30,18,30196,4530,3,186,102,192,19,18,517,1,22,540
30,18,30196,4531,3,182,167,137,9,5,500,2,17,519
30,18,30196,4534,3,142,130,111,6,4,393,4,18,415
30,18,30196,4535,3,60,141,48,0,0,249,1,2,252
30,18,30196,4538,3,170,279,138,12,4,603,1,24,628
30,18,30196,4539,3,331,380,240,27,13,991,5,17,1013
30,18,30201,4570,3,197,297,123,152,18,787,1,33,821
30,18,30201,4571,3,330,550,255,318,14,1467,5,80,1552
30,18,30201,4574,3,201,240,67,15,4,527,3,35,565
30,18,30201,4575,3,4,234,10,1,1,250,0,22,272
30,18,30201,4578,3,180,102,35,8,2,327,3,18,348
30,18,30201,4579,3,45,63,22,8,2,140,0,28,168
30,18,30201,4582,3,119,149,93,28,7,396,5,45,446
30,18,30201,4583,3,133,104,62,19,2,320,0,40,360
30,18,30201,4586,3,116,115,88,33,2,354,0,23,377
30,18,30201,4587,3,66,76,62,3,1,208,0,0,208
30,18,30201,4590,3,165,208,56,29,2,460,1,41,502
30,18,30201,4591,3,51,102,37,6,2,198,3,24,225
30,18,30201,4594,3,99,101,50,10,0,260,3,23,286
30,18,30201,4595,3,54,29,3,2,0,88,0,13,101
30,19,30005,85,3,211,312,122,5,1,651,0,6,657
30,19,30005,86,3,134,314,124,4,2,578,2,4,584
30,19,30005,87,3,68,69,7,1,1,146,0,8,154
30,19,30005,90,3,57,76,38,0,1,172,2,6,180
30,19,30005,91,3,118,201,42,2,7,370,0,13,383
30,19,30013,287,3,195,265,234,13,6,713,0,20,733
30,19,30013,290,3,222,166,81,6,1,476,2,11,489
30,19,30013,291,3,216,256,97,10,5,584,0,16,600
30,19,30016,339,3,249,273,209,20,5,756,5,25,786
30,19,30016,342,3,208,204,146,8,7,573,4,28,605
30,19,30016,343,3,189,193,164,8,7,561,0,30,591
30,19,30016,346,3,259,239,149,11,9,667,1,29,697
30,19,30016,347,3,29,34,59,0,1,123,1,0,124
30,19,30016,350,3,174,205,147,0,3,529,2,11,542
30,19,30016,351,3,103,118,205,2,2,430,2,8,440
30,19,30016,354,3,285,387,253,5,5,935,3,28,966
30,19,30016,355,3,60,195,154,5,4,418,0,14,432
30,19,30016,358,3,203,185,77,1,2,468,0,22,490
30,19,30016,359,3,94,21,62,6,1,184,0,0,184
30,19,30016,362,3,140,219,254,1,3,617,0,6,623
30,19,30034,632,3,176,288,401,16,8,889,4,41,934
30,19,30034,634,3,184,262,334,12,7,799,1,30,830
30,19,30034,635,3,158,263,287,8,5,721,1,40,762
30,19,30034,638,3,197,268,436,14,11,926,0,30,956
30,19,30034,639,3,94,174,261,8,3,540,0,21,561
30,19,30034,642,3,122,241,236,11,10,620,3,20,643
30,19,30034,643,3,331,395,442,31,16,1215,13,27,1255
30,19,30034,646,3,14,154,135,0,4,307,0,44,351
30,19,30034,647,3,269,269,329,1,7,875,1,36,912
30,19,30034,650,3,146,109,200,5,2,462,0,13,475
30,19,30034,651,3,66,164,329,1,1,561,1,16,578
30,19,30034,654,3,121,284,334,4,5,748,0,39,787
30,19,30034,655,3,128,203,304,10,5,650,0,33,683
30,19,30098,2221,3,175,135,138,14,6,468,8,28,504
30,19,30098,2222,3,270,167,162,30,5,634,2,19,655
30,19,30098,2223,3,91,74,70,13,2,250,0,7,257
30,19,30098,2226,3,104,177,118,12,0,411,1,12,424
30,19,30098,2227,3,176,197,125,27,2,527,3,11,541
30,19,30098,2230,3,155,204,141,12,2,514,2,16,532
30,19,30098,2231,3,144,161,149,16,3,473,1,12,486
30,19,30098,2234,3,258,293,260,27,7,845,5,25,875
30,19,30098,2235,3,142,284,112,15,7,560,0,10,570
30,19,30140,3321,3,78,134,166,10,1,389,2,7,398
30,19,30140,3322,3,148,156,201,16,3,524,2,11,537
30,19,30140,3323,3,124,191,174,11,2,502,0,28,530
30,19,30142,3328,3,89,155,160,4,2,410,1,31,442
30,19,30142,3330,3,170,247,218,16,11,662,3,17,682
30,19,30142,3331,3,140,161,207,9,4,521,1,13,535
30,19,30142,3334,3,171,201,245,13,7,637,1,9,647
30,19,30142,3335,3,196,225,249,19,14,703,1,26,730
30,19,30142,3338,3,155,204,273,19,11,662,1,16,679
30,19,30142,3339,3,252,208,396,10,9,875,1,25,901
30,19,30142,3342,3,119,209,134,19,5,486,0,9,495
30,19,30142,3343,3,210,240,246,25,6,727,3,25,755
30,19,30142,3346,3,162,211,224,29,9,635,0,14,649
30,19,30142,3347,3,201,257,182,40,8,688,0,13,701
30,19,30142,3350,3,277,273,459,22,3,1034,0,37,1071
30,19,30142,3351,3,206,271,285,24,14,800,2,16,818
30,19,30142,3354,3,177,197,214,16,5,609,0,28,637
30,19,30142,3355,3,277,295,386,25,15,998,4,29,1031
30,19,30142,3358,3,151,78,116,2,5,352,1,12,365
30,19,30142,3359,3,221,159,108,10,3,501,0,14,515
30,19,30142,3362,3,151,324,340,16,3,834,12,28,874
30,19,30142,3363,3,74,93,121,1,1,290,3,17,310
30,19,30142,3366,3,31,537,418,3,2,991,1,35,1027
30,19,30142,3367,3,65,300,556,1,1,923,2,37,962
30,19,30142,3370,3,183,110,134,11,4,442,1,10,453
30,19,30142,3371,3,187,260,329,9,4,789,1,17,807
30,19,30142,3374,3,356,236,173,4,10,779,1,14,794
30,19,30142,3375,3,78,449,538,2,4,1071,0,50,1121
30,19,30142,3378,3,310,389,398,19,6,1122,1,29,1152
30,19,30142,3379,3,84,253,357,4,8,706,0,18,724
30,19,30142,3382,3,61,111,175,1,1,349,0,11,360
30,19,30142,3383,3,117,197,216,2,0,532,0,17,549
30,19,30142,3386,3,42,154,203,0,0,399,1,46,446
30,19,30142,3387,3,24,159,252,1,4,440,0,10,450
30,19,30142,3390,3,98,200,88,2,1,389,0,9,398
30,19,30142,3391,3,13,108,174,1,0,296,0,15,311
30,19,30142,3394,3,120,292,170,1,4,587,8,32,627
30,19,30142,3395,3,74,113,107,1,1,296,1,10,307
30,19,30142,3398,3,201,348,262,1,2,814,1,33,848
30,19,30142,3399,3,63,243,171,0,2,479,3,27,509
30,19,30142,3402,3,62,297,370,3,4,736,1,29,766
30,19,30142,3403,3,57,306,117,0,6,486,1,13,500
30,19,30142,3406,3,150,220,228,6,5,609,2,22,633
30,19,30142,3407,3,86,134,169,3,3,395,1,0,396
30,19,30144,3437,3,119,712,190,10,3,1034,1,41,1076
30,19,30144,3438,3,70,566,209,6,2,853,0,36,889
30,19,30144,3439,3,44,287,108,5,1,445,0,21,466
30,19,30144,3442,3,99,386,100,3,0,588,0,15,603
30,19,30144,3443,3,50,321,218,1,1,591,1,13,605
30,19,30144,3446,3,99,406,193,4,4,706,0,20,726
30,19,30144,3447,3,63,191,144,3,1,402,0,39,441
30,19,30144,3450,3,101,192,91,5,0,389,0,30,419
30,19,30144,3451,3,7,162,90,0,0,259,0,14,273
30,19,30144,3454,3,58,311,195,5,3,572,0,21,593
30,19,30144,3455,3,51,213,352,1,1,618,2,38,658
30,19,30144,3458,3,12,328,180,4,3,527,0,13,540
30,19,30144,3459,3,43,243,171,2,0,459,0,23,482
30,19,30144,3462,3,17,156,168,1,2,344,0,12,356
30,19,30144,3463,3,43,337,287,1,1,669,0,36,705
30,19,30144,3466,3,60,213,321,2,4,600,0,29,629
30,19,30144,3467,3,43,362,290,1,1,697,0,42,739
30,19,30144,3470,3,39,261,234,0,0,534,0,23,557
30,19,30144,3471,3,69,352,302,3,1,727,0,37,764
30,19,30144,3474,3,100,195,195,5,2,497,0,39,536
30,19,30177,3985,3,220,112,249,18,6,605,1,22,628
30,19,30177,3986,3,194,99,206,13,6,518,1,17,536
30,19,30177,3987,3,140,127,155,14,3,439,0,14,453
30,19,30177,3990,3,164,64,158,7,3,396,2,6,404
30,19,30177,3991,3,149,151,166,9,3,478,1,16,495
30,19,30177,3994,3,229,218,95,5,3,550,3,19,572
30,19,30177,3995,3,226,74,103,4,0,407,2,17,426
30,19,30177,3998,3,140,40,24,1,1,206,1,14,221
30,20,30003,7,3,403,332,354,27,18,1134,1,49,1184
30,20,30003,10,3,255,186,240,16,7,704,0,25,729
30,20,30003,11,3,302,265,254,20,8,849,1,20,870
30,20,30003,14,3,296,228,262,10,4,800,2,22,824
30,20,30003,15,3,241,250,282,16,11,800,1,34,835
30,20,30003,18,3,251,219,197,19,14,700,1,26,727
30,20,30003,19,3,255,286,251,19,14,825,1,22,848
30,20,30003,22,3,241,162,251,17,5,676,2,36,714
30,20,30003,23,3,293,221,374,24,6,918,1,23,942
30,20,30003,26,3,311,284,225,18,12,850,0,21,871
30,20,30003,27,3,285,337,319,37,17,995,2,16,1013
30,20,30003,30,3,287,227,333,15,13,875,0,20,895
30,20,30003,31,3,257,191,248,7,9,712,1,21,734
30,20,30003,34,3,392,287,88,2,4,773,1,23,797
30,20,30003,35,3,262,390,21,0,1,674,1,10,685
30,20,30003,38,3,250,337,196,4,3,790,6,47,843
30,20,30003,39,3,221,290,246,6,6,769,0,32,801
30,20,30003,42,3,243,357,257,2,1,860,0,35,895
30,20,30003,43,3,234,287,177,9,1,708,3,21,732
30,20,30003,46,3,225,124,58,3,3,413,3,8,424
30,20,30208,1118,3,183,122,55,8,7,375,2,16,393
30,20,30208,1119,3,101,97,100,4,5,307,4,6,317
30,20,30208,1122,3,163,190,92,8,4,457,3,15,475
30,20,30208,1123,3,153,128,104,8,6,399,4,8,411
30,20,30208,1126,3,243,219,161,14,13,650,0,12,662
30,20,30208,1127,3,269,211,180,15,12,687,8,26,721
30,20,30208,1130,3,221,231,137,13,7,609,8,13,630
30,20,30208,1131,3,216,220,117,11,10,574,3,24,601
30,20,30208,1143,3,155,183,87,4,3,432,0,28,460
30,20,30056,1310,3,59,249,188,10,0,506,1,15,522
30,20,30056,1311,3,107,251,252,12,2,624,0,11,635
30,20,30056,1314,3,86,229,104,3,3,425,0,19,444
30,20,30056,1315,3,57,249,25,1,2,334,0,1,335
30,20,30056,1318,3,202,148,264,1,5,620,0,19,639
30,20,30056,1319,3,107,217,228,4,6,562,12,20,594
30,20,30079,1701,3,515,265,253,24,19,1076,2,35,1113
30,20,30079,1702,3,468,172,139,21,3,803,3,37,843
30,20,30079,1703,3,716,281,258,22,9,1286,6,30,1322
30,20,30079,1706,3,364,192,162,11,3,732,0,24,756
30,20,30079,1707,3,425,173,120,14,7,739,4,32,775
30,20,30079,1710,3,447,204,131,16,5,803,7,32,842
30,20,30079,1711,3,264,309,73,3,8,657,2,22,681
30,20,30079,1714,3,357,272,77,3,6,715,4,31,750
30,20,30079,1715,3,324,299,75,4,5,707,1,30,738
30,20,30095,2179,3,431,264,48,4,0,747,4,12,763
30,20,30095,2182,3,369,293,54,4,2,722,0,6,728
30,20,30095,2183,3,367,335,74,2,2,780,0,14,794
30,20,30095,2186,3,123,202,61,2,3,391,0,10,401
30,20,30095,2187,3,135,192,32,2,4,365,0,16,381
30,20,30095,2190,3,261,188,21,2,0,472,0,11,483
30,20,30095,2191,3,159,408,20,3,1,591,4,13,608
30,20,30095,2194,3,230,165,22,1,0,418,0,11,429
30,20,30095,2195,3,247,295,15,1,2,560,1,22,583
30,20,30095,2198,3,319,180,42,1,5,547,8,16,571
30,20,30095,2199,3,441,492,51,3,3,990,0,20,1010
30,20,30131,3081,3,507,440,194,10,17,1168,1,28,1197
30,20,30131,3082,3,611,515,438,20,19,1603,5,26,1634
30,20,30131,3083,3,210,185,97,6,3,501,0,16,517
30,20,30131,3086,3,174,323,47,2,0,546,1,14,561
30,20,30131,3087,3,285,155,129,1,1,571,0,10,581
30,20,30131,3090,3,96,233,25,0,0,354,0,8,362
30,20,30131,3091,3,64,160,14,0,1,239,0,14,253
30,20,30131,3094,3,288,248,107,3,5,651,2,12,665
30,20,30131,3095,3,226,141,135,1,3,506,3,28,537
30,20,30131,3098,3,153,204,144,3,6,510,5,16,531
30,20,30131,3099,3,223,320,182,11,8,744,14,39,797
30,20,30131,3102,3,99,154,51,3,4,311,0,10,321
30,20,30131,3103,3,284,270,363,2,6,925,2,30,957
30,20,30131,3106,3,103,81,42,0,0,226,0,9,235
30,20,30212,3107,3,314,280,120,3,0,717,4,16,737
30,20,30143,3409,3,62,82,87,1,2,234,0,13,247
30,20,30143,3410,3,87,232,152,1,2,474,0,16,490
30,20,30143,3411,3,108,239,89,5,5,446,0,16,462
30,20,30143,3414,3,204,298,110,2,1,615,0,22,637
30,20,30143,3415,3,111,170,211,1,4,497,0,5,502
30,20,30143,3418,3,171,111,45,0,0,327,0,11,338
30,20,30143,3419,3,62,185,46,0,1,294,0,5,299
30,20,30143,3422,3,291,250,97,3,3,644,3,31,678
30,20,30143,3423,3,146,69,88,0,3,306,0,5,311
30,20,30143,3426,3,118,74,129,3,3,327,0,36,363
30,20,30143,3427,3,129,70,121,3,4,327,0,13,340
30,20,30143,3430,3,100,99,54,2,1,256,2,6,264
30,20,30143,3431,3,142,165,92,0,2,401,0,17,418
30,20,30143,3434,3,155,122,11,3,0,291,18,18,327
30,20,30143,3435,3,272,211,114,0,2,599,2,31,632
30,20,30145,3475,3,351,234,392,9,7,993,2,32,1027
30,20,30145,3478,3,337,269,205,5,1,817,2,16,835
30,20,30145,3479,3,274,232,231,6,5,748,1,30,779
30,20,30145,3482,3,12,35,30,0,0,77,0,6,83
30,20,30145,3483,3,59,75,45,0,0,179,0,5,184
30,20,30145,3486,3,129,171,215,5,6,526,0,24,550
30,20,30145,3487,3,197,279,300,4,6,786,2,29,817
30,20,30145,3490,3,129,277,162,2,4,574,1,16,591
30,20,30145,3491,3,203,208,224,9,7,651,3,16,670
30,20,30168,3780,3,162,115,172,6,0,455,1,17,473
30,20,30168,3782,3,232,106,107,7,2,454,0,23,477
30,20,30168,3783,3,150,196,96,11,2,455,0,10,465
30,20,30168,3786,3,136,64,204,3,4,411,2,5,418
30,20,30168,3787,3,416,95,53,3,1,568,0,18,586
30,20,30168,3790,3,389,214,118,7,4,732,0,39,771
30,20,30168,3791,3,195,160,61,3,1,420,4,20,444
30,20,30168,3794,3,108,38,88,4,1,239,0,11,250
30,20,30168,3795,3,95,92,72,1,5,265,0,12,277
30,20,30168,3798,3,129,38,34,2,1,204,0,8,212
30,20,30189,4171,3,121,238,148,0,2,509,1,17,527
30,20,30208,4712,3,37,46,79,1,0,163,0,11,174
30,20,30212,4720,3,80,67,113,2,2,264,2,9,275
30,20,30212,4722,3,8,17,78,0,1,104,0,2,106
30,21,30050,1184,3,121,151,176,3,6,457,0,24,481
30,21,30050,1186,3,110,229,218,9,2,568,0,28,596
30,21,30050,1187,3,76,114,123,1,2,316,0,7,323
30,21,30050,1190,3,109,186,185,9,4,493,2,22,517
30,21,30050,1191,3,81,241,187,19,1,529,0,12,541
30,21,30050,1194,3,61,279,241,17,1,599,0,11,610
30,21,30050,1195,3,61,320,151,14,3,549,5,13,567
30,21,30050,1198,3,91,272,229,7,3,602,3,10,615
30,21,30050,1199,3,58,299,179,9,2,547,2,9,558
30,21,30050,1202,3,93,135,280,7,5,520,1,19,540
30,21,30050,1203,3,121,133,201,2,11,468,2,10,480
30,21,30050,1206,3,129,152,438,9,8,736,2,7,745
30,21,30050,1207,3,153,281,507,9,7,957,5,39,1001
30,21,30050,1210,3,73,99,161,4,5,342,0,5,347
30,21,30050,1211,3,31,53,61,2,2,149,0,1,150
30,21,30050,1214,3,111,170,266,17,8,572,0,10,582
30,21,30050,1215,3,82,146,143,7,6,384,0,5,389
30,21,30050,1218,3,86,186,265,11,10,558,2,7,567
30,21,30050,1219,3,123,173,449,13,10,768,4,13,785
30,21,30050,1222,3,198,253,400,13,15,879,2,29,910
30,21,30050,1223,3,68,119,180,2,4,373,2,7,382
30,21,30050,1226,3,121,164,272,3,3,563,5,16,584
30,21,30050,1227,3,56,72,171,4,3,306,2,4,312
30,21,30050,1230,3,70,117,219,10,5,421,1,0,422
30,21,30050,1231,3,88,147,277,7,6,525,0,2,527
30,21,30050,1234,3,158,253,446,11,14,882,0,8,890
30,21,30050,1235,3,155,196,385,10,15,761,3,16,780
30,21,30050,1238,3,203,366,494,10,18,1091,0,8,1099
30,21,30050,1239,3,181,267,513,13,8,982,0,25,1007
30,21,30050,1242,3,164,331,485,12,8,1000,6,22,1028
30,21,30050,1243,3,131,241,323,5,6,706,2,9,717
30,21,30050,1246,3,88,203,190,2,2,485,1,8,494
30,21,30050,1247,3,135,240,209,12,2,598,1,7,606
30,21,30050,1250,3,121,115,183,0,0,419,0,18,437
30,21,30050,1251,3,82,268,246,2,3,601,2,18,621
30,21,30061,1390,3,109,283,193,5,3,593,0,16,609
30,21,30061,1391,3,120,262,194,3,10,589,1,11,601
30,21,30061,1394,3,237,213,263,6,5,724,4,18,746
30,21,30061,1395,3,42,11,55,2,1,111,0,2,113
30,21,30061,1398,3,112,133,267,7,2,521,0,17,538
30,21,30061,1399,3,89,122,200,4,2,417,0,7,424
30,21,30061,1402,3,23,36,32,0,0,91,0,7,98
30,21,30075,1641,3,144,468,161,16,3,792,0,9,801
30,21,30075,1642,3,122,488,177,9,7,803,0,16,819
30,21,30075,1643,3,41,160,134,1,5,341,1,0,342
30,21,30075,1646,3,134,54,73,1,0,262,0,18,280
30,21,30075,1647,3,161,153,403,4,3,724,2,28,754
30,21,30075,1650,3,134,134,272,4,7,551,0,12,563
30,21,30075,1651,3,169,239,345,19,5,777,1,36,814
30,21,30075,1654,3,77,92,79,3,1,252,2,0,254
30,21,30075,1655,3,136,179,111,4,3,433,2,23,458
30,21,30075,1658,3,147,156,121,9,3,436,8,9,453
30,21,30075,1659,3,100,272,137,8,4,521,2,20,543
30,21,30075,1662,3,86,282,146,6,4,524,0,27,551
30,21,30075,1663,3,47,119,76,11,2,255,2,10,267
30,21,30075,1666,3,276,350,183,0,6,815,0,42,857
30,21,30075,1667,3,239,325,122,4,2,692,6,32,730
30,21,30091,2105,3,64,92,152,6,4,318,0,5,323
30,21,30091,2106,3,101,116,156,5,4,382,1,12,395
30,21,30091,2107,3,139,283,272,12,6,712,0,24,736
30,21,30091,2110,3,135,181,152,3,2,473,1,14,488
30,21,30091,2111,3,80,94,100,2,4,280,4,4,288
30,21,30091,2114,3,167,352,273,10,3,805,1,22,828
30,21,30091,2115,3,162,221,201,13,11,608,1,15,624
30,21,30091,2118,3,103,215,199,20,4,541,0,13,554
30,21,30091,2119,3,86,119,111,8,1,325,1,13,339
30,21,30091,2122,3,142,235,198,9,4,588,0,10,598
30,21,30091,2123,3,129,205,266,13,6,619,0,8,627
30,21,30091,2126,3,68,184,217,15,6,490,0,11,501
30,21,30091,2127,3,100,182,257,29,7,575,0,7,582
30,21,30091,2130,3,45,110,59,4,0,218,0,11,229
30,21,30091,2131,3,62,99,74,0,2,237,0,1,238
30,21,30091,2134,3,35,35,57,0,0,127,0,0,127
30,21,30091,2135,3,23,121,97,0,1,242,0,5,247
30,21,30105,2379,3,214,526,365,49,9,1163,0,57,1220
30,21,30210,2382,3,55,211,96,3,3,368,1,11,380
30,21,30105,2383,3,129,100,97,1,1,328,0,13,341
30,21,30210,2386,3,160,502,441,37,8,1148,0,54,1202
30,21,30105,2387,3,130,393,261,28,6,818,0,12,830
30,21,30117,2640,3,209,156,286,22,4,677,3,6,686
30,21,30117,2642,3,296,244,229,6,9,784,2,8,794
30,21,30117,2643,3,167,185,177,8,1,538,2,8,548
30,21,30117,2646,3,156,225,240,4,1,626,0,8,634
30,21,30117,2647,3,78,65,60,5,1,209,0,4,213
30,21,30121,2770,3,22,21,52,1,1,97,2,3,102
30,21,30121,2771,3,99,374,334,11,7,825,0,13,838
30,21,30121,2774,3,135,366,420,4,6,931,2,13,946
30,21,30121,2775,3,139,335,358,1,2,835,2,15,852
30,21,30123,2805,3,220,236,209,6,3,674,2,31,707
30,21,30123,2806,3,183,376,235,7,4,805,1,21,827
30,21,30123,2807,3,243,208,229,12,3,695,0,12,707
30,21,30123,2810,3,185,274,152,13,9,633,3,14,650
30,21,30123,2811,3,114,184,285,3,8,594,0,28,622
30,21,30146,3494,3,165,280,242,7,4,698,0,16,714
30,21,30146,3495,3,171,330,327,4,8,840,0,4,844
30,21,30146,3498,3,59,139,75,0,0,273,0,4,277
30,21,30146,3499,3,97,208,50,1,2,358,0,5,363
30,21,30150,3530,3,261,308,198,13,8,788,9,48,845
30,21,30150,3531,3,236,324,362,35,8,965,0,28,993
30,21,30210,3534,3,96,317,168,4,2,587,5,40,632
30,21,30210,3535,3,45,355,257,12,3,672,0,50,722
30,21,30150,3538,3,155,515,306,5,4,985,0,63,1048
30,21,30150,3539,3,643,451,173,25,10,1302,6,94,1402
30,21,30150,3542,3,247,272,291,11,14,835,4,50,889
30,21,30171,3808,3,239,132,169,12,1,553,0,7,560
30,21,30171,3810,3,196,82,133,3,3,417,0,2,419
30,21,30171,3811,3,272,141,207,11,2,633,0,13,646
30,21,30171,3814,3,181,73,111,3,3,371,2,3,376
30,21,30171,3815,3,242,167,157,5,4,575,2,15,592
30,21,30171,3818,3,72,184,221,1,3,481,0,14,495
30,21,30171,3819,3,363,165,205,1,2,736,2,11,749
30,21,30171,3822,3,209,235,137,6,1,588,1,17,606
30,21,30171,3823,3,102,252,109,1,1,465,1,23,489
30,21,30199,4557,3,111,563,590,20,4,1288,4,30,1322
30,21,30199,4558,3,122,697,749,11,3,1582,0,32,1614
30,21,30199,4559,3,34,254,323,11,0,622,0,15,637
30,21,30210,4717,3,11,126,12,3,3,155,0,4,159
30,21,30210,4718,3,87,155,19,1,4,266,0,4,270
31,1,31008,37,3,201,273,228,3,1,706,0,13,719
31,1,31008,38,3,178,253,136,3,2,572,0,21,593
31,1,31008,39,3,98,56,65,0,0,219,0,4,223
31,1,31010,47,3,308,354,14,1,3,680,0,12,692
31,1,31012,54,3,125,104,6,1,0,236,0,0,236
31,1,31012,55,3,298,174,10,1,1,484,0,6,490
31,1,31012,58,3,83,88,2,2,1,176,0,4,180
31,1,31014,65,3,317,338,17,0,1,673,0,9,682
31,1,31014,66,3,82,54,1,0,0,137,0,2,139
31,1,31016,70,3,518,542,22,1,0,1083,0,15,1098
31,1,31017,71,3,491,425,12,3,1,932,0,18,950
31,1,31017,74,3,211,184,9,0,0,404,0,6,410
31,1,31019,78,3,877,454,298,4,2,1635,4,20,1659
31,1,31019,79,3,428,243,172,0,0,843,0,10,853
31,1,31019,82,3,421,254,119,0,0,794,0,6,800
31,1,31019,83,3,522,386,116,3,2,1029,1,24,1054
31,1,31019,86,3,710,430,80,0,2,1222,0,31,1253
31,1,31019,87,3,223,85,2,0,0,310,0,1,311
31,1,31019,90,3,168,144,25,0,1,338,0,4,342
31,1,31021,93,3,325,370,72,3,1,771,0,14,785
31,1,31021,94,3,379,306,61,2,0,748,0,7,755
31,1,31021,95,3,267,308,40,3,0,618,1,4,623
31,1,31021,98,3,158,121,12,1,1,293,0,6,299
31,1,31022,99,3,692,570,3,0,0,1265,0,2,1267
31,1,31022,102,3,205,185,4,0,0,394,0,2,396
31,1,31030,127,3,155,249,11,0,0,415,1,5,421
31,1,31030,130,3,145,181,9,2,0,337,0,5,342
31,1,31032,134,3,484,299,100,6,2,891,0,20,911
31,1,31032,135,3,431,277,70,4,2,784,0,10,794
31,1,31032,138,3,728,243,121,7,4,1103,0,14,1117
31,1,31032,139,3,117,159,35,2,2,315,0,7,322
31,1,31042,224,3,299,296,25,2,3,625,0,12,637
31,1,31042,226,3,361,340,78,3,1,783,0,18,801
31,1,31043,227,3,537,696,61,0,0,1294,1,10,1305
31,1,31057,709,3,284,320,49,21,0,674,0,9,683
31,1,31057,710,3,321,239,32,10,0,602,1,11,614
31,1,31057,711,3,340,286,39,10,4,679,1,10,690
31,1,31057,714,3,335,182,33,9,0,559,0,6,565
31,1,31058,715,3,270,298,112,8,4,692,0,8,700
31,1,31058,718,3,263,297,112,9,3,684,0,23,707
31,1,31058,719,3,277,298,121,14,8,718,1,9,728
31,1,31058,722,3,119,95,47,6,0,267,0,12,279
31,1,31058,723,3,335,224,106,15,1,681,1,11,693
31,1,31058,726,3,48,35,12,0,0,95,0,3,98
31,1,31058,727,3,30,61,20,0,0,111,0,1,112
31,1,31058,730,3,131,91,70,2,2,296,0,1,297
31,1,31058,731,3,2,21,7,0,0,30,0,0,30
31,1,31060,765,3,129,239,183,0,1,552,1,9,562
31,1,31061,766,3,280,361,46,7,0,694,0,12,706
31,1,31061,767,3,218,181,75,2,1,477,1,5,483
31,1,31065,776,3,438,234,13,7,1,693,0,10,703
31,1,31069,789,3,205,229,27,3,2,466,3,8,477
31,1,31069,790,3,114,177,17,1,0,309,3,6,318
31,1,31069,791,3,189,173,22,0,1,385,0,6,391
31,1,31069,794,3,120,110,10,0,0,240,1,4,245
31,1,31069,795,3,134,104,5,0,0,243,0,5,248
31,1,31071,798,3,291,266,55,5,4,621,0,8,629
31,1,31071,799,3,65,64,47,0,0,176,0,2,178
31,1,31073,802,3,433,562,267,1,0,1263,0,18,1281
31,1,31081,851,3,298,343,26,0,1,668,0,8,676
31,1,31081,854,3,52,42,0,0,0,94,0,1,95
31,1,31085,867,3,329,497,220,8,5,1059,3,20,1082
31,1,31085,870,3,451,364,27,1,0,843,0,27,870
31,1,31085,871,3,104,90,46,1,0,241,0,1,242
31,1,31085,874,3,390,551,261,1,6,1209,1,41,1251
31,1,31091,901,3,234,233,62,2,0,531,0,12,543
31,1,31091,902,3,229,138,75,10,3,455,0,8,463
31,1,31091,903,3,396,484,106,4,4,994,1,25,1020
31,1,31091,906,3,108,76,60,0,1,245,0,1,246
31,1,31091,907,3,262,173,123,1,0,559,0,7,566
31,1,31092,910,3,121,203,15,0,0,339,0,9,348
31,1,31092,911,3,297,530,23,1,2,853,0,11,864
31,1,31094,922,3,166,163,122,0,0,451,0,11,462
31,1,31094,923,3,146,191,249,2,0,588,0,12,600
31,1,31096,932,3,248,162,53,4,3,470,0,12,482
31,1,31096,934,3,394,209,54,5,4,666,2,9,677
31,1,31096,935,3,505,334,91,16,17,963,2,32,997
31,1,31096,938,3,464,307,119,8,7,905,3,14,922
31,1,31096,939,3,485,208,65,9,7,774,1,11,786
31,1,31096,942,3,397,256,63,20,1,737,0,14,751
31,1,31096,943,3,267,187,52,14,4,524,0,13,537
31,1,31096,946,3,393,261,106,13,3,776,4,24,804
31,1,31096,947,3,321,138,58,7,6,530,0,26,556
31,1,31096,950,3,360,280,99,16,8,763,0,16,779
31,1,31096,951,3,328,163,73,11,5,580,1,10,591
31,1,31096,954,3,555,266,73,8,3,905,0,10,915
31,1,31096,955,3,452,266,54,7,4,783,0,19,802
31,1,31096,958,3,255,234,71,17,4,581,0,23,604
31,1,31096,959,3,490,345,105,9,3,952,0,9,961
31,1,31096,962,3,89,35,4,0,0,128,0,2,130
31,1,31096,963,3,89,41,10,1,0,141,0,5,146
31,1,31096,966,3,390,283,128,11,4,816,0,14,830
31,1,31096,967,3,103,83,20,1,1,208,0,20,228
31,1,31096,970,3,596,299,108,13,1,1017,0,29,1046
31,1,31096,971,3,306,287,85,6,1,685,0,19,704
31,1,31097,974,3,276,228,12,2,0,518,2,15,535
31,1,31097,975,3,240,248,26,3,0,517,0,12,529
31,1,31098,978,3,279,386,247,10,6,928,0,11,939
31,1,31098,979,3,216,328,215,17,5,781,1,18,800
31,1,31098,982,3,126,221,117,3,6,473,1,9,483
31,1,31098,983,3,99,91,57,1,0,248,1,4,253
31,1,31099,986,3,376,335,16,1,2,730,0,5,735
31,1,31099,987,3,163,75,12,0,0,250,0,4,254
31,1,31102,1010,3,375,389,149,20,11,944,3,14,961
31,1,31102,1011,3,352,339,206,32,7,936,0,10,946
31,1,31102,1014,3,311,210,121,7,7,656,0,16,672
31,1,31102,1015,3,326,258,101,14,4,703,1,13,717
31,1,31102,1018,3,482,371,228,18,8,1107,4,27,1138
31,1,31102,1019,3,336,313,148,17,5,819,1,10,830
31,1,31102,1022,3,306,305,128,17,2,758,1,11,770
31,1,31102,1023,3,397,295,145,10,6,853,1,20,874
31,1,31102,1026,3,298,314,204,15,3,834,1,9,844
31,1,31102,1027,3,353,301,215,14,2,885,0,34,919
31,1,31102,1030,3,296,207,110,14,6,633,0,22,655
31,1,31102,1031,3,350,275,182,13,1,821,0,18,839
31,1,31102,1034,3,361,450,195,3,0,1009,0,14,1023
31,1,31102,1035,3,111,152,146,3,1,413,1,22,436
31,1,31102,1038,3,57,293,208,0,2,560,0,6,566
31,1,31102,1039,3,288,278,88,0,1,655,0,12,667
31,1,31102,1042,3,108,80,215,1,1,405,0,7,412
31,1,31104,1045,3,281,255,17,1,1,555,0,9,564
31,1,31104,1046,3,276,399,29,2,0,706,0,4,710
31,1,31104,1047,3,211,447,53,2,3,716,1,9,726
31,1,31104,1050,3,46,112,0,0,1,159,0,6,165
31,1,31104,1051,3,112,359,11,0,0,482,1,5,488
31,1,31104,1054,3,56,84,5,0,1,146,0,7,153
31,1,31104,1055,3,555,229,19,0,0,803,0,13,816
31,2,31002,7,3,306,464,108,26,10,914,13,32,959
31,2,31002,10,3,390,724,103,23,15,1255,17,43,1315
31,2,31002,11,3,188,217,31,2,1,439,1,4,444
31,2,31004,20,3,299,414,53,15,5,786,0,20,806
31,2,31004,22,3,168,260,53,21,1,503,2,16,521
31,2,31004,23,3,135,211,36,13,9,404,0,17,421
31,2,31005,26,3,228,309,12,3,3,555,0,11,566
31,2,31006,27,3,582,419,28,36,5,1070,0,26,1096
31,2,31006,30,3,262,306,37,19,1,625,0,14,639
31,2,31006,31,3,140,105,34,2,1,282,1,1,284
31,2,31007,34,3,426,303,77,18,5,829,4,10,843
31,2,31007,35,3,295,259,87,10,7,658,2,13,673
31,2,31009,41,3,168,140,69,10,1,388,0,6,394
31,2,31009,42,3,244,175,98,37,1,555,2,5,562
31,2,31009,43,3,270,189,77,39,3,578,2,15,595
31,2,31009,46,3,44,12,34,2,1,93,0,0,93
31,2,31013,59,3,352,419,83,17,7,878,0,25,903
31,2,31013,62,3,432,419,88,17,3,959,4,18,981
31,2,31013,63,3,25,60,5,2,1,93,0,3,96
31,2,31020,91,3,451,548,35,14,4,1052,0,22,1074
31,2,31026,110,3,161,272,39,7,2,481,1,25,507
31,2,31026,111,3,253,380,33,16,2,684,1,10,695
31,2,31027,114,3,275,320,97,35,5,732,0,14,746
31,2,31027,115,3,377,483,153,55,9,1077,1,23,1101
31,2,31027,118,3,236,209,103,33,2,583,0,11,594
31,2,31028,120,3,256,262,80,8,0,606,0,13,619
31,2,31029,122,3,238,195,153,4,0,590,0,8,598
31,2,31029,123,3,257,278,123,18,3,679,2,17,698
31,2,31029,126,3,226,151,161,2,4,544,0,0,544
31,2,31031,131,3,185,358,6,2,1,552,0,11,563
31,2,31034,152,3,132,101,44,3,1,281,0,10,291
31,2,31034,154,3,244,153,68,5,3,473,0,12,485
31,2,31034,155,3,285,194,56,9,5,549,7,12,568
31,2,31035,158,3,141,96,35,7,1,280,0,0,280
31,2,31035,159,3,435,272,50,10,2,769,3,13,785
31,2,31039,187,3,361,368,31,14,4,778,0,18,796
31,2,31040,190,3,154,300,66,20,4,544,0,9,553
31,2,31040,191,3,180,289,76,12,4,561,0,21,582
31,2,31040,194,3,220,334,109,14,3,680,0,36,716
31,2,31040,195,3,275,408,142,24,7,856,2,14,872
31,2,31040,198,3,481,396,110,15,8,1010,5,17,1032
31,2,31040,199,3,288,537,51,9,6,891,0,25,916
31,2,31040,202,3,95,163,13,0,0,271,0,4,275
31,2,31040,203,3,253,224,70,2,4,553,1,16,570
31,2,31041,206,3,572,963,212,40,11,1798,2,65,1865
31,2,31041,207,3,524,877,130,34,17,1582,4,59,1645
31,2,31041,210,3,218,241,71,24,9,563,3,14,580
31,2,31041,211,3,495,440,133,47,14,1129,7,41,1177
31,2,31041,214,3,431,372,98,37,15,953,9,22,984
31,2,31041,215,3,258,277,136,28,18,717,2,14,733
31,2,31041,218,3,734,609,225,67,22,1657,28,50,1735
31,2,31041,219,3,555,552,156,37,18,1318,13,52,1383
31,2,31041,222,3,140,144,31,3,2,320,2,10,332
31,2,31041,223,3,295,191,81,23,4,594,1,25,620
31,2,31051,657,3,193,172,22,12,0,399,0,10,409
31,2,31051,658,3,265,339,34,11,3,652,3,7,662
31,2,31051,659,3,115,124,6,2,0,247,0,5,252
31,2,31052,662,3,585,469,98,48,23,1223,8,39,1270
31,2,31052,663,3,445,357,68,36,24,930,4,29,963
31,2,31052,666,3,283,298,109,20,9,719,4,17,740
31,2,31052,667,3,521,364,168,32,11,1096,2,21,1119
31,2,31052,670,3,295,225,43,16,3,582,0,24,606
31,2,31052,671,3,159,194,57,3,0,413,1,11,425
31,2,31052,674,3,493,258,32,14,5,802,4,20,826
31,2,31052,675,3,71,71,5,5,1,153,0,2,155
31,2,31052,678,3,207,92,44,6,5,354,10,0,364
31,2,31052,679,3,284,180,44,18,3,529,4,8,541
31,2,31054,687,3,186,183,31,35,1,436,4,4,444
31,2,31059,734,3,277,401,52,8,6,744,1,12,757
31,2,31059,735,3,54,60,7,6,0,127,0,4,131
31,2,31059,738,3,67,97,30,0,0,194,0,6,200
31,2,31059,739,3,192,395,107,16,12,722,0,18,740
31,2,31059,742,3,284,519,102,13,25,943,5,22,970
31,2,31059,743,3,165,244,88,8,24,529,1,11,541
31,2,31059,746,3,298,397,113,19,16,843,0,26,869
31,2,31059,747,3,141,194,51,10,7,403,0,12,415
31,2,31059,750,3,267,351,72,18,8,716,2,35,753
31,2,31059,751,3,16,20,3,1,0,40,0,1,41
31,2,31059,754,3,391,740,192,14,13,1350,3,38,1391
31,2,31059,755,3,307,514,122,27,13,983,3,25,1011
31,2,31059,758,3,341,586,150,39,17,1133,0,25,1158
31,2,31059,759,3,26,99,39,10,3,177,0,5,182
31,2,31059,762,3,99,189,30,7,5,330,1,22,353
31,2,31059,763,3,224,483,137,33,10,887,3,37,927
31,2,31067,781,3,423,318,47,18,5,811,11,7,829
31,2,31067,782,3,183,242,23,9,3,460,7,4,471
31,2,31067,783,3,414,445,81,19,7,966,5,37,1008
31,2,31068,786,3,272,313,73,21,3,682,0,10,692
31,2,31068,787,3,310,311,46,7,3,677,1,10,688
31,2,31072,800,3,107,192,233,8,1,541,2,11,554
31,2,31074,803,3,371,370,63,11,5,820,0,22,842
31,2,31077,817,3,381,344,32,18,1,776,0,20,796
31,2,31077,818,3,200,152,9,4,0,365,0,0,365
31,2,31078,819,3,297,231,34,9,1,572,0,5,577
31,2,31078,822,3,305,276,27,10,4,622,2,4,628
31,2,31078,823,3,18,20,7,2,0,47,0,0,47
31,2,31082,855,3,194,275,17,93,1,580,0,23,603
31,2,31082,858,3,132,274,14,78,1,499,1,17,517
31,2,31083,859,3,175,233,43,7,0,458,1,11,470
31,2,31084,862,3,269,348,18,5,2,642,0,4,646
31,2,31084,863,3,383,368,17,4,2,774,0,10,784
31,2,31084,866,3,72,105,13,0,0,190,0,5,195
31,2,31086,875,3,95,139,36,5,0,275,0,7,282
31,2,31088,880,3,167,210,11,11,2,401,1,8,410
31,2,31090,898,3,402,449,19,5,2,877,0,17,894
31,2,31090,899,3,447,494,23,9,3,976,2,18,996
31,2,31093,912,3,289,299,80,20,13,701,1,20,722
31,2,31093,914,3,327,341,114,21,6,809,1,18,828
31,2,31093,915,3,255,269,103,10,4,641,0,9,650
31,2,31093,918,3,418,255,63,13,7,756,3,18,777
31,2,31093,919,3,268,198,61,25,4,556,6,34,596
31,2,31095,926,3,237,225,65,15,5,547,0,7,554
31,2,31095,927,3,100,101,41,6,2,250,2,4,256
31,2,31095,930,3,84,57,42,2,0,185,5,0,190
31,2,31095,931,3,146,60,13,2,0,221,0,11,232
31,2,31103,1043,3,240,222,11,6,1,480,2,9,491
31,2,31105,1056,3,355,710,167,23,7,1262,3,20,1285
31,2,31106,1058,3,225,314,106,9,1,655,0,9,664
31,2,31106,1059,3,39,85,22,8,0,154,0,5,159
31,3,31050,254,3,1838,945,585,273,78,3719,8,60,3787
31,3,31050,255,3,184,131,60,27,12,414,0,15,429
31,3,31050,258,3,350,250,124,24,17,765,2,15,782
31,3,31050,259,3,440,230,101,23,10,804,3,17,824
31,3,31050,267,3,663,241,89,38,18,1049,8,11,1068
31,3,31050,270,3,401,240,137,44,19,841,2,20,863
31,3,31050,271,3,370,287,90,45,18,810,7,18,835
31,3,31050,285,3,369,246,72,34,13,734,1,20,755
31,3,31050,286,3,406,216,76,23,13,734,10,27,771
31,3,31050,287,3,534,238,116,35,19,942,2,19,963
31,3,31050,290,3,287,129,76,37,13,542,2,9,553
31,3,31050,291,3,570,247,139,54,29,1039,0,16,1055
31,3,31050,294,3,436,152,339,33,8,968,3,17,988
31,3,31050,295,3,653,265,91,51,20,1080,2,15,1097
31,3,31050,308,3,1409,819,532,177,49,2986,5,44,3035
31,3,31050,310,3,288,286,137,59,22,792,0,15,807
31,3,31050,311,3,898,391,265,90,40,1684,2,22,1708
31,3,31050,314,3,333,181,122,37,14,687,6,18,711
31,3,31050,315,3,334,166,84,76,8,668,1,19,688
31,3,31050,338,3,354,179,76,49,13,671,3,14,688
31,3,31050,339,3,296,201,54,31,14,596,1,10,607
31,3,31050,342,3,331,282,139,47,15,814,3,10,827
31,3,31050,343,3,145,250,83,30,7,515,0,34,549
31,3,31050,346,3,355,179,119,59,20,732,3,9,744
31,3,31050,347,3,419,218,98,65,15,815,2,14,831
31,3,31050,350,3,381,183,62,33,15,674,1,15,690
31,3,31050,351,3,534,185,74,35,17,845,1,9,855
31,3,31050,365,3,274,121,66,22,8,491,3,0,494
31,3,31050,366,3,336,125,78,34,10,583,1,14,598
31,3,31050,367,3,505,182,76,39,8,810,0,16,826
31,3,31050,370,3,372,180,79,49,14,694,5,10,709
31,3,31050,371,3,426,200,87,53,14,780,2,5,787
31,3,31050,374,3,187,163,71,30,7,458,3,17,478
31,3,31050,375,3,237,260,88,33,5,623,9,41,673
31,3,31050,378,3,299,248,87,25,14,673,5,31,709
31,3,31050,379,3,351,208,91,29,11,690,12,13,715
31,3,31050,382,3,1730,1101,539,270,75,3715,17,69,3801
31,3,31050,383,3,433,225,131,57,18,864,2,15,881
31,3,31050,386,3,306,202,76,34,12,630,2,11,643
31,3,31050,387,3,243,179,69,33,13,537,5,15,557
31,3,31050,390,3,238,156,87,23,4,508,1,19,528
31,3,31050,391,3,409,226,111,50,10,806,4,25,835
31,3,31050,394,3,243,110,55,27,9,444,1,6,451
31,3,31050,410,3,311,167,63,42,13,596,9,11,616
31,3,31050,411,3,272,212,68,34,9,595,2,10,607
31,3,31050,414,3,434,219,112,68,25,858,11,5,874
31,3,31050,415,3,442,209,114,58,25,848,7,8,863
31,3,31050,418,3,260,181,70,35,7,553,3,20,576
31,3,31050,419,3,344,199,65,27,13,648,2,14,664
31,3,31050,422,3,303,243,132,46,13,737,0,25,762
31,3,31050,423,3,296,169,95,38,16,614,3,8,625
31,3,31050,426,3,250,118,74,32,13,487,3,13,503
31,3,31050,460,3,192,67,47,12,5,323,2,4,329
31,3,31050,462,3,199,112,79,21,4,415,0,20,435
31,3,31050,463,3,226,116,73,22,10,447,0,14,461
31,3,31050,466,3,365,200,61,29,9,664,4,7,675
31,3,31050,467,3,283,208,60,35,10,596,1,10,607
31,3,31050,470,3,290,201,56,22,7,576,6,7,589
31,3,31050,471,3,676,473,201,80,29,1459,6,30,1495
31,3,31050,474,3,1972,1553,615,261,64,4465,18,110,4593
31,3,31050,475,3,334,352,111,54,20,871,5,14,890
31,3,31050,478,3,397,205,94,32,9,737,5,16,758
31,3,31050,479,3,307,211,80,34,10,642,8,18,668
31,3,31050,498,3,316,201,80,27,10,634,4,12,650
31,3,31050,499,3,229,193,50,28,4,504,4,10,518
31,3,31050,560,3,244,185,61,24,8,522,6,16,544
31,3,31050,562,3,350,159,101,11,11,632,2,12,646
31,3,31050,563,3,334,236,67,16,4,657,3,19,679
31,3,31050,574,3,227,206,63,17,6,519,2,15,536
31,3,31050,575,3,243,227,60,20,8,558,2,16,576
31,3,31050,580,3,322,257,59,20,9,667,3,30,700
31,3,31050,582,3,301,180,105,34,8,628,0,16,644
31,3,31050,583,3,307,153,89,21,12,582,0,12,594
31,3,31050,586,3,173,91,64,27,15,370,0,5,375
31,3,31050,587,3,285,157,97,35,12,586,3,11,600
31,3,31050,590,3,336,321,150,40,18,865,2,15,882
31,3,31050,591,3,242,154,78,16,6,496,0,10,506
31,3,31050,594,3,501,317,133,66,17,1034,6,19,1059
31,3,31050,595,3,206,139,62,26,10,443,4,13,460
31,3,31050,598,3,355,216,91,26,15,703,5,25,733
31,3,31050,599,3,285,186,98,28,13,610,8,5,623
31,3,31050,602,3,298,185,70,12,13,578,2,19,599
31,3,31050,603,3,519,294,176,59,19,1067,12,33,1112
31,3,31050,606,3,408,286,120,20,15,849,1,24,874
31,3,31050,607,3,345,253,86,37,8,729,3,24,756
31,3,31050,610,3,397,227,84,33,12,753,3,29,785
31,3,31050,611,3,769,504,221,47,14,1555,6,54,1615
31,3,31050,614,3,366,325,86,30,7,814,3,22,839
31,3,31050,615,3,370,247,85,25,12,739,3,29,771
31,3,31050,618,3,349,243,111,31,13,747,2,15,764
31,3,31050,619,3,312,305,94,28,15,754,0,29,783
31,3,31050,622,3,209,174,64,20,5,472,7,6,485
31,3,31050,623,3,285,200,57,23,9,574,5,18,597
31,3,31050,626,3,705,457,174,64,18,1418,10,36,1464
31,3,31050,627,3,718,501,242,43,35,1539,7,45,1591
31,3,31050,630,3,95,105,28,24,0,252,1,9,262
31,3,31050,631,3,183,303,24,9,7,526,2,24,552
31,3,31050,634,3,272,270,106,33,12,693,8,21,722
31,3,31050,635,3,302,276,107,48,9,742,1,27,770
31,3,31050,638,3,250,269,78,29,5,631,12,16,659
31,3,31050,639,3,274,319,69,32,12,706,6,18,730
31,3,31050,644,3,507,535,71,27,18,1158,7,44,1209
31,3,31050,648,3,140,143,32,4,1,320,0,15,335
31,3,31050,1060,3,217,170,80,28,11,506,2,4,512
31,3,31050,1062,3,246,110,74,42,19,491,0,5,496
31,3,31050,1063,3,187,117,59,28,12,403,0,5,408
31,3,31050,1066,3,191,112,72,29,10,414,3,2,419
31,3,31050,1067,3,241,108,81,22,7,459,0,11,470
31,3,31050,1070,3,277,124,79,51,16,547,2,9,558
31,3,31050,1071,3,279,118,80,38,11,526,0,5,531
31,3,31050,1074,3,226,119,66,24,12,447,1,2,450
31,3,31050,1075,3,154,126,60,24,9,373,1,3,377
31,3,31050,1078,3,312,84,58,36,12,502,3,7,512
31,3,31050,1079,3,162,153,31,14,9,369,1,8,378
31,4,31050,261,3,709,261,106,37,27,1140,1,8,1149
31,4,31050,262,3,334,79,63,20,10,506,0,1,507
31,4,31050,263,3,758,328,181,56,32,1355,4,18,1377
31,4,31050,266,3,392,222,107,31,9,761,0,22,783
31,4,31050,273,3,425,132,49,17,12,635,2,9,646
31,4,31050,274,3,611,232,86,14,16,959,0,11,970
31,4,31050,275,3,649,245,104,22,20,1040,2,9,1051
31,4,31050,278,3,1116,544,306,84,41,2091,16,37,2144
31,4,31050,279,3,627,290,142,36,24,1119,3,10,1132
31,4,31050,282,3,428,189,96,41,15,769,9,7,785
31,4,31050,283,3,296,267,80,23,10,676,2,14,692
31,4,31050,296,3,502,137,62,23,13,737,0,9,746
31,4,31050,298,3,988,344,190,54,25,1601,4,17,1622
31,4,31050,299,3,559,281,137,51,17,1045,4,30,1079
31,4,31050,302,3,521,221,122,40,27,931,1,16,948
31,4,31050,303,3,1805,1023,563,159,80,3630,16,46,3692
31,4,31050,306,3,431,126,46,11,8,622,0,9,631
31,4,31050,307,3,527,156,59,16,9,767,1,133,901
31,4,31050,317,3,453,132,57,22,11,675,0,5,680
31,4,31050,318,3,378,101,34,9,13,535,0,6,541
31,4,31050,319,3,482,241,100,29,13,865,3,24,892
31,4,31050,322,3,533,287,161,39,15,1035,7,9,1051
31,4,31050,323,3,355,187,103,39,22,706,2,10,718
31,4,31050,326,3,429,219,160,26,14,848,1,16,865
31,4,31050,327,3,567,299,204,32,16,1118,9,20,1147
31,4,31050,330,3,332,130,92,15,15,584,1,6,591
31,4,31050,331,3,378,166,91,17,12,664,5,17,686
31,4,31050,334,3,345,91,49,19,16,520,1,3,524
31,4,31050,335,3,491,135,66,29,11,732,1,8,741
31,4,31050,353,3,384,78,88,14,6,570,2,11,583
31,4,31050,354,3,459,177,114,24,18,792,3,11,806
31,4,31050,355,3,504,198,139,31,18,890,0,26,916
31,4,31050,358,3,444,211,130,35,11,831,8,24,863
31,4,31050,359,3,483,218,131,27,15,874,3,22,899
31,4,31050,362,3,394,276,156,31,12,869,1,19,889
31,4,31050,363,3,503,229,146,36,16,930,1,24,955
31,4,31050,395,3,247,103,81,24,8,463,0,11,474
31,4,31050,398,3,290,142,110,31,15,588,2,9,599
31,4,31050,399,3,369,141,90,24,9,633,7,13,653
31,4,31050,402,3,378,259,110,26,11,784,18,0,802
31,4,31050,403,3,424,377,128,34,9,972,10,41,1023
31,4,31050,406,3,382,259,101,35,8,785,4,21,810
31,4,31050,407,3,295,197,105,40,11,648,0,17,665
31,4,31050,427,3,157,40,65,11,9,282,0,7,289
31,4,31050,430,3,240,120,84,19,10,473,3,5,481
31,4,31050,431,3,271,147,62,35,8,523,4,10,537
31,4,31050,434,3,428,243,101,42,12,826,3,36,865
31,4,31050,435,3,308,228,68,25,8,637,3,23,663
31,4,31050,438,3,461,234,112,20,14,841,3,16,860
31,4,31050,439,3,395,264,95,38,13,805,4,11,820
31,4,31050,442,3,238,131,70,11,8,458,3,5,466
31,4,31050,443,3,245,203,44,24,11,527,3,21,551
31,4,31050,446,3,407,272,81,29,15,804,6,24,834
31,4,31050,447,3,388,232,121,31,9,781,4,9,794
31,4,31050,450,3,453,226,103,33,13,828,3,17,848
31,4,31050,451,3,323,296,157,32,5,813,3,17,833
31,4,31050,454,3,453,189,157,25,19,843,2,11,856
31,4,31050,455,3,506,221,134,27,10,898,1,17,916
31,4,31050,458,3,247,124,71,20,2,464,4,12,480
31,4,31050,459,3,130,74,45,8,5,262,0,4,266
31,4,31050,481,3,262,108,61,21,9,461,0,13,474
31,4,31050,482,3,347,149,84,21,11,612,3,15,630
31,4,31050,483,3,457,162,129,32,14,794,3,19,816
31,4,31050,486,3,518,249,162,36,19,984,0,28,1012
31,4,31050,487,3,537,231,121,25,11,925,4,19,948
31,4,31050,490,3,317,280,76,26,9,708,3,15,726
31,4,31050,491,3,441,318,104,23,22,908,8,29,945
31,4,31050,494,3,706,408,203,58,25,1400,2,30,1432
31,4,31050,495,3,293,217,87,15,11,623,0,16,639
31,4,31050,501,3,207,129,64,17,6,423,3,11,437
31,4,31050,502,3,297,142,86,30,9,564,1,11,576
31,4,31050,503,3,295,121,61,15,6,498,3,14,515
31,4,31050,506,3,366,180,80,26,7,659,3,5,667
31,4,31050,507,3,275,146,75,27,9,532,5,22,559
31,4,31050,510,3,1652,1287,501,105,52,3597,24,70,3691
31,4,31050,511,3,250,217,63,24,5,559,3,15,577
31,4,31050,514,3,277,197,88,30,10,602,0,26,628
31,4,31050,515,3,484,261,146,33,17,941,6,29,976
31,4,31050,518,3,277,180,78,18,15,568,0,16,584
31,4,31050,519,3,538,313,119,45,23,1038,1,26,1065
31,4,31050,522,3,305,205,85,28,8,631,0,20,651
31,4,31050,523,3,416,301,132,41,7,897,3,25,925
31,4,31050,526,3,432,220,98,39,16,805,6,32,843
31,4,31050,527,3,531,377,107,25,8,1048,5,28,1081
31,4,31050,530,3,386,360,119,26,16,907,8,26,941
31,4,31050,531,3,255,138,83,22,7,505,2,10,517
31,4,31050,534,3,413,289,131,30,13,876,4,16,896
31,4,31050,535,3,359,210,54,16,10,649,4,20,673
31,4,31050,538,3,437,299,112,33,12,893,5,24,922
31,4,31050,539,3,369,167,78,23,12,649,5,16,670
31,4,31050,542,3,311,212,82,15,11,631,1,15,647
31,4,31050,543,3,336,158,75,27,5,601,1,16,618
31,4,31050,546,3,427,258,136,27,11,859,6,24,889
31,4,31050,547,3,291,224,87,19,7,628,6,25,659
31,4,31050,550,3,182,193,89,16,29,509,0,10,519
31,4,31050,551,3,460,198,129,30,16,833,0,17,850
31,4,31050,554,3,288,189,77,24,8,586,4,21,611
31,4,31050,555,3,291,224,78,12,13,618,1,15,634
31,4,31050,558,3,280,224,62,14,7,587,1,17,605
31,4,31050,559,3,335,263,73,22,7,700,4,15,719
31,4,31050,566,3,305,254,83,20,6,668,4,16,688
31,4,31050,567,3,286,228,117,30,17,678,5,10,693
31,4,31050,570,3,470,560,160,39,14,1243,2,21,1266
31,4,31050,571,3,259,216,76,29,11,591,7,2,600
31,4,31050,577,3,295,210,53,26,8,592,6,19,617
31,4,31050,578,3,525,384,206,38,23,1176,8,16,1200
31,4,31050,579,3,197,157,72,16,16,458,0,12,470
31,4,31050,641,3,480,319,93,33,12,937,4,20,961
31,4,31050,642,3,831,504,108,40,18,1501,6,46,1553
31,4,31050,643,3,411,335,61,14,11,832,2,14,848
31,4,31050,646,3,464,242,108,25,11,850,5,23,878
31,4,31050,647,3,95,149,23,5,4,276,8,16,300
31,4,31050,650,3,390,440,247,32,8,1117,10,35,1162
31,4,31050,651,3,101,58,22,5,1,187,0,4,191
31,4,31050,654,3,475,330,100,23,1,929,2,14,945
31,4,31050,655,3,266,217,25,2,1,511,1,26,538
31,5,31001,1,3,511,354,63,14,3,945,5,25,975
31,5,31001,2,3,79,37,5,0,2,123,0,3,126
31,5,31001,3,3,97,16,36,0,1,150,2,2,154
31,5,31001,6,3,112,125,19,4,2,262,0,5,267
31,5,31003,14,3,323,424,61,36,1,845,0,11,856
31,5,31003,15,3,404,402,62,28,1,897,0,19,916
31,5,31003,18,3,171,216,48,7,4,446,0,4,450
31,5,31003,19,3,7,27,8,1,0,43,0,3,46
31,5,31011,50,3,154,291,62,43,2,552,1,31,584
31,5,31011,51,3,239,305,160,39,10,753,1,37,791
31,5,31015,67,3,311,331,46,17,1,706,1,8,715
31,5,31018,75,3,178,178,37,2,1,396,1,9,406
31,5,31023,103,3,226,429,61,9,6,731,0,10,741
31,5,31024,106,3,312,242,50,2,3,609,1,8,618
31,5,31024,107,3,311,223,79,4,5,622,0,13,635
31,5,31033,142,3,316,410,184,34,10,954,4,30,988
31,5,31033,143,3,255,248,131,21,9,664,0,17,681
31,5,31033,146,3,178,340,168,37,4,727,2,19,748
31,5,31033,147,3,60,37,17,19,2,135,0,4,139
31,5,31033,150,3,396,123,94,16,7,636,1,6,643
31,5,31033,151,3,243,512,92,51,4,902,0,7,909
31,5,31036,162,3,278,214,98,18,5,613,1,10,624
31,5,31036,163,3,287,195,84,15,6,587,2,19,608
31,5,31036,166,3,28,55,10,3,0,96,0,5,101
31,5,31036,167,3,76,227,154,14,1,472,6,18,496
31,5,31037,170,3,375,248,34,2,3,662,7,19,688
31,5,31037,171,3,22,36,0,3,0,61,0,5,66
31,5,31038,174,3,405,289,58,31,14,797,1,23,821
31,5,31038,175,3,462,278,65,39,15,859,2,18,879
31,5,31038,178,3,638,459,119,30,8,1254,0,38,1292
31,5,31038,179,3,517,275,67,27,12,898,0,15,913
31,5,31038,182,3,273,233,43,10,1,560,0,26,586
31,5,31038,183,3,236,212,25,27,3,503,0,7,510
31,5,31038,186,3,783,377,80,12,12,1264,6,45,1315
31,5,31044,228,3,128,162,49,7,1,347,0,9,356
31,5,31044,230,3,370,508,101,22,7,1008,1,31,1040
31,5,31044,231,3,54,51,9,6,2,122,0,2,124
31,5,31046,234,3,291,227,27,1,2,548,0,11,559
31,5,31046,235,3,320,399,46,0,3,768,0,14,782
31,5,31047,238,3,221,177,14,4,1,417,0,9,426
31,5,31048,239,3,277,434,311,18,12,1052,2,28,1082
31,5,31048,242,3,176,277,318,9,3,783,0,16,799
31,5,31048,243,3,211,380,317,24,11,943,0,20,963
31,5,31048,246,3,222,397,81,29,7,736,3,50,789
31,5,31048,247,3,293,277,29,4,1,604,0,20,624
31,5,31048,250,3,229,332,55,2,0,618,8,6,632
31,5,31048,251,3,7,32,14,0,0,53,0,10,63
31,5,31053,680,3,128,234,71,12,6,451,0,12,463
31,5,31053,682,3,393,399,98,19,11,920,0,28,948
31,5,31053,683,3,220,213,71,17,3,524,0,13,537
31,5,31053,686,3,39,103,15,9,1,167,0,5,172
31,5,31055,690,3,301,405,85,18,1,810,1,18,829
31,5,31055,691,3,303,356,105,17,3,784,0,10,794
31,5,31056,694,3,444,296,88,27,4,859,1,8,868
31,5,31056,695,3,293,352,82,34,2,763,1,14,778
31,5,31056,698,3,282,331,102,26,4,745,1,20,766
31,5,31056,699,3,337,341,90,29,7,804,0,16,820
31,5,31056,702,3,250,238,68,19,4,579,0,14,593
31,5,31056,703,3,217,149,42,9,3,420,1,22,443
31,5,31056,706,3,118,178,41,1,0,338,0,29,367
31,5,31056,707,3,236,245,15,1,0,497,0,2,499
31,5,31062,769,3,314,425,30,27,4,800,0,26,826
31,5,31062,770,3,340,565,54,31,8,998,1,35,1034
31,5,31062,771,3,69,212,26,8,2,317,1,14,332
31,5,31063,774,3,290,107,54,8,1,460,1,12,473
31,5,31064,775,3,397,423,45,25,1,891,2,18,911
31,5,31066,778,3,376,403,50,1,1,831,0,11,842
31,5,31066,779,3,245,241,21,2,2,511,0,4,515
31,5,31075,805,3,412,398,64,4,9,887,1,15,903
31,5,31075,806,3,520,488,67,4,3,1082,0,21,1103
31,5,31076,807,3,566,684,120,31,9,1410,10,33,1453
31,5,31076,810,3,428,432,74,26,3,963,0,27,990
31,5,31076,811,3,77,216,6,3,1,303,1,6,310
31,5,31076,814,3,341,360,70,12,2,785,0,34,819
31,5,31076,815,3,288,249,8,1,0,546,0,20,566
31,5,31079,826,3,498,247,101,16,3,865,2,21,888
31,5,31079,827,3,502,424,189,37,10,1162,0,11,1173
31,5,31079,830,3,357,292,117,25,5,796,1,21,818
31,5,31079,831,3,247,266,79,20,6,618,0,19,637
31,5,31079,834,3,262,270,89,37,7,665,0,18,683
31,5,31079,835,3,500,461,150,29,7,1147,1,24,1172
31,5,31079,838,3,242,225,75,12,1,555,0,9,564
31,5,31079,839,3,214,337,88,7,1,647,0,14,661
31,5,31079,842,3,241,506,79,11,6,843,2,26,871
31,5,31079,843,3,87,203,27,4,1,322,0,15,337
31,5,31080,846,3,698,481,69,28,8,1284,1,32,1317
31,5,31080,847,3,387,510,34,8,3,942,0,11,953
31,5,31087,878,3,546,311,113,27,5,1002,2,15,1019
31,5,31087,879,3,500,259,80,31,5,875,0,10,885
31,5,31089,882,3,432,414,136,14,10,1006,3,15,1024
31,5,31089,883,3,257,253,87,19,6,622,0,9,631
31,5,31089,886,3,332,228,96,25,9,690,0,13,703
31,5,31089,887,3,341,254,101,8,4,708,1,10,719
31,5,31089,890,3,297,346,97,16,2,758,0,6,764
31,5,31089,891,3,443,428,164,31,9,1075,2,18,1095
31,5,31089,894,3,443,416,112,22,5,998,1,18,1017
31,5,31089,895,3,376,350,63,21,4,814,0,20,834
31,5,31100,988,3,478,355,43,17,5,898,6,36,940
31,5,31101,990,3,736,482,100,33,10,1361,6,41,1408
31,5,31101,991,3,774,634,124,31,24,1587,3,47,1637
31,5,31101,994,3,318,248,64,34,13,677,9,19,705
31,5,31101,995,3,551,498,118,32,22,1221,3,31,1255
31,5,31101,998,3,685,626,142,31,23,1507,6,36,1549
31,5,31101,999,3,364,315,59,15,5,758,1,30,789
31,5,31101,1002,3,267,203,118,39,19,646,7,16,669
31,5,31101,1003,3,207,228,126,29,19,609,1,17,627
31,5,31101,1006,3,397,716,126,26,11,1276,2,58,1336
31,5,31101,1007,3,149,73,13,2,3,240,0,8,248
32,1,32005,40,3,279,163,326,74,21,863,10,19,892
32,1,32005,42,3,104,66,95,10,9,284,2,7,293
32,1,32005,43,3,172,95,101,21,13,402,6,20,428
32,1,32005,46,3,149,97,149,10,3,408,1,17,426
32,1,32005,47,3,153,124,180,24,18,499,4,26,529
32,1,32005,50,3,239,124,175,37,8,583,5,7,595
32,1,32005,51,3,187,95,199,18,13,512,4,13,529
32,1,32005,54,3,270,193,252,46,28,789,11,31,831
32,1,32005,55,3,191,111,188,27,9,526,1,25,552
32,1,32005,58,3,55,34,112,10,3,214,7,9,230
32,1,32005,59,3,40,35,173,5,1,254,2,7,263
32,1,32009,114,3,94,51,63,4,1,213,1,10,224
32,1,32009,115,3,60,57,45,13,4,179,7,5,191
32,1,32009,118,3,64,53,63,10,0,190,3,5,198
32,1,32009,119,3,140,93,56,6,3,298,2,5,305
32,1,32009,122,3,61,63,44,3,0,171,8,8,187
32,1,32009,123,3,29,88,61,3,6,187,0,4,191
32,1,32009,126,3,34,14,7,2,2,59,2,0,61
32,1,32009,127,3,82,42,46,5,4,179,0,4,183
32,1,32009,130,3,47,66,29,7,7,156,5,6,167
32,1,32009,131,3,24,22,11,1,1,59,3,6,68
32,1,32009,134,3,58,51,26,13,1,149,2,7,158
32,1,32010,135,3,123,128,234,30,16,531,11,21,563
32,1,32010,138,3,44,63,171,19,5,302,7,7,316
32,1,32010,139,3,122,124,373,29,16,664,12,20,696
32,1,32010,142,3,93,69,197,10,7,376,6,14,396
32,1,32010,143,3,81,69,197,22,8,377,7,13,397
32,1,32010,146,3,100,71,199,15,12,397,4,14,415
32,1,32010,147,3,107,81,168,24,14,394,1,12,407
32,1,32010,150,3,230,143,287,32,23,715,2,17,734
32,1,32010,151,3,170,127,300,25,15,637,0,22,659
32,1,32010,154,3,146,144,256,30,12,588,10,23,621
32,1,32010,155,3,104,97,293,22,9,525,11,12,548
32,1,32010,158,3,79,48,125,6,4,262,2,2,266
32,1,32010,159,3,125,80,175,14,16,410,4,7,421
32,1,32010,162,3,150,75,230,25,6,486,1,9,496
32,1,32010,163,3,272,188,348,39,31,878,6,14,898
32,1,32010,166,3,148,94,192,19,7,460,2,4,466
32,1,32010,167,3,156,78,194,17,8,453,1,14,468
32,1,32010,170,3,114,77,211,15,13,430,1,5,436
32,1,32010,171,3,125,104,236,15,9,489,7,7,503
32,1,32010,174,3,128,100,177,20,7,432,1,7,440
32,1,32010,175,3,128,91,155,21,6,401,4,9,414
32,1,32010,178,3,164,72,137,7,11,391,0,8,399
32,1,32010,179,3,130,103,117,21,19,390,0,13,403
32,1,32010,182,3,199,91,234,24,17,565,3,11,579
32,1,32010,183,3,162,82,89,12,10,355,1,5,361
32,1,32010,186,3,84,87,169,14,16,370,1,0,371
32,1,32010,187,3,63,66,117,14,9,269,1,5,275
32,1,32010,190,3,124,117,322,32,17,612,8,12,632
32,1,32010,191,3,129,102,173,17,11,432,14,6,452
32,1,32010,194,3,247,158,538,73,24,1040,7,13,1060
32,1,32010,195,3,135,99,231,19,15,499,6,13,518
32,1,32010,198,3,100,68,151,13,15,347,1,9,357
32,1,32010,199,3,93,39,85,15,4,236,0,10,246
32,1,32010,202,3,155,76,90,17,7,345,1,0,346
32,1,32010,203,3,173,126,145,11,17,472,1,8,481
32,1,32010,206,3,162,120,208,31,15,536,0,15,551
32,1,32010,207,3,136,73,205,16,16,446,1,8,455
32,1,32010,210,3,424,249,719,94,38,1524,15,19,1558
32,1,32010,211,3,148,123,287,62,12,632,3,12,647
32,1,32010,214,3,56,62,148,13,10,289,5,6,300
32,1,32010,215,3,69,60,97,12,4,242,3,8,253
32,1,32010,218,3,23,30,194,3,2,252,1,10,263
32,1,32010,219,3,16,44,61,6,2,129,0,5,134
32,1,32010,222,3,13,36,70,4,1,124,0,4,128
32,1,32010,223,3,16,24,60,1,0,101,0,1,102
32,1,32010,226,3,11,12,112,3,0,138,0,2,140
32,1,32010,227,3,64,39,162,6,6,277,1,3,281
32,1,32010,230,3,57,75,138,3,4,277,5,13,295
32,1,32010,231,3,54,93,109,5,4,265,2,11,278
32,1,32010,234,3,39,36,70,2,0,147,5,9,161
32,1,32010,235,3,28,50,151,1,1,231,3,17,251
32,1,32010,238,3,15,8,80,1,2,106,0,5,111
32,1,32010,239,3,62,118,131,8,5,324,4,10,338
32,1,32010,242,3,40,43,47,2,5,137,4,4,145
32,1,32010,243,3,36,41,205,11,9,302,4,9,315
32,1,32010,246,3,62,116,253,9,5,445,0,26,471
32,1,32010,247,3,8,24,58,3,7,100,0,1,101
32,1,32010,250,3,135,65,150,14,4,368,10,12,390
32,1,32010,251,3,76,78,118,4,11,287,4,11,302
32,1,32010,254,3,14,20,18,0,1,53,0,4,57
32,1,32010,255,3,3,9,44,1,0,57,0,4,61
32,1,32010,258,3,8,16,52,0,0,76,2,3,81
32,1,32010,259,3,14,23,96,3,3,139,5,6,150
32,1,32010,262,3,4,9,26,0,0,39,0,0,39
32,1,32010,263,3,44,21,92,7,3,167,0,29,196
32,1,32010,266,3,72,161,251,18,9,511,4,7,522
32,1,32010,267,3,136,196,281,17,6,636,3,20,659
32,1,32010,270,3,69,39,335,12,3,458,4,13,475
32,1,32010,271,3,61,72,337,14,10,494,2,11,507
32,1,32010,274,3,44,174,446,13,3,680,5,8,693
32,1,32010,275,3,50,34,70,8,5,167,7,8,182
32,1,32010,278,3,18,18,44,0,0,80,1,1,82
32,1,32010,279,3,20,118,129,9,2,278,7,10,295
32,1,32010,282,3,42,213,123,2,4,384,8,18,410
32,1,32010,283,3,19,30,80,1,1,131,10,4,145
32,1,32010,286,3,3,8,63,1,1,76,0,2,78
32,1,32010,287,3,2,4,45,1,1,53,0,0,53
32,1,32010,290,3,63,188,202,12,5,470,11,15,496
32,1,32010,291,3,32,151,99,2,2,286,4,15,305
32,1,32010,294,3,25,57,86,4,7,179,9,8,196
32,1,32010,295,3,26,55,33,10,2,126,5,3,134
32,1,32010,298,3,36,33,103,3,2,177,0,13,190
32,1,32010,299,3,15,22,70,1,0,108,3,5,116
32,1,32010,302,3,26,24,77,1,2,130,2,0,132
32,1,32010,303,3,27,168,124,4,2,325,6,19,350
32,1,32010,306,3,24,13,51,3,1,92,2,2,96
32,1,32010,307,3,40,63,155,5,2,265,0,8,273
32,1,32010,310,3,117,33,121,9,2,282,6,6,294
32,1,32010,311,3,19,69,135,1,1,225,1,5,231
32,1,32010,314,3,14,65,115,2,0,196,0,13,209
32,1,32010,315,3,4,37,26,0,1,68,0,0,68
32,1,32010,318,3,171,232,381,24,9,817,4,49,870
32,1,32010,319,3,0,13,56,0,0,69,0,3,72
32,1,32010,322,3,6,34,39,2,0,81,1,1,83
32,1,32010,323,3,1,2,53,0,0,56,0,1,57
32,1,32010,326,3,5,32,31,9,0,77,1,7,85
32,1,32010,327,3,11,42,38,1,0,92,0,6,98
32,1,32010,330,3,16,31,48,3,0,98,1,3,102
32,1,32010,331,3,8,6,30,0,0,44,0,0,44
32,1,32010,334,3,7,30,42,0,1,80,0,4,84
32,1,32010,335,3,11,29,49,4,1,94,2,1,97
32,1,32010,338,3,31,30,88,1,0,150,1,2,153
32,1,32010,339,3,18,5,121,8,1,153,3,0,156
32,1,32010,342,3,5,11,14,1,0,31,0,2,33
32,1,32010,343,3,16,16,51,1,0,84,0,0,84
32,1,32010,346,3,27,24,80,0,1,132,0,6,138
32,1,32010,347,3,13,52,15,1,1,82,0,3,85
32,1,32013,378,3,155,142,171,19,10,497,2,20,519
32,1,32013,379,3,155,131,231,24,10,551,0,14,565
32,1,32013,382,3,72,82,176,5,2,337,0,10,347
32,1,32013,383,3,38,10,26,2,2,78,0,3,81
32,1,32021,708,3,69,84,72,16,3,244,1,10,255
32,1,32021,710,3,57,70,73,11,1,212,0,7,219
32,1,32021,711,3,26,38,160,3,3,230,0,4,234
32,1,32021,714,3,17,58,27,1,0,103,0,0,103
32,1,32021,715,3,2,51,11,2,0,66,1,0,67
32,1,32029,884,3,177,31,129,12,3,352,3,7,362
32,1,32029,886,3,108,43,111,10,7,279,3,7,289
32,1,32029,887,3,144,38,115,10,4,311,1,1,313
32,1,32029,890,3,265,102,182,24,10,583,4,9,596
32,1,32029,891,3,201,83,126,8,6,424,10,4,438
32,1,32029,894,3,189,95,165,11,5,465,0,12,477
32,1,32029,895,3,151,35,67,6,3,262,4,5,271
32,1,32029,898,3,39,31,75,3,1,149,7,3,159
32,1,32029,899,3,26,17,77,1,4,125,3,5,133
32,1,32029,902,3,29,12,7,1,1,50,0,1,51
32,1,32029,903,3,92,72,44,13,6,227,1,5,233
32,1,32040,1256,3,174,137,158,29,9,507,0,10,517
32,1,32040,1258,3,191,103,95,19,10,418,1,7,426
32,1,32040,1259,3,136,99,97,12,3,347,1,5,353
32,1,32040,1262,3,18,83,105,3,2,211,1,13,225
32,1,32040,1263,3,21,38,68,3,2,132,0,3,135
32,1,32040,1266,3,84,108,172,4,5,373,6,16,395
32,1,32040,1267,3,14,71,62,1,0,148,1,5,154
32,1,32040,1270,3,61,66,225,9,1,362,0,13,375
32,1,32040,1271,3,28,110,68,7,4,217,1,9,227
32,1,32040,1274,3,125,68,54,0,4,251,6,10,267
32,1,32040,1275,3,18,54,64,1,5,142,1,6,149
32,1,32040,1278,3,49,165,193,4,2,413,2,18,433
32,1,32040,1279,3,94,253,145,9,1,502,6,0,508
32,1,32040,1282,3,28,40,20,3,0,91,0,5,96
32,1,32042,1289,3,165,200,109,16,6,496,4,11,511
32,1,32042,1290,3,173,229,112,13,5,532,4,14,550
32,1,32042,1291,3,108,106,68,5,1,288,1,5,294
32,1,32042,1294,3,169,87,79,8,8,351,0,7,358
32,1,32042,1295,3,53,75,55,13,1,197,1,6,204
32,1,32042,1298,3,129,119,78,9,6,341,0,14,355
32,1,32042,1299,3,299,175,106,23,6,609,1,9,619
32,1,32042,1302,3,216,128,69,11,7,431,3,10,444
32,1,32042,1303,3,245,133,63,13,4,458,1,10,469
32,1,32042,1306,3,120,93,50,10,4,277,5,5,287
32,1,32042,1307,3,27,23,56,3,2,111,10,3,124
32,1,32042,1310,3,29,83,105,1,0,218,0,9,227
32,1,32042,1311,3,28,98,87,3,5,221,0,15,236
32,1,32042,1314,3,86,55,139,10,9,299,2,4,305
32,1,32042,1315,3,79,45,178,5,6,313,2,12,327
32,1,32042,1318,3,14,32,114,1,3,164,2,9,175
32,1,32042,1319,3,72,40,146,7,2,267,8,7,282
32,1,32042,1322,3,69,192,102,10,8,381,7,30,418
32,1,32042,1323,3,65,168,78,3,9,323,3,12,338
32,1,32042,1326,3,68,76,93,3,4,244,0,22,266
32,1,32042,1327,3,13,74,27,2,1,117,0,4,121
32,1,32042,1330,3,4,42,27,1,1,75,5,1,81
32,1,32042,1331,3,54,152,45,2,2,255,4,12,271
32,1,32042,1334,3,71,26,45,19,6,167,5,9,181
32,1,32042,1335,3,77,68,49,19,4,217,1,5,223
32,1,32042,1338,3,57,29,66,4,2,158,0,2,160
32,1,32042,1339,3,215,83,85,12,12,407,10,16,433
32,1,32042,1342,3,10,50,36,2,1,99,3,5,107
32,1,32042,1343,3,19,90,60,4,1,174,9,4,187
32,1,32042,1346,3,124,101,100,12,7,344,6,6,356
32,1,32042,1347,3,45,58,75,6,2,186,4,3,193
32,1,32042,1350,3,40,57,32,3,0,132,2,6,140
32,1,32042,1351,3,35,42,54,4,3,138,0,5,143
32,1,32042,1354,3,24,42,15,1,1,83,1,0,84
32,1,32042,1355,3,50,37,35,4,0,126,0,9,135
32,1,32042,1358,3,163,71,56,6,3,299,0,15,314
32,1,32042,1359,3,24,16,41,1,2,84,0,0,84
32,1,32042,1362,3,105,54,75,4,3,241,4,6,251
32,1,32042,1363,3,41,25,71,1,3,141,0,0,141
32,1,32042,1366,3,34,68,85,2,1,190,17,4,211
32,1,32042,1367,3,25,29,38,2,2,96,7,5,108
32,1,32042,1370,3,18,52,23,1,1,95,2,4,101
32,1,32042,1371,3,14,46,30,0,0,90,1,0,91
32,1,32042,1374,3,22,11,7,0,1,41,0,1,42
32,1,32042,1375,3,47,81,20,2,0,150,8,4,162
32,1,32042,1378,3,32,8,12,0,0,52,0,3,55
32,1,32042,1379,3,13,16,16,0,0,45,1,5,51
32,1,32042,1382,3,8,30,18,0,0,56,0,2,58
32,1,32042,1383,3,7,47,13,2,0,69,0,3,72
32,2,32001,1,3,67,42,52,21,2,184,1,6,191
32,2,32001,2,3,99,36,80,16,0,231,1,6,238
32,2,32001,3,3,173,60,152,23,5,413,2,9,424
32,2,32001,6,3,131,63,153,6,3,356,0,11,367
32,2,32001,7,3,56,30,16,3,1,106,0,4,110
32,2,32001,10,3,39,58,57,8,3,165,1,2,168
32,2,32001,11,3,10,5,31,0,0,46,0,2,48
32,2,32002,14,3,133,83,59,6,6,287,0,11,298
32,2,32002,15,3,184,62,32,7,12,297,2,14,313
32,2,32002,18,3,30,210,57,7,2,306,0,1,307
32,2,32002,19,3,22,54,57,1,3,137,0,4,141
32,2,32003,22,3,126,47,127,10,8,318,0,9,327
32,2,32003,23,3,87,37,53,7,3,187,0,1,188
32,2,32003,26,3,79,17,64,0,2,162,1,5,168
32,2,32003,27,3,25,10,75,0,0,110,0,2,112
32,2,32003,30,3,40,5,22,0,0,67,0,2,69
32,2,32004,31,3,98,58,37,2,0,195,0,3,198
32,2,32004,34,3,99,67,50,10,0,226,0,4,230
32,2,32004,35,3,139,95,33,4,2,273,0,4,277
32,2,32004,38,3,41,103,23,4,1,172,0,5,177
32,2,32004,39,3,38,23,44,0,0,105,0,1,106
32,2,32008,103,3,122,105,137,13,9,386,2,5,393
32,2,32008,106,3,106,120,149,12,3,390,2,1,393
32,2,32008,107,3,63,73,139,10,1,286,2,8,296
32,2,32008,110,3,44,83,45,2,2,176,0,5,181
32,2,32008,111,3,37,75,35,2,2,151,0,9,160
32,2,32011,349,3,68,73,36,15,7,199,0,7,206
32,2,32011,350,3,108,54,98,13,4,277,0,1,278
32,2,32011,351,3,81,60,66,3,6,216,0,3,219
32,2,32011,354,3,25,23,41,5,0,94,0,3,97
32,2,32011,355,3,6,6,39,0,0,51,0,1,52
32,2,32011,358,3,22,9,20,0,1,52,0,0,52
32,2,32012,359,3,157,33,47,6,3,246,0,12,258
32,2,32012,362,3,54,38,53,2,3,150,1,4,155
32,2,32012,363,3,3,31,14,1,0,49,2,1,52
32,2,32012,366,3,44,10,23,0,1,78,0,2,80
32,2,32012,367,3,12,8,21,2,0,43,0,1,44
32,2,32012,370,3,103,27,36,4,2,172,1,9,182
32,2,32012,371,3,70,16,31,4,1,122,1,3,126
32,2,32012,374,3,71,14,27,1,2,115,6,3,124
32,2,32012,375,3,22,22,28,0,2,74,0,6,80
32,2,32015,428,3,91,72,96,8,2,269,0,12,281
32,2,32015,430,3,55,37,64,6,0,162,0,7,169
32,2,32015,431,3,13,10,21,0,0,44,0,0,44
32,2,32015,434,3,19,17,11,0,0,47,0,2,49
32,2,32015,435,3,14,23,25,1,1,64,1,3,68
32,2,32018,552,3,170,86,129,16,6,407,4,9,420
32,2,32018,554,3,78,85,107,4,2,276,0,3,279
32,2,32018,555,3,43,34,55,3,4,139,0,2,141
32,2,32018,558,3,54,30,81,6,2,173,0,1,174
32,2,32018,559,3,105,21,44,5,5,180,0,10,190
32,2,32018,562,3,14,34,15,2,1,66,1,6,73
32,2,32018,563,3,30,19,27,1,1,78,0,5,83
32,2,32019,566,3,122,33,81,21,6,263,1,3,267
32,2,32019,567,3,216,72,135,20,8,451,1,7,459
32,2,32019,570,3,154,61,111,19,4,349,0,11,360
32,2,32019,571,3,150,44,93,12,8,307,2,6,315
32,2,32019,574,3,109,61,115,20,4,309,0,10,319
32,2,32019,575,3,133,78,91,13,7,322,0,11,333
32,2,32019,578,3,137,59,145,21,4,366,0,9,375
32,2,32019,579,3,160,50,98,26,9,343,0,11,354
32,2,32019,582,3,116,20,47,5,2,190,0,10,200
32,2,32019,583,3,157,67,80,6,3,313,0,28,341
32,2,32019,586,3,111,116,69,6,5,307,0,20,327
32,2,32019,587,3,105,47,50,3,2,207,2,4,213
32,2,32019,590,3,61,24,41,5,3,134,0,4,138
32,2,32019,591,3,43,21,25,3,1,93,0,2,95
32,2,32019,594,3,59,18,23,17,1,118,0,13,131
32,2,32019,595,3,11,29,5,1,0,46,2,2,50
32,2,32019,598,3,13,18,14,2,1,48,0,3,51
32,2,32019,599,3,74,33,92,8,4,211,2,13,226
32,2,32019,602,3,7,16,16,2,0,41,0,0,41
32,2,32019,603,3,30,44,16,2,0,92,0,2,94
32,2,32020,606,3,199,103,180,62,21,565,1,23,589
32,2,32020,607,3,73,39,143,18,9,282,2,11,295
32,2,32020,610,3,138,47,116,20,6,327,1,22,350
32,2,32020,611,3,128,85,101,38,11,363,0,8,371
32,2,32020,614,3,80,60,94,29,15,278,2,0,280
32,2,32020,615,3,97,67,99,28,7,298,0,10,308
32,2,32020,618,3,136,60,121,32,12,361,2,14,377
32,2,32020,619,3,96,82,123,30,8,339,1,18,358
32,2,32020,622,3,108,53,108,58,9,336,1,16,353
32,2,32020,623,3,48,71,87,33,5,244,0,4,248
32,2,32020,626,3,92,83,113,45,13,346,0,9,355
32,2,32020,627,3,117,123,175,64,22,501,3,12,516
32,2,32020,630,3,90,70,107,29,11,307,0,11,318
32,2,32020,631,3,92,80,94,28,10,304,2,7,313
32,2,32020,634,3,54,80,110,27,8,279,1,2,282
32,2,32020,635,3,62,75,108,21,6,272,1,18,291
32,2,32020,638,3,109,111,141,31,15,407,0,24,431
32,2,32020,639,3,60,60,68,22,3,213,2,12,227
32,2,32020,642,3,122,60,94,35,7,318,0,18,336
32,2,32020,643,3,119,83,138,57,14,411,2,12,425
32,2,32020,646,3,112,59,94,33,10,308,4,8,320
32,2,32020,647,3,66,41,60,20,9,196,2,14,212
32,2,32020,650,3,48,35,54,23,2,162,0,4,166
32,2,32020,651,3,68,28,52,13,4,165,0,12,177
32,2,32020,654,3,89,36,57,17,8,207,1,15,223
32,2,32020,655,3,38,21,40,3,2,104,0,7,111
32,2,32020,658,3,24,9,17,3,0,53,1,8,62
32,2,32020,659,3,52,18,23,2,1,96,0,6,102
32,2,32020,662,3,39,12,21,3,0,75,0,0,75
32,2,32020,663,3,52,33,29,3,3,120,0,5,125
32,2,32020,666,3,87,10,5,1,0,103,0,4,107
32,2,32020,667,3,62,7,15,1,0,85,0,5,90
32,2,32020,670,3,49,26,52,3,1,131,2,7,140
32,2,32020,671,3,75,18,51,3,3,150,2,4,156
32,2,32020,674,3,27,11,12,0,0,50,1,2,53
32,2,32020,675,3,93,36,33,4,1,167,0,4,171
32,2,32020,678,3,28,12,21,1,0,62,0,3,65
32,2,32020,679,3,27,48,55,6,0,136,0,4,140
32,2,32020,682,3,70,34,133,12,6,255,0,5,260
32,2,32020,683,3,23,33,17,6,4,83,0,5,88
32,2,32020,686,3,70,28,21,8,0,127,4,4,135
32,2,32020,687,3,33,33,63,4,1,134,0,5,139
32,2,32020,690,3,34,15,17,4,2,72,0,2,74
32,2,32020,691,3,47,35,37,1,1,121,0,8,129
32,2,32020,694,3,69,61,23,3,1,157,0,9,166
32,2,32020,695,3,19,22,15,3,2,61,0,1,62
32,2,32020,698,3,45,46,22,3,3,119,0,0,119
32,2,32020,699,3,41,32,29,3,2,107,0,4,107
32,2,32020,702,3,10,7,14,0,0,31,0,3,34
32,2,32020,703,3,9,19,10,2,0,40,0,2,42
32,2,32020,706,3,29,3,7,1,1,41,0,2,43
32,2,32020,707,3,17,14,18,3,2,54,0,8,62
32,2,32023,742,3,208,179,167,58,13,625,3,17,645
32,2,32023,743,3,104,90,118,32,10,354,1,16,371
32,2,32023,746,3,76,94,108,25,12,315,2,9,326
32,2,32023,747,3,98,45,81,22,13,259,0,4,263
32,2,32023,750,3,69,64,81,13,10,237,1,10,248
32,2,32023,751,3,54,43,34,5,2,138,0,2,140
32,2,32023,754,3,29,36,30,12,1,108,0,9,117
32,2,32023,755,3,55,24,42,6,1,128,0,4,132
32,2,32023,758,3,52,18,60,3,2,135,0,5,140
32,2,32023,759,3,8,15,8,2,1,34,0,2,36
32,2,32023,762,3,22,10,56,2,1,91,0,2,93
32,2,32025,794,3,119,93,197,25,12,446,2,8,456
32,2,32025,795,3,139,109,188,17,9,462,0,15,477
32,2,32025,798,3,198,136,213,36,17,600,2,9,611
32,2,32025,799,3,33,92,177,2,2,306,4,6,316
32,2,32025,802,3,45,90,120,9,4,268,0,9,277
32,2,32025,803,3,85,62,106,5,3,261,1,6,268
32,2,32025,806,3,30,34,73,4,3,144,1,4,149
32,2,32025,807,3,4,28,12,1,0,45,0,1,46
32,2,32028,876,3,67,137,83,9,0,296,0,1,297
32,2,32028,878,3,49,34,34,3,1,121,0,0,121
32,2,32028,879,3,14,27,24,0,0,65,0,0,65
32,2,32028,882,3,19,11,34,2,0,66,1,3,70
32,2,32028,883,3,13,18,58,0,2,91,0,0,91
32,2,32030,906,3,89,49,42,0,5,185,0,3,188
32,2,32030,907,3,145,41,30,5,0,221,0,2,223
32,2,32030,910,3,30,5,13,0,1,49,0,0,49
32,2,32030,911,3,67,29,30,1,1,128,0,4,132
32,2,32031,914,3,63,206,44,13,3,329,0,10,339
32,2,32031,915,3,65,174,55,17,4,315,2,15,332
32,2,32031,918,3,135,208,64,12,6,425,2,20,447
32,2,32031,919,3,103,24,39,7,1,174,0,5,179
32,2,32031,922,3,5,22,10,1,0,38,0,0,38
32,2,32031,923,3,55,58,90,1,2,206,1,12,219
32,2,32031,926,3,39,29,30,4,0,102,0,3,105
32,2,32031,927,3,106,119,70,6,4,305,0,13,318
32,2,32031,930,3,10,17,5,3,0,35,0,1,36
32,2,32031,931,3,65,34,6,3,1,109,0,3,112
32,2,32031,934,3,17,25,20,1,1,64,0,5,69
32,2,32031,935,3,13,21,3,0,2,39,2,1,42
32,2,32031,938,3,20,31,8,2,0,61,0,4,65
32,2,32031,939,3,20,8,6,1,1,36,0,0,36
32,2,32031,943,3,39,6,5,1,2,53,0,0,53
32,2,32033,954,3,82,61,100,8,6,257,0,0,257
32,2,32033,955,3,41,46,50,7,7,151,0,3,154
32,2,32033,958,3,56,96,66,4,3,225,2,6,233
32,2,32033,959,3,26,12,24,0,1,63,1,2,66
32,2,32033,962,3,48,54,23,1,5,131,0,3,134
32,2,32033,963,3,80,50,28,3,3,164,1,9,174
32,2,32034,966,3,207,141,75,25,5,453,0,32,485
32,2,32034,967,3,188,113,86,30,11,428,0,16,444
32,2,32034,970,3,166,98,77,30,7,378,1,7,386
32,2,32034,971,3,179,114,99,37,8,437,0,19,456
32,2,32034,974,3,160,65,139,20,12,396,0,19,415
32,2,32034,975,3,85,50,59,13,2,209,0,4,213
32,2,32034,978,3,183,103,76,18,10,390,0,19,409
32,2,32034,979,3,180,79,112,28,12,411,0,18,429
32,2,32034,982,3,211,99,104,12,10,436,0,7,443
32,2,32034,983,3,151,71,74,31,12,339,0,13,352
32,2,32034,986,3,13,51,11,5,1,81,0,7,88
32,2,32034,987,3,29,21,47,5,2,104,2,4,110
32,2,32034,990,3,14,26,13,3,3,59,0,0,59
32,2,32034,991,3,6,3,20,0,0,29,0,0,29
32,2,32034,994,3,39,11,13,1,0,64,0,0,64
32,2,32034,995,3,84,33,86,4,2,209,0,17,226
32,2,32034,998,3,43,16,21,2,1,83,0,1,84
32,2,32034,999,3,95,73,53,10,4,235,1,9,245
32,2,32034,1002,3,90,89,57,8,6,250,13,13,276
32,2,32034,1003,3,118,57,25,7,2,209,0,6,215
32,2,32034,1006,3,13,15,10,1,0,39,0,2,41
32,2,32034,1007,3,88,19,20,5,0,132,0,2,134
32,2,32034,1010,3,18,24,9,1,0,52,0,2,54
32,2,32034,1011,3,30,17,37,4,0,88,0,6,94
32,2,32034,1014,3,53,7,13,2,0,75,0,2,77
32,2,32034,1015,3,39,3,6,2,0,50,0,2,52
32,2,32034,1018,3,15,17,40,1,1,74,0,4,78
32,2,32034,1019,3,64,23,22,7,1,117,0,8,125
32,2,32043,1384,3,51,39,63,11,4,168,1,8,177
32,2,32043,1386,3,21,14,13,1,0,49,0,2,51
32,2,32043,1387,3,62,18,30,2,3,115,0,4,119
32,2,32044,1390,3,185,105,75,14,5,384,0,13,397
32,2,32044,1391,3,226,108,53,23,5,415,1,8,424
32,2,32044,1394,3,90,48,32,7,4,181,0,7,188
32,2,32044,1395,3,87,58,61,2,2,210,1,7,218
32,2,32044,1398,3,40,57,124,9,5,235,2,11,248
32,2,32044,1399,3,27,57,77,0,0,161,0,4,165
32,2,32044,1402,3,134,65,61,1,0,261,0,12,273
32,2,32044,1403,3,44,95,44,6,0,189,0,5,194
32,2,32044,1406,3,28,15,9,1,0,53,0,2,55
32,2,32044,1407,3,47,20,18,3,0,88,0,4,92
32,2,32044,1410,3,13,14,12,1,0,40,0,1,41
32,2,32044,1411,3,70,35,34,0,1,140,0,9,149
32,2,32045,1414,3,80,78,115,13,1,287,1,2,290
32,2,32045,1415,3,40,82,106,0,0,228,0,1,229
32,2,32045,1418,3,65,67,60,14,2,208,0,5,213
32,2,32045,1419,3,33,42,83,0,0,158,0,5,163
32,2,32045,1422,3,9,28,95,1,0,133,0,8,141
32,2,32045,1423,3,39,136,120,6,2,303,1,3,307
32,2,32045,1426,3,9,16,34,1,0,60,0,6,66
32,2,32045,1427,3,14,57,65,2,0,138,0,2,140
32,2,32045,1430,3,33,170,160,4,0,367,0,13,380
32,2,32045,1431,3,2,40,38,0,0,80,0,3,83
32,2,32046,1434,3,89,85,42,10,2,228,0,9,237
32,2,32046,1435,3,86,107,81,10,7,291,1,4,296
32,2,32046,1438,3,9,15,32,0,1,57,1,3,61
32,2,32046,1439,3,67,9,47,4,0,127,0,0,127
32,2,32046,1442,3,52,128,93,6,1,280,0,0,280
32,2,32046,1443,3,43,75,41,5,1,165,3,3,171
32,2,32046,1446,3,10,20,18,2,2,52,0,3,55
32,2,32046,1447,3,29,28,62,3,0,122,0,5,127
32,2,32046,1450,3,41,26,46,1,1,115,1,4,120
32,2,32046,1451,3,14,22,22,1,1,60,0,0,60
32,2,32046,1454,3,14,75,13,0,1,103,0,4,107
32,2,32046,1455,3,26,73,133,3,3,238,0,8,246
32,2,32046,1458,3,23,7,11,0,0,41,0,0,41
32,2,32046,1459,3,5,18,12,3,0,38,0,2,40
32,2,32046,1462,3,11,23,15,2,2,53,0,2,55
32,2,32046,1463,3,11,25,27,0,1,64,0,3,67
32,2,32047,1466,3,104,73,100,6,5,288,1,11,300
32,2,32047,1467,3,161,103,89,8,9,370,2,4,376
32,2,32058,1470,3,43,102,121,5,0,271,1,10,282
32,2,32058,1471,3,79,59,136,6,3,283,1,0,284
32,2,32058,1474,3,11,37,51,2,1,102,0,5,107
32,2,32047,1475,3,48,48,35,3,1,135,0,2,137
32,2,32047,1478,3,71,24,68,1,2,166,0,1,167
32,2,32047,1479,3,71,10,16,0,1,98,0,3,101
32,2,32058,1482,3,17,60,52,0,0,129,0,7,136
32,2,32058,1483,3,8,31,65,4,2,110,2,2,114
32,2,32048,1486,3,184,127,214,30,11,566,3,12,581
32,2,32048,1487,3,106,82,139,15,8,350,5,7,362
32,2,32048,1490,3,123,80,90,9,4,306,0,3,309
32,2,32048,1491,3,132,83,99,18,10,342,0,7,349
32,2,32048,1494,3,88,82,86,12,3,271,0,9,280
32,2,32048,1495,3,139,96,99,11,8,353,1,10,364
32,2,32048,1498,3,189,311,261,64,21,846,6,26,878
32,2,32048,1499,3,81,64,77,19,3,244,0,8,252
32,2,32048,1502,3,71,26,70,0,2,169,1,4,174
32,2,32048,1503,3,37,15,40,5,4,101,0,1,102
32,2,32048,1506,3,36,12,92,5,0,145,0,4,149
32,2,32048,1507,3,43,57,54,5,3,162,1,4,167
32,2,32048,1510,3,23,27,188,2,3,243,0,8,251
32,2,32048,1511,3,107,38,173,21,6,345,1,6,352
32,2,32048,1514,3,54,30,44,3,1,132,0,5,137
32,2,32048,1515,3,21,7,30,1,1,60,0,0,60
32,2,32048,1518,3,46,21,16,3,1,87,1,6,94
32,2,32048,1519,3,36,23,35,1,0,95,0,2,97
32,2,32048,1522,3,44,25,42,5,0,116,0,6,122
32,2,32048,1523,3,45,33,61,5,5,149,0,3,152
32,2,32049,1526,3,96,85,114,34,10,339,1,12,352
32,2,32049,1527,3,137,95,196,28,5,461,0,10,471
32,2,32049,1530,3,108,65,92,9,1,275,0,10,285
32,2,32049,1531,3,146,91,154,26,10,427,0,11,438
32,2,32049,1534,3,161,126,140,31,18,476,0,8,484
32,2,32049,1535,3,205,90,182,37,8,522,3,17,542
32,2,32049,1538,3,172,68,112,25,6,383,1,5,389
32,2,32049,1539,3,66,125,64,4,2,261,0,14,275
32,2,32049,1542,3,18,26,25,0,0,69,1,3,73
32,2,32049,1543,3,46,74,96,2,5,223,5,7,235
32,2,32049,1546,3,64,31,49,4,3,151,0,7,158
32,2,32049,1547,3,13,44,51,1,1,110,0,2,112
32,2,32049,1550,3,33,28,29,1,0,91,0,2,93
32,2,32049,1551,3,37,41,99,0,0,177,2,6,185
32,2,32049,1554,3,29,37,22,2,0,90,0,2,92
32,2,32049,1555,3,53,38,36,6,1,134,0,1,135
32,2,32049,1558,3,54,37,46,3,2,142,0,3,145
32,2,32049,1559,3,50,102,138,8,0,298,0,8,306
32,2,32049,1562,3,28,110,116,6,3,263,0,7,270
32,2,32049,1563,3,76,112,85,5,5,283,0,5,288
32,2,32049,1566,3,16,42,26,1,0,85,0,0,85
32,2,32049,1567,3,40,33,22,0,1,96,0,2,98
32,2,32049,1570,3,33,30,36,6,3,108,0,4,112
32,2,32049,1571,3,64,19,66,2,0,151,1,1,153
32,2,32049,1574,3,12,3,10,1,0,26,0,0,26
32,2,32049,1575,3,11,37,46,3,0,97,1,1,99
32,2,32049,1578,3,104,63,75,5,6,253,0,4,257
32,2,32049,1579,3,29,26,20,2,0,77,0,1,78
32,2,32049,1582,3,18,32,11,3,0,64,0,3,67
32,2,32049,1583,3,9,11,23,0,0,43,0,0,43
32,2,32049,1586,3,83,20,161,1,2,267,1,8,276
32,2,32049,1587,3,15,10,47,0,0,72,0,1,73
32,2,32049,1590,3,12,69,11,0,0,92,0,4,96
32,2,32049,1591,3,25,28,34,0,2,89,0,3,92
32,2,32049,1594,3,28,11,32,4,0,75,0,1,76
32,2,32049,1596,3,7,26,70,0,0,103,0,13,116
32,2,32049,1598,3,6,7,60,0,0,73,0,1,74
32,2,32049,1599,3,23,19,12,1,1,56,0,2,58
32,2,32055,1711,3,212,115,121,57,9,514,0,23,537
32,2,32055,1714,3,97,93,68,10,4,272,4,8,284
32,2,32055,1715,3,142,74,102,20,7,345,2,12,359
32,2,32055,1718,3,155,88,96,29,5,373,0,17,390
32,2,32055,1719,3,149,78,81,25,7,340,2,7,349
32,2,32055,1722,3,98,46,58,15,4,221,2,2,225
32,2,32055,1723,3,157,92,40,7,4,300,6,4,310
32,2,32055,1726,3,87,149,50,11,8,305,1,11,317
32,2,32055,1727,3,125,71,60,67,4,327,0,23,350
32,2,32055,1730,3,59,81,51,43,5,239,0,14,253
32,2,32055,1731,3,52,53,77,11,6,199,8,7,214
32,2,32055,1734,3,93,80,113,8,3,297,8,22,327
32,2,32055,1735,3,20,13,39,1,1,74,1,3,78
32,2,32055,1738,3,17,82,108,4,0,211,0,6,217
32,2,32055,1739,3,33,55,122,4,4,218,3,14,235
32,2,32055,1742,3,6,23,34,2,1,66,1,1,68
32,2,32055,1743,3,29,45,25,4,2,105,1,2,108
32,2,32055,1746,3,37,23,29,2,0,91,0,3,94
32,2,32055,1747,3,11,17,9,2,0,39,0,2,41
32,2,32055,1750,3,42,25,31,2,2,102,0,5,107
32,2,32055,1751,3,53,10,19,5,2,89,3,6,98
32,2,32055,1754,3,10,4,17,3,0,34,0,2,36
32,2,32055,1755,3,91,21,16,18,3,149,0,6,155
32,2,32055,1758,3,48,24,33,3,2,110,0,11,121
32,2,32055,1759,3,25,80,49,2,0,156,4,6,166
32,2,32055,1762,3,18,16,34,1,0,69,0,6,75
32,2,32055,1763,3,22,12,8,8,3,53,0,3,56
32,2,32055,1766,3,9,8,26,1,1,45,0,3,48
32,2,32055,1767,3,5,24,9,2,0,40,0,0,40
32,2,32055,1770,3,13,14,19,0,0,46,0,8,54
32,2,32055,1771,3,1,14,12,0,0,27,0,0,27
32,3,32006,61,3,144,79,111,28,9,371,3,10,384
32,3,32006,62,3,101,46,161,24,4,336,0,7,343
32,3,32006,63,3,124,54,104,16,4,302,0,9,311
32,3,32006,66,3,106,62,163,25,10,366,3,10,379
32,3,32006,67,3,54,26,93,6,3,182,1,3,186
32,3,32006,70,3,24,41,157,5,0,227,0,0,227
32,3,32006,71,3,11,29,26,0,0,66,0,3,69
32,3,32007,74,3,65,104,71,12,5,257,0,7,264
32,3,32007,75,3,92,98,82,27,6,305,0,3,308
32,3,32007,78,3,71,122,87,43,3,326,0,7,333
32,3,32007,79,3,120,153,125,26,11,435,2,7,444
32,3,32007,82,3,32,50,44,9,1,136,0,0,136
32,3,32007,83,3,11,83,78,1,0,173,0,4,177
32,3,32007,86,3,11,35,38,4,2,90,0,3,93
32,3,32007,87,3,4,41,42,0,0,87,0,3,90
32,3,32007,90,3,1,29,9,0,0,39,0,0,39
32,3,32007,91,3,6,72,75,1,0,154,0,3,157
32,3,32007,94,3,5,17,63,2,0,87,0,1,88
32,3,32007,95,3,9,29,21,2,0,61,0,0,61
32,3,32007,98,3,2,60,23,0,0,85,0,4,89
32,3,32007,99,3,6,11,19,1,0,37,0,1,38
32,3,32007,102,3,3,24,23,1,1,52,0,2,54
32,3,32014,386,3,232,81,113,12,2,440,0,12,452
32,3,32014,387,3,236,48,94,8,1,387,0,15,402
32,3,32014,390,3,138,61,78,4,0,281,0,8,289
32,3,32014,391,3,187,49,116,10,10,372,0,14,386
32,3,32014,394,3,36,35,70,0,0,141,1,6,148
32,3,32014,395,3,59,22,81,3,1,166,0,0,166
32,3,32014,398,3,71,30,57,1,0,159,14,14,187
32,3,32014,399,3,44,88,56,1,0,189,1,7,197
32,3,32014,402,3,92,55,134,0,5,286,0,24,310
32,3,32014,403,3,33,31,41,1,3,109,0,3,112
32,3,32014,406,3,25,94,79,1,1,200,0,4,204
32,3,32014,407,3,41,114,70,2,0,227,0,2,229
32,3,32014,410,3,15,63,78,2,0,158,2,7,167
32,3,32014,411,3,48,63,33,3,0,147,0,6,153
32,3,32014,414,3,62,110,112,1,1,286,0,7,293
32,3,32014,415,3,28,52,58,2,0,140,0,3,143
32,3,32014,418,3,37,16,39,1,0,93,0,1,94
32,3,32014,419,3,37,27,48,2,1,115,0,9,124
32,3,32014,422,3,12,22,25,1,0,60,2,1,63
32,3,32014,423,3,10,13,29,0,0,52,4,0,56
32,3,32014,426,3,25,53,26,1,0,105,0,1,106
32,3,32014,427,3,53,12,22,0,0,87,1,1,89
32,3,32022,718,3,154,108,188,9,9,468,0,10,478
32,3,32022,719,3,212,123,111,9,15,470,7,9,486
32,3,32022,722,3,182,100,121,8,10,421,0,11,432
32,3,32022,723,3,152,64,151,10,9,386,3,15,404
32,3,32022,726,3,174,62,134,14,8,392,3,7,402
32,3,32022,727,3,163,32,84,9,7,295,2,5,302
32,3,32022,730,3,146,73,95,12,13,339,3,6,348
32,3,32022,731,3,90,29,67,3,4,193,3,2,198
32,3,32022,734,3,64,28,49,1,1,143,0,4,147
32,3,32022,735,3,39,37,50,2,1,129,3,4,136
32,3,32022,738,3,18,6,32,1,0,57,7,2,66
32,3,32022,739,3,127,42,107,4,2,282,6,7,295
32,3,32026,808,3,37,58,91,9,4,199,0,5,204
32,3,32026,810,3,26,56,90,0,0,172,0,6,178
32,3,32026,811,3,17,69,126,14,0,226,0,5,231
32,3,32026,814,3,10,32,62,1,0,105,2,4,111
32,3,32026,815,3,16,25,21,0,1,63,0,1,64
32,3,32026,818,3,2,18,11,0,0,31,0,2,33
32,3,32026,819,3,10,30,46,0,2,88,0,3,91
32,3,32026,822,3,22,85,87,8,3,205,1,8,214
32,3,32026,823,3,17,64,17,4,0,102,2,5,109
32,3,32026,826,3,1,62,66,0,0,129,0,0,129
32,3,32026,827,3,26,50,63,3,3,145,0,9,154
32,3,32026,830,3,5,26,21,0,0,52,0,0,52
32,3,32026,831,3,2,39,57,1,0,99,0,3,102
32,3,32026,834,3,3,24,55,2,0,84,0,0,84
32,3,32026,835,3,3,74,61,0,0,138,0,2,140
32,3,32026,838,3,11,41,32,1,2,87,0,0,87
32,3,32026,839,3,2,13,25,0,0,40,0,1,41
32,3,32026,842,3,34,16,51,10,1,112,0,1,113
32,3,32026,843,3,10,38,26,1,0,75,1,0,76
32,3,32026,846,3,10,36,30,2,0,78,4,0,82
32,3,32026,847,3,2,19,15,0,0,36,0,1,37
32,3,32026,850,3,7,8,23,0,0,38,0,0,38
32,3,32026,851,3,2,25,35,0,1,63,0,4,67
32,3,32026,854,3,3,14,44,0,0,61,0,3,64
32,3,32026,856,3,4,27,17,1,0,49,0,0,49
32,3,32026,858,3,3,11,19,0,0,33,0,9,42
32,3,32026,859,3,2,54,45,0,0,101,0,0,101
32,3,32026,862,3,6,19,32,0,0,57,1,1,59
32,3,32026,863,3,9,35,56,1,3,104,0,1,105
32,3,32026,866,3,12,23,25,1,1,62,0,1,63
32,3,32026,867,3,3,43,68,1,0,115,0,3,118
32,3,32027,870,3,0,32,30,1,1,64,0,0,64
32,3,32027,871,3,10,39,70,1,1,121,0,4,125
32,3,32027,874,3,5,40,9,0,0,54,0,1,55
32,3,32027,875,3,1,20,22,0,0,43,0,1,44
32,3,32032,945,3,227,121,163,43,17,571,11,7,589
32,3,32032,946,3,246,115,185,38,25,609,3,13,625
32,3,32032,947,3,236,166,199,42,12,655,8,26,689
32,3,32032,950,3,8,18,10,1,1,38,1,1,40
32,3,32032,951,3,166,77,127,13,2,385,0,21,406
32,3,32037,1080,3,157,98,99,22,11,387,0,22,409
32,3,32037,1082,3,90,58,103,18,3,272,3,10,285
32,3,32037,1083,3,20,27,24,2,0,73,0,3,76
32,3,32037,1086,3,120,128,232,26,4,510,4,28,542
32,3,32037,1087,3,113,142,240,13,7,515,5,25,545
32,3,32037,1090,3,356,74,129,16,7,582,6,5,593
32,3,32037,1091,3,73,68,144,7,6,298,2,16,316
32,3,32039,1192,3,80,100,114,12,4,310,0,8,318
32,3,32039,1194,3,108,77,85,34,17,321,5,4,330
32,3,32039,1195,3,77,93,105,13,14,302,8,15,325
32,3,32039,1198,3,79,126,87,14,6,312,0,16,328
32,3,32039,1199,3,163,54,95,19,12,343,0,9,352
32,3,32039,1202,3,209,191,162,45,30,637,1,18,656
32,3,32039,1203,3,106,120,86,20,13,345,0,11,356
32,3,32039,1206,3,132,109,112,18,12,383,2,8,393
32,3,32039,1207,3,185,98,106,26,16,431,2,6,439
32,3,32039,1210,3,143,140,135,18,12,448,1,8,457
32,3,32039,1211,3,175,169,134,26,20,524,1,9,534
32,3,32039,1214,3,85,82,85,14,7,273,0,0,273
32,3,32039,1215,3,296,236,236,59,34,861,5,13,879
32,3,32039,1218,3,83,86,95,7,5,276,1,10,287
32,3,32039,1219,3,47,78,114,3,5,247,3,6,256
32,3,32039,1222,3,34,73,97,3,2,209,9,7,225
32,3,32039,1223,3,47,122,98,10,7,284,3,4,291
32,3,32039,1226,3,204,241,185,20,19,669,4,10,683
32,3,32039,1227,3,92,122,69,7,10,300,1,12,313
32,3,32039,1230,3,57,116,87,5,4,269,1,7,277
32,3,32039,1231,3,36,279,86,1,1,403,1,10,414
32,3,32039,1234,3,152,55,49,8,1,265,0,4,269
32,3,32039,1235,3,84,260,80,4,3,431,4,12,447
32,3,32039,1238,3,39,135,58,5,6,243,1,3,247
32,3,32039,1239,3,42,94,58,5,5,204,5,9,218
32,3,32039,1242,3,171,120,70,2,2,365,2,7,374
32,3,32039,1243,3,15,47,68,1,5,136,0,7,143
32,3,32039,1246,3,41,47,88,4,3,183,2,3,188
32,3,32039,1247,3,32,56,94,7,4,193,1,6,200
32,3,32039,1250,3,72,156,116,11,7,362,14,7,383
32,3,32039,1251,3,17,57,39,1,3,117,0,3,120
32,3,32039,1254,3,11,21,10,1,0,43,0,0,43
32,3,32039,1255,3,6,82,50,2,3,143,0,0,143
32,3,32041,1283,3,18,88,109,3,0,218,0,5,223
32,3,32041,1286,3,14,148,253,5,1,421,0,9,430
32,3,32041,1287,3,19,45,80,5,0,149,1,7,157
32,3,32050,1601,3,118,91,101,12,6,328,5,11,344
32,3,32050,1602,3,105,131,132,11,2,381,2,9,392
32,3,32050,1603,3,157,94,249,14,2,516,4,14,534
32,3,32050,1606,3,102,92,266,18,9,487,0,22,509
32,3,32050,1607,3,128,108,215,21,9,481,5,23,509
32,3,32051,1610,3,208,88,203,24,13,536,5,13,554
32,3,32051,1611,3,109,66,183,19,12,389,0,13,402
32,3,32051,1614,3,124,182,209,25,13,553,4,6,563
32,3,32051,1615,3,108,160,190,30,10,498,4,14,516
32,3,32051,1618,3,52,85,222,8,2,369,2,13,384
32,3,32051,1619,3,7,42,86,3,3,141,1,0,142
32,3,32051,1622,3,50,83,92,11,3,239,0,17,256
32,3,32051,1623,3,21,50,48,5,0,124,0,8,132
32,3,32051,1626,3,6,20,60,3,0,89,0,0,89
32,3,32051,1627,3,52,82,193,8,9,344,0,15,359
32,3,32051,1630,3,26,41,44,6,1,118,0,5,123
32,3,32051,1631,3,55,34,100,7,1,197,0,8,205
32,3,32051,1634,3,57,35,138,18,5,253,2,12,267
32,3,32051,1635,3,38,38,197,8,5,286,2,5,293
32,3,32051,1638,3,119,45,172,13,7,356,0,16,372
32,3,32051,1639,3,156,28,127,7,4,322,1,3,326
32,3,32051,1642,3,18,35,94,1,0,148,0,4,152
32,3,32051,1643,3,96,25,75,3,2,201,0,9,210
32,3,32051,1646,3,4,19,47,3,3,76,0,1,77
32,3,32051,1647,3,6,10,38,3,1,58,0,0,58
32,3,32051,1650,3,20,16,92,3,0,131,1,9,141
32,3,32051,1651,3,6,2,18,0,0,26,0,3,29
32,3,32051,1654,3,26,90,79,5,1,201,0,9,210
32,3,32051,1655,3,30,34,58,11,4,137,0,9,146
32,3,32051,1658,3,29,15,26,3,0,73,0,0,73
32,3,32056,1772,3,119,107,122,38,19,405,2,12,419
32,3,32056,1774,3,110,135,241,41,23,550,3,20,573
32,3,32056,1775,3,144,147,240,49,23,603,3,15,621
32,3,32056,1778,3,150,128,217,45,24,564,7,30,601
32,3,32056,1779,3,119,145,178,38,21,501,4,6,511
32,3,32056,1782,3,101,101,145,43,20,410,2,16,428
32,3,32056,1783,3,123,102,182,45,28,480,8,12,500
32,3,32056,1786,3,88,87,83,38,6,302,3,16,321
32,3,32056,1787,3,116,79,77,24,9,305,2,10,317
32,3,32056,1790,3,108,137,179,34,11,469,5,4,478
32,3,32056,1791,3,146,165,333,50,11,705,15,22,742
32,3,32056,1794,3,131,88,104,26,11,360,0,13,373
32,3,32056,1795,3,87,68,121,25,13,314,4,16,334
32,3,32056,1798,3,117,97,176,36,21,447,6,9,462
32,3,32056,1799,3,102,93,180,39,14,428,7,23,458
32,3,32056,1802,3,98,75,119,41,12,345,2,9,356
32,3,32056,1803,3,135,103,184,59,23,504,2,8,514
32,3,32056,1806,3,143,141,220,52,16,572,4,12,588
32,3,32056,1807,3,187,139,224,50,28,628,1,18,647
32,3,32056,1810,3,200,138,129,50,21,538,3,18,559
32,3,32056,1811,3,133,87,153,48,19,440,4,16,460
32,3,32056,1814,3,105,34,56,21,2,218,0,5,223
32,3,32056,1815,3,138,78,77,24,18,335,2,7,344
32,3,32056,1818,3,360,257,145,39,17,818,2,16,836
32,3,32056,1819,3,157,137,184,45,27,550,5,11,566
32,3,32056,1822,3,126,138,158,50,16,488,13,17,518
32,3,32056,1823,3,126,155,161,44,20,506,13,21,540
32,3,32056,1826,3,250,187,99,28,14,578,3,10,591
32,3,32056,1827,3,231,142,130,30,10,543,2,8,553
32,3,32056,1830,3,133,83,132,29,21,398,2,15,415
32,3,32056,1831,3,451,264,272,80,33,1100,8,29,1137
32,3,32056,1834,3,99,144,191,47,17,498,14,19,531
32,3,32056,1835,3,115,89,158,43,15,420,0,26,446
32,3,32056,1838,3,146,97,124,44,9,420,2,10,432
32,3,32056,1839,3,151,107,128,30,10,426,4,11,441
32,3,32056,1842,3,107,122,144,36,18,427,5,17,449
32,3,32056,1843,3,154,103,179,44,24,504,13,8,525
32,3,32056,1846,3,94,95,166,45,16,416,3,23,442
32,3,32056,1847,3,120,147,209,64,22,562,2,9,573
32,3,32056,1850,3,78,45,115,23,21,282,4,10,296
32,3,32056,1851,3,118,96,159,26,21,420,0,16,436
32,3,32056,1854,3,109,99,157,38,11,414,3,20,437
32,3,32056,1855,3,90,107,137,31,9,374,10,16,400
32,3,32056,1858,3,102,139,151,54,15,461,7,15,483
32,3,32056,1859,3,198,186,267,64,26,741,11,38,790
32,3,32056,1862,3,241,150,202,70,21,684,3,17,704
32,3,32056,1863,3,135,127,165,47,15,489,4,16,509
32,3,32056,1866,3,84,62,92,23,13,274,0,12,286
32,3,32056,1867,3,58,53,63,20,6,200,3,7,210
32,3,32056,1870,3,576,320,488,147,69,1600,4,22,1626
32,3,32056,1871,3,39,41,116,8,2,206,0,5,211
32,3,32056,1874,3,208,136,227,36,13,620,20,21,661
32,3,32056,1875,3,195,125,136,20,25,501,7,13,521
32,3,32056,1878,3,55,57,109,6,6,233,3,8,244
32,3,32056,1879,3,42,41,96,10,2,191,4,6,201
32,3,32056,1882,3,34,24,40,0,3,101,0,10,111
32,4,32016,436,3,51,80,197,13,7,348,0,9,357
32,4,32016,438,3,51,103,151,23,10,338,0,18,356
32,4,32016,439,3,72,104,158,17,8,359,8,9,376
32,4,32016,442,3,112,111,152,20,10,405,3,29,437
32,4,32016,443,3,56,66,60,15,5,202,0,11,213
32,4,32016,446,3,104,36,98,12,5,255,10,10,275
32,4,32016,447,3,185,71,145,11,1,413,1,13,427
32,4,32016,450,3,80,85,77,17,6,265,8,14,287
32,4,32016,451,3,75,60,84,16,6,241,7,10,258
32,4,32016,454,3,31,66,57,16,3,173,1,14,188
32,4,32016,455,3,50,54,159,10,4,277,4,12,293
32,4,32016,458,3,48,51,55,26,2,182,4,7,193
32,4,32016,459,3,89,16,206,6,6,323,0,7,330
32,4,32017,462,3,72,54,81,24,6,237,4,3,244
32,4,32017,463,3,335,113,237,81,27,793,9,17,819
32,4,32017,466,3,194,151,261,76,26,708,8,19,735
32,4,32017,467,3,276,198,309,100,49,932,2,17,951
32,4,32017,470,3,492,400,867,200,70,2029,37,61,2127
32,4,32017,471,3,313,269,388,90,33,1093,5,28,1126
32,4,32017,474,3,177,76,148,59,20,480,3,13,496
32,4,32017,475,3,187,121,153,68,24,553,0,17,570
32,4,32017,478,3,95,76,99,32,19,321,2,0,323
32,4,32017,479,3,103,76,111,45,18,353,0,13,366
32,4,32017,482,3,122,133,160,48,21,484,2,11,497
32,4,32017,483,3,150,101,186,61,22,520,2,11,533
32,4,32017,486,3,155,131,170,43,16,515,4,5,524
32,4,32017,487,3,136,150,139,40,12,477,6,11,494
32,4,32017,490,3,218,103,167,50,11,549,3,16,568
32,4,32017,491,3,67,46,98,22,6,239,0,7,246
32,4,32017,494,3,407,242,442,151,50,1292,2,53,1347
32,4,32017,495,3,163,98,195,69,26,551,1,10,562
32,4,32017,498,3,72,68,148,32,13,333,0,10,343
32,4,32017,499,3,227,94,179,62,21,583,0,23,606
32,4,32017,502,3,137,146,178,37,21,519,12,20,551
32,4,32017,503,3,150,106,149,37,15,457,1,16,474
32,4,32017,506,3,111,148,144,31,22,456,10,18,484
32,4,32017,507,3,275,332,479,104,50,1240,25,64,1329
32,4,32017,510,3,231,189,260,104,37,821,17,24,862
32,4,32017,511,3,13,14,114,4,2,147,1,4,152
32,4,32017,514,3,63,83,207,9,7,369,0,15,384
32,4,32017,515,3,33,36,179,7,3,258,2,10,270
32,4,32017,518,3,86,101,182,39,13,421,2,17,440
32,4,32017,519,3,115,91,187,44,18,455,3,17,475
32,4,32017,522,3,102,75,215,35,14,441,0,19,460
32,4,32017,523,3,122,181,211,26,15,555,3,13,571
32,4,32057,526,3,19,104,88,10,0,221,0,8,229
32,4,32057,527,3,172,229,351,24,14,790,10,22,822
32,4,32057,530,3,86,241,227,28,11,593,5,17,615
32,4,32057,531,3,112,228,245,17,7,609,11,14,634
32,4,32017,534,3,106,106,99,18,6,335,2,27,364
32,4,32017,535,3,119,119,201,30,9,478,6,22,506
32,4,32017,538,3,53,16,55,5,5,134,0,9,143
32,4,32017,539,3,144,122,187,31,9,493,7,15,515
32,4,32017,542,3,130,99,199,26,15,469,7,20,496
32,4,32017,543,3,104,173,244,15,12,548,10,36,594
32,4,32017,546,3,17,10,37,2,1,67,0,7,74
32,4,32017,547,3,15,26,87,6,2,136,1,8,145
32,4,32017,550,3,1084,646,1378,439,185,3732,8,102,3842
32,4,32017,551,3,143,198,320,73,43,777,22,27,826
32,4,32024,763,3,180,93,272,51,22,618,11,27,656
32,4,32024,766,3,135,69,205,61,13,483,1,15,499
32,4,32024,767,3,116,79,164,47,14,420,0,14,434
32,4,32024,770,3,60,46,120,24,9,259,0,8,267
32,4,32024,771,3,20,61,89,6,2,178,3,4,185
32,4,32024,774,3,123,80,154,41,16,414,0,24,438
32,4,32024,775,3,109,62,186,23,15,395,0,1,396
32,4,32024,778,3,115,65,120,11,2,313,7,11,331
32,4,32024,779,3,133,128,163,15,13,452,6,22,480
32,4,32024,782,3,182,131,92,22,6,433,7,16,456
32,4,32024,783,3,40,34,116,0,1,191,2,9,202
32,4,32024,786,3,75,176,176,50,18,495,4,24,523
32,4,32024,787,3,44,181,104,15,4,348,1,27,376
32,4,32024,790,3,153,123,191,16,16,499,0,33,532
32,4,32024,791,3,122,92,144,20,10,388,2,10,400
32,4,32035,1020,3,102,81,151,13,2,349,0,13,362
32,4,32035,1022,3,43,65,136,6,3,253,0,5,258
32,4,32035,1023,3,55,69,111,0,6,241,2,5,248
32,4,32035,1026,3,49,154,172,10,1,386,11,6,403
32,4,32035,1027,3,16,76,39,7,0,138,0,3,141
32,4,32035,1030,3,150,91,299,18,10,568,2,34,604
32,4,32035,1031,3,43,146,208,20,5,422,2,15,439
32,4,32035,1034,3,10,54,84,2,3,153,0,2,155
32,4,32035,1035,3,9,22,24,3,0,58,0,2,60
32,4,32036,1038,3,141,156,113,45,14,469,1,13,483
32,4,32036,1039,3,93,133,99,49,10,384,8,13,405
32,4,32036,1042,3,113,191,94,35,20,453,5,14,472
32,4,32036,1043,3,180,168,103,29,16,496,1,27,524
32,4,32036,1046,3,149,110,84,41,8,392,6,15,413
32,4,32036,1047,3,171,240,161,48,22,642,9,19,670
32,4,32036,1050,3,48,66,57,7,4,182,5,10,197
32,4,32036,1051,3,52,113,188,8,4,365,1,9,375
32,4,32036,1054,3,50,99,61,5,5,220,0,4,224
32,4,32036,1055,3,48,32,56,3,0,139,2,6,147
32,4,32036,1058,3,98,71,36,8,0,213,1,16,230
32,4,32036,1059,3,35,108,41,7,4,195,1,0,196
32,4,32036,1062,3,33,40,31,3,2,109,0,7,116
32,4,32036,1063,3,53,30,55,5,2,145,3,7,155
32,4,32036,1066,3,48,92,146,5,3,294,1,20,315
32,4,32036,1067,3,147,74,177,25,10,433,2,20,455
32,4,32036,1070,3,33,21,90,8,3,155,4,5,164
32,4,32036,1071,3,75,15,64,5,3,162,0,9,171
32,4,32036,1074,3,13,19,18,4,3,57,0,1,58
32,4,32036,1075,3,12,28,17,5,2,64,0,0,64
32,4,32036,1078,3,14,61,14,1,0,90,6,10,106
32,4,32036,1079,3,7,28,7,0,0,42,0,0,42
32,4,32038,1094,3,159,213,101,6,6,485,4,20,509
32,4,32038,1095,3,148,175,64,8,4,399,0,7,406
32,4,32038,1098,3,7,87,40,1,0,135,0,5,140
32,4,32038,1099,3,20,192,66,2,1,281,0,9,290
32,4,32038,1102,3,19,107,30,0,1,157,0,4,161
32,4,32038,1103,3,3,77,34,1,0,115,0,0,115
32,4,32038,1106,3,38,283,150,1,2,474,0,23,497
32,4,32038,1107,3,46,102,82,1,2,233,1,0,234
32,4,32038,1110,3,26,140,55,1,3,225,0,13,238
32,4,32038,1111,3,44,317,98,7,1,467,1,16,484
32,4,32038,1114,3,16,120,94,5,3,238,0,6,244
32,4,32038,1115,3,54,366,93,9,4,526,0,12,538
32,4,32038,1118,3,90,143,93,11,7,344,0,26,370
32,4,32038,1119,3,119,198,147,5,5,474,4,10,488
32,4,32038,1122,3,36,82,36,0,2,156,2,3,161
32,4,32038,1123,3,30,194,187,0,5,416,1,21,438
32,4,32038,1126,3,10,88,42,3,0,143,0,4,147
32,4,32038,1127,3,60,345,278,7,8,698,0,20,718
32,4,32038,1130,3,13,192,164,5,5,379,0,12,391
32,4,32038,1131,3,21,189,225,7,4,446,4,17,467
32,4,32038,1134,3,25,200,185,3,2,415,0,3,418
32,4,32038,1135,3,32,176,117,0,3,328,3,5,336
32,4,32038,1138,3,85,365,110,5,6,571,1,13,585
32,4,32038,1139,3,15,214,74,1,2,306,0,10,316
32,4,32038,1142,3,12,116,48,6,2,184,0,4,188
32,4,32038,1143,3,55,158,48,7,5,273,0,17,290
32,4,32038,1146,3,14,56,42,0,1,113,0,8,121
32,4,32038,1147,3,62,153,48,6,2,271,0,20,291
32,4,32038,1150,3,28,136,60,3,0,227,3,6,236
32,4,32038,1151,3,34,146,76,2,4,262,2,7,271
32,4,32038,1154,3,35,99,52,8,4,198,7,5,210
32,4,32038,1155,3,99,182,47,0,0,328,0,21,349
32,4,32038,1158,3,5,140,13,1,0,159,1,6,166
32,4,32038,1159,3,54,185,59,3,0,301,2,16,319
32,4,32038,1162,3,5,44,42,0,0,91,0,3,94
32,4,32038,1163,3,10,30,20,0,0,60,0,3,63
32,4,32038,1166,3,5,75,13,0,0,93,0,8,101
32,4,32038,1167,3,6,55,15,1,1,78,0,4,82
32,4,32038,1170,3,8,81,35,2,0,126,3,3,132
32,4,32038,1171,3,31,90,80,6,3,210,0,6,216
32,4,32038,1174,3,22,69,46,0,1,138,0,8,146
32,4,32038,1175,3,8,33,43,1,0,85,0,4,89
32,4,32038,1178,3,3,52,32,0,0,87,0,1,88
32,4,32038,1179,3,20,43,45,3,6,117,0,6,123
32,4,32038,1182,3,18,73,39,2,2,134,0,8,142
32,4,32038,1183,3,3,72,34,0,0,109,0,6,115
32,4,32038,1186,3,3,63,25,0,0,91,0,3,94
32,4,32038,1187,3,8,77,31,1,0,117,1,3,121
32,4,32038,1190,3,12,115,37,0,0,164,0,6,170
32,4,32038,1191,3,10,43,52,0,0,105,0,2,107
32,4,32052,1659,3,118,213,302,62,7,702,3,13,718
32,4,32052,1662,3,112,206,301,36,27,682,2,17,701
32,4,32052,1663,3,24,95,101,5,3,228,1,4,233
32,4,32052,1666,3,18,113,145,6,2,284,0,2,286
32,4,32052,1667,3,43,143,215,0,5,406,0,0,406
32,4,32052,1670,3,35,99,84,9,3,230,1,4,235
32,4,32052,1671,3,76,282,276,17,5,656,1,16,673
32,4,32052,1674,3,5,32,55,2,1,95,0,0,95
32,4,32053,1675,3,85,196,186,30,8,505,2,19,526
32,4,32053,1678,3,119,122,278,21,11,551,2,12,565
32,4,32053,1679,3,79,89,115,14,6,303,1,11,315
32,4,32053,1682,3,64,40,123,6,4,237,2,8,247
32,4,32053,1683,3,52,126,108,9,2,297,0,8,305
32,4,32053,1686,3,55,134,118,17,3,327,1,7,335
32,4,32054,1687,3,51,229,237,17,10,544,2,16,562
32,4,32054,1690,3,43,59,119,5,0,226,0,1,227
32,4,32054,1691,3,50,190,118,7,1,366,0,27,393
32,4,32054,1694,3,31,29,100,1,1,162,0,23,185
32,4,32054,1695,3,37,78,122,1,0,238,1,11,250
32,4,32054,1698,3,10,33,114,0,1,158,0,7,165
32,4,32054,1699,3,45,152,233,4,1,435,0,17,452
32,4,32054,1702,3,15,34,83,3,2,137,0,13,150
32,4,32054,1703,3,14,13,48,2,0,77,3,5,85
32,4,32054,1706,3,3,32,20,0,0,55,0,1,56
32,4,32054,1707,3,18,49,24,0,1,92,0,8,100
32,4,32054,1710,3,22,62,88,6,2,180,0,8,188
